BA,BNotA,NotBA,NotBNotA,alignment,baseDenom,baseNum,category,conv,corpus,docId,numUtterances,powerDenom,powerNum,replierId,sparsityA,sparsityB,speakerId
1,0,0,2,0.980829253,2,0,do,"('OPE', 'MOT')",Providence,ale01.xml,3,1,1,MOT,14,64,OPE
0,3,1,8,0.080042708,11,3,the,"('TOY', 'MOT')",Providence,ale01.xml,12,1,0,MOT,141,282,TOY
1,1,5,5,0,6,1,to,"('TOY', 'MOT')",Providence,ale01.xml,12,6,1,MOT,141,282,TOY
0,1,4,7,-0.182321557,8,1,for,"('TOY', 'MOT')",Providence,ale01.xml,12,4,0,MOT,141,282,TOY
1,1,1,0,-0.287682072,1,1,you,"('OPE', 'MOT')",Providence,ale01.xml,3,2,1,MOT,14,64,OPE
0,1,1,1,-0.405465108,2,1,where,"('OPE', 'MOT')",Providence,ale01.xml,3,1,0,MOT,14,64,OPE
0,2,4,6,-0.587786665,8,2,a,"('TOY', 'MOT')",Providence,ale01.xml,12,4,0,MOT,141,282,TOY
1,0,1,15,2.140066163,15,0,to,"('AD2', 'MOT')",Providence,ale02.xml,17,2,1,MOT,306,85,AD2
1,0,3,13,1.609437912,13,0,one,"('AD2', 'MOT')",Providence,ale02.xml,17,4,1,MOT,306,85,AD2
2,0,4,11,1.584120104,11,0,the,"('AD2', 'MOT')",Providence,ale02.xml,17,6,2,MOT,306,85,AD2
1,0,0,3,1.203972804,3,0,a,"('OPE', 'MOT')",Providence,ale02.xml,4,1,1,MOT,20,13,OPE
0,1,1,15,1.098612289,16,1,oh,"('AD2', 'MOT')",Providence,ale02.xml,17,1,0,MOT,306,85,AD2
0,1,1,15,1.098612289,16,1,put,"('AD2', 'MOT')",Providence,ale02.xml,17,1,0,MOT,306,85,AD2
0,1,2,14,0.753771802,15,1,and,"('AD2', 'MOT')",Providence,ale02.xml,17,2,0,MOT,306,85,AD2
1,0,0,1,0.693147181,1,0,on,"('MOT', 'OPE')",Providence,ale02.xml,2,1,1,OPE,26,14,MOT
0,1,3,13,0.470003629,14,1,it,"('AD2', 'MOT')",Providence,ale02.xml,17,3,0,MOT,306,85,AD2
0,1,3,13,0.470003629,14,1,on,"('AD2', 'MOT')",Providence,ale02.xml,17,3,0,MOT,306,85,AD2
0,10,1,23,0.0588405,33,10,one,"('CHI', 'MOT')",Providence,ale02.xml,34,1,0,MOT,121,701,CHI
1,1,0,0,0,1,1,what,"('MOT', 'AD2')",Providence,ale02.xml,2,1,1,AD2,30,21,MOT
0,1,6,10,-0.207639365,11,1,you,"('AD2', 'MOT')",Providence,ale02.xml,17,6,0,MOT,306,85,AD2
0,1,6,10,-0.207639365,11,1,there,"('AD2', 'MOT')",Providence,ale02.xml,17,6,0,MOT,306,85,AD2
1,3,6,7,-0.405465108,10,3,go,"('AD2', 'MOT')",Providence,ale02.xml,17,7,1,MOT,306,85,AD2
0,2,5,10,-0.405465108,12,2,get,"('AD2', 'MOT')",Providence,ale02.xml,17,5,0,MOT,306,85,AD2
0,1,1,0,-0.693147181,1,1,on,"('MOT', 'AD2')",Providence,ale02.xml,2,1,0,AD2,30,21,MOT
0,14,1,142,1.255932543,156,14,no,"('CHI', 'MOT')",Providence,ale03.xml,157,1,0,MOT,727,2906,CHI
1,31,0,125,1.191394022,156,31,a,"('CHI', 'MOT')",Providence,ale03.xml,157,1,1,MOT,727,2906,CHI
0,17,1,139,1.073610986,156,17,one,"('CHI', 'MOT')",Providence,ale03.xml,157,1,0,MOT,727,2906,CHI
1,26,0,97,1.127011763,123,26,a,"('CHI', 'MOT')",Providence,ale04.xml,124,1,1,MOT,691,2017,CHI
0,1,1,6,0.405465108,7,1,yeah,"('GRA', 'MOT')",Providence,ale04.xml,8,1,0,MOT,42,37,GRA
0,3,1,4,-0.287682072,7,3,what,"('GRA', 'MOT')",Providence,ale04.xml,8,1,0,MOT,42,37,GRA
1,23,0,123,1.413693335,146,23,oh,"('CHI', 'MOT')",Providence,ale06.xml,147,1,1,MOT,782,2288,CHI
1,0,0,4,1.386294361,4,0,with,"('MOT', 'GRA')",Providence,ale06.xml,5,1,1,GRA,47,25,MOT
0,20,1,126,0.854077547,146,20,this,"('CHI', 'MOT')",Providence,ale06.xml,147,1,0,MOT,782,2288,CHI
0,1,1,6,0.405465108,7,1,that,"('GRA', 'MOT')",Providence,ale06.xml,8,1,0,MOT,36,170,GRA
1,2,1,4,0.287682072,6,2,is,"('GRA', 'MOT')",Providence,ale06.xml,8,2,1,MOT,36,170,GRA
0,1,2,5,0,6,1,oh,"('GRA', 'MOT')",Providence,ale06.xml,8,2,0,MOT,36,170,GRA
0,2,1,5,0,7,2,he,"('GRA', 'MOT')",Providence,ale06.xml,8,1,0,MOT,36,170,GRA
0,1,1,3,0,4,1,the,"('MOT', 'GRA')",Providence,ale06.xml,5,1,0,GRA,47,25,MOT
0,3,1,1,-0.693147181,4,3,on,"('MOT', 'GRA')",Providence,ale06.xml,5,1,0,GRA,47,25,MOT
0,1,6,259,2.795755782,260,1,big,"('MOT', 'CHI')",Providence,ale07.xml,266,6,0,CHI,3025,832,MOT
0,1,12,253,2.212972934,254,1,want,"('MOT', 'CHI')",Providence,ale07.xml,266,12,0,CHI,3025,832,MOT
0,2,11,253,1.885514439,255,2,no,"('MOT', 'CHI')",Providence,ale07.xml,266,11,0,CHI,3025,832,MOT
0,1,18,247,1.832581464,248,1,do,"('MOT', 'CHI')",Providence,ale07.xml,266,18,0,CHI,3025,832,MOT
1,0,0,7,1.791759469,7,0,one,"('MOT', 'FAT')",Providence,ale07.xml,8,1,1,FAT,61,36,MOT
1,0,0,6,1.673976434,6,0,go,"('FAT', 'MOT')",Providence,ale07.xml,7,1,1,MOT,31,90,FAT
1,0,0,6,1.673976434,6,0,no,"('FAT', 'MOT')",Providence,ale07.xml,7,1,1,MOT,31,90,FAT
1,0,0,6,1.673976434,6,0,oh,"('GRA', 'MOT')",Providence,ale07.xml,7,1,1,MOT,56,60,GRA
1,0,0,6,1.673976434,6,0,look,"('GRA', 'MOT')",Providence,ale07.xml,7,1,1,MOT,56,60,GRA
0,2,1,34,1.440361582,36,2,is,"('CHI', 'MOT')",Providence,ale07.xml,37,1,0,MOT,128,224,CHI
1,0,1,6,1.386294361,6,0,you,"('MOT', 'FAT')",Providence,ale07.xml,8,2,1,FAT,61,36,MOT
1,2,0,9,1.060871961,11,2,that,"('CHI', 'FAT')",Providence,ale07.xml,12,1,1,FAT,50,42,CHI
1,1,0,5,0.980829253,6,1,oh,"('FAT', 'MOT')",Providence,ale07.xml,7,1,1,MOT,31,90,FAT
1,1,0,5,0.980829253,6,1,he,"('GRA', 'MOT')",Providence,ale07.xml,7,1,1,MOT,56,60,GRA
0,3,2,32,0.83832919,35,3,oh,"('CHI', 'MOT')",Providence,ale07.xml,37,2,0,MOT,128,224,CHI
6,16,33,211,0.832846742,227,16,that,"('MOT', 'CHI')",Providence,ale07.xml,266,39,6,CHI,3025,832,MOT
0,3,26,237,0.770438855,240,3,oh,"('MOT', 'CHI')",Providence,ale07.xml,266,26,0,CHI,3025,832,MOT
0,5,1,31,0.747214402,36,5,what,"('CHI', 'MOT')",Providence,ale07.xml,37,1,0,MOT,128,224,CHI
0,1,54,211,0.647477144,212,1,a,"('MOT', 'CHI')",Providence,ale07.xml,266,54,0,CHI,3025,832,MOT
1,14,15,236,0.624154309,250,14,what,"('MOT', 'CHI')",Providence,ale07.xml,266,16,1,CHI,3025,832,MOT
0,2,39,225,0.621537648,227,2,it,"('MOT', 'CHI')",Providence,ale07.xml,266,39,0,CHI,3025,832,MOT
2,10,31,223,0.604954469,233,10,this,"('MOT', 'CHI')",Providence,ale07.xml,266,33,2,CHI,3025,832,MOT
1,1,1,4,0.559615788,5,1,you,"('GRA', 'MOT')",Providence,ale07.xml,7,2,1,MOT,56,60,GRA
0,1,1,6,0.405465108,7,1,go,"('MOT', 'FAT')",Providence,ale07.xml,8,1,0,FAT,61,36,MOT
0,2,1,9,0.36772478,11,2,is,"('CHI', 'FAT')",Providence,ale07.xml,12,1,0,FAT,50,42,CHI
0,1,1,5,0.287682072,6,1,for,"('FAT', 'MOT')",Providence,ale07.xml,7,1,0,MOT,31,90,FAT
0,1,1,5,0.287682072,6,1,little,"('FAT', 'MOT')",Providence,ale07.xml,7,1,0,MOT,31,90,FAT
0,1,1,5,0.287682072,6,1,that,"('FAT', 'MOT')",Providence,ale07.xml,7,1,0,MOT,31,90,FAT
0,1,1,5,0.287682072,6,1,go,"('GRA', 'MOT')",Providence,ale07.xml,7,1,0,MOT,56,60,GRA
0,1,1,5,0.287682072,6,1,that,"('GRA', 'MOT')",Providence,ale07.xml,7,1,0,MOT,56,60,GRA
1,12,28,225,0.170674171,237,12,is,"('MOT', 'CHI')",Providence,ale07.xml,266,29,1,CHI,3025,832,MOT
0,2,64,200,0.029852963,202,2,one,"('MOT', 'CHI')",Providence,ale07.xml,266,64,0,CHI,3025,832,MOT
0,2,1,5,0,7,2,want,"('MOT', 'FAT')",Providence,ale07.xml,8,1,0,FAT,61,36,MOT
0,1,2,5,0,6,1,do,"('MOT', 'FAT')",Providence,ale07.xml,8,2,0,FAT,61,36,MOT
0,2,1,5,0,7,2,the,"('MOT', 'FAT')",Providence,ale07.xml,8,1,0,FAT,61,36,MOT
0,1,2,5,0,6,1,to,"('MOT', 'FAT')",Providence,ale07.xml,8,2,0,FAT,61,36,MOT
0,2,1,5,0,7,2,oh,"('MOT', 'GRA')",Providence,ale07.xml,8,1,0,GRA,39,27,MOT
0,2,1,4,-0.117783036,6,2,the,"('FAT', 'MOT')",Providence,ale07.xml,7,1,0,MOT,31,90,FAT
0,1,3,4,-0.356674944,5,1,get,"('MOT', 'FAT')",Providence,ale07.xml,8,3,0,FAT,61,36,MOT
0,3,2,2,-0.826678573,5,3,you,"('FAT', 'MOT')",Providence,ale07.xml,7,2,0,MOT,31,90,FAT
0,3,2,2,-0.826678573,5,3,to,"('GRA', 'MOT')",Providence,ale07.xml,7,2,0,MOT,56,60,GRA
0,3,1,208,2.876385516,211,3,little,"('CHI', 'MOT')",Providence,ale08.xml,212,1,0,MOT,758,2261,CHI
0,4,1,207,2.653241965,211,4,go,"('CHI', 'MOT')",Providence,ale08.xml,212,1,0,MOT,758,2261,CHI
0,4,1,207,2.653241965,211,4,no,"('CHI', 'MOT')",Providence,ale08.xml,212,1,0,MOT,758,2261,CHI
1,14,0,197,2.247776856,211,14,one,"('CHI', 'MOT')",Providence,ale08.xml,212,1,1,MOT,758,2261,CHI
2,9,5,196,1.931521412,205,9,oh,"('CHI', 'MOT')",Providence,ale08.xml,212,7,2,MOT,758,2261,CHI
0,1,3,63,1.887069649,64,1,this,"('MOT', 'CHI')",Providence,ale08.xml,67,3,0,CHI,578,230,MOT
1,15,2,194,1.662978679,209,15,is,"('CHI', 'MOT')",Providence,ale08.xml,212,3,1,MOT,758,2261,CHI
0,13,1,198,1.623622547,211,13,this,"('CHI', 'MOT')",Providence,ale08.xml,212,1,0,MOT,758,2261,CHI
0,1,6,60,1.370546004,61,1,a,"('MOT', 'CHI')",Providence,ale08.xml,67,6,0,CHI,578,230,MOT
0,5,1,61,1.329135947,66,5,that,"('MOT', 'CHI')",Providence,ale08.xml,67,1,0,CHI,578,230,MOT
0,5,2,60,1.026638789,65,5,what,"('MOT', 'CHI')",Providence,ale08.xml,67,2,0,CHI,578,230,MOT
2,26,5,179,0.938269639,205,26,a,"('CHI', 'MOT')",Providence,ale08.xml,212,7,2,MOT,758,2261,CHI
1,0,0,1,0.693147181,1,0,that,"('FAT', 'CHI')",Providence,ale08.xml,2,1,1,CHI,6,11,FAT
4,21,20,167,0.507322993,188,21,that,"('CHI', 'MOT')",Providence,ale08.xml,212,24,4,MOT,758,2261,CHI
3,16,25,168,0.377630309,184,16,what,"('CHI', 'MOT')",Providence,ale08.xml,212,28,3,MOT,758,2261,CHI
0,1,1,0,-0.693147181,1,1,you,"('FAT', 'MOT')",Providence,ale08.xml,2,1,0,MOT,15,31,FAT
0,1,6,253,2.772588722,254,1,for,"('MOT', 'CHI')",Providence,ale09.xml,260,6,0,CHI,2430,947,MOT
0,1,1,58,2.319114395,59,1,there,"('CHI', 'MOT')",Providence,ale09.xml,60,1,0,MOT,298,409,CHI
0,1,20,239,1.704748092,240,1,it,"('MOT', 'CHI')",Providence,ale09.xml,260,20,0,CHI,2430,947,MOT
1,2,27,230,1.648658626,232,2,this,"('MOT', 'CHI')",Providence,ale09.xml,260,28,1,CHI,2430,947,MOT
0,5,7,248,1.552279499,253,5,there,"('MOT', 'CHI')",Providence,ale09.xml,260,7,0,CHI,2430,947,MOT
1,6,13,240,1.488077055,246,6,is,"('MOT', 'CHI')",Providence,ale09.xml,260,14,1,CHI,2430,947,MOT
0,2,23,235,1.158975438,237,2,a,"('MOT', 'CHI')",Providence,ale09.xml,260,23,0,CHI,2430,947,MOT
0,4,2,54,1.098612289,58,4,oh,"('CHI', 'MOT')",Providence,ale09.xml,60,2,0,MOT,298,409,CHI
0,7,1,52,0.932820034,59,7,that,"('CHI', 'MOT')",Providence,ale09.xml,60,1,0,MOT,298,409,CHI
0,2,29,229,0.91843896,231,2,oh,"('MOT', 'CHI')",Providence,ale09.xml,260,29,0,CHI,2430,947,MOT
1,7,22,230,0.871293366,237,7,what,"('MOT', 'CHI')",Providence,ale09.xml,260,23,1,CHI,2430,947,MOT
1,26,16,217,-0.045870454,243,26,that,"('MOT', 'CHI')",Providence,ale09.xml,260,17,1,CHI,2430,947,MOT
0,1,1,1,-0.405465108,2,1,that,"('FAT', 'MOT')",Providence,ale09.xml,3,1,0,MOT,12,123,FAT
0,1,1,1,-0.405465108,2,1,that,"('MOT', 'FAT')",Providence,ale09.xml,3,1,0,FAT,22,10,MOT
0,1,1,190,3.47093072,191,1,my,"('MOT', 'CHI')",Providence,ale10.xml,192,1,0,CHI,1788,732,MOT
1,2,3,150,2.839728025,152,2,where,"('CHI', 'MOT')",Providence,ale10.xml,156,4,1,MOT,542,1589,CHI
0,3,1,188,2.777783539,191,3,where,"('MOT', 'CHI')",Providence,ale10.xml,192,1,0,CHI,1788,732,MOT
1,0,20,171,2.710944559,171,0,it,"('MOT', 'CHI')",Providence,ale10.xml,192,21,1,CHI,1788,732,MOT
0,3,1,152,2.571339156,155,3,but,"('CHI', 'MOT')",Providence,ale10.xml,156,1,0,MOT,542,1589,CHI
0,3,1,152,2.571339156,155,3,my,"('CHI', 'MOT')",Providence,ale10.xml,156,1,0,MOT,542,1589,CHI
1,1,11,179,2.564949357,180,1,oh,"('MOT', 'CHI')",Providence,ale10.xml,192,12,1,CHI,1788,732,MOT
0,1,6,185,2.463853241,186,1,this,"('MOT', 'CHI')",Providence,ale10.xml,192,6,0,CHI,1788,732,MOT
0,2,4,186,2.356652314,188,2,he,"('MOT', 'CHI')",Providence,ale10.xml,192,4,0,CHI,1788,732,MOT
0,2,3,151,2.335374916,153,2,did,"('CHI', 'MOT')",Providence,ale10.xml,156,3,0,MOT,542,1589,CHI
1,4,5,182,2.240709689,186,4,go,"('MOT', 'CHI')",Providence,ale10.xml,192,6,1,CHI,1788,732,MOT
1,6,3,146,1.992430165,152,6,no,"('CHI', 'MOT')",Providence,ale10.xml,156,4,1,MOT,542,1589,CHI
0,1,15,176,1.661025281,177,1,is,"('MOT', 'CHI')",Providence,ale10.xml,192,15,0,CHI,1788,732,MOT
0,9,1,146,1.655048424,155,9,this,"('CHI', 'MOT')",Providence,ale10.xml,156,1,0,MOT,542,1589,CHI
0,3,7,182,1.647589678,185,3,did,"('MOT', 'CHI')",Providence,ale10.xml,192,7,0,CHI,1788,732,MOT
1,1,0,10,1.466337069,11,1,you,"('MOT', 'TO2')",Providence,ale10.xml,12,1,1,TO2,68,112,MOT
1,17,2,136,1.236762627,153,17,it,"('CHI', 'MOT')",Providence,ale10.xml,156,3,1,MOT,542,1589,CHI
0,12,3,141,0.869037847,153,12,go,"('CHI', 'MOT')",Providence,ale10.xml,156,3,0,MOT,542,1589,CHI
0,9,8,175,0.620576488,184,9,no,"('MOT', 'CHI')",Providence,ale10.xml,192,8,0,CHI,1788,732,MOT
3,9,24,120,0.591610761,129,9,that,"('CHI', 'MOT')",Providence,ale10.xml,156,27,3,MOT,542,1589,CHI
0,2,35,155,0.359374001,157,2,what,"('MOT', 'CHI')",Providence,ale10.xml,192,35,0,CHI,1788,732,MOT
2,30,18,142,-0.26736207,172,30,that,"('MOT', 'CHI')",Providence,ale10.xml,192,20,2,CHI,1788,732,MOT
0,1,3,326,3.493472658,327,1,he,"('MOT', 'CHI')",Providence,ale11.xml,330,3,0,CHI,2916,1302,MOT
0,1,5,324,3.150902841,325,1,where,"('MOT', 'CHI')",Providence,ale11.xml,330,5,0,CHI,2916,1302,MOT
1,0,0,19,2.63905733,19,0,they,"('GRA', 'MOT')",Providence,ale11.xml,20,1,1,MOT,101,204,GRA
1,0,0,19,2.63905733,19,0,one,"('GRA', 'MOT')",Providence,ale11.xml,20,1,1,MOT,101,204,GRA
0,1,1,70,2.498699972,71,1,yeah,"('CHI', 'MOT')",Providence,ale11.xml,72,1,0,MOT,295,657,CHI
1,2,21,306,2.153053359,308,2,oh,"('MOT', 'CHI')",Providence,ale11.xml,330,22,1,CHI,2916,1302,MOT
0,1,18,311,2.060513532,312,1,and,"('MOT', 'CHI')",Providence,ale11.xml,330,18,0,CHI,2916,1302,MOT
0,1,3,68,1.960094784,69,1,no,"('CHI', 'MOT')",Providence,ale11.xml,72,3,0,MOT,295,657,CHI
1,1,0,18,1.945910149,19,1,it,"('GRA', 'MOT')",Providence,ale11.xml,20,1,1,MOT,101,204,GRA
1,0,0,8,1.897119985,8,0,he,"('MOT', 'UNC')",Providence,ale11.xml,9,1,1,UNC,69,45,MOT
1,7,1,63,1.504077397,70,7,this,"('CHI', 'MOT')",Providence,ale11.xml,72,2,1,MOT,295,657,CHI
0,5,10,315,1.497885427,320,5,all,"('MOT', 'CHI')",Providence,ale11.xml,330,10,0,CHI,2916,1302,MOT
0,1,32,297,1.484274769,298,1,is,"('MOT', 'CHI')",Providence,ale11.xml,330,32,0,CHI,2916,1302,MOT
2,3,0,15,1.32175584,18,3,a,"('GRA', 'MOT')",Providence,ale11.xml,20,2,2,MOT,101,204,GRA
0,1,1,18,1.252762968,19,1,what,"('GRA', 'MOT')",Providence,ale11.xml,20,1,0,MOT,101,204,GRA
0,1,1,18,1.252762968,19,1,there,"('GRA', 'MOT')",Providence,ale11.xml,20,1,0,MOT,101,204,GRA
0,1,2,17,0.916290732,18,1,you,"('GRA', 'MOT')",Providence,ale11.xml,20,2,0,MOT,101,204,GRA
0,2,1,17,0.84729786,19,2,was,"('GRA', 'MOT')",Providence,ale11.xml,20,1,0,MOT,101,204,GRA
1,5,7,59,0.78845736,64,5,that,"('CHI', 'MOT')",Providence,ale11.xml,72,8,1,MOT,295,657,CHI
1,0,0,1,0.693147181,1,0,you,"('GRA', 'UNC')",Providence,ale11.xml,2,1,1,UNC,17,27,GRA
1,0,0,1,0.693147181,1,0,that,"('UNC', 'OPE')",Providence,ale11.xml,2,1,1,OPE,8,12,UNC
0,1,3,16,0.641853886,17,1,is,"('GRA', 'MOT')",Providence,ale11.xml,20,3,0,MOT,101,204,GRA
0,1,1,8,0.606135804,9,1,for,"('MOT', 'GRA')",Providence,ale11.xml,10,1,0,GRA,59,48,MOT
0,1,1,8,0.606135804,9,1,not,"('MOT', 'GRA')",Providence,ale11.xml,10,1,0,GRA,59,48,MOT
2,37,10,281,0.590289795,318,37,no,"('MOT', 'CHI')",Providence,ale11.xml,330,12,2,CHI,2916,1302,MOT
0,9,2,61,0.587786665,70,9,a,"('CHI', 'MOT')",Providence,ale11.xml,72,2,0,MOT,295,657,CHI
1,1,1,4,0.559615788,5,1,that,"('CHI', 'UNC')",Providence,ale11.xml,7,2,1,UNC,38,34,CHI
0,3,1,16,0.559615788,19,3,for,"('GRA', 'MOT')",Providence,ale11.xml,20,1,0,MOT,101,204,GRA
0,1,1,7,0.510825624,8,1,you,"('MOT', 'UNC')",Providence,ale11.xml,9,1,0,UNC,69,45,MOT
0,1,1,7,0.510825624,8,1,go,"('MOT', 'UNC')",Providence,ale11.xml,9,1,0,UNC,69,45,MOT
0,4,36,290,0.443335382,294,4,a,"('MOT', 'CHI')",Providence,ale11.xml,330,36,0,CHI,2916,1302,MOT
0,1,4,15,0.405465108,16,1,that,"('GRA', 'MOT')",Providence,ale11.xml,20,4,0,MOT,101,204,GRA
0,1,1,6,0.405465108,7,1,this,"('UNC', 'CHI')",Providence,ale11.xml,8,1,0,CHI,34,31,UNC
0,1,1,6,0.405465108,7,1,no,"('UNC', 'CHI')",Providence,ale11.xml,8,1,0,CHI,34,31,UNC
0,2,1,9,0.36772478,11,2,no,"('UNC', 'MOT')",Providence,ale11.xml,12,1,0,MOT,40,95,UNC
0,2,1,9,0.36772478,11,2,that,"('UNC', 'MOT')",Providence,ale11.xml,12,1,0,MOT,40,95,UNC
0,5,1,14,0.15415068,19,5,of,"('GRA', 'MOT')",Providence,ale11.xml,20,1,0,MOT,101,204,GRA
0,1,2,6,0.117783036,7,1,this,"('MOT', 'UNC')",Providence,ale11.xml,9,2,0,UNC,69,45,MOT
0,5,2,13,-0.182321557,18,5,and,"('GRA', 'MOT')",Providence,ale11.xml,20,2,0,MOT,101,204,GRA
0,2,2,6,-0.182321557,8,2,the,"('MOT', 'GRA')",Providence,ale11.xml,10,2,0,GRA,59,48,MOT
1,14,44,271,-0.205568406,285,14,this,"('MOT', 'CHI')",Providence,ale11.xml,330,45,1,CHI,2916,1302,MOT
0,9,1,10,-0.356674944,19,9,the,"('GRA', 'MOT')",Providence,ale11.xml,20,1,0,MOT,101,204,GRA
0,40,33,257,-1.568476555,297,40,that,"('MOT', 'CHI')",Providence,ale11.xml,330,33,0,CHI,2916,1302,MOT
1,2,0,206,3.843030134,208,2,up,"('CHI', 'MOT')",Providence,ale12.xml,209,1,1,MOT,695,2058,CHI
1,0,7,189,3.642835516,189,0,where,"('MOT', 'CHI')",Providence,ale12.xml,197,8,1,CHI,1489,645,MOT
4,4,1,200,3.38196602,204,4,all,"('CHI', 'MOT')",Providence,ale12.xml,209,5,4,MOT,695,2058,CHI
1,0,16,180,2.952714888,180,0,is,"('MOT', 'CHI')",Providence,ale12.xml,197,17,1,CHI,1489,645,MOT
0,1,5,191,2.628800829,192,1,all,"('MOT', 'CHI')",Providence,ale12.xml,197,5,0,CHI,1489,645,MOT
1,1,1,32,2.1690537,33,1,was,"('MOT', 'GRA')",Providence,ale12.xml,35,2,1,GRA,263,231,MOT
1,1,1,32,2.1690537,33,1,he,"('MOT', 'GRA')",Providence,ale12.xml,35,2,1,GRA,263,231,MOT
1,1,1,32,2.1690537,33,1,that,"('MOT', 'GRA')",Providence,ale12.xml,35,2,1,GRA,263,231,MOT
1,1,2,31,1.916922612,32,1,oh,"('MOT', 'GRA')",Providence,ale12.xml,35,3,1,GRA,263,231,MOT
0,2,8,187,1.851076046,189,2,no,"('MOT', 'CHI')",Providence,ale12.xml,197,8,0,CHI,1489,645,MOT
1,1,0,15,1.791759469,16,1,no,"('CHI', 'GRA')",Providence,ale12.xml,17,1,1,GRA,55,100,CHI
0,1,1,33,1.791759469,34,1,for,"('MOT', 'GRA')",Providence,ale12.xml,35,1,0,GRA,263,231,MOT
0,1,1,33,1.791759469,34,1,of,"('MOT', 'GRA')",Providence,ale12.xml,35,1,0,GRA,263,231,MOT
0,1,1,33,1.791759469,34,1,they,"('MOT', 'GRA')",Providence,ale12.xml,35,1,0,GRA,263,231,MOT
0,1,1,33,1.791759469,34,1,there,"('MOT', 'GRA')",Providence,ale12.xml,35,1,0,GRA,263,231,MOT
0,1,1,33,1.791759469,34,1,see,"('MOT', 'GRA')",Providence,ale12.xml,35,1,0,GRA,263,231,MOT
0,1,1,33,1.791759469,34,1,up,"('MOT', 'GRA')",Providence,ale12.xml,35,1,0,GRA,263,231,MOT
0,1,1,33,1.791759469,34,1,put,"('MOT', 'GRA')",Providence,ale12.xml,35,1,0,GRA,263,231,MOT
0,1,1,33,1.791759469,34,1,one,"('MOT', 'GRA')",Providence,ale12.xml,35,1,0,GRA,263,231,MOT
0,1,1,33,1.791759469,34,1,where,"('MOT', 'GRA')",Providence,ale12.xml,35,1,0,GRA,263,231,MOT
0,1,1,33,1.791759469,34,1,think,"('MOT', 'GRA')",Providence,ale12.xml,35,1,0,GRA,263,231,MOT
3,5,16,173,1.742969305,178,5,that,"('MOT', 'CHI')",Providence,ale12.xml,197,19,3,CHI,1489,645,MOT
0,2,10,185,1.658228077,187,2,this,"('MOT', 'CHI')",Providence,ale12.xml,197,10,0,CHI,1489,645,MOT
0,1,17,179,1.566420527,180,1,a,"('MOT', 'CHI')",Providence,ale12.xml,197,17,0,CHI,1489,645,MOT
1,3,0,19,1.386294361,22,3,have,"('GRA', 'MOT')",Providence,ale12.xml,23,1,1,MOT,121,259,GRA
0,1,1,21,1.386294361,22,1,no,"('GRA', 'MOT')",Providence,ale12.xml,23,1,0,MOT,121,259,GRA
0,2,1,32,1.386294361,34,2,not,"('MOT', 'GRA')",Providence,ale12.xml,35,1,0,GRA,263,231,MOT
3,2,2,16,1.337504197,18,2,like,"('GRA', 'MOT')",Providence,ale12.xml,23,5,3,MOT,121,259,GRA
0,1,3,31,1.223775432,32,1,what,"('MOT', 'GRA')",Providence,ale12.xml,35,3,0,GRA,263,231,MOT
0,3,1,31,1.098612289,34,3,are,"('MOT', 'GRA')",Providence,ale12.xml,35,1,0,GRA,263,231,MOT
0,2,2,31,1.070441412,33,2,this,"('MOT', 'GRA')",Providence,ale12.xml,35,2,0,GRA,263,231,MOT
0,2,2,31,1.070441412,33,2,a,"('MOT', 'GRA')",Providence,ale12.xml,35,2,0,GRA,263,231,MOT
1,3,1,18,1.056052674,21,3,that,"('GRA', 'MOT')",Providence,ale12.xml,23,2,1,MOT,121,259,GRA
2,2,3,16,1.049822124,18,2,it,"('GRA', 'MOT')",Providence,ale12.xml,23,5,2,MOT,121,259,GRA
1,1,0,5,0.980829253,6,1,that,"('CHI', 'FAT')",Providence,ale12.xml,7,1,1,FAT,25,32,CHI
0,2,1,20,0.980829253,22,2,in,"('GRA', 'MOT')",Providence,ale12.xml,23,1,0,MOT,121,259,GRA
0,2,1,20,0.980829253,22,2,we,"('GRA', 'MOT')",Providence,ale12.xml,23,1,0,MOT,121,259,GRA
0,2,1,20,0.980829253,22,2,put,"('GRA', 'MOT')",Providence,ale12.xml,23,1,0,MOT,121,259,GRA
0,2,1,20,0.980829253,22,2,do,"('GRA', 'MOT')",Providence,ale12.xml,23,1,0,MOT,121,259,GRA
1,1,1,7,0.916290732,8,1,you,"('FAT', 'MOT')",Providence,ale12.xml,10,2,1,MOT,49,65,FAT
0,1,1,12,0.916290732,13,1,a,"('GRA', 'CHI')",Providence,ale12.xml,14,1,0,CHI,66,68,GRA
0,1,1,12,0.916290732,13,1,you,"('MOT', 'FAT')",Providence,ale12.xml,14,1,0,FAT,80,67,MOT
0,1,1,12,0.916290732,13,1,of,"('MOT', 'FAT')",Providence,ale12.xml,14,1,0,FAT,80,67,MOT
0,1,1,12,0.916290732,13,1,think,"('MOT', 'FAT')",Providence,ale12.xml,14,1,0,FAT,80,67,MOT
0,1,1,12,0.916290732,13,1,to,"('MOT', 'FAT')",Providence,ale12.xml,14,1,0,FAT,80,67,MOT
0,16,3,190,0.894886823,206,16,no,"('CHI', 'MOT')",Providence,ale12.xml,209,3,0,MOT,695,2058,CHI
3,24,9,173,0.821666031,197,24,that,"('CHI', 'MOT')",Providence,ale12.xml,209,12,3,MOT,695,2058,CHI
1,3,2,17,0.78845736,20,3,you,"('GRA', 'MOT')",Providence,ale12.xml,23,3,1,MOT,121,259,GRA
0,3,2,30,0.782759339,33,3,and,"('MOT', 'GRA')",Providence,ale12.xml,35,2,0,GRA,263,231,MOT
0,1,2,14,0.753771802,15,1,that,"('CHI', 'GRA')",Providence,ale12.xml,17,2,0,GRA,55,100,CHI
0,1,1,8,0.606135804,9,1,what,"('FAT', 'MOT')",Providence,ale12.xml,10,1,0,MOT,49,65,FAT
0,1,1,8,0.606135804,9,1,he,"('FAT', 'MOT')",Providence,ale12.xml,10,1,0,MOT,49,65,FAT
0,1,2,11,0.559615788,12,1,a,"('MOT', 'FAT')",Providence,ale12.xml,14,2,0,FAT,80,67,MOT
0,1,2,11,0.559615788,12,1,but,"('MOT', 'FAT')",Providence,ale12.xml,14,2,0,FAT,80,67,MOT
0,4,1,18,0.470003629,22,4,to,"('GRA', 'MOT')",Providence,ale12.xml,23,1,0,MOT,121,259,GRA
1,4,5,25,0.438254931,29,4,you,"('MOT', 'GRA')",Providence,ale12.xml,35,6,1,GRA,263,231,MOT
1,0,1,1,0.405465108,1,0,oh,"('UNI', 'GRA')",Providence,ale12.xml,3,2,1,GRA,25,22,UNI
0,3,2,18,0.362905494,21,3,yeah,"('GRA', 'MOT')",Providence,ale12.xml,23,2,0,MOT,121,259,GRA
0,4,2,17,0.139761942,21,4,he,"('GRA', 'MOT')",Providence,ale12.xml,23,2,0,MOT,121,259,GRA
0,6,1,16,0.133531393,22,6,the,"('GRA', 'MOT')",Providence,ale12.xml,23,1,0,MOT,121,259,GRA
1,4,1,4,0,8,4,it,"('FAT', 'MOT')",Providence,ale12.xml,10,2,1,MOT,49,65,FAT
0,3,6,26,-0.031748698,29,3,to,"('MOT', 'GRA')",Providence,ale12.xml,35,6,0,GRA,263,231,MOT
0,1,3,6,-0.105360516,7,1,was,"('FAT', 'MOT')",Providence,ale12.xml,10,3,0,MOT,49,65,FAT
0,2,3,9,-0.143100844,11,2,it,"('MOT', 'FAT')",Providence,ale12.xml,14,3,0,FAT,80,67,MOT
0,1,1,1,-0.405465108,2,1,you,"('UNI', 'GRA')",Providence,ale12.xml,3,1,0,GRA,25,22,UNI
0,1,1,1,-0.405465108,2,1,have,"('UNI', 'GRA')",Providence,ale12.xml,3,1,0,GRA,25,22,UNI
0,2,1,261,3.382505249,263,2,where,"('CHI', 'MOT')",Providence,ale13.xml,264,1,0,MOT,1197,2097,CHI
0,1,2,201,3.238678452,202,1,where,"('MOT', 'CHI')",Providence,ale13.xml,204,2,0,CHI,1550,792,MOT
1,2,5,256,3.075774981,258,2,up,"('CHI', 'MOT')",Providence,ale13.xml,264,6,1,MOT,1197,2097,CHI
0,2,2,200,2.833213344,202,2,up,"('MOT', 'CHI')",Providence,ale13.xml,204,2,0,CHI,1550,792,MOT
0,8,1,255,2.28389296,263,8,all,"('CHI', 'MOT')",Providence,ale13.xml,264,1,0,MOT,1197,2097,CHI
1,21,0,242,2.083222265,263,21,a,"('CHI', 'MOT')",Providence,ale13.xml,264,1,1,MOT,1197,2097,CHI
0,12,1,251,1.91616818,263,12,oh,"('CHI', 'MOT')",Providence,ale13.xml,264,1,0,MOT,1197,2097,CHI
0,14,1,249,1.773067336,263,14,is,"('CHI', 'MOT')",Providence,ale13.xml,264,1,0,MOT,1197,2097,CHI
0,1,15,188,1.725912903,189,1,the,"('MOT', 'CHI')",Providence,ale13.xml,204,15,0,CHI,1550,792,MOT
1,0,2,10,1.568615918,10,0,want,"('MOT', 'FAT')",Providence,ale13.xml,13,3,1,FAT,110,67,MOT
1,2,23,178,1.540445041,180,2,one,"('MOT', 'CHI')",Providence,ale13.xml,204,24,1,CHI,1550,792,MOT
12,18,21,213,1.51620077,231,18,no,"('CHI', 'MOT')",Providence,ale13.xml,264,33,12,MOT,1197,2097,CHI
0,19,1,244,1.485385264,263,19,this,"('CHI', 'MOT')",Providence,ale13.xml,264,1,0,MOT,1197,2097,CHI
1,0,0,4,1.386294361,4,0,and,"('TO1', 'MOT')",Providence,ale13.xml,5,1,1,MOT,29,76,TO1
1,9,8,186,1.275870544,195,9,no,"('MOT', 'CHI')",Providence,ale13.xml,204,9,1,CHI,1550,792,MOT
0,24,1,239,1.262241712,263,24,the,"('CHI', 'MOT')",Providence,ale13.xml,264,1,0,MOT,1197,2097,CHI
0,1,25,178,1.209512985,179,1,what,"('MOT', 'CHI')",Providence,ale13.xml,204,25,0,CHI,1550,792,MOT
7,15,26,216,1.202543212,231,15,one,"('CHI', 'MOT')",Providence,ale13.xml,264,33,7,MOT,1197,2097,CHI
3,63,0,198,1.190127398,261,63,you,"('CHI', 'MOT')",Providence,ale13.xml,264,3,3,MOT,1197,2097,CHI
1,0,1,4,1.098612289,4,0,there,"('MOT', 'OPE')",Providence,ale13.xml,6,2,1,OPE,82,55,MOT
0,1,31,172,0.975131232,173,1,this,"('MOT', 'CHI')",Providence,ale13.xml,204,31,0,CHI,1550,792,MOT
0,2,22,180,0.938269639,182,2,is,"('MOT', 'CHI')",Providence,ale13.xml,204,22,0,CHI,1550,792,MOT
1,1,2,9,0.875468737,10,1,on,"('MOT', 'FAT')",Providence,ale13.xml,13,3,1,FAT,110,67,MOT
0,1,1,11,0.84729786,12,1,it,"('MOT', 'FAT')",Providence,ale13.xml,13,1,0,FAT,110,67,MOT
0,1,1,11,0.84729786,12,1,there,"('MOT', 'FAT')",Providence,ale13.xml,13,1,0,FAT,110,67,MOT
0,1,1,11,0.84729786,12,1,he,"('MOT', 'FAT')",Providence,ale13.xml,13,1,0,FAT,110,67,MOT
0,1,1,10,0.773189888,11,1,oh,"('FAT', 'MOT')",Providence,ale13.xml,12,1,0,MOT,42,161,FAT
1,19,10,234,0.673729095,253,19,that,"('CHI', 'MOT')",Providence,ale13.xml,264,11,1,MOT,1197,2097,CHI
1,0,2,2,0.470003629,2,0,a,"('TO1', 'MOT')",Providence,ale13.xml,5,3,1,MOT,29,76,TO1
0,2,1,9,0.36772478,11,2,the,"('FAT', 'MOT')",Providence,ale13.xml,12,1,0,MOT,42,161,FAT
0,1,3,9,0.182321557,10,1,do,"('MOT', 'FAT')",Providence,ale13.xml,13,3,0,FAT,110,67,MOT
0,1,1,4,0.15415068,5,1,it,"('MOT', 'OPE')",Providence,ale13.xml,6,1,0,OPE,82,55,MOT
0,1,1,4,0.15415068,5,1,and,"('MOT', 'OPE')",Providence,ale13.xml,6,1,0,OPE,82,55,MOT
1,2,0,1,0.105360516,3,2,the,"('MOT', 'TO1')",Providence,ale13.xml,4,1,1,TO1,13,48,MOT
0,2,2,8,0,10,2,it,"('FAT', 'MOT')",Providence,ale13.xml,12,2,0,MOT,42,161,FAT
3,27,27,147,-0.241162057,174,27,that,"('MOT', 'CHI')",Providence,ale13.xml,204,30,3,CHI,1550,792,MOT
0,1,5,7,-0.336472237,8,1,you,"('MOT', 'FAT')",Providence,ale13.xml,13,5,0,FAT,110,67,MOT
0,3,1,2,-0.538996501,5,3,to,"('MOT', 'OPE')",Providence,ale13.xml,6,1,0,OPE,82,55,MOT
0,1,3,2,-0.693147181,3,1,the,"('MOT', 'OPE')",Providence,ale13.xml,6,3,0,OPE,82,55,MOT
1,5,0,411,3.838256855,416,5,want,"('CHI', 'MOT')",Providence,ale14.xml,417,1,1,MOT,1203,3518,CHI
0,3,1,413,3.550574783,416,3,up,"('CHI', 'MOT')",Providence,ale14.xml,417,1,0,MOT,1203,3518,CHI
2,7,1,407,3.440418095,414,7,where,"('CHI', 'MOT')",Providence,ale14.xml,417,3,2,MOT,1203,3518,CHI
0,4,1,412,3.327431231,416,4,was,"('CHI', 'MOT')",Providence,ale14.xml,417,1,0,MOT,1203,3518,CHI
0,6,1,410,2.990958995,416,6,at,"('CHI', 'MOT')",Providence,ale14.xml,417,1,0,MOT,1203,3518,CHI
0,8,1,408,2.739644567,416,8,yeah,"('CHI', 'MOT')",Providence,ale14.xml,417,1,0,MOT,1203,3518,CHI
1,18,0,398,2.685577345,416,18,go,"('CHI', 'MOT')",Providence,ale14.xml,417,1,1,MOT,1203,3518,CHI
1,14,4,398,2.065052804,412,14,no,"('CHI', 'MOT')",Providence,ale14.xml,417,5,1,MOT,1203,3518,CHI
1,35,0,381,2.046497386,416,35,to,"('CHI', 'MOT')",Providence,ale14.xml,417,1,1,MOT,1203,3518,CHI
2,1,3,33,2.043073898,34,1,up,"('MOT', 'CHI')",Providence,ale14.xml,39,5,2,CHI,276,88,MOT
1,0,0,9,1.992430165,9,0,to,"('TOY', 'MOT')",Providence,ale14.xml,10,1,1,MOT,47,53,TOY
1,0,1,12,1.945910149,12,0,oh,"('GRA', 'MOT')",Providence,ale14.xml,14,2,1,MOT,74,89,GRA
0,1,1,37,1.897119985,38,1,it,"('MOT', 'CHI')",Providence,ale14.xml,39,1,0,CHI,276,88,MOT
0,21,1,395,1.84582669,416,21,look,"('CHI', 'MOT')",Providence,ale14.xml,417,1,0,MOT,1203,3518,CHI
2,59,0,356,1.651059587,415,59,the,"('CHI', 'MOT')",Providence,ale14.xml,417,2,2,MOT,1203,3518,CHI
1,0,1,8,1.609437912,8,0,it,"('MOT', 'GRA')",Providence,ale14.xml,10,2,1,GRA,77,74,MOT
1,0,1,8,1.609437912,8,0,no,"('MOT', 'GRA')",Providence,ale14.xml,10,2,1,GRA,77,74,MOT
0,18,3,396,1.476808369,414,18,there,"('CHI', 'MOT')",Providence,ale14.xml,417,3,0,MOT,1203,3518,CHI
1,25,5,386,1.379056694,411,25,is,"('CHI', 'MOT')",Providence,ale14.xml,417,6,1,MOT,1203,3518,CHI
0,1,3,35,1.335001067,36,1,a,"('MOT', 'CHI')",Providence,ale14.xml,39,3,0,CHI,276,88,MOT
1,1,0,8,1.299282984,9,1,one,"('CHI', 'GRA')",Providence,ale14.xml,10,1,1,GRA,31,95,CHI
1,1,0,8,1.299282984,9,1,have,"('MOT', 'GRA')",Providence,ale14.xml,10,1,1,GRA,77,74,MOT
0,16,5,396,1.246742481,412,16,see,"('CHI', 'MOT')",Providence,ale14.xml,417,5,0,MOT,1203,3518,CHI
0,47,1,369,1.065668133,416,47,it,"('CHI', 'MOT')",Providence,ale14.xml,417,1,0,MOT,1203,3518,CHI
1,0,3,6,0.980829253,6,0,you,"('MOT', 'GRA')",Providence,ale14.xml,10,4,1,GRA,77,74,MOT
2,2,0,6,0.916290732,8,2,no,"('GRA', 'CHI')",Providence,ale14.xml,10,2,2,CHI,79,23,GRA
0,1,1,12,0.916290732,13,1,look,"('GRA', 'MOT')",Providence,ale14.xml,14,1,0,MOT,74,89,GRA
0,1,1,12,0.916290732,13,1,what,"('GRA', 'MOT')",Providence,ale14.xml,14,1,0,MOT,74,89,GRA
0,1,1,12,0.916290732,13,1,is,"('GRA', 'MOT')",Providence,ale14.xml,14,1,0,MOT,74,89,GRA
12,60,23,322,0.793800133,382,60,one,"('CHI', 'MOT')",Providence,ale14.xml,417,35,12,MOT,1203,3518,CHI
1,47,6,363,0.645744942,410,47,a,"('CHI', 'MOT')",Providence,ale14.xml,417,7,1,MOT,1203,3518,CHI
11,55,30,321,0.633249039,376,55,that,"('CHI', 'MOT')",Providence,ale14.xml,417,41,11,MOT,1203,3518,CHI
1,1,2,6,0.587786665,7,1,oh,"('MOT', 'GRA')",Providence,ale14.xml,10,3,1,GRA,77,74,MOT
0,1,2,11,0.559615788,12,1,a,"('GRA', 'MOT')",Providence,ale14.xml,14,2,0,MOT,74,89,GRA
0,48,3,366,0.52942705,414,48,this,"('CHI', 'MOT')",Providence,ale14.xml,417,3,0,MOT,1203,3518,CHI
0,2,1,11,0.510825624,13,2,are,"('GRA', 'MOT')",Providence,ale14.xml,14,1,0,MOT,74,89,GRA
0,2,1,11,0.510825624,13,2,the,"('GRA', 'MOT')",Providence,ale14.xml,14,1,0,MOT,74,89,GRA
0,36,6,375,0.333088139,411,36,what,"('CHI', 'MOT')",Providence,ale14.xml,417,6,0,MOT,1203,3518,CHI
0,3,1,10,0.223143551,13,3,you,"('GRA', 'MOT')",Providence,ale14.xml,14,1,0,MOT,74,89,GRA
0,1,2,7,0.223143551,8,1,that,"('MOT', 'GRA')",Providence,ale14.xml,10,2,0,GRA,77,74,MOT
0,2,1,7,0.200670695,9,2,that,"('CHI', 'GRA')",Providence,ale14.xml,10,1,0,GRA,31,95,CHI
0,46,7,364,-0.02634883,410,46,oh,"('CHI', 'MOT')",Providence,ale14.xml,417,7,0,MOT,1203,3518,CHI
0,3,8,28,-0.192371893,31,3,that,"('MOT', 'CHI')",Providence,ale14.xml,39,8,0,CHI,276,88,MOT
0,4,1,5,-0.310154928,9,4,the,"('MOT', 'GRA')",Providence,ale14.xml,10,1,0,GRA,77,74,MOT
1,0,0,54,3.619886583,54,0,no,"('CHI', 'GRA')",Providence,ale15.xml,55,1,1,GRA,148,210,CHI
1,0,3,80,3.308106959,80,0,did,"('GRA', 'CHI')",Providence,ale15.xml,84,4,1,CHI,504,243,GRA
1,1,0,61,3.060270795,62,1,can,"('GRA', 'MOT')",Providence,ale15.xml,63,1,1,MOT,289,415,GRA
0,1,1,105,2.890371758,106,1,we,"('MOT', 'CHI')",Providence,ale15.xml,107,1,0,CHI,1268,321,MOT
0,1,1,105,2.890371758,106,1,my,"('MOT', 'CHI')",Providence,ale15.xml,107,1,0,CHI,1268,321,MOT
2,1,3,72,2.777043073,73,1,she,"('MOT', 'GRA')",Providence,ale15.xml,78,5,2,GRA,519,419,MOT
0,1,1,76,2.577688383,77,1,gonna,"('MOT', 'GRA')",Providence,ale15.xml,78,1,0,GRA,519,419,MOT
0,1,1,76,2.577688383,77,1,for,"('MOT', 'GRA')",Providence,ale15.xml,78,1,0,GRA,519,419,MOT
0,1,1,76,2.577688383,77,1,at,"('MOT', 'GRA')",Providence,ale15.xml,78,1,0,GRA,519,419,MOT
1,1,3,73,2.538973871,74,1,this,"('MOT', 'GRA')",Providence,ale15.xml,78,4,1,GRA,519,419,MOT
3,4,1,76,2.391816227,80,4,no,"('CHI', 'MOT')",Providence,ale15.xml,84,4,3,MOT,261,673,CHI
0,1,1,61,2.367123614,62,1,see,"('GRA', 'MOT')",Providence,ale15.xml,63,1,0,MOT,289,415,GRA
0,1,1,61,2.367123614,62,1,put,"('GRA', 'MOT')",Providence,ale15.xml,63,1,0,MOT,289,415,GRA
1,0,10,67,2.362304328,67,0,a,"('MOT', 'GRA')",Providence,ale15.xml,78,11,1,GRA,519,419,MOT
0,1,2,81,2.351375257,82,1,where,"('CHI', 'MOT')",Providence,ale15.xml,84,2,0,MOT,261,673,CHI
3,2,3,55,2.285777975,57,2,oh,"('GRA', 'MOT')",Providence,ale15.xml,63,6,3,MOT,289,415,GRA
0,1,2,75,2.277267285,76,1,but,"('MOT', 'GRA')",Providence,ale15.xml,78,2,0,GRA,519,419,MOT
0,1,2,75,2.277267285,76,1,up,"('MOT', 'GRA')",Providence,ale15.xml,78,2,0,GRA,519,419,MOT
0,1,2,75,2.277267285,76,1,put,"('MOT', 'GRA')",Providence,ale15.xml,78,2,0,GRA,519,419,MOT
0,1,2,75,2.277267285,76,1,are,"('MOT', 'GRA')",Providence,ale15.xml,78,2,0,GRA,519,419,MOT
0,1,2,75,2.277267285,76,1,not,"('MOT', 'GRA')",Providence,ale15.xml,78,2,0,GRA,519,419,MOT
0,2,1,81,2.245426679,83,2,did,"('CHI', 'MOT')",Providence,ale15.xml,84,1,0,MOT,261,673,CHI
1,3,0,51,2.233592222,54,3,oh,"('CHI', 'GRA')",Providence,ale15.xml,55,1,1,GRA,148,210,CHI
0,1,1,53,2.233592222,54,1,this,"('CHI', 'GRA')",Providence,ale15.xml,55,1,0,GRA,148,210,CHI
0,2,2,103,2.187922185,105,2,where,"('MOT', 'CHI')",Providence,ale15.xml,107,2,0,CHI,1268,321,MOT
0,2,1,75,2.172223275,77,2,go,"('MOT', 'GRA')",Providence,ale15.xml,78,1,0,GRA,519,419,MOT
0,2,1,75,2.172223275,77,2,with,"('MOT', 'GRA')",Providence,ale15.xml,78,1,0,GRA,519,419,MOT
1,0,14,69,2.122613714,69,0,you,"('GRA', 'CHI')",Providence,ale15.xml,84,15,1,CHI,504,243,GRA
0,1,3,80,2.116255515,81,1,and,"('GRA', 'CHI')",Providence,ale15.xml,84,3,0,CHI,504,243,GRA
1,2,4,77,2.043073898,79,2,oh,"('GRA', 'CHI')",Providence,ale15.xml,84,5,1,CHI,504,243,GRA
0,1,3,74,2.041220329,75,1,like,"('MOT', 'GRA')",Providence,ale15.xml,78,3,0,GRA,519,419,MOT
0,2,1,60,1.961658506,62,2,yeah,"('GRA', 'MOT')",Providence,ale15.xml,63,1,0,MOT,289,415,GRA
0,3,1,80,1.957744607,83,3,for,"('CHI', 'MOT')",Providence,ale15.xml,84,1,0,MOT,261,673,CHI
2,8,0,74,1.945910149,82,8,oh,"('CHI', 'MOT')",Providence,ale15.xml,84,2,2,MOT,261,673,CHI
0,3,1,74,1.884541203,77,3,yeah,"('MOT', 'GRA')",Providence,ale15.xml,78,1,0,GRA,519,419,MOT
0,3,1,74,1.884541203,77,3,my,"('MOT', 'GRA')",Providence,ale15.xml,78,1,0,GRA,519,419,MOT
0,2,2,74,1.871802177,76,2,in,"('MOT', 'GRA')",Providence,ale15.xml,78,2,0,GRA,519,419,MOT
0,2,2,74,1.871802177,76,2,no,"('MOT', 'GRA')",Providence,ale15.xml,78,2,0,GRA,519,419,MOT
0,1,4,73,1.84582669,74,1,one,"('MOT', 'GRA')",Providence,ale15.xml,78,4,0,GRA,519,419,MOT
0,1,3,59,1.824549292,60,1,all,"('GRA', 'MOT')",Providence,ale15.xml,63,3,0,MOT,289,415,GRA
0,1,3,59,1.824549292,60,1,on,"('GRA', 'MOT')",Providence,ale15.xml,63,3,0,MOT,289,415,GRA
2,4,6,95,1.8017098,99,4,is,"('MOT', 'CHI')",Providence,ale15.xml,107,8,2,CHI,1268,321,MOT
2,2,8,66,1.763588592,68,2,that,"('MOT', 'GRA')",Providence,ale15.xml,78,10,2,GRA,519,419,MOT
2,3,4,54,1.71041383,57,3,and,"('GRA', 'MOT')",Providence,ale15.xml,63,6,2,MOT,289,415,GRA
0,3,1,59,1.673976434,62,3,for,"('GRA', 'MOT')",Providence,ale15.xml,63,1,0,MOT,289,415,GRA
0,2,2,59,1.658228077,61,2,is,"('GRA', 'MOT')",Providence,ale15.xml,63,2,0,MOT,289,415,GRA
0,1,4,58,1.625967214,59,1,she,"('GRA', 'MOT')",Providence,ale15.xml,63,4,0,MOT,289,415,GRA
1,6,1,55,1.504077397,61,6,what,"('GRA', 'MOT')",Providence,ale15.xml,63,2,1,MOT,289,415,GRA
0,2,4,72,1.440361582,74,2,on,"('MOT', 'GRA')",Providence,ale15.xml,78,4,0,GRA,519,419,MOT
0,3,2,58,1.370546004,61,3,do,"('GRA', 'MOT')",Providence,ale15.xml,63,2,0,MOT,289,415,GRA
1,4,5,68,1.30833282,72,4,to,"('MOT', 'GRA')",Providence,ale15.xml,78,6,1,GRA,519,419,MOT
0,2,5,71,1.272965676,73,2,is,"('MOT', 'GRA')",Providence,ale15.xml,78,5,0,GRA,519,419,MOT
0,5,1,57,1.268511325,62,5,that,"('GRA', 'MOT')",Providence,ale15.xml,63,1,0,MOT,289,415,GRA
0,3,4,77,1.228665417,80,3,no,"('GRA', 'CHI')",Providence,ale15.xml,84,4,0,CHI,504,243,GRA
0,2,4,57,1.220502106,59,2,the,"('GRA', 'MOT')",Providence,ale15.xml,63,4,0,MOT,289,415,GRA
1,6,4,73,1.195776037,79,6,is,"('GRA', 'CHI')",Providence,ale15.xml,84,5,1,CHI,504,243,GRA
1,1,11,42,1.16760516,43,1,that,"('CHI', 'GRA')",Providence,ale15.xml,55,12,1,GRA,148,210,CHI
0,4,2,57,1.147402453,61,4,no,"('GRA', 'MOT')",Providence,ale15.xml,63,2,0,MOT,289,415,GRA
0,5,1,49,1.134979933,54,5,a,"('CHI', 'GRA')",Providence,ale15.xml,55,1,0,GRA,148,210,CHI
0,3,3,57,1.131402111,60,3,was,"('GRA', 'MOT')",Providence,ale15.xml,63,3,0,MOT,289,415,GRA
0,1,14,92,1.088140989,93,1,this,"('MOT', 'CHI')",Providence,ale15.xml,107,14,0,CHI,1268,321,MOT
4,13,6,84,1.080593783,97,13,what,"('MOT', 'CHI')",Providence,ale15.xml,107,10,4,CHI,1268,321,MOT
0,9,1,74,1.041453875,83,9,on,"('CHI', 'MOT')",Providence,ale15.xml,84,1,0,MOT,261,673,CHI
0,1,15,91,1.016934258,92,1,the,"('MOT', 'CHI')",Providence,ale15.xml,107,15,0,CHI,1268,321,MOT
0,3,5,70,0.985283603,73,3,you,"('MOT', 'GRA')",Providence,ale15.xml,78,5,0,GRA,519,419,MOT
0,3,5,70,0.985283603,73,3,do,"('MOT', 'GRA')",Providence,ale15.xml,78,5,0,GRA,519,419,MOT
1,2,20,84,0.93637749,86,2,a,"('MOT', 'CHI')",Providence,ale15.xml,107,21,1,CHI,1268,321,MOT
1,6,6,71,0.919460307,77,6,one,"('CHI', 'MOT')",Providence,ale15.xml,84,7,1,MOT,261,673,CHI
0,11,1,72,0.859132318,83,11,it,"('CHI', 'MOT')",Providence,ale15.xml,84,1,0,MOT,261,673,CHI
3,13,7,84,0.857450232,97,13,one,"('MOT', 'CHI')",Providence,ale15.xml,107,10,3,CHI,1268,321,MOT
2,10,3,48,0.849151429,58,10,you,"('GRA', 'MOT')",Providence,ale15.xml,63,5,2,MOT,289,415,GRA
1,4,6,44,0.798507696,48,4,is,"('CHI', 'GRA')",Providence,ale15.xml,55,7,1,GRA,148,210,CHI
0,6,3,69,0.78845736,75,6,and,"('MOT', 'GRA')",Providence,ale15.xml,78,3,0,GRA,519,419,MOT
0,4,5,69,0.762140052,73,4,what,"('MOT', 'GRA')",Providence,ale15.xml,78,5,0,GRA,519,419,MOT
0,4,6,74,0.693147181,78,4,this,"('CHI', 'MOT')",Providence,ale15.xml,84,6,0,MOT,261,673,CHI
1,4,11,62,0.664159644,66,4,the,"('MOT', 'GRA')",Providence,ale15.xml,78,12,1,GRA,519,419,MOT
1,1,35,70,0.652873281,71,1,you,"('MOT', 'CHI')",Providence,ale15.xml,107,36,1,CHI,1268,321,MOT
1,14,3,66,0.600056757,80,14,that,"('GRA', 'CHI')",Providence,ale15.xml,84,4,1,CHI,504,243,GRA
0,3,8,67,0.587786665,70,3,it,"('MOT', 'GRA')",Providence,ale15.xml,78,8,0,GRA,519,419,MOT
0,12,2,70,0.47957308,82,12,a,"('CHI', 'MOT')",Providence,ale15.xml,84,2,0,MOT,261,673,CHI
0,5,5,53,0.356674944,58,5,to,"('GRA', 'MOT')",Providence,ale15.xml,63,5,0,MOT,289,415,GRA
0,3,15,89,0.323787077,92,3,it,"('MOT', 'CHI')",Providence,ale15.xml,107,15,0,CHI,1268,321,MOT
0,1,1,5,0.287682072,6,1,yeah,"('GRA', 'ADU')",Providence,ale15.xml,7,1,0,ADU,51,30,GRA
0,1,1,5,0.287682072,6,1,it,"('GRA', 'ADU')",Providence,ale15.xml,7,1,0,ADU,51,30,GRA
1,5,15,63,0.259511195,68,5,what,"('CHI', 'MOT')",Providence,ale15.xml,84,16,1,MOT,261,673,CHI
1,6,8,40,0.22054277,46,6,what,"('CHI', 'GRA')",Providence,ale15.xml,55,9,1,GRA,148,210,CHI
0,23,1,60,0.165985137,83,23,you,"('CHI', 'MOT')",Providence,ale15.xml,84,1,0,MOT,261,673,CHI
0,1,1,4,0.15415068,5,1,one,"('ENV', 'MOT')",Providence,ale15.xml,6,1,0,MOT,45,18,ENV
0,1,1,4,0.15415068,5,1,up,"('MOT', 'ADU')",Providence,ale15.xml,6,1,0,ADU,57,21,MOT
0,1,1,4,0.15415068,5,1,the,"('MOT', 'ADU')",Providence,ale15.xml,6,1,0,ADU,57,21,MOT
0,2,20,62,0,64,2,that,"('CHI', 'MOT')",Providence,ale15.xml,84,20,0,MOT,261,673,CHI
0,12,4,62,-0.025975486,74,12,oh,"('MOT', 'GRA')",Providence,ale15.xml,78,4,0,GRA,519,419,MOT
0,4,13,67,-0.027028672,71,4,is,"('CHI', 'MOT')",Providence,ale15.xml,84,13,0,MOT,261,673,CHI
0,2,1,4,-0.117783036,6,2,you,"('MOT', 'ENV')",Providence,ale15.xml,7,1,0,ENV,19,33,MOT
0,1,2,4,-0.133531393,5,1,one,"('MOT', 'ENV')",Providence,ale15.xml,7,2,0,ENV,19,33,MOT
0,9,5,49,-0.15415068,58,9,a,"('GRA', 'MOT')",Providence,ale15.xml,63,5,0,MOT,289,415,GRA
0,1,1,2,-0.182321557,3,1,one,"('CHI', 'ENV')",Providence,ale15.xml,4,1,0,ENV,10,19,CHI
1,14,14,78,-0.304821582,92,14,that,"('MOT', 'CHI')",Providence,ale15.xml,107,15,1,CHI,1268,321,MOT
0,1,3,3,-0.510825624,4,1,oh,"('GRA', 'ADU')",Providence,ale15.xml,7,3,0,ADU,51,30,GRA
0,15,7,62,-0.600365447,77,15,what,"('GRA', 'CHI')",Providence,ale15.xml,84,7,0,CHI,504,243,GRA
1,0,1,58,3.401197382,58,0,get,"('MOT', 'GRA')",Providence,ale16.xml,60,2,1,GRA,498,227,MOT
1,1,0,62,3.075774981,63,1,there,"('GRA', 'MOT')",Providence,ale16.xml,64,1,1,MOT,306,455,GRA
1,1,1,61,2.772588722,62,1,to,"('GRA', 'MOT')",Providence,ale16.xml,64,2,1,MOT,306,455,GRA
1,2,0,61,2.670309873,63,2,one,"('GRA', 'MOT')",Providence,ale16.xml,64,1,1,MOT,306,455,GRA
1,1,2,60,2.533696814,61,1,yeah,"('GRA', 'MOT')",Providence,ale16.xml,64,3,1,MOT,306,455,GRA
0,1,1,62,2.382627801,63,1,up,"('GRA', 'MOT')",Providence,ale16.xml,64,1,0,MOT,306,455,GRA
1,0,1,18,2.302585093,18,0,no,"('CHI', 'GRA')",Providence,ale16.xml,20,2,1,GRA,53,92,CHI
0,4,1,140,2.275556421,144,4,oh,"('CHI', 'MOT')",Providence,ale16.xml,145,1,0,MOT,381,1327,CHI
0,4,1,140,2.275556421,144,4,wanna,"('CHI', 'MOT')",Providence,ale16.xml,145,1,0,MOT,381,1327,CHI
0,3,2,133,2.154664963,136,3,oh,"('MOT', 'CHI')",Providence,ale16.xml,138,2,0,CHI,1467,352,MOT
1,2,2,59,2.128231706,61,2,it,"('GRA', 'MOT')",Providence,ale16.xml,64,3,1,MOT,306,455,GRA
1,1,4,54,2.097141119,55,1,one,"('MOT', 'GRA')",Providence,ale16.xml,60,5,1,GRA,498,227,MOT
0,1,2,61,2.079441542,62,1,are,"('GRA', 'MOT')",Providence,ale16.xml,64,2,0,MOT,306,455,GRA
0,1,2,57,2.014903021,58,1,yeah,"('MOT', 'GRA')",Providence,ale16.xml,60,2,0,GRA,498,227,MOT
0,1,2,57,2.014903021,58,1,with,"('MOT', 'GRA')",Providence,ale16.xml,60,2,0,GRA,498,227,MOT
0,1,2,57,2.014903021,58,1,where,"('MOT', 'GRA')",Providence,ale16.xml,60,2,0,GRA,498,227,MOT
0,2,1,61,1.977162693,63,2,on,"('GRA', 'MOT')",Providence,ale16.xml,64,1,0,MOT,306,455,GRA
1,1,0,18,1.945910149,19,1,oh,"('CHI', 'GRA')",Providence,ale16.xml,20,1,1,GRA,53,92,CHI
1,1,5,53,1.945910149,54,1,this,"('MOT', 'GRA')",Providence,ale16.xml,60,6,1,GRA,498,227,MOT
0,6,1,138,1.939084184,144,6,there,"('CHI', 'MOT')",Providence,ale16.xml,145,1,0,MOT,381,1327,CHI
2,0,0,7,1.909542505,7,0,you,"('MOT', 'ADU')",Providence,ale16.xml,9,2,2,ADU,58,47,MOT
1,0,0,8,1.897119985,8,0,they,"('ADU', 'GRA')",Providence,ale16.xml,9,1,1,GRA,64,67,ADU
0,1,8,129,1.887069649,130,1,did,"('MOT', 'CHI')",Providence,ale16.xml,138,8,0,CHI,1467,352,MOT
1,2,3,54,1.863218433,56,2,what,"('MOT', 'GRA')",Providence,ale16.xml,60,4,1,GRA,498,227,MOT
0,1,3,60,1.840549633,61,1,in,"('GRA', 'MOT')",Providence,ale16.xml,64,3,0,MOT,306,455,GRA
1,6,0,57,1.823012013,63,6,is,"('GRA', 'MOT')",Providence,ale16.xml,64,1,1,MOT,306,455,GRA
1,1,6,52,1.810108608,53,1,that,"('MOT', 'GRA')",Providence,ale16.xml,60,7,1,GRA,498,227,MOT
0,1,3,56,1.774952351,57,1,did,"('MOT', 'GRA')",Providence,ale16.xml,60,3,0,GRA,498,227,MOT
0,1,3,56,1.774952351,57,1,is,"('MOT', 'GRA')",Providence,ale16.xml,60,3,0,GRA,498,227,MOT
0,1,3,56,1.774952351,57,1,on,"('MOT', 'GRA')",Providence,ale16.xml,60,3,0,GRA,498,227,MOT
0,3,1,60,1.68948062,63,3,like,"('GRA', 'MOT')",Providence,ale16.xml,64,1,0,MOT,306,455,GRA
0,1,4,59,1.642227735,60,1,of,"('GRA', 'MOT')",Providence,ale16.xml,64,4,0,MOT,306,455,GRA
0,1,4,55,1.575536361,56,1,there,"('MOT', 'GRA')",Providence,ale16.xml,60,4,0,GRA,498,227,MOT
0,3,1,53,1.575536361,56,3,no,"('GRA', 'CHI')",Providence,ale16.xml,57,1,0,CHI,334,154,GRA
2,14,2,127,1.561647249,141,14,a,"('CHI', 'MOT')",Providence,ale16.xml,145,4,2,MOT,381,1327,CHI
1,1,8,47,1.514127733,48,1,a,"('GRA', 'CHI')",Providence,ale16.xml,57,9,1,CHI,334,154,GRA
1,0,1,7,1.504077397,7,0,he,"('ADU', 'GRA')",Providence,ale16.xml,9,2,1,GRA,64,67,ADU
2,1,12,45,1.504077397,46,1,the,"('MOT', 'GRA')",Providence,ale16.xml,60,14,2,GRA,498,227,MOT
0,1,5,58,1.471816535,59,1,and,"('GRA', 'MOT')",Providence,ale16.xml,64,5,0,MOT,306,455,GRA
0,4,1,59,1.466337069,63,4,no,"('GRA', 'MOT')",Providence,ale16.xml,64,1,0,MOT,306,455,GRA
0,2,3,59,1.435084525,61,2,have,"('GRA', 'MOT')",Providence,ale16.xml,64,3,0,MOT,306,455,GRA
1,2,6,51,1.4046435,53,2,a,"('MOT', 'GRA')",Providence,ale16.xml,60,7,1,GRA,498,227,MOT
0,1,5,54,1.403993938,55,1,it,"('MOT', 'GRA')",Providence,ale16.xml,60,5,0,GRA,498,227,MOT
4,15,5,121,1.366207603,136,15,one,"('CHI', 'MOT')",Providence,ale16.xml,145,9,4,MOT,381,1327,CHI
0,5,1,58,1.284015512,63,5,go,"('GRA', 'MOT')",Providence,ale16.xml,64,1,0,MOT,306,455,GRA
1,4,4,55,1.248672983,59,4,oh,"('GRA', 'MOT')",Providence,ale16.xml,64,5,1,MOT,306,455,GRA
0,5,1,54,1.220502106,59,5,are,"('MOT', 'GRA')",Providence,ale16.xml,60,1,0,GRA,498,227,MOT
1,1,0,7,1.203972804,8,1,to,"('ADU', 'GRA')",Providence,ale16.xml,9,1,1,GRA,64,67,ADU
0,3,3,54,1.08180517,57,3,have,"('MOT', 'GRA')",Providence,ale16.xml,60,3,0,GRA,498,227,MOT
2,10,2,50,1.036091932,60,10,you,"('GRA', 'MOT')",Providence,ale16.xml,64,4,2,MOT,306,455,GRA
2,12,7,117,1.010964982,129,12,no,"('MOT', 'CHI')",Providence,ale16.xml,138,9,2,CHI,1467,352,MOT
2,9,10,117,1.00900013,126,9,a,"('MOT', 'CHI')",Providence,ale16.xml,138,12,2,CHI,1467,352,MOT
2,7,14,122,1.003996312,129,7,no,"('CHI', 'MOT')",Providence,ale16.xml,145,16,2,MOT,381,1327,CHI
0,7,1,56,0.99633344,63,7,put,"('GRA', 'MOT')",Providence,ale16.xml,64,1,0,MOT,306,455,GRA
1,35,0,109,0.994622575,144,35,the,"('CHI', 'MOT')",Providence,ale16.xml,145,1,1,MOT,381,1327,CHI
0,1,8,51,0.993251773,52,1,no,"('MOT', 'GRA')",Providence,ale16.xml,60,8,0,GRA,498,227,MOT
0,1,1,13,0.980829253,14,1,oh,"('ADU', 'MOT')",Providence,ale16.xml,15,1,0,MOT,52,91,ADU
0,1,1,13,0.980829253,14,1,a,"('ADU', 'MOT')",Providence,ale16.xml,15,1,0,MOT,52,91,ADU
2,5,7,46,0.87924946,51,5,oh,"('MOT', 'GRA')",Providence,ale16.xml,60,9,2,GRA,498,227,MOT
2,1,1,5,0.875468737,6,1,the,"('ADU', 'GRA')",Providence,ale16.xml,9,3,2,GRA,64,67,ADU
0,3,4,50,0.829279355,53,3,that,"('GRA', 'CHI')",Providence,ale16.xml,57,4,0,CHI,334,154,GRA
0,1,26,111,0.710846758,112,1,it,"('MOT', 'CHI')",Providence,ale16.xml,138,26,0,CHI,1467,352,MOT
3,7,23,105,0.710846758,112,7,one,"('MOT', 'CHI')",Providence,ale16.xml,138,26,3,CHI,1467,352,MOT
2,4,11,43,0.672944473,47,4,you,"('MOT', 'GRA')",Providence,ale16.xml,60,13,2,GRA,498,227,MOT
0,1,2,12,0.628608659,13,1,it,"('ADU', 'MOT')",Providence,ale16.xml,15,2,0,MOT,52,91,ADU
0,2,1,12,0.575364145,14,2,he,"('ADU', 'MOT')",Providence,ale16.xml,15,1,0,MOT,52,91,ADU
0,8,2,54,0.575364145,62,8,that,"('GRA', 'MOT')",Providence,ale16.xml,64,2,0,MOT,306,455,GRA
0,4,5,55,0.555525803,59,4,what,"('GRA', 'MOT')",Providence,ale16.xml,64,5,0,MOT,306,455,GRA
0,1,1,7,0.510825624,8,1,with,"('ADU', 'GRA')",Providence,ale16.xml,9,1,0,GRA,64,67,ADU
0,1,1,7,0.510825624,8,1,was,"('ADU', 'GRA')",Providence,ale16.xml,9,1,0,GRA,64,67,ADU
0,1,1,7,0.510825624,8,1,think,"('ADU', 'GRA')",Providence,ale16.xml,9,1,0,GRA,64,67,ADU
0,1,1,7,0.510825624,8,1,have,"('MOT', 'ADU')",Providence,ale16.xml,9,1,0,ADU,58,47,MOT
0,2,2,11,0.223143551,13,2,you,"('ADU', 'MOT')",Providence,ale16.xml,15,2,0,MOT,52,91,ADU
0,1,2,6,0.117783036,7,1,for,"('ADU', 'GRA')",Providence,ale16.xml,9,2,0,GRA,64,67,ADU
0,1,2,6,0.117783036,7,1,it,"('MOT', 'ADU')",Providence,ale16.xml,9,2,0,ADU,58,47,MOT
0,2,1,6,0.105360516,8,2,and,"('ADU', 'GRA')",Providence,ale16.xml,9,1,0,GRA,64,67,ADU
1,14,6,43,-0.134590154,57,14,the,"('GRA', 'MOT')",Providence,ale16.xml,64,7,1,MOT,306,455,GRA
0,11,4,49,-0.149531734,60,11,a,"('GRA', 'MOT')",Providence,ale16.xml,64,4,0,MOT,306,455,GRA
0,1,1,1,-0.405465108,2,1,no,"('CHI', 'ADU')",Providence,ale16.xml,3,1,0,ADU,9,11,CHI
0,5,29,104,-0.516216472,109,5,that,"('MOT', 'CHI')",Providence,ale16.xml,138,29,0,CHI,1467,352,MOT
1,0,0,20,2.685577345,20,0,gonna,"('MOT', 'GRA')",Providence,ale17.xml,21,1,1,GRA,179,167,MOT
1,0,0,20,2.685577345,20,0,he,"('MOT', 'GRA')",Providence,ale17.xml,21,1,1,GRA,179,167,MOT
3,4,5,133,2.408745289,137,4,no,"('MOT', 'CHI')",Providence,ale17.xml,145,8,3,CHI,1671,476,MOT
1,0,1,19,2.351375257,19,0,get,"('MOT', 'GRA')",Providence,ale17.xml,21,2,1,GRA,179,167,MOT
1,1,0,19,1.992430165,20,1,but,"('MOT', 'GRA')",Providence,ale17.xml,21,1,1,GRA,179,167,MOT
1,0,1,11,1.871802177,11,0,no,"('GRA', 'MOT')",Providence,ale17.xml,13,2,1,MOT,84,133,GRA
2,2,0,17,1.658228077,19,2,they,"('MOT', 'GRA')",Providence,ale17.xml,21,2,2,GRA,179,167,MOT
0,1,11,133,1.654558348,134,1,one,"('MOT', 'CHI')",Providence,ale17.xml,145,11,0,CHI,1671,476,MOT
0,8,1,130,1.645805557,138,8,no,"('CHI', 'MOT')",Providence,ale17.xml,139,1,0,MOT,470,1969,CHI
1,0,0,5,1.540445041,5,0,for,"('MOT', 'FAT')",Providence,ale17.xml,6,1,1,FAT,39,29,MOT
0,1,13,131,1.496642418,132,1,see,"('MOT', 'CHI')",Providence,ale17.xml,145,13,0,CHI,1671,476,MOT
0,10,1,128,1.445134861,138,10,oh,"('CHI', 'MOT')",Providence,ale17.xml,139,1,0,MOT,470,1969,CHI
0,10,1,128,1.445134861,138,10,one,"('CHI', 'MOT')",Providence,ale17.xml,139,1,0,MOT,470,1969,CHI
1,0,1,6,1.386294361,6,0,see,"('FAT', 'MOT')",Providence,ale17.xml,8,2,1,MOT,54,54,FAT
0,1,1,19,1.299282984,20,1,look,"('MOT', 'GRA')",Providence,ale17.xml,21,1,0,GRA,179,167,MOT
0,1,1,19,1.299282984,20,1,no,"('MOT', 'GRA')",Providence,ale17.xml,21,1,0,GRA,179,167,MOT
0,1,1,19,1.299282984,20,1,can,"('MOT', 'GRA')",Providence,ale17.xml,21,1,0,GRA,179,167,MOT
0,1,1,19,1.299282984,20,1,not,"('MOT', 'GRA')",Providence,ale17.xml,21,1,0,GRA,179,167,MOT
0,1,1,19,1.299282984,20,1,and,"('MOT', 'GRA')",Providence,ale17.xml,21,1,0,GRA,179,167,MOT
0,2,11,132,1.24909324,134,2,oh,"('MOT', 'CHI')",Providence,ale17.xml,145,11,0,CHI,1671,476,MOT
2,2,2,15,1.15267951,17,2,it,"('MOT', 'GRA')",Providence,ale17.xml,21,4,2,GRA,179,167,MOT
1,1,0,6,1.098612289,7,1,and,"('FAT', 'GRA')",Providence,ale17.xml,8,1,1,GRA,45,65,FAT
1,0,1,4,1.098612289,4,0,the,"('MOT', 'FAT')",Providence,ale17.xml,6,2,1,FAT,39,29,MOT
1,2,2,16,0.980829253,18,2,have,"('MOT', 'GRA')",Providence,ale17.xml,21,3,1,GRA,179,167,MOT
1,0,0,2,0.980829253,2,0,go,"('OPE', 'MOT')",Providence,ale17.xml,3,1,1,MOT,14,44,OPE
1,0,0,2,0.980829253,2,0,to,"('OPE', 'MOT')",Providence,ale17.xml,3,1,1,MOT,14,44,OPE
0,1,2,18,0.965080896,19,1,see,"('MOT', 'GRA')",Providence,ale17.xml,21,2,0,GRA,179,167,MOT
0,1,2,18,0.965080896,19,1,is,"('MOT', 'GRA')",Providence,ale17.xml,21,2,0,GRA,179,167,MOT
0,2,1,18,0.893817876,20,2,of,"('MOT', 'GRA')",Providence,ale17.xml,21,1,0,GRA,179,167,MOT
0,2,1,18,0.893817876,20,2,that,"('MOT', 'GRA')",Providence,ale17.xml,21,1,0,GRA,179,167,MOT
0,2,1,18,0.893817876,20,2,do,"('MOT', 'GRA')",Providence,ale17.xml,21,1,0,GRA,179,167,MOT
0,1,1,11,0.84729786,12,1,have,"('GRA', 'MOT')",Providence,ale17.xml,13,1,0,MOT,84,133,GRA
0,1,1,11,0.84729786,12,1,see,"('GRA', 'MOT')",Providence,ale17.xml,13,1,0,MOT,84,133,GRA
1,0,3,4,0.693147181,4,0,yeah,"('FAT', 'GRA')",Providence,ale17.xml,8,4,1,GRA,45,65,FAT
0,1,3,17,0.693147181,18,1,what,"('MOT', 'GRA')",Providence,ale17.xml,21,3,0,GRA,179,167,MOT
8,12,29,96,0.66919394,108,12,a,"('MOT', 'CHI')",Providence,ale17.xml,145,37,8,CHI,1671,476,MOT
0,1,2,10,0.485507816,11,1,that,"('GRA', 'MOT')",Providence,ale17.xml,13,2,0,MOT,84,133,GRA
1,2,2,8,0.470003629,10,2,he,"('GRA', 'MOT')",Providence,ale17.xml,13,3,1,MOT,84,133,GRA
0,2,1,10,0.441832752,12,2,they,"('GRA', 'MOT')",Providence,ale17.xml,13,1,0,MOT,84,133,GRA
0,1,1,6,0.405465108,7,1,the,"('FAT', 'GRA')",Providence,ale17.xml,8,1,0,GRA,45,65,FAT
0,1,1,6,0.405465108,7,1,of,"('FAT', 'MOT')",Providence,ale17.xml,8,1,0,MOT,54,54,FAT
0,1,1,6,0.405465108,7,1,can,"('FAT', 'MOT')",Providence,ale17.xml,8,1,0,MOT,54,54,FAT
0,2,3,16,0.287682072,18,2,a,"('MOT', 'GRA')",Providence,ale17.xml,21,3,0,GRA,179,167,MOT
0,3,2,16,0.271933715,19,3,did,"('MOT', 'GRA')",Providence,ale17.xml,21,2,0,GRA,179,167,MOT
0,1,3,9,0.182321557,10,1,yeah,"('GRA', 'MOT')",Providence,ale17.xml,13,3,0,MOT,84,133,GRA
0,3,1,9,0.15415068,12,3,the,"('GRA', 'MOT')",Providence,ale17.xml,13,1,0,MOT,84,133,GRA
2,31,7,99,0.117783036,130,31,a,"('CHI', 'MOT')",Providence,ale17.xml,139,9,2,MOT,470,1969,CHI
0,2,2,9,0.080042708,11,2,to,"('GRA', 'MOT')",Providence,ale17.xml,13,2,0,MOT,84,133,GRA
0,2,1,5,0,7,2,a,"('FAT', 'GRA')",Providence,ale17.xml,8,1,0,GRA,45,65,FAT
0,1,2,5,0,6,1,he,"('FAT', 'GRA')",Providence,ale17.xml,8,2,0,GRA,45,65,FAT
0,2,1,5,0,7,2,to,"('FAT', 'GRA')",Providence,ale17.xml,8,1,0,GRA,45,65,FAT
0,1,2,5,0,6,1,what,"('FAT', 'MOT')",Providence,ale17.xml,8,2,0,MOT,54,54,FAT
0,4,1,8,-0.068992871,12,4,it,"('GRA', 'MOT')",Providence,ale17.xml,13,1,0,MOT,84,133,GRA
1,3,6,11,-0.117783036,14,3,the,"('MOT', 'GRA')",Providence,ale17.xml,21,7,1,GRA,179,167,MOT
0,5,2,14,-0.133531393,19,5,yeah,"('MOT', 'GRA')",Providence,ale17.xml,21,2,0,GRA,179,167,MOT
0,3,4,14,-0.233614851,17,3,this,"('MOT', 'GRA')",Providence,ale17.xml,21,4,0,GRA,179,167,MOT
0,2,2,4,-0.405465108,6,2,with,"('FAT', 'GRA')",Providence,ale17.xml,8,2,0,GRA,45,65,FAT
0,2,3,3,-0.762140052,5,2,the,"('FAT', 'MOT')",Providence,ale17.xml,8,3,0,MOT,54,54,FAT
0,4,6,11,-0.85566611,15,4,oh,"('MOT', 'GRA')",Providence,ale17.xml,21,6,0,GRA,179,167,MOT
2,5,2,157,2.614959778,162,5,where,"('CHI', 'MOT')",Providence,ale18.xml,166,4,2,MOT,607,1993,CHI
2,3,6,155,2.48490665,158,3,oh,"('CHI', 'MOT')",Providence,ale18.xml,166,8,2,MOT,607,1993,CHI
1,0,17,102,2.341805806,102,0,on,"('MOT', 'CHI')",Providence,ale18.xml,120,18,1,CHI,1815,402,MOT
1,0,0,13,2.302585093,13,0,a,"('MOT', 'GRA')",Providence,ale18.xml,14,1,1,GRA,105,93,MOT
1,10,1,154,2.020945335,164,10,go,"('CHI', 'MOT')",Providence,ale18.xml,166,2,1,MOT,607,1993,CHI
1,0,2,15,1.916922612,15,0,oh,"('GRA', 'MOT')",Providence,ale18.xml,18,3,1,MOT,80,152,GRA
2,18,2,144,1.462280268,162,18,that,"('CHI', 'MOT')",Providence,ale18.xml,166,4,2,MOT,607,1993,CHI
0,1,11,108,1.451433663,109,1,do,"('MOT', 'CHI')",Providence,ale18.xml,120,11,0,CHI,1815,402,MOT
0,3,5,112,1.429969425,115,3,want,"('MOT', 'CHI')",Providence,ale18.xml,120,5,0,CHI,1815,402,MOT
1,0,2,8,1.386294361,8,0,that,"('CHI', 'GRA')",Providence,ale18.xml,11,3,1,GRA,37,71,CHI
0,2,8,110,1.335001067,112,2,one,"('MOT', 'CHI')",Providence,ale18.xml,120,8,0,CHI,1815,402,MOT
3,9,12,142,1.280933845,151,9,no,"('CHI', 'MOT')",Providence,ale18.xml,166,15,3,MOT,607,1993,CHI
0,15,1,150,1.246792802,165,15,and,"('CHI', 'MOT')",Providence,ale18.xml,166,1,0,MOT,607,1993,CHI
2,2,1,13,1.223775432,15,2,she,"('GRA', 'MOT')",Providence,ale18.xml,18,3,2,MOT,80,152,GRA
0,1,1,16,1.15267951,17,1,is,"('GRA', 'MOT')",Providence,ale18.xml,18,1,0,MOT,80,152,GRA
0,1,1,16,1.15267951,17,1,are,"('GRA', 'MOT')",Providence,ale18.xml,18,1,0,MOT,80,152,GRA
0,1,17,102,1.01637419,103,1,it,"('MOT', 'CHI')",Providence,ale18.xml,120,17,0,CHI,1815,402,MOT
0,1,1,13,0.980829253,14,1,want,"('GRA', 'CHI')",Providence,ale18.xml,15,1,0,CHI,68,64,GRA
0,1,1,13,0.980829253,14,1,it,"('GRA', 'CHI')",Providence,ale18.xml,15,1,0,CHI,68,64,GRA
0,2,12,106,0.962810748,108,2,that,"('MOT', 'CHI')",Providence,ale18.xml,120,12,0,CHI,1815,402,MOT
1,2,1,11,0.916290732,13,2,oh,"('GRA', 'CHI')",Providence,ale18.xml,15,2,1,CHI,68,64,GRA
0,1,1,12,0.916290732,13,1,yeah,"('MOT', 'GRA')",Providence,ale18.xml,14,1,0,GRA,105,93,MOT
0,1,1,12,0.916290732,13,1,get,"('MOT', 'GRA')",Providence,ale18.xml,14,1,0,GRA,105,93,MOT
0,1,1,12,0.916290732,13,1,is,"('MOT', 'GRA')",Providence,ale18.xml,14,1,0,GRA,105,93,MOT
0,1,1,12,0.916290732,13,1,put,"('MOT', 'GRA')",Providence,ale18.xml,14,1,0,GRA,105,93,MOT
0,1,1,12,0.916290732,13,1,that,"('MOT', 'GRA')",Providence,ale18.xml,14,1,0,GRA,105,93,MOT
0,1,2,15,0.810930216,16,1,where,"('GRA', 'MOT')",Providence,ale18.xml,18,2,0,MOT,80,152,GRA
1,10,7,102,0.728865263,112,10,oh,"('MOT', 'CHI')",Providence,ale18.xml,120,8,1,CHI,1815,402,MOT
5,15,14,86,0.609377297,101,15,no,"('MOT', 'CHI')",Providence,ale18.xml,120,19,5,CHI,1815,402,MOT
0,12,5,149,0.582890694,161,12,one,"('CHI', 'MOT')",Providence,ale18.xml,166,5,0,MOT,607,1993,CHI
0,2,1,12,0.575364145,14,2,no,"('GRA', 'CHI')",Providence,ale18.xml,15,1,0,CHI,68,64,GRA
0,1,3,14,0.530628251,15,1,the,"('GRA', 'MOT')",Providence,ale18.xml,18,3,0,MOT,80,152,GRA
0,2,1,11,0.510825624,13,2,oh,"('MOT', 'GRA')",Providence,ale18.xml,14,1,0,GRA,105,93,MOT
0,2,1,11,0.510825624,13,2,are,"('MOT', 'GRA')",Providence,ale18.xml,14,1,0,GRA,105,93,MOT
0,16,4,146,0.474893615,162,16,in,"('CHI', 'MOT')",Providence,ale18.xml,166,4,0,MOT,607,1993,CHI
1,29,4,132,0.439789851,161,29,the,"('CHI', 'MOT')",Providence,ale18.xml,166,5,1,MOT,607,1993,CHI
0,2,2,14,0.405465108,16,2,for,"('GRA', 'MOT')",Providence,ale18.xml,18,2,0,MOT,80,152,GRA
0,2,2,14,0.405465108,16,2,he,"('GRA', 'MOT')",Providence,ale18.xml,18,2,0,MOT,80,152,GRA
2,4,2,6,0.182321557,10,4,you,"('MOT', 'GRA')",Providence,ale18.xml,14,4,2,GRA,105,93,MOT
0,2,2,10,0.15415068,12,2,it,"('MOT', 'GRA')",Providence,ale18.xml,14,2,0,GRA,105,93,MOT
0,3,23,94,-0.010050336,97,3,a,"('MOT', 'CHI')",Providence,ale18.xml,120,23,0,CHI,1815,402,MOT
0,3,3,12,-0.162518929,15,3,go,"('GRA', 'MOT')",Providence,ale18.xml,18,3,0,MOT,80,152,GRA
0,4,1,6,-0.223143551,10,4,what,"('CHI', 'GRA')",Providence,ale18.xml,11,1,0,GRA,37,71,CHI
0,1,1,1,-0.405465108,2,1,you,"('OPE', 'MOT')",Providence,ale18.xml,3,1,0,MOT,21,32,OPE
1,0,0,21,2.730029108,21,0,see,"('GRA', 'MOT')",Providence,ale19.xml,22,1,1,MOT,190,342,GRA
1,0,1,16,2.197224577,16,0,one,"('GRA', 'CHI')",Providence,ale19.xml,18,2,1,CHI,209,70,GRA
0,1,3,80,2.116255515,81,1,where,"('MOT', 'CHI')",Providence,ale19.xml,84,3,0,CHI,1609,280,MOT
1,1,0,20,2.036881927,21,1,but,"('GRA', 'MOT')",Providence,ale19.xml,22,1,1,MOT,190,342,GRA
1,0,3,21,2.036881927,21,0,go,"('MOT', 'GRA')",Providence,ale19.xml,25,4,1,GRA,369,226,MOT
1,0,16,67,1.982814706,67,0,this,"('MOT', 'CHI')",Providence,ale19.xml,84,17,1,CHI,1609,280,MOT
1,6,1,87,1.914819562,93,6,is,"('CHI', 'MOT')",Providence,ale19.xml,95,2,1,MOT,314,1152,CHI
1,0,3,18,1.897119985,18,0,what,"('GRA', 'MOT')",Providence,ale19.xml,22,4,1,MOT,190,342,GRA
1,0,4,20,1.838279485,20,0,and,"('MOT', 'GRA')",Providence,ale19.xml,25,5,1,GRA,369,226,MOT
1,1,1,22,1.832581464,23,1,get,"('MOT', 'GRA')",Providence,ale19.xml,25,2,1,GRA,369,226,MOT
1,2,0,22,1.754019141,24,2,do,"('MOT', 'GRA')",Providence,ale19.xml,25,1,1,GRA,369,226,MOT
1,0,0,6,1.673976434,6,0,the,"('CHI', 'GRA')",Providence,ale19.xml,7,1,1,GRA,23,28,CHI
0,5,1,89,1.673976434,94,5,where,"('CHI', 'MOT')",Providence,ale19.xml,95,1,0,MOT,314,1152,CHI
0,5,1,89,1.673976434,94,5,and,"('CHI', 'MOT')",Providence,ale19.xml,95,1,0,MOT,314,1152,CHI
2,14,0,79,1.558144618,93,14,that,"('CHI', 'MOT')",Providence,ale19.xml,95,2,2,MOT,314,1152,CHI
0,1,7,76,1.479076095,77,1,is,"('MOT', 'CHI')",Providence,ale19.xml,84,7,0,CHI,1609,280,MOT
1,1,2,18,1.435084525,19,1,go,"('GRA', 'MOT')",Providence,ale19.xml,22,3,1,MOT,190,342,GRA
1,1,2,18,1.435084525,19,1,put,"('GRA', 'MOT')",Providence,ale19.xml,22,3,1,MOT,190,342,GRA
0,5,2,88,1.375823061,93,5,go,"('CHI', 'MOT')",Providence,ale19.xml,95,2,0,MOT,314,1152,CHI
0,1,8,75,1.360976553,76,1,that,"('MOT', 'CHI')",Providence,ale19.xml,84,8,0,CHI,1609,280,MOT
0,1,1,20,1.343734747,21,1,with,"('GRA', 'MOT')",Providence,ale19.xml,22,1,0,MOT,190,342,GRA
0,1,1,20,1.343734747,21,1,little,"('GRA', 'MOT')",Providence,ale19.xml,22,1,0,MOT,190,342,GRA
1,1,3,20,1.343734747,21,1,the,"('MOT', 'GRA')",Providence,ale19.xml,25,4,1,GRA,369,226,MOT
0,2,6,87,1.332805676,89,2,oh,"('CHI', 'MOT')",Providence,ale19.xml,95,6,0,MOT,314,1152,CHI
1,2,2,20,1.16315081,22,2,in,"('MOT', 'GRA')",Providence,ale19.xml,25,3,1,GRA,369,226,MOT
0,1,10,73,1.15267951,74,1,and,"('MOT', 'CHI')",Providence,ale19.xml,84,10,0,CHI,1609,280,MOT
2,3,1,16,1.147402453,19,3,a,"('GRA', 'MOT')",Providence,ale19.xml,22,3,2,MOT,190,342,GRA
0,1,2,22,1.139434283,23,1,yeah,"('MOT', 'GRA')",Providence,ale19.xml,25,2,0,GRA,369,226,MOT
1,1,19,63,1.098612289,64,1,one,"('MOT', 'CHI')",Providence,ale19.xml,84,20,1,CHI,1609,280,MOT
4,16,3,72,1.078809661,88,16,one,"('CHI', 'MOT')",Providence,ale19.xml,95,7,4,MOT,314,1152,CHI
0,2,1,22,1.060871961,24,2,is,"('MOT', 'GRA')",Providence,ale19.xml,25,1,0,GRA,369,226,MOT
1,3,1,17,1.011600912,20,3,one,"('GRA', 'MOT')",Providence,ale19.xml,22,2,1,MOT,190,342,GRA
1,3,11,69,0.971860583,72,3,a,"('MOT', 'CHI')",Providence,ale19.xml,84,12,1,CHI,1609,280,MOT
0,2,1,19,0.938269639,21,2,this,"('GRA', 'MOT')",Providence,ale19.xml,22,1,0,MOT,190,342,GRA
0,2,1,19,0.938269639,21,2,do,"('GRA', 'MOT')",Providence,ale19.xml,22,1,0,MOT,190,342,GRA
1,2,3,19,0.938269639,21,2,what,"('MOT', 'GRA')",Providence,ale19.xml,25,4,1,GRA,369,226,MOT
0,1,3,21,0.875468737,22,1,there,"('MOT', 'GRA')",Providence,ale19.xml,25,3,0,GRA,369,226,MOT
0,1,3,21,0.875468737,22,1,to,"('MOT', 'GRA')",Providence,ale19.xml,25,3,0,GRA,369,226,MOT
1,3,2,19,0.875468737,22,3,he,"('MOT', 'GRA')",Providence,ale19.xml,25,3,1,GRA,369,226,MOT
0,2,9,73,0.84729786,75,2,go,"('MOT', 'CHI')",Providence,ale19.xml,84,9,0,CHI,1609,280,MOT
1,2,3,16,0.798507696,18,2,there,"('GRA', 'MOT')",Providence,ale19.xml,22,4,1,MOT,190,342,GRA
0,2,1,15,0.747214402,17,2,where,"('GRA', 'CHI')",Providence,ale19.xml,18,1,0,CHI,209,70,GRA
0,3,1,18,0.650587566,21,3,it,"('GRA', 'MOT')",Providence,ale19.xml,22,1,0,MOT,190,342,GRA
0,3,1,18,0.650587566,21,3,for,"('GRA', 'MOT')",Providence,ale19.xml,22,1,0,MOT,190,342,GRA
0,3,1,18,0.650587566,21,3,not,"('GRA', 'MOT')",Providence,ale19.xml,22,1,0,MOT,190,342,GRA
1,5,1,15,0.606135804,20,5,oh,"('GRA', 'MOT')",Providence,ale19.xml,22,2,1,MOT,190,342,GRA
1,3,3,15,0.510825624,18,3,the,"('GRA', 'MOT')",Providence,ale19.xml,22,4,1,MOT,190,342,GRA
0,2,3,20,0.470003629,22,2,no,"('MOT', 'GRA')",Providence,ale19.xml,25,3,0,GRA,369,226,MOT
0,3,2,20,0.446287103,23,3,oh,"('MOT', 'GRA')",Providence,ale19.xml,25,2,0,GRA,369,226,MOT
0,4,1,17,0.427444015,21,4,are,"('GRA', 'MOT')",Providence,ale19.xml,22,1,0,MOT,190,342,GRA
1,4,3,17,0.427444015,21,4,on,"('MOT', 'GRA')",Providence,ale19.xml,25,4,1,GRA,369,226,MOT
0,2,2,14,0.405465108,16,2,is,"('GRA', 'CHI')",Providence,ale19.xml,18,2,0,CHI,209,70,GRA
0,2,3,17,0.336472237,19,2,in,"('GRA', 'MOT')",Providence,ale19.xml,22,3,0,MOT,190,342,GRA
1,2,26,55,0.304776506,57,2,the,"('MOT', 'CHI')",Providence,ale19.xml,84,27,1,CHI,1609,280,MOT
0,2,4,19,0.245122458,21,2,it,"('MOT', 'GRA')",Providence,ale19.xml,25,4,0,GRA,369,226,MOT
0,2,4,19,0.245122458,21,2,a,"('MOT', 'GRA')",Providence,ale19.xml,25,4,0,GRA,369,226,MOT
0,5,1,16,0.245122458,21,5,look,"('GRA', 'MOT')",Providence,ale19.xml,22,1,0,MOT,190,342,GRA
0,7,7,81,0.223143551,88,7,no,"('CHI', 'MOT')",Providence,ale19.xml,95,7,0,MOT,314,1152,CHI
1,9,1,11,0.09531018,20,9,you,"('GRA', 'MOT')",Providence,ale19.xml,22,2,1,MOT,190,342,GRA
0,3,3,16,0.048790164,19,3,to,"('GRA', 'MOT')",Providence,ale19.xml,22,3,0,MOT,190,342,GRA
0,3,15,66,0.043172172,69,3,no,"('MOT', 'CHI')",Providence,ale19.xml,84,15,0,CHI,1609,280,MOT
0,6,2,17,-0.113328685,23,6,that,"('MOT', 'GRA')",Providence,ale19.xml,25,2,0,GRA,369,226,MOT
0,4,4,17,-0.265703166,21,4,you,"('MOT', 'GRA')",Providence,ale19.xml,25,4,0,GRA,369,226,MOT
0,2,6,10,-0.538996501,12,2,oh,"('GRA', 'CHI')",Providence,ale19.xml,18,6,0,CHI,209,70,GRA
1,0,12,165,3.103090792,165,0,can,"('MOT', 'CHI')",Providence,ale20.xml,178,13,1,CHI,3920,766,MOT
1,0,20,157,2.626557167,157,0,there,"('MOT', 'CHI')",Providence,ale20.xml,178,21,1,CHI,3920,766,MOT
0,1,5,172,2.525728644,173,1,where,"('MOT', 'CHI')",Providence,ale20.xml,178,5,0,CHI,3920,766,MOT
1,0,43,134,1.77716067,134,0,it,"('MOT', 'CHI')",Providence,ale20.xml,178,44,1,CHI,3920,766,MOT
2,2,23,151,1.747588251,153,2,oh,"('MOT', 'CHI')",Providence,ale20.xml,178,25,2,CHI,3920,766,MOT
0,2,11,165,1.466337069,167,2,up,"('MOT', 'CHI')",Providence,ale20.xml,178,11,0,CHI,3920,766,MOT
0,1,18,159,1.398716881,160,1,go,"('MOT', 'CHI')",Providence,ale20.xml,178,18,0,CHI,3920,766,MOT
2,6,16,154,1.244566201,160,6,no,"('MOT', 'CHI')",Providence,ale20.xml,178,18,2,CHI,3920,766,MOT
0,1,26,151,1.011600912,152,1,and,"('MOT', 'CHI')",Providence,ale20.xml,178,26,0,CHI,3920,766,MOT
0,1,28,149,0.929535959,150,1,is,"('MOT', 'CHI')",Providence,ale20.xml,178,28,0,CHI,3920,766,MOT
6,10,40,122,0.574653665,132,10,a,"('MOT', 'CHI')",Providence,ale20.xml,178,46,6,CHI,3920,766,MOT
3,7,37,131,0.510825624,138,7,that,"('MOT', 'CHI')",Providence,ale20.xml,178,40,3,CHI,3920,766,MOT
0,1,42,135,0.449916871,136,1,this,"('MOT', 'CHI')",Providence,ale20.xml,178,42,0,CHI,3920,766,MOT
1,3,50,124,0.19637331,127,3,the,"('MOT', 'CHI')",Providence,ale20.xml,178,51,1,CHI,3920,766,MOT
1,3,0,303,3.938340314,306,3,want,"('CHI', 'MOT')",Providence,ale21.xml,307,1,1,MOT,1259,3109,CHI
0,4,1,302,3.022049582,306,4,where,"('CHI', 'MOT')",Providence,ale21.xml,307,1,0,MOT,1259,3109,CHI
1,16,0,290,2.491421331,306,16,is,"('CHI', 'MOT')",Providence,ale21.xml,307,1,1,MOT,1259,3109,CHI
0,6,2,299,2.394643237,305,6,go,"('CHI', 'MOT')",Providence,ale21.xml,307,2,0,MOT,1259,3109,CHI
3,8,8,288,2.321213913,296,8,all,"('CHI', 'MOT')",Providence,ale21.xml,307,11,3,MOT,1259,3109,CHI
3,27,2,275,1.825207403,302,27,it,"('CHI', 'MOT')",Providence,ale21.xml,307,5,3,MOT,1259,3109,CHI
4,15,13,275,1.569164013,290,15,no,"('CHI', 'MOT')",Providence,ale21.xml,307,17,4,MOT,1259,3109,CHI
0,13,3,291,1.47508986,304,13,and,"('CHI', 'MOT')",Providence,ale21.xml,307,3,0,MOT,1259,3109,CHI
5,32,14,256,0.920610393,288,32,one,"('CHI', 'MOT')",Providence,ale21.xml,307,19,5,MOT,1259,3109,CHI
15,42,24,226,0.896238499,268,42,a,"('CHI', 'MOT')",Providence,ale21.xml,307,39,15,MOT,1259,3109,CHI
5,42,10,250,0.880925777,292,42,the,"('CHI', 'MOT')",Providence,ale21.xml,307,15,5,MOT,1259,3109,CHI
2,35,7,263,0.820980552,298,35,oh,"('CHI', 'MOT')",Providence,ale21.xml,307,9,2,MOT,1259,3109,CHI
0,34,5,268,0.215769491,302,34,that,"('CHI', 'MOT')",Providence,ale21.xml,307,5,0,MOT,1259,3109,CHI
1,0,12,385,3.943521672,385,0,see,"('MOT', 'CHI')",Providence,ale22.xml,398,13,1,CHI,3772,1667,MOT
0,1,23,374,2.020222182,375,1,and,"('MOT', 'CHI')",Providence,ale22.xml,398,23,0,CHI,3772,1667,MOT
1,1,51,345,1.863218433,346,1,it,"('MOT', 'CHI')",Providence,ale22.xml,398,52,1,CHI,3772,1667,MOT
1,0,94,303,1.838747979,303,0,you,"('MOT', 'CHI')",Providence,ale22.xml,398,95,1,CHI,3772,1667,MOT
0,3,15,380,1.733735629,383,3,there,"('MOT', 'CHI')",Providence,ale22.xml,398,15,0,CHI,3772,1667,MOT
1,8,19,370,1.345051403,378,8,oh,"('MOT', 'CHI')",Providence,ale22.xml,398,20,1,CHI,3772,1667,MOT
0,6,16,376,1.114360646,382,6,where,"('MOT', 'CHI')",Providence,ale22.xml,398,16,0,CHI,3772,1667,MOT
1,8,25,364,1.08797389,372,8,that,"('MOT', 'CHI')",Providence,ale22.xml,398,26,1,CHI,3772,1667,MOT
0,3,33,362,0.963719425,365,3,is,"('MOT', 'CHI')",Providence,ale22.xml,398,33,0,CHI,3772,1667,MOT
1,13,20,364,0.85613184,377,13,no,"('MOT', 'CHI')",Providence,ale22.xml,398,21,1,CHI,3772,1667,MOT
17,51,49,281,0.530761327,332,51,a,"('MOT', 'CHI')",Providence,ale22.xml,398,66,17,CHI,3772,1667,MOT
1,8,47,342,0.447530773,350,8,the,"('MOT', 'CHI')",Providence,ale22.xml,398,48,1,CHI,3772,1667,MOT
2,23,27,346,0.402773316,369,23,one,"('MOT', 'CHI')",Providence,ale22.xml,398,29,2,CHI,3772,1667,MOT
4,1,7,155,3.413936407,156,1,and,"('CHI', 'MOT')",Providence,ale23.xml,167,11,4,MOT,680,1466,CHI
0,1,4,256,3.071921412,257,1,yeah,"('MOT', 'CHI')",Providence,ale23.xml,261,4,0,CHI,2371,774,MOT
2,6,1,158,2.655252016,164,6,oh,"('CHI', 'MOT')",Providence,ale23.xml,167,3,2,MOT,680,1466,CHI
0,2,7,252,2.249340578,254,2,where,"('MOT', 'CHI')",Providence,ale23.xml,261,7,0,CHI,2371,774,MOT
0,2,12,247,1.787783321,249,2,go,"('MOT', 'CHI')",Providence,ale23.xml,261,12,0,CHI,2371,774,MOT
0,11,1,155,1.540445041,166,11,that,"('CHI', 'MOT')",Providence,ale23.xml,167,1,0,MOT,680,1466,CHI
2,2,44,213,1.508696343,215,2,one,"('MOT', 'CHI')",Providence,ale23.xml,261,46,2,CHI,2371,774,MOT
5,14,8,140,1.425515074,154,14,a,"('CHI', 'MOT')",Providence,ale23.xml,167,13,5,MOT,680,1466,CHI
0,2,18,241,1.406913648,243,2,in,"('MOT', 'CHI')",Providence,ale23.xml,261,18,0,CHI,2371,774,MOT
0,3,14,244,1.358569813,247,3,oh,"('MOT', 'CHI')",Providence,ale23.xml,261,14,0,CHI,2371,774,MOT
1,12,5,149,1.142506482,161,12,no,"('CHI', 'MOT')",Providence,ale23.xml,167,6,1,MOT,680,1466,CHI
0,20,1,146,0.980829253,166,20,the,"('CHI', 'MOT')",Providence,ale23.xml,167,1,0,MOT,680,1466,CHI
1,7,20,233,0.967149149,240,7,the,"('MOT', 'CHI')",Providence,ale23.xml,261,21,1,CHI,2371,774,MOT
1,5,32,223,0.784118959,228,5,a,"('MOT', 'CHI')",Providence,ale23.xml,261,33,1,CHI,2371,774,MOT
1,17,14,229,0.482990825,246,17,no,"('MOT', 'CHI')",Providence,ale23.xml,261,15,1,CHI,2371,774,MOT
0,1,1,0,-0.693147181,1,1,he,"('MOT', 'GRA')",Providence,ale23.xml,2,1,0,GRA,20,7,MOT
0,22,33,206,-1.252762968,228,22,that,"('MOT', 'CHI')",Providence,ale23.xml,261,33,0,CHI,2371,774,MOT
1,2,1,594,4.601831285,596,2,little,"('CHI', 'MOT')",Providence,ale24.xml,598,2,1,MOT,2870,3676,CHI
1,4,0,593,4.380358578,597,4,on,"('CHI', 'MOT')",Providence,ale24.xml,598,1,1,MOT,2870,3676,CHI
0,2,2,594,3.908684104,596,2,big,"('CHI', 'MOT')",Providence,ale24.xml,598,2,0,MOT,2870,3676,CHI
1,5,2,590,3.683866912,595,5,did,"('CHI', 'MOT')",Providence,ale24.xml,598,3,1,MOT,2870,3676,CHI
0,2,3,593,3.683866912,595,2,up,"('CHI', 'MOT')",Providence,ale24.xml,598,3,0,MOT,2870,3676,CHI
1,10,0,587,3.591901217,597,10,all,"('CHI', 'MOT')",Providence,ale24.xml,598,1,1,MOT,2870,3676,CHI
1,9,1,587,3.39785848,596,9,in,"('CHI', 'MOT')",Providence,ale24.xml,598,2,1,MOT,2870,3676,CHI
0,8,1,589,3.099424732,597,8,have,"('CHI', 'MOT')",Providence,ale24.xml,598,1,0,MOT,2870,3676,CHI
0,9,1,588,2.994064216,597,9,are,"('CHI', 'MOT')",Providence,ale24.xml,598,1,0,MOT,2870,3676,CHI
0,10,1,587,2.898754037,597,10,yeah,"('CHI', 'MOT')",Providence,ale24.xml,598,1,0,MOT,2870,3676,CHI
0,6,3,589,2.836569052,595,6,with,"('CHI', 'MOT')",Providence,ale24.xml,598,3,0,MOT,2870,3676,CHI
0,11,1,586,2.81174266,597,11,get,"('CHI', 'MOT')",Providence,ale24.xml,598,1,0,MOT,2870,3676,CHI
0,9,2,587,2.7047113,596,9,put,"('CHI', 'MOT')",Providence,ale24.xml,598,2,0,MOT,2870,3676,CHI
1,5,13,579,2.502118779,584,5,want,"('CHI', 'MOT')",Providence,ale24.xml,598,14,1,MOT,2870,3676,CHI
1,11,6,580,2.396210352,591,11,go,"('CHI', 'MOT')",Providence,ale24.xml,598,7,1,MOT,2870,3676,CHI
0,18,1,579,2.35221033,597,18,make,"('CHI', 'MOT')",Providence,ale24.xml,598,1,0,MOT,2870,3676,CHI
1,12,13,572,1.72892889,584,12,and,"('CHI', 'MOT')",Providence,ale24.xml,598,14,1,MOT,2870,3676,CHI
4,32,12,550,1.592459576,582,32,one,"('CHI', 'MOT')",Providence,ale24.xml,598,16,4,MOT,2870,3676,CHI
1,27,6,564,1.548912492,591,27,there,"('CHI', 'MOT')",Providence,ale24.xml,598,7,1,MOT,2870,3676,CHI
1,5,39,553,1.491654877,558,5,where,"('CHI', 'MOT')",Providence,ale24.xml,598,40,1,MOT,2870,3676,CHI
5,39,13,541,1.473618189,580,39,it,"('CHI', 'MOT')",Providence,ale24.xml,598,18,5,MOT,2870,3676,CHI
0,35,2,561,1.423777454,596,35,see,"('CHI', 'MOT')",Providence,ale24.xml,598,2,0,MOT,2870,3676,CHI
2,28,12,556,1.332047526,584,28,oh,"('CHI', 'MOT')",Providence,ale24.xml,598,14,2,MOT,2870,3676,CHI
0,31,3,564,1.316743298,595,31,do,"('CHI', 'MOT')",Providence,ale24.xml,598,3,0,MOT,2870,3676,CHI
1,71,3,523,1.014962259,594,71,what,"('CHI', 'MOT')",Providence,ale24.xml,598,4,1,MOT,2870,3676,CHI
23,39,118,418,0.655379956,457,39,that,"('CHI', 'MOT')",Providence,ale24.xml,598,141,23,MOT,2870,3676,CHI
1,80,5,512,0.606135804,592,80,you,"('CHI', 'MOT')",Providence,ale24.xml,598,6,1,MOT,2870,3676,CHI
4,50,36,508,0.267879445,558,50,is,"('CHI', 'MOT')",Providence,ale24.xml,598,40,4,MOT,2870,3676,CHI
22,90,76,410,0.238064643,500,90,a,"('CHI', 'MOT')",Providence,ale24.xml,598,98,22,MOT,2870,3676,CHI
0,45,11,542,-0.01516457,587,45,this,"('CHI', 'MOT')",Providence,ale24.xml,598,11,0,MOT,2870,3676,CHI
3,41,50,504,-0.05425964,545,41,no,"('CHI', 'MOT')",Providence,ale24.xml,598,53,3,MOT,2870,3676,CHI
2,40,40,516,-0.07479045,556,40,the,"('CHI', 'MOT')",Providence,ale24.xml,598,42,2,MOT,2870,3676,CHI
1,1,6,515,4.052750665,516,1,my,"('MOT', 'CHI')",Providence,ale25.xml,523,7,1,CHI,4281,1847,MOT
0,1,5,517,3.614771482,518,1,with,"('MOT', 'CHI')",Providence,ale25.xml,523,5,0,CHI,4281,1847,MOT
1,1,13,508,3.463780868,509,1,there,"('MOT', 'CHI')",Providence,ale25.xml,523,14,1,CHI,4281,1847,MOT
1,0,29,493,3.43196904,493,0,go,"('MOT', 'CHI')",Providence,ale25.xml,523,30,1,CHI,4281,1847,MOT
0,1,7,515,3.359603484,516,1,wanna,"('MOT', 'CHI')",Providence,ale25.xml,523,7,0,CHI,4281,1847,MOT
3,3,26,491,2.772588722,494,3,one,"('MOT', 'CHI')",Providence,ale25.xml,523,29,3,CHI,4281,1847,MOT
0,1,15,507,2.708050201,508,1,want,"('MOT', 'CHI')",Providence,ale25.xml,523,15,0,CHI,4281,1847,MOT
0,2,12,509,2.502606227,511,2,yeah,"('MOT', 'CHI')",Providence,ale25.xml,523,12,0,CHI,4281,1847,MOT
0,1,22,500,2.349389159,501,1,do,"('MOT', 'CHI')",Providence,ale25.xml,523,22,0,CHI,4281,1847,MOT
0,1,24,498,2.265362383,499,1,see,"('MOT', 'CHI')",Providence,ale25.xml,523,24,0,CHI,4281,1847,MOT
0,3,13,507,2.143980063,510,3,where,"('MOT', 'CHI')",Providence,ale25.xml,523,13,0,CHI,4281,1847,MOT
0,2,26,495,1.781789297,497,2,get,"('MOT', 'CHI')",Providence,ale25.xml,523,26,0,CHI,4281,1847,MOT
0,1,50,472,1.518923905,473,1,is,"('MOT', 'CHI')",Providence,ale25.xml,523,50,0,CHI,4281,1847,MOT
5,23,25,470,1.352527499,493,23,no,"('MOT', 'CHI')",Providence,ale25.xml,523,30,5,CHI,4281,1847,MOT
1,3,60,459,1.303602645,462,3,it,"('MOT', 'CHI')",Providence,ale25.xml,523,61,1,CHI,4281,1847,MOT
4,9,71,439,1.07229498,448,9,a,"('MOT', 'CHI')",Providence,ale25.xml,523,75,4,CHI,4281,1847,MOT
0,3,53,467,0.763351439,470,3,the,"('MOT', 'CHI')",Providence,ale25.xml,523,53,0,CHI,4281,1847,MOT
0,7,33,483,0.563689113,490,7,oh,"('MOT', 'CHI')",Providence,ale25.xml,523,33,0,CHI,4281,1847,MOT
2,33,25,463,0.415556011,496,33,and,"('MOT', 'CHI')",Providence,ale25.xml,523,27,2,CHI,4281,1847,MOT
0,2,123,398,0.069526063,400,2,you,"('MOT', 'CHI')",Providence,ale25.xml,523,123,0,CHI,4281,1847,MOT
3,68,50,402,-0.698166343,470,68,that,"('MOT', 'CHI')",Providence,ale25.xml,523,53,3,CHI,4281,1847,MOT
1,0,4,302,4.464264733,302,0,do,"('MOT', 'CHI')",Providence,ale26.xml,307,5,1,CHI,2389,1327,MOT
1,0,7,299,4.097672352,299,0,on,"('MOT', 'CHI')",Providence,ale26.xml,307,8,1,CHI,2389,1327,MOT
3,1,2,191,4.015095191,192,1,big,"('CHI', 'MOT')",Providence,ale26.xml,197,5,3,MOT,1000,1402,CHI
1,0,10,296,3.82529131,296,0,we,"('MOT', 'CHI')",Providence,ale26.xml,307,11,1,CHI,2389,1327,MOT
0,1,1,195,3.496507561,196,1,with,"('CHI', 'MOT')",Providence,ale26.xml,197,1,0,MOT,1000,1402,CHI
0,2,2,303,3.241941098,305,2,my,"('MOT', 'CHI')",Providence,ale26.xml,307,2,0,CHI,2389,1327,MOT
1,2,5,299,3.228826156,301,2,where,"('MOT', 'CHI')",Providence,ale26.xml,307,6,1,CHI,2389,1327,MOT
0,1,2,194,3.203762187,195,1,my,"('CHI', 'MOT')",Providence,ale26.xml,197,2,0,MOT,1000,1402,CHI
1,5,0,191,3.091042453,196,5,not,"('CHI', 'MOT')",Providence,ale26.xml,197,1,1,MOT,1000,1402,CHI
0,2,1,194,3.091042453,196,2,get,"('CHI', 'MOT')",Providence,ale26.xml,197,1,0,MOT,1000,1402,CHI
0,2,1,194,3.091042453,196,2,we,"('CHI', 'MOT')",Providence,ale26.xml,197,1,0,MOT,1000,1402,CHI
0,1,5,301,3.077970372,302,1,yeah,"('MOT', 'CHI')",Providence,ale26.xml,307,5,0,CHI,2389,1327,MOT
0,1,5,301,3.077970372,302,1,with,"('MOT', 'CHI')",Providence,ale26.xml,307,5,0,CHI,2389,1327,MOT
1,2,7,297,2.999060064,299,2,did,"('MOT', 'CHI')",Providence,ale26.xml,307,8,1,CHI,2389,1327,MOT
0,1,6,300,2.941144083,301,1,for,"('MOT', 'CHI')",Providence,ale26.xml,307,6,0,CHI,2389,1327,MOT
0,1,6,300,2.941144083,301,1,at,"('MOT', 'CHI')",Providence,ale26.xml,307,6,0,CHI,2389,1327,MOT
0,3,3,301,2.727852828,304,3,want,"('MOT', 'CHI')",Providence,ale26.xml,307,3,0,CHI,2389,1327,MOT
0,4,1,192,2.58021683,196,4,go,"('CHI', 'MOT')",Providence,ale26.xml,197,1,0,MOT,1000,1402,CHI
0,4,1,192,2.58021683,196,4,are,"('CHI', 'MOT')",Providence,ale26.xml,197,1,0,MOT,1000,1402,CHI
0,1,10,296,2.522389743,297,1,in,"('MOT', 'CHI')",Providence,ale26.xml,307,10,0,CHI,2389,1327,MOT
0,3,2,192,2.510615006,195,3,did,"('CHI', 'MOT')",Providence,ale26.xml,197,2,0,MOT,1000,1402,CHI
0,3,2,192,2.510615006,195,3,up,"('CHI', 'MOT')",Providence,ale26.xml,197,2,0,MOT,1000,1402,CHI
0,5,1,191,2.397895273,196,5,all,"('CHI', 'MOT')",Providence,ale26.xml,197,1,0,MOT,1000,1402,CHI
1,6,6,294,2.260439472,300,6,go,"('MOT', 'CHI')",Providence,ale26.xml,307,7,1,CHI,2389,1327,MOT
0,6,1,190,2.243744593,196,6,gonna,"('CHI', 'MOT')",Providence,ale26.xml,197,1,0,MOT,1000,1402,CHI
0,6,1,190,2.243744593,196,6,look,"('CHI', 'MOT')",Providence,ale26.xml,197,1,0,MOT,1000,1402,CHI
1,0,0,12,2.233592222,12,0,one,"('GRA', 'CHI')",Providence,ale26.xml,13,1,1,CHI,67,54,GRA
0,2,9,296,2.207274913,298,2,what,"('MOT', 'CHI')",Providence,ale26.xml,307,9,0,CHI,2389,1327,MOT
0,1,15,291,2.157219243,292,1,put,"('MOT', 'CHI')",Providence,ale26.xml,307,15,0,CHI,2389,1327,MOT
7,5,33,262,2.144723834,267,5,one,"('MOT', 'CHI')",Providence,ale26.xml,307,40,7,CHI,2389,1327,MOT
1,7,6,293,2.126908079,300,7,there,"('MOT', 'CHI')",Providence,ale26.xml,307,7,1,CHI,2389,1327,MOT
14,13,9,161,2.020601042,174,13,that,"('CHI', 'MOT')",Providence,ale26.xml,197,23,14,MOT,1000,1402,CHI
2,5,9,181,1.978345425,186,5,oh,"('CHI', 'MOT')",Providence,ale26.xml,197,11,2,MOT,1000,1402,CHI
1,5,6,185,1.961658506,190,5,and,"('CHI', 'MOT')",Providence,ale26.xml,197,7,1,MOT,1000,1402,CHI
0,2,12,293,1.956062521,295,2,look,"('MOT', 'CHI')",Providence,ale26.xml,307,12,0,CHI,2389,1327,MOT
1,5,12,289,1.883696965,294,5,is,"('MOT', 'CHI')",Providence,ale26.xml,307,13,1,CHI,2389,1327,MOT
1,5,12,289,1.883696965,294,5,no,"('MOT', 'CHI')",Providence,ale26.xml,307,13,1,CHI,2389,1327,MOT
0,5,3,189,1.876917278,194,5,yeah,"('CHI', 'MOT')",Providence,ale26.xml,197,3,0,MOT,1000,1402,CHI
1,11,2,183,1.876917278,194,11,this,"('CHI', 'MOT')",Providence,ale26.xml,197,3,1,MOT,1000,1402,CHI
0,1,24,282,1.701245462,283,1,to,"('MOT', 'CHI')",Providence,ale26.xml,307,24,0,CHI,2389,1327,MOT
2,1,63,241,1.697940714,242,1,the,"('MOT', 'CHI')",Providence,ale26.xml,307,65,2,CHI,2389,1327,MOT
1,0,0,6,1.673976434,6,0,yeah,"('MOT', 'GRA')",Providence,ale26.xml,7,1,1,GRA,50,33,MOT
1,0,0,6,1.673976434,6,0,not,"('MOT', 'GRA')",Providence,ale26.xml,7,1,1,GRA,50,33,MOT
0,3,12,292,1.668380448,295,3,get,"('MOT', 'CHI')",Providence,ale26.xml,307,12,0,CHI,2389,1327,MOT
0,7,3,187,1.589235205,194,7,there,"('CHI', 'MOT')",Providence,ale26.xml,197,3,0,MOT,1000,1402,CHI
2,19,2,174,1.584120104,193,19,is,"('CHI', 'MOT')",Providence,ale26.xml,197,4,2,MOT,1000,1402,CHI
4,9,13,171,1.566420527,180,9,no,"('CHI', 'MOT')",Providence,ale26.xml,197,17,4,MOT,1000,1402,CHI
0,13,1,183,1.550597412,196,13,to,"('CHI', 'MOT')",Providence,ale26.xml,197,1,0,MOT,1000,1402,CHI
2,6,22,277,1.547094782,283,6,that,"('MOT', 'CHI')",Providence,ale26.xml,307,24,2,CHI,2389,1327,MOT
1,14,3,179,1.466337069,193,14,the,"('CHI', 'MOT')",Providence,ale26.xml,197,4,1,MOT,1000,1402,CHI
1,12,4,180,1.450145833,192,12,one,"('CHI', 'MOT')",Providence,ale26.xml,197,5,1,MOT,1000,1402,CHI
1,7,16,283,1.346020462,290,7,oh,"('MOT', 'CHI')",Providence,ale26.xml,307,17,1,CHI,2389,1327,MOT
1,1,2,10,0.955511445,11,1,it,"('GRA', 'MOT')",Providence,ale26.xml,14,3,1,MOT,133,84,GRA
3,13,26,265,0.94803943,278,13,this,"('MOT', 'CHI')",Providence,ale26.xml,307,29,3,CHI,2389,1327,MOT
1,30,2,164,0.927836723,194,30,you,"('CHI', 'MOT')",Providence,ale26.xml,197,3,1,MOT,1000,1402,CHI
0,1,1,12,0.916290732,13,1,in,"('GRA', 'MOT')",Providence,ale26.xml,14,1,0,MOT,133,84,GRA
0,1,1,12,0.916290732,13,1,have,"('GRA', 'MOT')",Providence,ale26.xml,14,1,0,MOT,133,84,GRA
0,1,1,12,0.916290732,13,1,but,"('GRA', 'MOT')",Providence,ale26.xml,14,1,0,MOT,133,84,GRA
0,1,1,12,0.916290732,13,1,is,"('GRA', 'MOT')",Providence,ale26.xml,14,1,0,MOT,133,84,GRA
0,1,1,12,0.916290732,13,1,put,"('GRA', 'MOT')",Providence,ale26.xml,14,1,0,MOT,133,84,GRA
0,1,1,12,0.916290732,13,1,he,"('GRA', 'MOT')",Providence,ale26.xml,14,1,0,MOT,133,84,GRA
0,1,1,12,0.916290732,13,1,to,"('GRA', 'MOT')",Providence,ale26.xml,14,1,0,MOT,133,84,GRA
0,1,1,12,0.916290732,13,1,and,"('GRA', 'MOT')",Providence,ale26.xml,14,1,0,MOT,133,84,GRA
1,2,1,10,0.84729786,12,2,oh,"('GRA', 'MOT')",Providence,ale26.xml,14,2,1,MOT,133,84,GRA
0,1,1,11,0.84729786,12,1,a,"('GRA', 'CHI')",Providence,ale26.xml,13,1,0,CHI,67,54,GRA
0,1,1,10,0.773189888,11,1,no,"('CHI', 'GRA')",Providence,ale26.xml,12,1,0,GRA,44,83,CHI
9,29,16,143,0.764606145,172,29,a,"('CHI', 'MOT')",Providence,ale26.xml,197,25,9,MOT,1000,1402,CHI
1,2,1,8,0.693147181,10,2,oh,"('CHI', 'GRA')",Providence,ale26.xml,12,2,1,GRA,44,83,CHI
1,32,3,161,0.677879708,193,32,it,"('CHI', 'MOT')",Providence,ale26.xml,197,4,1,MOT,1000,1402,CHI
0,1,2,11,0.559615788,12,1,that,"('GRA', 'MOT')",Providence,ale26.xml,14,2,0,MOT,133,84,GRA
0,1,2,11,0.559615788,12,1,are,"('GRA', 'MOT')",Providence,ale26.xml,14,2,0,MOT,133,84,GRA
0,2,1,11,0.510825624,13,2,no,"('GRA', 'MOT')",Providence,ale26.xml,14,1,0,MOT,133,84,GRA
0,2,1,11,0.510825624,13,2,can,"('GRA', 'MOT')",Providence,ale26.xml,14,1,0,MOT,133,84,GRA
2,8,49,248,0.484055383,256,8,it,"('MOT', 'CHI')",Providence,ale26.xml,307,51,2,CHI,2389,1327,MOT
0,1,1,5,0.287682072,6,1,a,"('MOT', 'GRA')",Providence,ale26.xml,7,1,0,GRA,50,33,MOT
0,1,3,10,0.262364264,11,1,get,"('GRA', 'MOT')",Providence,ale26.xml,14,3,0,MOT,133,84,GRA
0,11,17,279,0.247408173,290,11,and,"('MOT', 'CHI')",Providence,ale26.xml,307,17,0,CHI,2389,1327,MOT
6,27,43,231,0.242561637,258,27,a,"('MOT', 'CHI')",Providence,ale26.xml,307,49,6,CHI,2389,1327,MOT
0,3,1,10,0.223143551,13,3,go,"('GRA', 'MOT')",Providence,ale26.xml,14,1,0,MOT,133,84,GRA
0,3,1,10,0.223143551,13,3,what,"('GRA', 'MOT')",Providence,ale26.xml,14,1,0,MOT,133,84,GRA
1,5,63,238,0.21299118,243,5,you,"('MOT', 'CHI')",Providence,ale26.xml,307,64,1,CHI,2389,1327,MOT
1,1,0,0,0,1,1,in,"('OPE', 'MOT')",Providence,ale26.xml,2,1,1,MOT,12,56,OPE
1,1,0,0,0,1,1,the,"('OPE', 'MOT')",Providence,ale26.xml,2,1,1,MOT,12,56,OPE
0,4,1,8,-0.068992871,12,4,the,"('GRA', 'CHI')",Providence,ale26.xml,13,1,0,CHI,67,54,GRA
0,2,3,8,-0.223143551,10,2,is,"('GRA', 'CHI')",Providence,ale26.xml,13,3,0,CHI,67,54,GRA
0,1,5,8,-0.241162057,9,1,the,"('GRA', 'MOT')",Providence,ale26.xml,14,5,0,MOT,133,84,GRA
0,4,2,8,-0.356674944,12,4,you,"('GRA', 'MOT')",Providence,ale26.xml,14,2,0,MOT,133,84,GRA
0,4,2,7,-0.430782916,11,4,where,"('GRA', 'CHI')",Providence,ale26.xml,13,2,0,CHI,67,54,GRA
1,0,6,328,4.295015258,328,0,did,"('MOT', 'CHI')",Providence,ale27.xml,335,7,1,CHI,2504,1569,MOT
1,0,12,322,3.765840495,322,0,on,"('MOT', 'CHI')",Providence,ale27.xml,335,13,1,CHI,2504,1569,MOT
0,1,2,332,3.73468899,333,1,she,"('MOT', 'CHI')",Providence,ale27.xml,335,2,0,CHI,2504,1569,MOT
3,6,0,326,3.642087293,332,6,big,"('MOT', 'CHI')",Providence,ale27.xml,335,3,3,CHI,2504,1569,MOT
0,1,3,331,3.5085559,332,1,with,"('MOT', 'CHI')",Providence,ale27.xml,335,3,0,CHI,2504,1569,MOT
0,1,4,330,3.32323584,331,1,gonna,"('MOT', 'CHI')",Providence,ale27.xml,335,4,0,CHI,2504,1569,MOT
0,1,4,330,3.32323584,331,1,up,"('MOT', 'CHI')",Providence,ale27.xml,335,4,0,CHI,2504,1569,MOT
0,1,1,144,3.198673118,145,1,my,"('CHI', 'MOT')",Providence,ale27.xml,146,1,0,MOT,751,1066,CHI
0,2,3,330,3.103090792,332,2,make,"('MOT', 'CHI')",Providence,ale27.xml,335,3,0,CHI,2504,1569,MOT
0,1,6,328,3.029529653,329,1,little,"('MOT', 'CHI')",Providence,ale27.xml,335,6,0,CHI,2504,1569,MOT
0,1,8,326,2.800325477,327,1,look,"('MOT', 'CHI')",Providence,ale27.xml,335,8,0,CHI,2504,1569,MOT
0,2,1,143,2.793208009,145,2,little,"('CHI', 'MOT')",Providence,ale27.xml,146,1,0,MOT,751,1066,CHI
0,1,9,325,2.701971155,326,1,can,"('MOT', 'CHI')",Providence,ale27.xml,335,9,0,CHI,2504,1569,MOT
1,2,12,320,2.667228207,322,2,there,"('MOT', 'CHI')",Providence,ale27.xml,335,13,1,CHI,2504,1569,MOT
0,1,10,324,2.611906341,325,1,are,"('MOT', 'CHI')",Providence,ale27.xml,335,10,0,CHI,2504,1569,MOT
1,2,14,318,2.535873093,320,2,do,"('MOT', 'CHI')",Providence,ale27.xml,335,15,1,CHI,2504,1569,MOT
0,3,1,142,2.505525937,145,3,did,"('CHI', 'MOT')",Providence,ale27.xml,146,1,0,MOT,751,1066,CHI
0,3,1,142,2.505525937,145,3,is,"('CHI', 'MOT')",Providence,ale27.xml,146,1,0,MOT,751,1066,CHI
0,3,1,142,2.505525937,145,3,one,"('CHI', 'MOT')",Providence,ale27.xml,146,1,0,MOT,751,1066,CHI
0,3,6,326,2.336382473,329,3,want,"('MOT', 'CHI')",Providence,ale27.xml,335,6,0,CHI,2504,1569,MOT
0,4,1,141,2.282382386,145,4,want,"('CHI', 'MOT')",Providence,ale27.xml,146,1,0,MOT,751,1066,CHI
0,2,3,141,2.268683541,143,2,look,"('CHI', 'MOT')",Providence,ale27.xml,146,3,0,MOT,751,1066,CHI
0,2,3,141,2.268683541,143,2,wanna,"('CHI', 'MOT')",Providence,ale27.xml,146,3,0,MOT,751,1066,CHI
1,4,3,138,2.261763098,142,4,all,"('CHI', 'MOT')",Providence,ale27.xml,146,4,1,MOT,751,1066,CHI
0,1,15,319,2.248191021,320,1,in,"('MOT', 'CHI')",Providence,ale27.xml,335,15,0,CHI,2504,1569,MOT
0,3,2,141,2.211017899,144,3,on,"('CHI', 'MOT')",Providence,ale27.xml,146,2,0,MOT,751,1066,CHI
2,4,19,310,2.109422374,314,4,go,"('MOT', 'CHI')",Providence,ale27.xml,335,21,2,CHI,2504,1569,MOT
0,5,1,140,2.100060829,145,5,there,"('CHI', 'MOT')",Providence,ale27.xml,146,1,0,MOT,751,1066,CHI
1,8,7,319,1.989395261,327,8,where,"('MOT', 'CHI')",Providence,ale27.xml,335,8,1,CHI,2504,1569,MOT
0,4,2,140,1.987874348,144,4,in,"('CHI', 'MOT')",Providence,ale27.xml,146,2,0,MOT,751,1066,CHI
1,10,1,134,1.892564168,144,10,that,"('CHI', 'MOT')",Providence,ale27.xml,146,2,1,MOT,751,1066,CHI
1,4,6,135,1.835244581,139,4,and,"('CHI', 'MOT')",Providence,ale27.xml,146,7,1,MOT,751,1066,CHI
0,7,1,138,1.812378756,145,7,it,"('CHI', 'MOT')",Providence,ale27.xml,146,1,0,MOT,751,1066,CHI
0,3,4,139,1.791759469,142,3,no,"('CHI', 'MOT')",Providence,ale27.xml,146,4,0,MOT,751,1066,CHI
1,0,1,10,1.791759469,10,0,a,"('OPE', 'MOT')",Providence,ale27.xml,12,2,1,MOT,49,168,OPE
5,6,37,287,1.748635043,293,6,it,"('MOT', 'CHI')",Providence,ale27.xml,335,42,5,CHI,2504,1569,MOT
1,3,29,302,1.567964664,305,3,this,"('MOT', 'CHI')",Providence,ale27.xml,335,30,1,CHI,2504,1569,MOT
4,10,24,297,1.543686535,307,10,one,"('MOT', 'CHI')",Providence,ale27.xml,335,28,4,CHI,2504,1569,MOT
1,0,0,5,1.540445041,5,0,wanna,"('MOT', 'OPE')",Providence,ale27.xml,6,1,1,OPE,52,47,MOT
1,0,0,5,1.540445041,5,0,that,"('MOT', 'OPE')",Providence,ale27.xml,6,1,1,OPE,52,47,MOT
1,1,0,10,1.466337069,11,1,gonna,"('OPE', 'MOT')",Providence,ale27.xml,12,1,1,MOT,49,168,OPE
0,3,17,315,1.437587656,318,3,get,"('MOT', 'CHI')",Providence,ale27.xml,335,17,0,CHI,2504,1569,MOT
0,6,3,137,1.421385681,143,6,do,"('CHI', 'MOT')",Providence,ale27.xml,146,3,0,MOT,751,1066,CHI
4,9,13,120,1.237611163,129,9,a,"('CHI', 'MOT')",Providence,ale27.xml,146,17,4,MOT,751,1066,CHI
0,1,2,22,1.139434283,23,1,the,"('CHI', 'OPE')",Providence,ale27.xml,25,2,0,OPE,131,124,CHI
1,2,0,7,0.893817876,9,2,a,"('OPE', 'CHI')",Providence,ale27.xml,10,1,1,CHI,60,47,OPE
0,1,3,21,0.875468737,22,1,oh,"('CHI', 'OPE')",Providence,ale27.xml,25,3,0,OPE,131,124,CHI
1,1,0,4,0.84729786,5,1,it,"('MOT', 'OPE')",Providence,ale27.xml,6,1,1,OPE,52,47,MOT
0,1,1,10,0.773189888,11,1,go,"('OPE', 'MOT')",Providence,ale27.xml,12,1,0,MOT,49,168,OPE
0,1,1,10,0.773189888,11,1,is,"('OPE', 'MOT')",Providence,ale27.xml,12,1,0,MOT,49,168,OPE
0,1,1,10,0.773189888,11,1,are,"('OPE', 'MOT')",Providence,ale27.xml,12,1,0,MOT,49,168,OPE
5,30,21,279,0.765360667,309,30,oh,"('MOT', 'CHI')",Providence,ale27.xml,335,26,5,CHI,2504,1569,MOT
0,5,9,132,0.744819191,137,5,oh,"('CHI', 'MOT')",Providence,ale27.xml,146,9,0,MOT,751,1066,CHI
0,7,20,308,0.588417779,315,7,no,"('MOT', 'CHI')",Providence,ale27.xml,335,20,0,CHI,2504,1569,MOT
0,10,15,310,0.543442929,320,10,and,"('MOT', 'CHI')",Providence,ale27.xml,335,15,0,CHI,2504,1569,MOT
5,35,24,271,0.504353109,306,35,a,"('MOT', 'CHI')",Providence,ale27.xml,335,29,5,CHI,2504,1569,MOT
5,19,46,265,0.481727093,284,19,the,"('MOT', 'CHI')",Providence,ale27.xml,335,51,5,CHI,2504,1569,MOT
1,2,0,3,0.441832752,5,2,you,"('MOT', 'OPE')",Providence,ale27.xml,6,1,1,OPE,52,47,MOT
0,2,1,9,0.36772478,11,2,you,"('OPE', 'MOT')",Providence,ale27.xml,12,1,0,MOT,49,168,OPE
0,2,1,9,0.36772478,11,2,what,"('OPE', 'MOT')",Providence,ale27.xml,12,1,0,MOT,49,168,OPE
5,38,10,93,0.185333607,131,38,the,"('CHI', 'MOT')",Providence,ale27.xml,146,15,5,MOT,751,1066,CHI
0,8,27,300,0.17205189,308,8,is,"('MOT', 'CHI')",Providence,ale27.xml,335,27,0,CHI,2504,1569,MOT
0,1,1,4,0.15415068,5,1,there,"('MOT', 'OPE')",Providence,ale27.xml,6,1,0,OPE,52,47,MOT
5,45,36,249,-0.107722589,294,45,that,"('MOT', 'CHI')",Providence,ale27.xml,335,41,5,CHI,2504,1569,MOT
0,2,6,17,-0.133531393,19,2,a,"('CHI', 'OPE')",Providence,ale27.xml,25,6,0,OPE,131,124,CHI
0,5,4,16,-0.448024723,21,5,that,"('CHI', 'OPE')",Providence,ale27.xml,25,4,0,OPE,131,124,CHI
1,0,4,312,4.496630017,312,0,see,"('MOT', 'CHI')",Providence,ale28.xml,317,5,1,CHI,2404,1615,MOT
2,2,2,311,3.96081317,313,2,big,"('MOT', 'CHI')",Providence,ale28.xml,317,4,2,CHI,2404,1615,MOT
2,1,6,308,3.842672927,309,1,for,"('MOT', 'CHI')",Providence,ale28.xml,317,8,2,CHI,2404,1615,MOT
1,2,3,311,3.555348061,313,2,all,"('MOT', 'CHI')",Providence,ale28.xml,317,4,1,CHI,2404,1615,MOT
1,1,9,306,3.248434627,307,1,have,"('MOT', 'CHI')",Providence,ale28.xml,317,10,1,CHI,2404,1615,MOT
2,1,15,299,3.171453146,300,1,get,"('MOT', 'CHI')",Providence,ale28.xml,317,17,2,CHI,2404,1615,MOT
1,7,1,308,2.986313052,315,7,look,"('MOT', 'CHI')",Providence,ale28.xml,317,2,1,CHI,2404,1615,MOT
0,1,6,310,2.973614468,311,1,did,"('MOT', 'CHI')",Providence,ale28.xml,317,6,0,CHI,2404,1615,MOT
4,3,14,296,2.934521543,299,3,there,"('MOT', 'CHI')",Providence,ale28.xml,317,18,4,CHI,2404,1615,MOT
3,2,21,291,2.716560891,293,2,in,"('MOT', 'CHI')",Providence,ale28.xml,317,24,3,CHI,2404,1615,MOT
0,1,10,306,2.555287447,307,1,up,"('MOT', 'CHI')",Providence,ale28.xml,317,10,0,CHI,2404,1615,MOT
2,3,15,297,2.478305966,300,3,on,"('MOT', 'CHI')",Providence,ale28.xml,317,17,2,CHI,2404,1615,MOT
0,1,11,305,2.472003245,306,1,do,"('MOT', 'CHI')",Providence,ale28.xml,317,11,0,CHI,2404,1615,MOT
6,6,17,288,2.471483629,294,6,this,"('MOT', 'CHI')",Providence,ale28.xml,317,23,6,CHI,2404,1615,MOT
0,3,5,309,2.417188476,312,3,at,"('MOT', 'CHI')",Providence,ale28.xml,317,5,0,CHI,2404,1615,MOT
0,2,1,96,2.407945609,98,2,with,"('CHI', 'MOT')",Providence,ale28.xml,99,1,0,MOT,415,752,CHI
0,1,13,303,2.32238772,304,1,go,"('MOT', 'CHI')",Providence,ale28.xml,317,13,0,CHI,2404,1615,MOT
0,3,7,307,2.159484249,310,3,want,"('MOT', 'CHI')",Providence,ale28.xml,317,7,0,CHI,2404,1615,MOT
0,2,10,305,2.149822338,307,2,are,"('MOT', 'CHI')",Providence,ale28.xml,317,10,0,CHI,2404,1615,MOT
0,3,1,95,2.120263536,98,3,big,"('CHI', 'MOT')",Providence,ale28.xml,99,1,0,MOT,415,752,CHI
0,3,1,95,2.120263536,98,3,on,"('CHI', 'MOT')",Providence,ale28.xml,99,1,0,MOT,415,752,CHI
1,3,4,91,1.925290862,94,3,no,"('CHI', 'MOT')",Providence,ale28.xml,99,5,1,MOT,415,752,CHI
0,2,13,302,1.916922612,304,2,to,"('MOT', 'CHI')",Providence,ale28.xml,317,13,0,CHI,2404,1615,MOT
0,8,4,305,1.763588592,313,8,with,"('MOT', 'CHI')",Providence,ale28.xml,317,4,0,CHI,2404,1615,MOT
2,7,16,292,1.730548738,299,7,oh,"('MOT', 'CHI')",Providence,ale28.xml,317,18,2,CHI,2404,1615,MOT
0,5,1,93,1.714798428,98,5,get,"('CHI', 'MOT')",Providence,ale28.xml,99,1,0,MOT,415,752,CHI
0,5,1,93,1.714798428,98,5,one,"('CHI', 'MOT')",Providence,ale28.xml,99,1,0,MOT,415,752,CHI
0,20,1,296,1.618916656,316,20,my,"('MOT', 'CHI')",Providence,ale28.xml,317,1,0,CHI,2404,1615,MOT
0,2,18,297,1.612765703,299,2,can,"('MOT', 'CHI')",Providence,ale28.xml,317,18,0,CHI,2404,1615,MOT
0,7,6,304,1.587320107,311,7,where,"('MOT', 'CHI')",Providence,ale28.xml,317,6,0,CHI,2404,1615,MOT
2,8,3,86,1.519825754,94,8,a,"('CHI', 'MOT')",Providence,ale28.xml,99,5,2,MOT,415,752,CHI
0,3,16,298,1.437066686,301,3,yeah,"('MOT', 'CHI')",Providence,ale28.xml,317,16,0,CHI,2404,1615,MOT
0,5,2,92,1.41706602,97,5,put,"('CHI', 'MOT')",Providence,ale28.xml,99,2,0,MOT,415,752,CHI
2,7,23,285,1.406913648,292,7,a,"('MOT', 'CHI')",Providence,ale28.xml,317,25,2,CHI,2404,1615,MOT
0,3,17,297,1.379693677,300,3,and,"('MOT', 'CHI')",Providence,ale28.xml,317,17,0,CHI,2404,1615,MOT
0,4,4,91,1.173513597,95,4,in,"('CHI', 'MOT')",Providence,ale28.xml,99,4,0,MOT,415,752,CHI
1,6,24,286,1.134979933,292,6,that,"('MOT', 'CHI')",Providence,ale28.xml,317,25,1,CHI,2404,1615,MOT
2,5,43,267,1.069833324,272,5,it,"('MOT', 'CHI')",Providence,ale28.xml,317,45,2,CHI,2404,1615,MOT
1,0,0,2,0.980829253,2,0,you,"('OPE', 'MOT')",Providence,ale28.xml,3,1,1,MOT,9,17,OPE
3,9,13,74,0.635988767,83,9,that,"('CHI', 'MOT')",Providence,ale28.xml,99,16,3,MOT,415,752,CHI
1,24,11,281,0.562061774,305,24,one,"('MOT', 'CHI')",Providence,ale28.xml,317,12,1,CHI,2404,1615,MOT
0,11,3,85,0.490622916,96,11,it,"('CHI', 'MOT')",Providence,ale28.xml,99,3,0,MOT,415,752,CHI
0,13,3,83,0.336472237,96,13,this,"('CHI', 'MOT')",Providence,ale28.xml,99,3,0,MOT,415,752,CHI
0,10,23,284,0.073588357,294,10,no,"('MOT', 'CHI')",Providence,ale28.xml,317,23,0,CHI,2404,1615,MOT
3,19,47,248,0.034029749,267,19,the,"('MOT', 'CHI')",Providence,ale28.xml,317,50,3,CHI,2404,1615,MOT
0,13,5,81,-0.020619287,94,13,the,"('CHI', 'MOT')",Providence,ale28.xml,99,5,0,MOT,415,752,CHI
0,1,1,2,-0.182321557,3,1,it,"('MOT', 'OPE')",Providence,ale28.xml,4,1,0,OPE,34,24,MOT
0,3,91,223,-0.489548225,226,3,you,"('MOT', 'CHI')",Providence,ale28.xml,317,91,0,CHI,2404,1615,MOT
1,0,3,418,4.941642423,418,0,was,"('MOT', 'CHI')",Providence,ale29.xml,422,4,1,CHI,3161,2223,MOT
6,1,10,405,4.373658385,406,1,little,"('MOT', 'CHI')",Providence,ale29.xml,422,16,6,CHI,3161,2223,MOT
0,1,1,420,4.25561271,421,1,of,"('MOT', 'CHI')",Providence,ale29.xml,422,1,0,CHI,3161,2223,MOT
1,0,11,410,4.0751132,410,0,for,"('MOT', 'CHI')",Providence,ale29.xml,422,12,1,CHI,3161,2223,MOT
1,0,11,410,4.0751132,410,0,all,"('MOT', 'CHI')",Providence,ale29.xml,422,12,1,CHI,3161,2223,MOT
0,2,1,419,3.850147602,421,2,make,"('MOT', 'CHI')",Providence,ale29.xml,422,1,0,CHI,3161,2223,MOT
2,1,12,407,3.649033546,408,1,get,"('MOT', 'CHI')",Providence,ale29.xml,422,14,2,CHI,3161,2223,MOT
0,1,5,416,3.39881359,417,1,not,"('MOT', 'CHI')",Providence,ale29.xml,422,5,0,CHI,3161,2223,MOT
2,2,11,407,3.310543013,409,2,in,"('MOT', 'CHI')",Providence,ale29.xml,422,13,2,CHI,3161,2223,MOT
4,6,6,406,3.204487087,412,6,big,"('MOT', 'CHI')",Providence,ale29.xml,422,10,4,CHI,3161,2223,MOT
1,3,7,411,3.034952987,414,3,he,"('MOT', 'CHI')",Providence,ale29.xml,422,8,1,CHI,3161,2223,MOT
0,2,5,415,2.993348482,417,2,where,"('MOT', 'CHI')",Providence,ale29.xml,422,5,0,CHI,3161,2223,MOT
1,1,20,400,2.863442346,401,1,see,"('MOT', 'CHI')",Providence,ale29.xml,422,21,1,CHI,3161,2223,MOT
2,2,22,396,2.733368009,398,2,and,"('MOT', 'CHI')",Providence,ale29.xml,422,24,2,CHI,3161,2223,MOT
1,3,11,407,2.688818839,410,3,up,"('MOT', 'CHI')",Providence,ale29.xml,422,12,1,CHI,3161,2223,MOT
0,4,4,414,2.63905733,418,4,did,"('MOT', 'CHI')",Providence,ale29.xml,422,4,0,CHI,3161,2223,MOT
0,2,8,412,2.629487879,414,2,yeah,"('MOT', 'CHI')",Providence,ale29.xml,422,8,0,CHI,3161,2223,MOT
1,2,18,401,2.553899521,403,2,go,"('MOT', 'CHI')",Providence,ale29.xml,422,19,1,CHI,3161,2223,MOT
0,1,1,73,2.538973871,74,1,is,"('CHI', 'MOT')",Providence,ale29.xml,75,1,0,MOT,423,579,CHI
1,1,29,391,2.510615006,392,1,put,"('MOT', 'CHI')",Providence,ale29.xml,422,30,1,CHI,3161,2223,MOT
0,1,15,406,2.487354631,407,1,like,"('MOT', 'CHI')",Providence,ale29.xml,422,15,0,CHI,3161,2223,MOT
1,0,0,16,2.48490665,16,0,go,"('MOT', 'FAT')",Providence,ale29.xml,17,1,1,FAT,151,139,MOT
1,0,0,16,2.48490665,16,0,in,"('MOT', 'FAT')",Providence,ale29.xml,17,1,1,FAT,151,139,MOT
1,0,0,16,2.48490665,16,0,there,"('MOT', 'FAT')",Providence,ale29.xml,17,1,1,FAT,151,139,MOT
1,0,0,16,2.48490665,16,0,this,"('MOT', 'FAT')",Providence,ale29.xml,17,1,1,FAT,151,139,MOT
0,5,4,413,2.456735773,418,5,my,"('MOT', 'CHI')",Providence,ale29.xml,422,4,0,CHI,3161,2223,MOT
1,10,4,407,2.387212679,417,10,want,"('MOT', 'CHI')",Providence,ale29.xml,422,5,1,CHI,3161,2223,MOT
3,6,17,396,2.350756637,402,6,that,"('MOT', 'CHI')",Providence,ale29.xml,422,20,3,CHI,3161,2223,MOT
0,3,8,411,2.341805806,414,3,wanna,"('MOT', 'CHI')",Providence,ale29.xml,422,8,0,CHI,3161,2223,MOT
0,1,2,72,2.238046572,73,1,want,"('CHI', 'MOT')",Providence,ale29.xml,75,2,0,MOT,423,579,CHI
0,2,1,72,2.133508763,74,2,it,"('CHI', 'MOT')",Providence,ale29.xml,75,1,0,MOT,423,579,CHI
0,1,23,398,2.081938422,399,1,do,"('MOT', 'CHI')",Providence,ale29.xml,422,23,0,CHI,3161,2223,MOT
0,5,7,410,2.044102175,415,5,look,"('MOT', 'CHI')",Providence,ale29.xml,422,7,0,CHI,3161,2223,MOT
0,1,3,71,2.00148,72,1,wanna,"('CHI', 'MOT')",Providence,ale29.xml,75,3,0,MOT,423,579,CHI
1,0,0,8,1.897119985,8,0,one,"('FAT', 'MOT')",Providence,ale29.xml,9,1,1,MOT,52,149,FAT
1,0,2,14,1.85629799,14,0,and,"('MOT', 'FAT')",Providence,ale29.xml,17,3,1,FAT,151,139,MOT
0,3,1,71,1.84582669,74,3,of,"('CHI', 'MOT')",Providence,ale29.xml,75,1,0,MOT,423,579,CHI
0,3,1,71,1.84582669,74,3,there,"('CHI', 'MOT')",Providence,ale29.xml,75,1,0,MOT,423,579,CHI
0,2,2,71,1.832581464,73,2,and,"('CHI', 'MOT')",Providence,ale29.xml,75,2,0,MOT,423,579,CHI
1,4,23,394,1.817077277,398,4,what,"('MOT', 'CHI')",Providence,ale29.xml,422,24,1,CHI,3161,2223,MOT
7,22,14,379,1.807389672,401,22,one,"('MOT', 'CHI')",Providence,ale29.xml,422,21,7,CHI,3161,2223,MOT
1,1,0,15,1.791759469,16,1,for,"('MOT', 'FAT')",Providence,ale29.xml,17,1,1,FAT,151,139,MOT
0,5,10,407,1.749199855,412,5,there,"('MOT', 'CHI')",Providence,ale29.xml,422,10,0,CHI,3161,2223,MOT
3,5,4,63,1.645805557,68,5,that,"('CHI', 'MOT')",Providence,ale29.xml,75,7,3,MOT,423,579,CHI
7,17,26,372,1.602429282,389,17,oh,"('MOT', 'CHI')",Providence,ale29.xml,422,33,7,CHI,3161,2223,MOT
3,10,25,384,1.568615918,394,10,on,"('MOT', 'CHI')",Providence,ale29.xml,422,28,3,CHI,3161,2223,MOT
5,11,36,370,1.493687693,381,11,it,"('MOT', 'CHI')",Providence,ale29.xml,422,41,5,CHI,3161,2223,MOT
0,6,13,403,1.364632864,409,6,is,"('MOT', 'CHI')",Providence,ale29.xml,422,13,0,CHI,3161,2223,MOT
0,4,2,69,1.32175584,73,4,to,"('CHI', 'MOT')",Providence,ale29.xml,75,2,0,MOT,423,579,CHI
1,4,5,65,1.266947603,69,4,one,"('CHI', 'MOT')",Providence,ale29.xml,75,6,1,MOT,423,579,CHI
2,10,2,61,1.199416988,71,10,in,"('CHI', 'MOT')",Providence,ale29.xml,75,4,2,MOT,423,579,CHI
1,1,2,13,1.16315081,14,1,to,"('MOT', 'FAT')",Providence,ale29.xml,17,3,1,FAT,151,139,MOT
5,26,21,370,1.150170098,396,26,no,"('MOT', 'CHI')",Providence,ale29.xml,422,26,5,CHI,3161,2223,MOT
0,1,1,15,1.098612289,16,1,they,"('MOT', 'FAT')",Providence,ale29.xml,17,1,0,FAT,151,139,MOT
0,1,1,15,1.098612289,16,1,all,"('MOT', 'FAT')",Providence,ale29.xml,17,1,0,FAT,151,139,MOT
3,11,3,58,1.084626047,69,11,the,"('CHI', 'MOT')",Providence,ale29.xml,75,6,3,MOT,423,579,CHI
2,6,6,61,1.084223551,67,6,go,"('CHI', 'MOT')",Providence,ale29.xml,75,8,2,MOT,423,579,CHI
5,28,21,368,1.078711134,396,28,this,"('MOT', 'CHI')",Providence,ale29.xml,422,26,5,CHI,3161,2223,MOT
1,1,107,313,1.055261848,314,1,you,"('MOT', 'CHI')",Providence,ale29.xml,422,108,1,CHI,3161,2223,MOT
0,9,1,65,0.929535959,74,9,what,"('CHI', 'MOT')",Providence,ale29.xml,75,1,0,MOT,423,579,CHI
4,24,28,366,0.835463403,390,24,a,"('MOT', 'CHI')",Providence,ale29.xml,422,32,4,CHI,3161,2223,MOT
0,10,1,64,0.834225779,74,10,a,"('CHI', 'MOT')",Providence,ale29.xml,75,1,0,MOT,423,579,CHI
2,5,11,57,0.757685702,62,5,no,"('CHI', 'MOT')",Providence,ale29.xml,75,13,2,MOT,423,579,CHI
0,1,2,14,0.753771802,15,1,do,"('MOT', 'FAT')",Providence,ale29.xml,17,2,0,FAT,151,139,MOT
0,13,1,61,0.593063722,74,13,you,"('CHI', 'MOT')",Providence,ale29.xml,75,1,0,MOT,423,579,CHI
0,1,1,7,0.510825624,8,1,this,"('CHI', 'FAT')",Providence,ale29.xml,9,1,0,FAT,56,46,CHI
0,1,1,7,0.510825624,8,1,the,"('CHI', 'FAT')",Providence,ale29.xml,9,1,0,FAT,56,46,CHI
0,1,1,7,0.510825624,8,1,in,"('FAT', 'MOT')",Providence,ale29.xml,9,1,0,MOT,52,149,FAT
0,1,1,7,0.510825624,8,1,that,"('FAT', 'MOT')",Providence,ale29.xml,9,1,0,MOT,52,149,FAT
0,1,1,7,0.510825624,8,1,do,"('FAT', 'MOT')",Providence,ale29.xml,9,1,0,MOT,52,149,FAT
1,8,7,59,0.427444015,67,8,this,"('CHI', 'MOT')",Providence,ale29.xml,75,8,1,MOT,423,579,CHI
0,3,1,13,0.405465108,16,3,a,"('MOT', 'FAT')",Providence,ale29.xml,17,1,0,FAT,151,139,MOT
0,2,2,13,0.348306694,15,2,what,"('MOT', 'FAT')",Providence,ale29.xml,17,2,0,FAT,151,139,MOT
0,2,1,6,0.105360516,8,2,you,"('FAT', 'MOT')",Providence,ale29.xml,9,1,0,MOT,52,149,FAT
0,10,4,61,0.100804699,71,10,oh,"('CHI', 'MOT')",Providence,ale29.xml,75,4,0,MOT,423,579,CHI
8,31,81,302,0.0347597,333,31,the,"('MOT', 'CHI')",Providence,ale29.xml,422,89,8,CHI,3161,2223,MOT
0,1,1,3,0,4,1,a,"('FAT', 'CHI')",Providence,ale29.xml,5,1,0,CHI,17,29,FAT
0,1,1,2,-0.182321557,3,1,is,"('CHI', 'OPE')",Providence,ale29.xml,4,1,0,OPE,21,24,CHI
0,1,3,5,-0.223143551,6,1,the,"('FAT', 'MOT')",Providence,ale29.xml,9,3,0,MOT,52,149,FAT
1,4,4,8,-0.223143551,12,4,you,"('MOT', 'FAT')",Providence,ale29.xml,17,5,1,FAT,151,139,MOT
0,4,1,4,-0.405465108,8,4,it,"('FAT', 'MOT')",Providence,ale29.xml,9,1,0,MOT,52,149,FAT
1,0,2,188,4.33073334,188,0,little,"('MOT', 'CHI')",Providence,ale30.xml,191,3,1,CHI,1721,980,MOT
1,0,6,184,3.721669277,184,0,see,"('MOT', 'CHI')",Providence,ale30.xml,191,7,1,CHI,1721,980,MOT
0,2,1,270,3.415903529,272,2,big,"('CHI', 'MOT')",Providence,ale30.xml,273,1,0,MOT,1268,2103,CHI
0,3,1,269,3.128221457,272,3,not,"('CHI', 'MOT')",Providence,ale30.xml,273,1,0,MOT,1268,2103,CHI
1,3,3,266,3.117212171,269,3,my,"('CHI', 'MOT')",Providence,ale30.xml,273,4,1,MOT,1268,2103,CHI
0,2,1,188,3.060270795,190,2,put,"('MOT', 'CHI')",Providence,ale30.xml,191,1,0,CHI,1721,980,MOT
0,2,1,188,3.060270795,190,2,big,"('MOT', 'CHI')",Providence,ale30.xml,191,1,0,CHI,1721,980,MOT
1,0,15,175,2.978925155,175,0,like,"('MOT', 'CHI')",Providence,ale30.xml,191,16,1,CHI,1721,980,MOT
0,1,3,187,2.944438979,188,1,are,"('MOT', 'CHI')",Providence,ale30.xml,191,3,0,CHI,1721,980,MOT
0,2,2,187,2.767366778,189,2,want,"('MOT', 'CHI')",Providence,ale30.xml,191,2,0,CHI,1721,980,MOT
0,5,1,267,2.722756348,272,5,yeah,"('CHI', 'MOT')",Providence,ale30.xml,273,1,0,MOT,1268,2103,CHI
0,5,1,267,2.722756348,272,5,of,"('CHI', 'MOT')",Providence,ale30.xml,273,1,0,MOT,1268,2103,CHI
0,3,3,267,2.610069793,270,3,look,"('CHI', 'MOT')",Providence,ale30.xml,273,3,0,MOT,1268,2103,CHI
0,6,1,266,2.568605669,272,6,gonna,"('CHI', 'MOT')",Providence,ale30.xml,273,1,0,MOT,1268,2103,CHI
0,4,1,186,2.549445171,190,4,wanna,"('MOT', 'CHI')",Providence,ale30.xml,191,1,0,CHI,1721,980,MOT
1,4,3,183,2.533696814,187,4,there,"('MOT', 'CHI')",Providence,ale30.xml,191,4,1,CHI,1721,980,MOT
1,4,4,182,2.374241082,186,4,go,"('MOT', 'CHI')",Providence,ale30.xml,191,5,1,CHI,1721,980,MOT
0,2,4,185,2.351375257,187,2,did,"('MOT', 'CHI')",Providence,ale30.xml,191,4,0,CHI,1721,980,MOT
0,1,7,183,2.335374916,184,1,get,"('MOT', 'CHI')",Providence,ale30.xml,191,7,0,CHI,1721,980,MOT
0,1,7,183,2.335374916,184,1,have,"('MOT', 'CHI')",Providence,ale30.xml,191,7,0,CHI,1721,980,MOT
0,6,2,265,2.277267285,271,6,little,"('CHI', 'MOT')",Providence,ale30.xml,273,2,0,MOT,1268,2103,CHI
0,6,2,265,2.277267285,271,6,all,"('CHI', 'MOT')",Providence,ale30.xml,273,2,0,MOT,1268,2103,CHI
2,15,2,254,2.136382918,269,15,one,"('CHI', 'MOT')",Providence,ale30.xml,273,4,2,MOT,1268,2103,CHI
1,1,18,171,2.114532861,172,1,to,"('MOT', 'CHI')",Providence,ale30.xml,191,19,1,CHI,1721,980,MOT
0,2,6,183,2.053054787,185,2,he,"('MOT', 'CHI')",Providence,ale30.xml,191,6,0,CHI,1721,980,MOT
0,2,6,183,2.053054787,185,2,do,"('MOT', 'CHI')",Providence,ale30.xml,191,6,0,CHI,1721,980,MOT
2,12,4,255,2.048932769,267,12,on,"('CHI', 'MOT')",Providence,ale30.xml,273,6,2,MOT,1268,2103,CHI
0,11,1,261,2.029609168,272,11,do,"('CHI', 'MOT')",Providence,ale30.xml,273,1,0,MOT,1268,2103,CHI
0,4,3,184,2.028148247,188,4,my,"('MOT', 'CHI')",Providence,ale30.xml,191,3,0,CHI,1721,980,MOT
0,8,2,263,2.025952857,271,8,with,"('CHI', 'MOT')",Providence,ale30.xml,273,2,0,MOT,1268,2103,CHI
0,8,2,263,2.025952857,271,8,are,"('CHI', 'MOT')",Providence,ale30.xml,273,2,0,MOT,1268,2103,CHI
1,10,4,258,1.947763718,268,10,put,"('CHI', 'MOT')",Providence,ale30.xml,273,5,1,MOT,1268,2103,CHI
0,1,11,179,1.945910149,180,1,yeah,"('MOT', 'CHI')",Providence,ale30.xml,191,11,0,CHI,1721,980,MOT
1,2,14,174,1.943105098,176,2,oh,"('MOT', 'CHI')",Providence,ale30.xml,191,15,1,CHI,1721,980,MOT
0,2,7,182,1.929909808,184,2,with,"('MOT', 'CHI')",Providence,ale30.xml,191,7,0,CHI,1721,980,MOT
0,9,2,262,1.920592341,271,9,we,"('CHI', 'MOT')",Providence,ale30.xml,273,2,0,MOT,1268,2103,CHI
3,6,17,247,1.890605304,253,6,where,"('CHI', 'MOT')",Providence,ale30.xml,273,20,3,MOT,1268,2103,CHI
0,2,8,181,1.819158443,183,2,can,"('MOT', 'CHI')",Providence,ale30.xml,191,8,0,CHI,1721,980,MOT
0,8,3,262,1.799139577,270,8,did,"('CHI', 'MOT')",Providence,ale30.xml,273,3,0,MOT,1268,2103,CHI
0,16,1,256,1.681302474,272,16,and,"('CHI', 'MOT')",Providence,ale30.xml,273,1,0,MOT,1268,2103,CHI
0,4,5,182,1.681093901,186,4,in,"('MOT', 'CHI')",Providence,ale30.xml,191,5,0,CHI,1721,980,MOT
1,15,4,253,1.573070268,268,15,see,"('CHI', 'MOT')",Providence,ale30.xml,273,5,1,MOT,1268,2103,CHI
8,28,7,230,1.557397034,258,28,that,"('CHI', 'MOT')",Providence,ale30.xml,273,15,8,MOT,1268,2103,CHI
0,3,8,180,1.531476371,183,3,at,"('MOT', 'CHI')",Providence,ale30.xml,191,8,0,CHI,1721,980,MOT
0,6,4,181,1.504077397,187,6,where,"('MOT', 'CHI')",Providence,ale30.xml,191,4,0,CHI,1721,980,MOT
2,6,13,170,1.501272346,176,6,is,"('MOT', 'CHI')",Providence,ale30.xml,191,15,2,CHI,1721,980,MOT
0,3,9,179,1.430746124,182,3,on,"('MOT', 'CHI')",Providence,ale30.xml,191,9,0,CHI,1721,980,MOT
0,7,4,180,1.370546004,187,7,look,"('MOT', 'CHI')",Providence,ale30.xml,191,4,0,CHI,1721,980,MOT
0,10,5,258,1.254616537,268,10,in,"('CHI', 'MOT')",Providence,ale30.xml,273,5,0,MOT,1268,2103,CHI
0,27,1,245,1.182311308,272,27,to,"('CHI', 'MOT')",Providence,ale30.xml,273,1,0,MOT,1268,2103,CHI
6,25,14,228,1.138034703,253,25,the,"('CHI', 'MOT')",Providence,ale30.xml,273,20,6,MOT,1268,2103,CHI
0,9,7,257,1.09117731,266,9,oh,"('CHI', 'MOT')",Providence,ale30.xml,273,7,0,MOT,1268,2103,CHI
4,11,23,153,0.869223221,164,11,a,"('MOT', 'CHI')",Providence,ale30.xml,191,27,4,CHI,1721,980,MOT
0,5,11,175,0.84729786,180,5,it,"('MOT', 'CHI')",Providence,ale30.xml,191,11,0,CHI,1721,980,MOT
4,19,21,229,0.839329691,248,19,a,"('CHI', 'MOT')",Providence,ale30.xml,273,25,4,MOT,1268,2103,CHI
0,12,7,254,0.828813046,266,12,go,"('CHI', 'MOT')",Providence,ale30.xml,273,7,0,MOT,1268,2103,CHI
1,4,27,159,0.78845736,163,4,that,"('MOT', 'CHI')",Providence,ale30.xml,191,28,1,CHI,1721,980,MOT
3,16,15,157,0.722134717,173,16,one,"('MOT', 'CHI')",Providence,ale30.xml,191,18,3,CHI,1721,980,MOT
2,39,6,226,0.6943964,265,39,what,"('CHI', 'MOT')",Providence,ale30.xml,273,8,2,MOT,1268,2103,CHI
5,11,34,141,0.630233355,152,11,the,"('MOT', 'CHI')",Providence,ale30.xml,191,39,5,CHI,1721,980,MOT
1,4,32,154,0.603535022,158,4,you,"('MOT', 'CHI')",Providence,ale30.xml,191,33,1,CHI,1721,980,MOT
0,50,1,222,0.582690185,272,50,you,"('CHI', 'MOT')",Providence,ale30.xml,273,1,0,MOT,1268,2103,CHI
1,24,10,238,0.485271101,262,24,it,"('CHI', 'MOT')",Providence,ale30.xml,273,11,1,MOT,1268,2103,CHI
0,8,11,172,0.441832752,180,8,what,"('MOT', 'CHI')",Providence,ale30.xml,191,11,0,CHI,1721,980,MOT
4,23,18,146,0.394993808,169,23,this,"('MOT', 'CHI')",Providence,ale30.xml,191,22,4,CHI,1721,980,MOT
0,18,8,247,0.340224586,265,18,no,"('CHI', 'MOT')",Providence,ale30.xml,273,8,0,MOT,1268,2103,CHI
0,16,10,247,0.261609832,263,16,there,"('CHI', 'MOT')",Providence,ale30.xml,273,10,0,MOT,1268,2103,CHI
3,26,17,145,0.152706636,171,26,no,"('MOT', 'CHI')",Providence,ale30.xml,191,20,3,CHI,1721,980,MOT
0,30,9,234,-0.248386169,264,30,is,"('CHI', 'MOT')",Providence,ale30.xml,273,9,0,MOT,1268,2103,CHI
0,2,1,3,-0.251314428,5,2,is,"('FAT', 'CHI')",Providence,ale30.xml,6,1,0,CHI,22,44,FAT
0,24,13,236,-0.358581522,260,24,this,"('CHI', 'MOT')",Providence,ale30.xml,273,13,0,MOT,1268,2103,CHI
0,1,1,1,-0.405465108,2,1,you,"('MOT', 'FAT')",Providence,ale30.xml,3,1,0,FAT,24,11,MOT
1,0,3,167,4.031286426,167,0,for,"('MOT', 'CHI')",Providence,ale31.xml,171,4,1,CHI,1842,708,MOT
1,1,1,168,3.755369195,169,1,big,"('MOT', 'CHI')",Providence,ale31.xml,171,2,1,CHI,1842,708,MOT
1,3,0,156,3.289644896,159,3,all,"('CHI', 'MOT')",Providence,ale31.xml,160,1,1,MOT,631,1848,CHI
0,1,2,157,2.995732274,158,1,at,"('CHI', 'MOT')",Providence,ale31.xml,160,2,0,MOT,631,1848,CHI
1,3,2,165,2.833213344,168,3,did,"('MOT', 'CHI')",Providence,ale31.xml,171,3,1,CHI,1842,708,MOT
1,0,17,153,2.740840024,153,0,he,"('MOT', 'CHI')",Providence,ale31.xml,171,18,1,CHI,1842,708,MOT
0,1,4,166,2.644992065,167,1,was,"('MOT', 'CHI')",Providence,ale31.xml,171,4,0,CHI,1842,708,MOT
0,1,4,166,2.644992065,167,1,at,"('MOT', 'CHI')",Providence,ale31.xml,171,4,0,CHI,1842,708,MOT
1,1,9,160,2.608843551,161,1,there,"('MOT', 'CHI')",Providence,ale31.xml,171,10,1,CHI,1842,708,MOT
1,4,2,153,2.543175558,157,4,my,"('CHI', 'MOT')",Providence,ale31.xml,160,3,1,MOT,631,1848,CHI
1,1,10,159,2.522646978,160,1,see,"('MOT', 'CHI')",Providence,ale31.xml,171,11,1,CHI,1842,708,MOT
0,1,5,165,2.48490665,166,1,not,"('MOT', 'CHI')",Providence,ale31.xml,171,5,0,CHI,1842,708,MOT
0,4,1,155,2.373354164,159,4,yeah,"('CHI', 'MOT')",Providence,ale31.xml,160,1,0,MOT,631,1848,CHI
0,1,7,163,2.22161603,164,1,go,"('MOT', 'CHI')",Providence,ale31.xml,171,7,0,CHI,1842,708,MOT
1,8,1,150,2.184802057,158,8,there,"('CHI', 'MOT')",Providence,ale31.xml,160,2,1,MOT,631,1848,CHI
1,0,0,11,2.159484249,11,0,big,"('CHI', 'ADU')",Providence,ale31.xml,12,1,1,ADU,57,63,CHI
1,9,1,149,2.079441542,158,9,up,"('CHI', 'MOT')",Providence,ale31.xml,160,2,1,MOT,631,1848,CHI
1,0,1,13,2.014903021,13,0,no,"('ADU', 'MOT')",Providence,ale31.xml,15,2,1,MOT,71,138,ADU
0,4,3,164,1.916922612,168,4,my,"('MOT', 'CHI')",Providence,ale31.xml,171,3,0,CHI,1842,708,MOT
0,7,1,152,1.903350535,159,7,get,"('CHI', 'MOT')",Providence,ale31.xml,160,1,0,MOT,631,1848,CHI
0,7,1,152,1.903350535,159,7,with,"('CHI', 'MOT')",Providence,ale31.xml,160,1,0,MOT,631,1848,CHI
0,2,6,152,1.871802177,154,2,look,"('CHI', 'MOT')",Providence,ale31.xml,160,6,0,MOT,631,1848,CHI
1,3,9,147,1.84582669,150,3,big,"('CHI', 'MOT')",Providence,ale31.xml,160,10,1,MOT,631,1848,CHI
1,16,0,143,1.842725913,159,16,like,"('CHI', 'MOT')",Providence,ale31.xml,160,1,1,MOT,631,1848,CHI
3,6,10,152,1.807507826,158,6,like,"('MOT', 'CHI')",Providence,ale31.xml,171,13,3,CHI,1842,708,MOT
0,1,12,158,1.749199855,159,1,in,"('MOT', 'CHI')",Providence,ale31.xml,171,12,0,CHI,1842,708,MOT
2,13,2,143,1.730390523,156,13,in,"('CHI', 'MOT')",Providence,ale31.xml,160,4,2,MOT,631,1848,CHI
1,1,24,145,1.701375408,146,1,one,"('MOT', 'CHI')",Providence,ale31.xml,171,25,1,CHI,1842,708,MOT
1,0,4,17,1.691676011,17,0,the,"('MOT', 'ADU')",Providence,ale31.xml,22,5,1,ADU,282,93,MOT
0,9,1,150,1.680206983,159,9,on,"('CHI', 'MOT')",Providence,ale31.xml,160,1,0,MOT,631,1848,CHI
4,7,13,136,1.562291134,143,7,one,"('CHI', 'MOT')",Providence,ale31.xml,160,17,4,MOT,631,1848,CHI
3,7,12,149,1.536234508,156,7,no,"('MOT', 'CHI')",Providence,ale31.xml,171,15,3,CHI,1842,708,MOT
7,5,33,126,1.440361582,131,5,this,"('MOT', 'CHI')",Providence,ale31.xml,171,40,7,CHI,1842,708,MOT
1,7,7,156,1.41706602,163,7,look,"('MOT', 'CHI')",Providence,ale31.xml,171,8,1,CHI,1842,708,MOT
0,1,18,152,1.354545663,153,1,to,"('MOT', 'CHI')",Providence,ale31.xml,171,18,0,CHI,1842,708,MOT
0,1,18,152,1.354545663,153,1,and,"('MOT', 'CHI')",Providence,ale31.xml,171,18,0,CHI,1842,708,MOT
0,1,1,20,1.343734747,21,1,there,"('MOT', 'ADU')",Providence,ale31.xml,22,1,0,ADU,282,93,MOT
6,6,29,130,1.316335773,136,6,the,"('MOT', 'CHI')",Providence,ale31.xml,171,35,6,CHI,1842,708,MOT
0,10,2,148,1.290984181,158,10,what,"('CHI', 'MOT')",Providence,ale31.xml,160,2,0,MOT,631,1848,CHI
0,11,2,147,1.203972804,158,11,and,"('CHI', 'MOT')",Providence,ale31.xml,160,2,0,MOT,631,1848,CHI
1,1,3,17,1.203972804,18,1,a,"('MOT', 'ADU')",Providence,ale31.xml,22,4,1,ADU,282,93,MOT
0,12,2,146,1.123930097,158,12,go,"('CHI', 'MOT')",Providence,ale31.xml,160,2,0,MOT,631,1848,CHI
4,8,22,137,1.070441412,145,8,that,"('MOT', 'CHI')",Providence,ale31.xml,171,26,4,CHI,1842,708,MOT
0,2,16,153,1.067261759,155,2,is,"('MOT', 'CHI')",Providence,ale31.xml,171,16,0,CHI,1842,708,MOT
5,35,2,118,1.05444107,153,35,the,"('CHI', 'MOT')",Providence,ale31.xml,160,7,5,MOT,631,1848,CHI
0,1,2,19,1.011600912,20,1,little,"('MOT', 'ADU')",Providence,ale31.xml,22,2,0,ADU,282,93,MOT
0,1,2,19,1.011600912,20,1,do,"('MOT', 'ADU')",Providence,ale31.xml,22,2,0,ADU,282,93,MOT
0,1,1,13,0.980829253,14,1,go,"('ADU', 'MOT')",Providence,ale31.xml,15,1,0,MOT,71,138,ADU
0,1,1,13,0.980829253,14,1,what,"('ADU', 'MOT')",Providence,ale31.xml,15,1,0,MOT,71,138,ADU
0,1,1,13,0.980829253,14,1,my,"('ADU', 'MOT')",Providence,ale31.xml,15,1,0,MOT,71,138,ADU
0,1,1,13,0.980829253,14,1,can,"('ADU', 'MOT')",Providence,ale31.xml,15,1,0,MOT,71,138,ADU
0,1,1,13,0.980829253,14,1,the,"('ADU', 'MOT')",Providence,ale31.xml,15,1,0,MOT,71,138,ADU
0,20,1,139,0.938269639,159,20,to,"('CHI', 'MOT')",Providence,ale31.xml,160,1,0,MOT,631,1848,CHI
1,4,21,145,0.922935275,149,4,it,"('MOT', 'CHI')",Providence,ale31.xml,171,22,1,CHI,1842,708,MOT
3,14,12,131,0.835463403,145,14,a,"('CHI', 'MOT')",Providence,ale31.xml,160,15,3,MOT,631,1848,CHI
0,17,2,141,0.798507696,158,17,that,"('CHI', 'MOT')",Providence,ale31.xml,160,2,0,MOT,631,1848,CHI
0,1,1,10,0.773189888,11,1,the,"('CHI', 'ADU')",Providence,ale31.xml,12,1,0,ADU,57,63,CHI
0,18,2,140,0.744440475,158,18,oh,"('CHI', 'MOT')",Providence,ale31.xml,160,2,0,MOT,631,1848,CHI
0,3,17,151,0.719122667,154,3,oh,"('MOT', 'CHI')",Providence,ale31.xml,171,17,0,CHI,1842,708,MOT
0,16,3,141,0.626252946,157,16,is,"('CHI', 'MOT')",Providence,ale31.xml,160,3,0,MOT,631,1848,CHI
1,23,4,132,0.625429007,155,23,it,"('CHI', 'MOT')",Providence,ale31.xml,160,5,1,MOT,631,1848,CHI
0,2,2,18,0.606135804,20,2,oh,"('MOT', 'ADU')",Providence,ale31.xml,22,2,0,ADU,282,93,MOT
0,2,2,18,0.606135804,20,2,are,"('MOT', 'ADU')",Providence,ale31.xml,22,2,0,ADU,282,93,MOT
2,28,5,125,0.577516998,153,28,this,"('CHI', 'MOT')",Providence,ale31.xml,160,7,2,MOT,631,1848,CHI
0,2,1,12,0.575364145,14,2,it,"('ADU', 'MOT')",Providence,ale31.xml,15,1,0,MOT,71,138,ADU
0,2,1,12,0.575364145,14,2,a,"('ADU', 'MOT')",Providence,ale31.xml,15,1,0,MOT,71,138,ADU
0,2,1,12,0.575364145,14,2,that,"('ADU', 'MOT')",Providence,ale31.xml,15,1,0,MOT,71,138,ADU
0,2,1,12,0.575364145,14,2,are,"('ADU', 'MOT')",Providence,ale31.xml,15,1,0,MOT,71,138,ADU
0,2,1,12,0.575364145,14,2,not,"('ADU', 'MOT')",Providence,ale31.xml,15,1,0,MOT,71,138,ADU
2,12,21,125,0.249261039,137,12,no,"('CHI', 'MOT')",Providence,ale31.xml,160,23,2,MOT,631,1848,CHI
0,5,19,147,0.200670695,152,5,a,"('MOT', 'CHI')",Providence,ale31.xml,171,19,0,CHI,1842,708,MOT
0,49,1,110,0.070769071,159,49,you,"('CHI', 'MOT')",Providence,ale31.xml,160,1,0,MOT,631,1848,CHI
2,6,4,10,-0.036367644,16,6,you,"('MOT', 'ADU')",Providence,ale31.xml,22,6,2,ADU,282,93,MOT
1,5,2,7,-0.068992871,12,5,you,"('ADU', 'MOT')",Providence,ale31.xml,15,3,1,MOT,71,138,ADU
0,1,1,1,-0.405465108,2,1,you,"('OPE', 'MOT')",Providence,ale31.xml,3,1,0,MOT,11,11,OPE
4,1,3,233,4.18289796,234,1,up,"('MOT', 'CHI')",Providence,ale32.xml,241,7,4,CHI,2684,1175,MOT
1,0,5,235,4.08176578,235,0,not,"('MOT', 'CHI')",Providence,ale32.xml,241,6,1,CHI,2684,1175,MOT
1,0,1,93,3.860729711,93,0,they,"('MOT', 'GRN')",Providence,ale32.xml,95,2,1,GRN,686,497,MOT
1,0,7,233,3.850147602,233,0,and,"('MOT', 'CHI')",Providence,ale32.xml,241,8,1,CHI,2684,1175,MOT
2,0,13,226,3.694744574,226,0,on,"('MOT', 'CHI')",Providence,ale32.xml,241,15,2,CHI,2684,1175,MOT
1,0,1,62,3.465735903,62,0,look,"('CHI', 'MOT')",Providence,ale32.xml,64,2,1,MOT,361,720,CHI
1,1,5,234,3.388618599,235,1,all,"('MOT', 'CHI')",Providence,ale32.xml,241,6,1,CHI,2684,1175,MOT
2,4,1,234,3.360375387,238,4,big,"('MOT', 'CHI')",Providence,ale32.xml,241,3,2,CHI,2684,1175,MOT
0,1,3,237,3.17805383,238,1,with,"('MOT', 'CHI')",Providence,ale32.xml,241,3,0,CHI,2684,1175,MOT
1,3,2,235,3.17805383,238,3,at,"('MOT', 'CHI')",Providence,ale32.xml,241,3,1,CHI,2684,1175,MOT
2,1,11,227,3.135494216,228,1,put,"('MOT', 'CHI')",Providence,ale32.xml,241,13,2,CHI,2684,1175,MOT
1,1,8,231,3.057425843,232,1,little,"('MOT', 'CHI')",Providence,ale32.xml,241,9,1,CHI,2684,1175,MOT
1,1,2,91,2.93385687,92,1,little,"('MOT', 'GRN')",Providence,ale32.xml,95,3,1,GRN,686,497,MOT
0,1,1,108,2.917770732,109,1,with,"('GRN', 'MOT')",Providence,ale32.xml,110,1,0,MOT,588,891,GRN
0,1,1,108,2.917770732,109,1,up,"('GRN', 'MOT')",Providence,ale32.xml,110,1,0,MOT,588,891,GRN
0,1,1,108,2.917770732,109,1,she,"('GRN', 'MOT')",Providence,ale32.xml,110,1,0,MOT,588,891,GRN
0,1,1,108,2.917770732,109,1,some,"('GRN', 'MOT')",Providence,ale32.xml,110,1,0,MOT,588,891,GRN
0,1,1,108,2.917770732,109,1,put,"('GRN', 'MOT')",Providence,ale32.xml,110,1,0,MOT,588,891,GRN
0,1,1,93,2.772588722,94,1,gonna,"('MOT', 'GRN')",Providence,ale32.xml,95,1,0,GRN,686,497,MOT
0,1,1,93,2.772588722,94,1,see,"('MOT', 'GRN')",Providence,ale32.xml,95,1,0,GRN,686,497,MOT
0,1,1,93,2.772588722,94,1,at,"('MOT', 'GRN')",Providence,ale32.xml,95,1,0,GRN,686,497,MOT
0,1,6,234,2.695471419,235,1,of,"('MOT', 'CHI')",Providence,ale32.xml,241,6,0,CHI,2684,1175,MOT
1,2,0,61,2.670309873,63,2,have,"('CHI', 'MOT')",Providence,ale32.xml,64,1,1,MOT,361,720,CHI
0,1,2,107,2.621038824,108,1,look,"('GRN', 'MOT')",Providence,ale32.xml,110,2,0,MOT,588,891,GRN
0,1,2,107,2.621038824,108,1,wanna,"('GRN', 'MOT')",Providence,ale32.xml,110,2,0,MOT,588,891,GRN
0,1,8,232,2.463853241,233,1,where,"('MOT', 'CHI')",Providence,ale32.xml,241,8,0,CHI,2684,1175,MOT
1,4,1,104,2.397895273,108,4,they,"('GRN', 'MOT')",Providence,ale32.xml,110,2,1,MOT,588,891,GRN
1,3,2,104,2.388762789,107,3,have,"('GRN', 'MOT')",Providence,ale32.xml,110,3,1,MOT,588,891,GRN
0,1,1,62,2.382627801,63,1,want,"('CHI', 'MOT')",Providence,ale32.xml,64,1,0,MOT,361,720,CHI
0,2,1,92,2.367123614,94,2,did,"('MOT', 'GRN')",Providence,ale32.xml,95,1,0,GRN,686,497,MOT
0,1,10,230,2.272984623,231,1,like,"('MOT', 'CHI')",Providence,ale32.xml,241,10,0,CHI,2684,1175,MOT
1,3,2,89,2.240709689,92,3,do,"('MOT', 'GRN')",Providence,ale32.xml,95,3,1,GRN,686,497,MOT
0,1,3,91,2.240709689,92,1,go,"('MOT', 'GRN')",Providence,ale32.xml,95,3,0,GRN,686,497,MOT
0,1,3,91,2.240709689,92,1,look,"('MOT', 'GRN')",Providence,ale32.xml,95,3,0,GRN,686,497,MOT
0,1,3,91,2.240709689,92,1,is,"('MOT', 'GRN')",Providence,ale32.xml,95,3,0,GRN,686,497,MOT
0,3,1,106,2.224623552,109,3,we,"('GRN', 'MOT')",Providence,ale32.xml,110,1,0,MOT,588,891,GRN
0,3,1,106,2.224623552,109,3,was,"('GRN', 'MOT')",Providence,ale32.xml,110,1,0,MOT,588,891,GRN
0,2,2,106,2.215573716,108,2,little,"('GRN', 'MOT')",Providence,ale32.xml,110,2,0,MOT,588,891,GRN
0,2,2,106,2.215573716,108,2,where,"('GRN', 'MOT')",Providence,ale32.xml,110,2,0,MOT,588,891,GRN
0,2,2,106,2.215573716,108,2,not,"('GRN', 'MOT')",Providence,ale32.xml,110,2,0,MOT,588,891,GRN
0,1,4,105,2.197224577,106,1,are,"('GRN', 'MOT')",Providence,ale32.xml,110,4,0,MOT,588,891,GRN
0,1,2,61,2.079441542,62,1,for,"('CHI', 'MOT')",Providence,ale32.xml,64,2,0,MOT,361,720,CHI
0,1,2,61,2.079441542,62,1,my,"('CHI', 'MOT')",Providence,ale32.xml,64,2,0,MOT,361,720,CHI
0,3,1,91,2.079441542,94,3,where,"('MOT', 'GRN')",Providence,ale32.xml,95,1,0,GRN,686,497,MOT
0,2,2,91,2.068970242,93,2,get,"('MOT', 'GRN')",Providence,ale32.xml,95,2,0,GRN,686,497,MOT
0,2,2,91,2.068970242,93,2,for,"('MOT', 'GRN')",Providence,ale32.xml,95,2,0,GRN,686,497,MOT
0,2,2,91,2.068970242,93,2,all,"('MOT', 'GRN')",Providence,ale32.xml,95,2,0,GRN,686,497,MOT
0,1,4,90,2.047692843,91,1,put,"('MOT', 'GRN')",Providence,ale32.xml,95,4,0,GRN,686,497,MOT
0,1,4,90,2.047692843,91,1,he,"('MOT', 'GRN')",Providence,ale32.xml,95,4,0,GRN,686,497,MOT
0,1,4,90,2.047692843,91,1,to,"('MOT', 'GRN')",Providence,ale32.xml,95,4,0,GRN,686,497,MOT
0,1,4,90,2.047692843,91,1,not,"('MOT', 'GRN')",Providence,ale32.xml,95,4,0,GRN,686,497,MOT
2,5,11,223,2.036881927,228,5,there,"('MOT', 'CHI')",Providence,ale32.xml,241,13,2,CHI,2684,1175,MOT
0,1,13,227,2.036881927,228,1,see,"('MOT', 'CHI')",Providence,ale32.xml,241,13,0,CHI,2684,1175,MOT
2,6,9,224,2.034490154,230,6,look,"('MOT', 'CHI')",Providence,ale32.xml,241,11,2,CHI,2684,1175,MOT
0,4,1,105,2.00148,109,4,is,"('GRN', 'MOT')",Providence,ale32.xml,110,1,0,MOT,588,891,GRN
1,0,0,9,1.992430165,9,0,get,"('CHI', 'OPE')",Providence,ale32.xml,10,1,1,OPE,68,51,CHI
1,0,0,9,1.992430165,9,0,one,"('CHI', 'OPE')",Providence,ale32.xml,10,1,1,OPE,68,51,CHI
1,0,0,9,1.992430165,9,0,a,"('OPE', 'CHI')",Providence,ale32.xml,10,1,1,CHI,37,71,OPE
1,0,0,9,1.992430165,9,0,one,"('OPE', 'CHI')",Providence,ale32.xml,10,1,1,CHI,37,71,OPE
1,0,0,9,1.992430165,9,0,big,"('OPE', 'CHI')",Providence,ale32.xml,10,1,1,CHI,37,71,OPE
0,3,2,105,1.927891644,108,3,can,"('GRN', 'MOT')",Providence,ale32.xml,110,2,0,MOT,588,891,GRN
0,1,5,89,1.882731247,90,1,on,"('MOT', 'GRN')",Providence,ale32.xml,95,5,0,GRN,686,497,MOT
0,1,5,89,1.882731247,90,1,and,"('MOT', 'GRN')",Providence,ale32.xml,95,5,0,GRN,686,497,MOT
2,6,3,99,1.879620825,105,6,one,"('GRN', 'MOT')",Providence,ale32.xml,110,5,2,MOT,588,891,GRN
0,4,1,90,1.85629799,94,4,there,"('MOT', 'GRN')",Providence,ale32.xml,95,1,0,GRN,686,497,MOT
0,4,1,90,1.85629799,94,4,are,"('MOT', 'GRN')",Providence,ale32.xml,95,1,0,GRN,686,497,MOT
0,3,2,90,1.781288169,93,3,but,"('MOT', 'GRN')",Providence,ale32.xml,95,2,0,GRN,686,497,MOT
0,4,2,104,1.704748092,108,4,but,"('GRN', 'MOT')",Providence,ale32.xml,110,2,0,MOT,588,891,GRN
4,5,3,52,1.69799131,57,5,in,"('CHI', 'MOT')",Providence,ale32.xml,64,7,4,MOT,361,720,CHI
0,3,3,104,1.695615609,107,3,do,"('GRN', 'MOT')",Providence,ale32.xml,110,3,0,MOT,588,891,GRN
0,3,1,60,1.68948062,63,3,go,"('CHI', 'MOT')",Providence,ale32.xml,64,1,0,MOT,361,720,CHI
0,3,1,60,1.68948062,63,3,yeah,"('CHI', 'MOT')",Providence,ale32.xml,64,1,0,MOT,361,720,CHI
1,0,0,6,1.673976434,6,0,oh,"('GRN', 'OPE')",Providence,ale32.xml,7,1,1,OPE,39,27,GRN
0,6,1,103,1.665007764,109,6,gonna,"('GRN', 'MOT')",Providence,ale32.xml,110,1,0,MOT,588,891,GRN
0,1,1,28,1.642227735,29,1,no,"('GRN', 'CHI')",Providence,ale32.xml,30,1,0,CHI,129,184,GRN
0,1,1,28,1.642227735,29,1,one,"('GRN', 'CHI')",Providence,ale32.xml,30,1,0,CHI,129,184,GRN
0,1,7,87,1.609437912,88,1,no,"('MOT', 'GRN')",Providence,ale32.xml,95,7,0,GRN,686,497,MOT
12,12,28,189,1.575536361,201,12,one,"('MOT', 'CHI')",Providence,ale32.xml,241,40,12,CHI,2684,1175,MOT
0,4,2,89,1.558144618,93,4,want,"('MOT', 'GRN')",Providence,ale32.xml,95,2,0,GRN,686,497,MOT
2,7,14,218,1.553749007,225,7,in,"('MOT', 'CHI')",Providence,ale32.xml,241,16,2,CHI,2684,1175,MOT
0,3,3,89,1.547562509,92,3,my,"('MOT', 'GRN')",Providence,ale32.xml,95,3,0,GRN,686,497,MOT
0,5,2,103,1.522426535,108,5,in,"('GRN', 'MOT')",Providence,ale32.xml,110,2,0,MOT,588,891,GRN
0,5,2,103,1.522426535,108,5,get,"('GRN', 'MOT')",Providence,ale32.xml,110,2,0,MOT,588,891,GRN
0,5,2,103,1.522426535,108,5,see,"('GRN', 'MOT')",Providence,ale32.xml,110,2,0,MOT,588,891,GRN
6,8,28,199,1.507500885,207,8,go,"('MOT', 'CHI')",Providence,ale32.xml,241,34,6,CHI,2684,1175,MOT
4,7,24,206,1.499437017,213,7,this,"('MOT', 'CHI')",Providence,ale32.xml,241,28,4,CHI,2684,1175,MOT
0,3,11,227,1.495493653,230,3,yeah,"('MOT', 'CHI')",Providence,ale32.xml,241,11,0,CHI,2684,1175,MOT
0,2,5,88,1.477266139,90,2,one,"('MOT', 'GRN')",Providence,ale32.xml,95,5,0,GRN,686,497,MOT
2,4,10,94,1.455287233,98,4,oh,"('GRN', 'MOT')",Providence,ale32.xml,110,12,2,MOT,588,891,GRN
0,2,3,59,1.435084525,61,2,put,"('CHI', 'MOT')",Providence,ale32.xml,64,3,0,MOT,361,720,CHI
0,1,25,215,1.395511016,216,1,what,"('MOT', 'CHI')",Providence,ale32.xml,241,25,0,CHI,2684,1175,MOT
1,4,20,216,1.350892434,220,4,no,"('MOT', 'CHI')",Providence,ale32.xml,241,21,1,CHI,2684,1175,MOT
0,3,13,225,1.343734747,228,3,is,"('MOT', 'CHI')",Providence,ale32.xml,241,13,0,CHI,2684,1175,MOT
0,1,1,20,1.343734747,21,1,was,"('MOT', 'OPE')",Providence,ale32.xml,22,1,0,OPE,203,92,MOT
0,1,1,20,1.343734747,21,1,what,"('MOT', 'OPE')",Providence,ale32.xml,22,1,0,OPE,203,92,MOT
0,1,1,20,1.343734747,21,1,my,"('MOT', 'OPE')",Providence,ale32.xml,22,1,0,OPE,203,92,MOT
0,1,1,20,1.343734747,21,1,to,"('MOT', 'OPE')",Providence,ale32.xml,22,1,0,OPE,203,92,MOT
0,3,5,102,1.340624324,105,3,like,"('GRN', 'MOT')",Providence,ale32.xml,110,5,0,MOT,588,891,GRN
0,1,2,27,1.32175584,28,1,that,"('GRN', 'CHI')",Providence,ale32.xml,30,2,0,CHI,129,184,GRN
1,1,1,12,1.32175584,13,1,a,"('OPE', 'MOT')",Providence,ale32.xml,15,2,1,MOT,46,186,OPE
0,5,3,102,1.290150501,107,5,there,"('GRN', 'MOT')",Providence,ale32.xml,110,3,0,MOT,588,891,GRN
2,3,13,77,1.285823831,80,3,it,"('MOT', 'GRN')",Providence,ale32.xml,95,15,2,GRN,686,497,MOT
5,12,6,87,1.276981271,99,12,it,"('GRN', 'MOT')",Providence,ale32.xml,110,11,5,MOT,588,891,GRN
4,9,8,89,1.272965676,98,9,a,"('GRN', 'MOT')",Providence,ale32.xml,110,12,4,MOT,588,891,GRN
4,4,48,185,1.263289381,189,4,it,"('MOT', 'CHI')",Providence,ale32.xml,241,52,4,CHI,2684,1175,MOT
1,5,3,55,1.236762627,60,5,this,"('CHI', 'MOT')",Providence,ale32.xml,64,4,1,MOT,361,720,CHI
0,2,1,27,1.236762627,29,2,a,"('GRN', 'CHI')",Providence,ale32.xml,30,1,0,CHI,129,184,GRN
0,2,1,27,1.236762627,29,2,where,"('GRN', 'CHI')",Providence,ale32.xml,30,1,0,CHI,129,184,GRN
0,7,2,101,1.234744463,108,7,go,"('GRN', 'MOT')",Providence,ale32.xml,110,2,0,MOT,588,891,GRN
1,8,4,97,1.222841289,105,8,what,"('GRN', 'MOT')",Providence,ale32.xml,110,5,1,MOT,588,891,GRN
0,6,2,87,1.221672381,93,6,yeah,"('MOT', 'GRN')",Providence,ale32.xml,95,2,0,GRN,686,497,MOT
0,2,20,219,1.217517029,221,2,get,"('MOT', 'CHI')",Providence,ale32.xml,241,20,0,CHI,2684,1175,MOT
0,2,7,86,1.203972804,88,2,this,"('MOT', 'GRN')",Providence,ale32.xml,95,7,0,GRN,686,497,MOT
2,5,11,92,1.193922468,97,5,that,"('GRN', 'MOT')",Providence,ale32.xml,110,13,2,MOT,588,891,GRN
0,5,10,226,1.174372335,231,5,want,"('MOT', 'CHI')",Providence,ale32.xml,241,10,0,CHI,2684,1175,MOT
0,4,2,58,1.16315081,62,4,there,"('CHI', 'MOT')",Providence,ale32.xml,64,2,0,MOT,361,720,CHI
1,9,4,96,1.117480773,105,9,no,"('GRN', 'MOT')",Providence,ale32.xml,110,5,1,MOT,588,891,GRN
0,8,2,100,1.116961427,108,8,and,"('GRN', 'MOT')",Providence,ale32.xml,110,2,0,MOT,588,891,GRN
0,5,4,101,1.098612289,106,5,for,"('GRN', 'MOT')",Providence,ale32.xml,110,4,0,MOT,588,891,GRN
0,5,4,101,1.098612289,106,5,of,"('GRN', 'MOT')",Providence,ale32.xml,110,4,0,MOT,588,891,GRN
0,1,1,15,1.098612289,16,1,in,"('CHI', 'GRN')",Providence,ale32.xml,17,1,0,GRN,65,113,CHI
0,1,1,15,1.098612289,16,1,a,"('CHI', 'GRN')",Providence,ale32.xml,17,1,0,GRN,65,113,CHI
0,2,8,85,1.087438988,87,2,like,"('MOT', 'GRN')",Providence,ale32.xml,95,8,0,GRN,686,497,MOT
0,8,7,226,1.06938265,234,8,my,"('MOT', 'CHI')",Providence,ale32.xml,241,7,0,CHI,2684,1175,MOT
0,3,6,86,1.045123604,89,3,of,"('MOT', 'GRN')",Providence,ale32.xml,95,6,0,GRN,686,497,MOT
1,1,2,11,1.029619417,12,1,oh,"('OPE', 'MOT')",Providence,ale32.xml,15,3,1,MOT,46,186,OPE
0,1,2,19,1.011600912,20,1,a,"('MOT', 'OPE')",Providence,ale32.xml,22,2,0,OPE,203,92,MOT
0,1,2,19,1.011600912,20,1,that,"('MOT', 'OPE')",Providence,ale32.xml,22,2,0,OPE,203,92,MOT
0,7,3,100,1.002468428,107,7,want,"('GRN', 'MOT')",Providence,ale32.xml,110,3,0,MOT,588,891,GRN
1,1,4,16,0.99852883,17,1,you,"('MOT', 'OPE')",Providence,ale32.xml,22,5,1,OPE,203,92,MOT
0,7,1,56,0.99633344,63,7,no,"('CHI', 'MOT')",Providence,ale32.xml,64,1,0,MOT,361,720,CHI
0,7,1,56,0.99633344,63,7,to,"('CHI', 'MOT')",Providence,ale32.xml,64,1,0,MOT,361,720,CHI
1,11,1,51,0.980829253,62,11,a,"('CHI', 'MOT')",Providence,ale32.xml,64,2,1,MOT,361,720,CHI
0,5,4,86,0.949080555,91,5,have,"('MOT', 'GRN')",Providence,ale32.xml,95,4,0,GRN,686,497,MOT
7,14,33,187,0.946927701,201,14,the,"('MOT', 'CHI')",Providence,ale32.xml,241,40,7,CHI,2684,1175,MOT
0,2,1,19,0.938269639,21,2,oh,"('MOT', 'OPE')",Providence,ale32.xml,22,1,0,OPE,203,92,MOT
0,2,1,19,0.938269639,21,2,yeah,"('MOT', 'OPE')",Providence,ale32.xml,22,1,0,OPE,203,92,MOT
0,3,20,218,0.929834957,221,3,to,"('MOT', 'CHI')",Providence,ale32.xml,241,20,0,CHI,2684,1175,MOT
1,6,4,53,0.912200747,59,6,one,"('CHI', 'MOT')",Providence,ale32.xml,64,5,1,MOT,361,720,CHI
1,2,0,7,0.893817876,9,2,it,"('CHI', 'OPE')",Providence,ale32.xml,10,1,1,OPE,68,51,CHI
0,8,3,99,0.884685392,107,8,this,"('GRN', 'MOT')",Providence,ale32.xml,110,3,0,MOT,588,891,GRN
1,0,2,4,0.875468737,4,0,you,"('GRN', 'OPE')",Providence,ale32.xml,7,3,1,OPE,39,27,GRN
0,1,4,25,0.84729786,26,1,you,"('GRN', 'CHI')",Providence,ale32.xml,30,4,0,CHI,129,184,GRN
1,18,2,89,0.830618171,107,18,the,"('GRN', 'MOT')",Providence,ale32.xml,110,3,1,MOT,588,891,GRN
8,13,5,38,0.82040896,51,13,the,"('CHI', 'MOT')",Providence,ale32.xml,64,13,8,MOT,361,720,CHI
0,2,11,82,0.79078565,84,2,in,"('MOT', 'GRN')",Providence,ale32.xml,95,11,0,GRN,686,497,MOT
0,9,3,98,0.779324877,107,9,to,"('GRN', 'MOT')",Providence,ale32.xml,110,3,0,MOT,588,891,GRN
0,1,3,18,0.741937345,19,1,it,"('MOT', 'OPE')",Providence,ale32.xml,22,3,0,OPE,203,92,MOT
0,4,20,217,0.706691406,221,4,oh,"('MOT', 'CHI')",Providence,ale32.xml,241,20,0,CHI,2684,1175,MOT
0,10,3,97,0.684014697,107,10,on,"('GRN', 'MOT')",Providence,ale32.xml,110,3,0,MOT,588,891,GRN
1,5,2,22,0.659245629,27,5,the,"('GRN', 'CHI')",Providence,ale32.xml,30,3,1,CHI,129,184,GRN
0,1,2,12,0.628608659,13,1,one,"('OPE', 'MOT')",Providence,ale32.xml,15,2,0,MOT,46,186,OPE
1,6,30,204,0.607315745,210,6,a,"('MOT', 'CHI')",Providence,ale32.xml,241,31,1,CHI,2684,1175,MOT
0,1,1,8,0.606135804,9,1,there,"('CHI', 'OPE')",Providence,ale32.xml,10,1,0,OPE,68,51,CHI
0,11,1,52,0.590868331,63,11,that,"('CHI', 'MOT')",Providence,ale32.xml,64,1,0,MOT,361,720,CHI
0,2,1,12,0.575364145,14,2,get,"('OPE', 'MOT')",Providence,ale32.xml,15,1,0,MOT,46,186,OPE
0,5,7,83,0.510825624,88,5,what,"('MOT', 'GRN')",Providence,ale32.xml,95,7,0,GRN,686,497,MOT
1,1,0,2,0.510825624,3,1,yeah,"('OPE', 'GRN')",Providence,ale32.xml,4,1,1,GRN,13,29,OPE
0,6,19,216,0.421213465,222,6,that,"('MOT', 'CHI')",Providence,ale32.xml,241,19,0,CHI,2684,1175,MOT
0,5,8,82,0.394291808,87,5,a,"('MOT', 'GRN')",Providence,ale32.xml,95,8,0,GRN,686,497,MOT
0,7,6,82,0.351976423,89,7,that,"('MOT', 'GRN')",Providence,ale32.xml,95,6,0,GRN,686,497,MOT
0,1,1,5,0.287682072,6,1,the,"('GRN', 'OPE')",Providence,ale32.xml,7,1,0,OPE,39,27,GRN
1,17,3,43,0.138150338,60,17,it,"('CHI', 'MOT')",Providence,ale32.xml,64,4,1,MOT,361,720,CHI
0,9,7,79,0,88,9,oh,"('MOT', 'GRN')",Providence,ale32.xml,95,7,0,GRN,686,497,MOT
0,3,2,10,-0.064538521,13,3,it,"('OPE', 'MOT')",Providence,ale32.xml,15,2,0,MOT,46,186,OPE
0,3,1,6,-0.087011377,9,3,the,"('OPE', 'CHI')",Providence,ale32.xml,10,1,0,CHI,37,71,OPE
0,1,2,4,-0.133531393,5,1,of,"('GRN', 'OPE')",Providence,ale32.xml,7,2,0,OPE,39,27,GRN
0,2,2,6,-0.182321557,8,2,oh,"('OPE', 'CHI')",Providence,ale32.xml,10,2,0,CHI,37,71,OPE
0,5,16,74,-0.287682072,79,5,the,"('MOT', 'GRN')",Providence,ale32.xml,95,16,0,GRN,686,497,MOT
3,18,21,53,-0.525781715,71,18,you,"('MOT', 'GRN')",Providence,ale32.xml,95,24,3,GRN,686,497,MOT
0,17,11,82,-0.840200599,99,17,yeah,"('GRN', 'MOT')",Providence,ale32.xml,110,11,0,MOT,588,891,GRN
1,26,17,66,-1.055127177,92,26,you,"('GRN', 'MOT')",Providence,ale32.xml,110,18,1,MOT,588,891,GRN
1,0,6,446,4.600715836,446,0,but,"('MOT', 'CHI')",Providence,ale33.xml,453,7,1,CHI,4517,1939,MOT
0,1,2,450,4.036450584,451,1,they,"('MOT', 'CHI')",Providence,ale33.xml,453,2,0,CHI,4517,1939,MOT
0,2,2,449,3.630985476,451,2,at,"('MOT', 'CHI')",Providence,ale33.xml,453,2,0,CHI,4517,1939,MOT
0,2,3,448,3.405631979,450,2,where,"('MOT', 'CHI')",Providence,ale33.xml,453,3,0,CHI,4517,1939,MOT
0,3,2,448,3.343303403,451,3,wanna,"('MOT', 'CHI')",Providence,ale33.xml,453,2,0,CHI,4517,1939,MOT
1,4,6,442,2.991277923,446,4,big,"('MOT', 'CHI')",Providence,ale33.xml,453,7,1,CHI,4517,1939,MOT
1,1,20,431,2.937550318,432,1,not,"('MOT', 'CHI')",Providence,ale33.xml,453,21,1,CHI,4517,1939,MOT
0,1,12,440,2.76136526,441,1,of,"('MOT', 'CHI')",Providence,ale33.xml,453,12,0,CHI,4517,1939,MOT
3,1,47,402,2.745790529,403,1,this,"('MOT', 'CHI')",Providence,ale33.xml,453,50,3,CHI,4517,1939,MOT
0,5,3,445,2.712484798,450,5,did,"('MOT', 'CHI')",Providence,ale33.xml,453,3,0,CHI,4517,1939,MOT
0,2,8,443,2.701361213,445,2,want,"('MOT', 'CHI')",Providence,ale33.xml,453,8,0,CHI,4517,1939,MOT
0,1,13,439,2.6901125,440,1,yeah,"('MOT', 'CHI')",Providence,ale33.xml,453,13,0,CHI,4517,1939,MOT
1,2,18,432,2.627654698,434,2,on,"('MOT', 'CHI')",Providence,ale33.xml,453,19,1,CHI,4517,1939,MOT
1,2,20,430,2.53208521,432,2,do,"('MOT', 'CHI')",Providence,ale33.xml,453,21,1,CHI,4517,1939,MOT
0,3,7,443,2.521274294,446,3,look,"('MOT', 'CHI')",Providence,ale33.xml,453,7,0,CHI,4517,1939,MOT
1,1,31,420,2.521011654,421,1,to,"('MOT', 'CHI')",Providence,ale33.xml,453,32,1,CHI,4517,1939,MOT
0,2,11,440,2.432262916,442,2,gonna,"('MOT', 'CHI')",Providence,ale33.xml,453,11,0,CHI,4517,1939,MOT
2,2,33,416,2.429336799,418,2,what,"('MOT', 'CHI')",Providence,ale33.xml,453,35,2,CHI,4517,1939,MOT
0,2,13,438,2.284647392,440,2,we,"('MOT', 'CHI')",Providence,ale33.xml,453,13,0,CHI,4517,1939,MOT
1,2,39,411,1.885143794,413,2,is,"('MOT', 'CHI')",Providence,ale33.xml,453,40,1,CHI,4517,1939,MOT
1,4,24,424,1.851657611,428,4,put,"('MOT', 'CHI')",Providence,ale33.xml,453,25,1,CHI,4517,1939,MOT
0,3,16,434,1.807833294,437,3,can,"('MOT', 'CHI')",Providence,ale33.xml,453,16,0,CHI,4517,1939,MOT
4,13,22,414,1.699632992,427,13,in,"('MOT', 'CHI')",Providence,ale33.xml,453,26,4,CHI,4517,1939,MOT
1,3,36,413,1.678772606,416,3,and,"('MOT', 'CHI')",Providence,ale33.xml,453,37,1,CHI,4517,1939,MOT
1,10,13,429,1.611708061,439,10,up,"('MOT', 'CHI')",Providence,ale33.xml,453,14,1,CHI,4517,1939,MOT
0,3,20,430,1.598009217,433,3,see,"('MOT', 'CHI')",Providence,ale33.xml,453,20,0,CHI,4517,1939,MOT
2,9,24,418,1.525279604,427,9,go,"('MOT', 'CHI')",Providence,ale33.xml,453,26,2,CHI,4517,1939,MOT
1,5,28,419,1.521839853,424,5,get,"('MOT', 'CHI')",Providence,ale33.xml,453,29,1,CHI,4517,1939,MOT
6,14,38,395,1.427811766,409,14,one,"('MOT', 'CHI')",Providence,ale33.xml,453,44,6,CHI,4517,1939,MOT
8,10,66,369,1.411395339,379,10,a,"('MOT', 'CHI')",Providence,ale33.xml,453,74,8,CHI,4517,1939,MOT
0,10,8,435,1.402078229,445,10,my,"('MOT', 'CHI')",Providence,ale33.xml,453,8,0,CHI,4517,1939,MOT
1,0,0,3,1.203972804,3,0,the,"('MOT', 'FAT')",Providence,ale33.xml,4,1,1,FAT,27,25,MOT
2,14,29,408,0.943787981,422,14,there,"('MOT', 'CHI')",Providence,ale33.xml,453,31,2,CHI,4517,1939,MOT
7,22,50,374,0.852861887,396,22,no,"('MOT', 'CHI')",Providence,ale33.xml,453,57,7,CHI,4517,1939,MOT
0,6,28,419,0.709676483,425,6,oh,"('MOT', 'CHI')",Providence,ale33.xml,453,28,0,CHI,4517,1939,MOT
3,27,36,387,0.371203045,414,27,that,"('MOT', 'CHI')",Providence,ale33.xml,453,39,3,CHI,4517,1939,MOT
6,23,72,352,0.318074871,375,23,it,"('MOT', 'CHI')",Providence,ale33.xml,453,78,6,CHI,4517,1939,MOT
1,5,98,349,0.161197925,354,5,you,"('MOT', 'CHI')",Providence,ale33.xml,453,99,1,CHI,4517,1939,MOT
8,33,81,331,0.06263788,364,33,the,"('MOT', 'CHI')",Providence,ale33.xml,453,89,8,CHI,4517,1939,MOT
0,1,1,2,-0.182321557,3,1,you,"('MOT', 'FAT')",Providence,ale33.xml,4,1,0,FAT,27,25,MOT
1,2,0,233,3.963982744,235,2,think,"('CHI', 'MOT')",Providence,ale34.xml,236,1,1,MOT,1246,1837,CHI
1,1,2,148,3.407841924,149,1,get,"('MOT', 'CHI')",Providence,ale34.xml,152,3,1,CHI,1351,575,MOT
1,0,0,36,3.232121052,36,0,and,"('GRA', 'CHI')",Providence,ale34.xml,37,1,1,CHI,361,142,GRA
1,1,3,147,3.218875825,148,1,no,"('MOT', 'CHI')",Providence,ale34.xml,152,4,1,CHI,1351,575,MOT
2,5,1,228,3.157000421,233,5,all,"('CHI', 'MOT')",Providence,ale34.xml,236,3,2,MOT,1246,1837,CHI
1,3,2,230,3.157000421,233,3,and,"('CHI', 'MOT')",Providence,ale34.xml,236,3,1,MOT,1246,1837,CHI
0,2,2,232,2.978925155,234,2,where,"('CHI', 'MOT')",Providence,ale34.xml,236,2,0,MOT,1246,1837,CHI
0,2,2,232,2.978925155,234,2,big,"('CHI', 'MOT')",Providence,ale34.xml,236,2,0,MOT,1246,1837,CHI
0,1,2,149,2.944438979,150,1,where,"('MOT', 'CHI')",Providence,ale34.xml,152,2,0,CHI,1351,575,MOT
0,4,1,231,2.76000994,235,4,look,"('CHI', 'MOT')",Providence,ale34.xml,236,1,0,MOT,1246,1837,CHI
0,1,3,148,2.714694744,149,1,with,"('MOT', 'CHI')",Providence,ale34.xml,152,3,0,CHI,1351,575,MOT
4,0,5,28,2.612740021,28,0,go,"('GRA', 'CHI')",Providence,ale34.xml,37,9,4,CHI,361,142,GRA
0,5,1,230,2.577688383,235,5,with,"('CHI', 'MOT')",Providence,ale34.xml,236,1,0,MOT,1246,1837,CHI
0,3,1,148,2.545531272,151,3,want,"('MOT', 'CHI')",Providence,ale34.xml,152,1,0,CHI,1351,575,MOT
0,2,2,148,2.538973871,150,2,up,"('MOT', 'CHI')",Providence,ale34.xml,152,2,0,CHI,1351,575,MOT
1,1,9,141,2.48490665,142,1,one,"('MOT', 'CHI')",Providence,ale34.xml,152,10,1,CHI,1351,575,MOT
1,0,3,33,2.456735773,33,0,that,"('GRA', 'CHI')",Providence,ale34.xml,37,4,1,CHI,361,142,GRA
1,0,0,15,2.427748236,15,0,this,"('MOT', 'GRA')",Providence,ale34.xml,16,1,1,GRA,142,127,MOT
1,0,0,15,2.427748236,15,0,is,"('MOT', 'GRA')",Providence,ale34.xml,16,1,1,GRA,142,127,MOT
1,0,0,15,2.427748236,15,0,put,"('MOT', 'GRA')",Providence,ale34.xml,16,1,1,GRA,142,127,MOT
0,1,5,146,2.364888976,147,1,are,"('MOT', 'CHI')",Providence,ale34.xml,152,5,0,CHI,1351,575,MOT
0,7,1,228,2.290006311,235,7,not,"('CHI', 'MOT')",Providence,ale34.xml,236,1,0,MOT,1246,1837,CHI
0,5,2,229,2.285777975,234,5,have,"('CHI', 'MOT')",Providence,ale34.xml,236,2,0,MOT,1246,1837,CHI
1,0,4,32,2.273597556,32,0,see,"('GRA', 'CHI')",Providence,ale34.xml,37,5,1,CHI,361,142,GRA
1,1,1,34,2.224623552,35,1,no,"('GRA', 'CHI')",Providence,ale34.xml,37,2,1,CHI,361,142,GRA
1,0,0,10,2.079441542,10,0,and,"('GRA', 'ENV')",Providence,ale34.xml,11,1,1,ENV,92,50,GRA
1,0,0,10,2.079441542,10,0,do,"('GRA', 'MOT')",Providence,ale34.xml,11,1,1,MOT,107,65,GRA
1,0,1,14,2.079441542,14,0,for,"('MOT', 'GRA')",Providence,ale34.xml,16,2,1,GRA,142,127,MOT
2,15,2,217,1.989585213,232,15,get,"('CHI', 'MOT')",Providence,ale34.xml,236,4,2,MOT,1246,1837,CHI
0,1,8,143,1.987874348,144,1,at,"('MOT', 'CHI')",Providence,ale34.xml,152,8,0,CHI,1351,575,MOT
0,10,1,225,1.97155258,235,10,can,"('CHI', 'MOT')",Providence,ale34.xml,236,1,0,MOT,1246,1837,CHI
0,2,9,225,1.937214442,227,2,my,"('CHI', 'MOT')",Providence,ale34.xml,236,9,0,MOT,1246,1837,CHI
1,3,8,140,1.885691289,143,3,look,"('MOT', 'CHI')",Providence,ale34.xml,152,9,1,CHI,1351,575,MOT
1,3,8,140,1.885691289,143,3,put,"('MOT', 'CHI')",Providence,ale34.xml,152,9,1,CHI,1351,575,MOT
0,4,6,226,1.757857918,230,4,there,"('CHI', 'MOT')",Providence,ale34.xml,236,6,0,MOT,1246,1837,CHI
0,6,4,226,1.717651497,232,6,want,"('CHI', 'MOT')",Providence,ale34.xml,236,4,0,MOT,1246,1837,CHI
1,3,10,138,1.704748092,141,3,in,"('MOT', 'CHI')",Providence,ale34.xml,152,11,1,CHI,1351,575,MOT
1,3,10,138,1.704748092,141,3,to,"('MOT', 'CHI')",Providence,ale34.xml,152,11,1,CHI,1351,575,MOT
0,1,1,30,1.704748092,31,1,but,"('CHI', 'GRA')",Providence,ale34.xml,32,1,0,GRA,128,302,CHI
0,1,1,30,1.704748092,31,1,is,"('CHI', 'GRA')",Providence,ale34.xml,32,1,0,GRA,128,302,CHI
0,4,4,144,1.609437912,148,4,go,"('MOT', 'CHI')",Providence,ale34.xml,152,4,0,CHI,1351,575,MOT
0,11,2,223,1.592630794,234,11,do,"('CHI', 'MOT')",Providence,ale34.xml,236,2,0,MOT,1246,1837,CHI
0,7,4,225,1.584120104,232,7,in,"('CHI', 'MOT')",Providence,ale34.xml,236,4,0,MOT,1246,1837,CHI
1,4,9,138,1.568615918,142,4,oh,"('MOT', 'CHI')",Providence,ale34.xml,152,10,1,CHI,1351,575,MOT
0,5,7,224,1.453433664,229,5,up,"('CHI', 'MOT')",Providence,ale34.xml,236,7,0,MOT,1246,1837,CHI
0,2,1,34,1.440361582,36,2,my,"('GRA', 'CHI')",Providence,ale34.xml,37,1,0,CHI,361,142,GRA
0,18,1,217,1.425008873,235,18,to,"('CHI', 'MOT')",Providence,ale34.xml,236,1,0,MOT,1246,1837,CHI
1,3,14,134,1.408113409,137,3,and,"('MOT', 'CHI')",Providence,ale34.xml,152,15,1,CHI,1351,575,MOT
0,11,3,222,1.365240952,233,11,what,"('CHI', 'MOT')",Providence,ale34.xml,236,3,0,MOT,1246,1837,CHI
0,15,2,219,1.304948722,234,15,are,"('CHI', 'MOT')",Providence,ale34.xml,236,2,0,MOT,1246,1837,CHI
1,22,3,210,1.221214611,232,22,it,"('CHI', 'MOT')",Providence,ale34.xml,236,4,1,MOT,1246,1837,CHI
2,29,3,202,1.202543212,231,29,a,"('CHI', 'MOT')",Providence,ale34.xml,236,5,2,MOT,1246,1837,CHI
0,11,4,221,1.178654996,232,11,is,"('CHI', 'MOT')",Providence,ale34.xml,236,4,0,MOT,1246,1837,CHI
0,1,3,28,1.131402111,29,1,that,"('CHI', 'GRA')",Providence,ale34.xml,32,3,0,GRA,128,302,CHI
1,1,2,12,1.098612289,13,1,a,"('MOT', 'GRA')",Providence,ale34.xml,16,3,1,GRA,142,127,MOT
0,1,4,32,1.070441412,33,1,there,"('GRA', 'CHI')",Providence,ale34.xml,37,4,0,CHI,361,142,GRA
0,1,1,14,1.041453875,15,1,gonna,"('MOT', 'GRA')",Providence,ale34.xml,16,1,0,GRA,142,127,MOT
0,1,1,14,1.041453875,15,1,we,"('MOT', 'GRA')",Providence,ale34.xml,16,1,0,GRA,142,127,MOT
1,2,27,122,1.029619417,124,2,a,"('MOT', 'CHI')",Providence,ale34.xml,152,28,1,CHI,1351,575,MOT
1,1,8,27,1.003302109,28,1,you,"('GRA', 'CHI')",Providence,ale34.xml,37,9,1,CHI,361,142,GRA
2,9,20,205,0.993251773,214,9,no,"('CHI', 'MOT')",Providence,ale34.xml,236,22,2,MOT,1246,1837,CHI
2,6,1,23,0.977251432,29,6,you,"('CHI', 'GRA')",Providence,ale34.xml,32,3,2,GRA,128,302,CHI
0,10,6,220,0.969400557,230,10,oh,"('CHI', 'MOT')",Providence,ale34.xml,236,6,0,MOT,1246,1837,CHI
0,10,6,220,0.969400557,230,10,go,"('CHI', 'MOT')",Providence,ale34.xml,236,6,0,MOT,1246,1837,CHI
0,4,9,139,0.969400557,143,4,on,"('MOT', 'CHI')",Providence,ale34.xml,152,9,0,CHI,1351,575,MOT
0,2,16,134,0.938269639,136,2,is,"('MOT', 'CHI')",Providence,ale34.xml,152,16,0,CHI,1351,575,MOT
1,16,8,211,0.895760567,227,16,that,"('CHI', 'MOT')",Providence,ale34.xml,236,9,1,MOT,1246,1837,CHI
6,62,3,165,0.838602153,227,62,you,"('CHI', 'MOT')",Providence,ale34.xml,236,9,6,MOT,1246,1837,CHI
0,1,6,30,0.723918839,31,1,in,"('GRA', 'CHI')",Providence,ale34.xml,37,6,0,CHI,361,142,GRA
0,1,1,9,0.693147181,10,1,you,"('GRA', 'ENV')",Providence,ale34.xml,11,1,0,ENV,92,50,GRA
0,1,1,9,0.693147181,10,1,oh,"('GRA', 'MOT')",Providence,ale34.xml,11,1,0,MOT,107,65,GRA
0,1,2,13,0.693147181,14,1,in,"('MOT', 'GRA')",Providence,ale34.xml,16,2,0,GRA,142,127,MOT
0,1,2,13,0.693147181,14,1,it,"('MOT', 'GRA')",Providence,ale34.xml,16,2,0,GRA,142,127,MOT
0,1,2,13,0.693147181,14,1,at,"('MOT', 'GRA')",Providence,ale34.xml,16,2,0,GRA,142,127,MOT
0,1,2,13,0.693147181,14,1,that,"('MOT', 'GRA')",Providence,ale34.xml,16,2,0,GRA,142,127,MOT
0,2,4,26,0.510825624,28,2,no,"('CHI', 'GRA')",Providence,ale34.xml,32,4,0,GRA,128,302,CHI
1,1,3,6,0.405465108,7,1,it,"('GRA', 'MOT')",Providence,ale34.xml,11,4,1,MOT,107,65,GRA
0,1,3,12,0.405465108,13,1,to,"('MOT', 'GRA')",Providence,ale34.xml,16,3,0,GRA,142,127,MOT
0,7,1,24,0.318453731,31,7,and,"('CHI', 'GRA')",Providence,ale34.xml,32,1,0,GRA,128,302,CHI
0,18,7,211,0.300754154,229,18,one,"('CHI', 'MOT')",Providence,ale34.xml,236,7,0,MOT,1246,1837,CHI
0,6,13,133,0.29479954,139,6,it,"('MOT', 'CHI')",Providence,ale34.xml,152,13,0,CHI,1351,575,MOT
0,2,2,12,0.287682072,14,2,go,"('MOT', 'GRA')",Providence,ale34.xml,16,2,0,GRA,142,127,MOT
0,2,1,8,0.287682072,10,2,you,"('GRA', 'MOT')",Providence,ale34.xml,11,1,0,MOT,107,65,GRA
3,8,37,104,0.187598614,112,8,the,"('MOT', 'CHI')",Providence,ale34.xml,152,40,3,CHI,1351,575,MOT
2,17,26,191,0.15415068,208,17,this,"('CHI', 'MOT')",Providence,ale34.xml,236,28,2,MOT,1246,1837,CHI
0,5,20,127,0.015037877,132,5,that,"('MOT', 'CHI')",Providence,ale34.xml,152,20,0,CHI,1351,575,MOT
0,3,2,11,0,14,3,and,"('MOT', 'GRA')",Providence,ale34.xml,16,2,0,GRA,142,127,MOT
0,2,4,10,-0.251314428,12,2,you,"('MOT', 'GRA')",Providence,ale34.xml,16,4,0,GRA,142,127,MOT
1,34,8,109,-0.283362411,143,34,this,"('MOT', 'CHI')",Providence,ale34.xml,152,9,1,CHI,1351,575,MOT
0,7,30,115,-0.724895879,122,7,you,"('MOT', 'CHI')",Providence,ale34.xml,152,30,0,CHI,1351,575,MOT
0,44,9,183,-0.770835759,227,44,the,"('CHI', 'MOT')",Providence,ale34.xml,236,9,0,MOT,1246,1837,CHI
0,3,6,7,-0.980829253,10,3,the,"('MOT', 'GRA')",Providence,ale34.xml,16,6,0,GRA,142,127,MOT
1,0,3,90,3.423176288,90,0,one,"('CHI', 'ENV')",Providence,ale35.xml,94,4,1,ENV,329,240,CHI
1,0,5,92,3.157000421,92,0,is,"('MOT', 'CHI')",Providence,ale35.xml,98,6,1,CHI,711,334,MOT
0,1,1,127,3.075774981,128,1,all,"('CHI', 'MOT')",Providence,ale35.xml,129,1,0,MOT,590,960,CHI
1,2,1,125,3.068052935,127,2,go,"('CHI', 'MOT')",Providence,ale35.xml,129,2,1,MOT,590,960,CHI
1,4,0,124,2.85263143,128,4,put,"('CHI', 'MOT')",Providence,ale35.xml,129,1,1,MOT,590,960,CHI
1,0,8,89,2.806111414,89,0,on,"('MOT', 'CHI')",Providence,ale35.xml,98,9,1,CHI,711,334,MOT
0,1,1,96,2.803360381,97,1,some,"('MOT', 'CHI')",Providence,ale35.xml,98,1,0,CHI,711,334,MOT
1,0,0,22,2.772588722,22,0,they,"('MOT', 'GRA')",Providence,ale35.xml,23,1,1,GRA,165,166,MOT
0,1,1,92,2.762117422,93,1,in,"('CHI', 'ENV')",Providence,ale35.xml,94,1,0,ENV,329,240,CHI
0,1,1,92,2.762117422,93,1,and,"('CHI', 'ENV')",Providence,ale35.xml,94,1,0,ENV,329,240,CHI
0,1,1,90,2.740840024,91,1,in,"('ENV', 'CHI')",Providence,ale35.xml,92,1,0,CHI,296,349,ENV
0,1,1,90,2.740840024,91,1,up,"('ENV', 'CHI')",Providence,ale35.xml,92,1,0,CHI,296,349,ENV
0,2,1,126,2.670309873,128,2,want,"('CHI', 'MOT')",Providence,ale35.xml,129,1,0,MOT,590,960,CHI
0,2,1,126,2.670309873,128,2,with,"('CHI', 'MOT')",Providence,ale35.xml,129,1,0,MOT,590,960,CHI
1,0,11,86,2.531426665,86,0,the,"('MOT', 'CHI')",Providence,ale35.xml,98,12,1,CHI,711,334,MOT
0,1,2,95,2.505525937,96,1,with,"('MOT', 'CHI')",Providence,ale35.xml,98,2,0,CHI,711,334,MOT
0,1,2,89,2.442347035,90,1,you,"('ENV', 'CHI')",Providence,ale35.xml,92,2,0,CHI,296,349,ENV
0,1,2,89,2.442347035,90,1,of,"('ENV', 'CHI')",Providence,ale35.xml,92,2,0,CHI,296,349,ENV
0,2,1,95,2.397895273,97,2,there,"('MOT', 'CHI')",Providence,ale35.xml,98,1,0,CHI,711,334,MOT
0,2,1,95,2.397895273,97,2,one,"('MOT', 'CHI')",Providence,ale35.xml,98,1,0,CHI,711,334,MOT
0,3,1,125,2.382627801,128,3,is,"('CHI', 'MOT')",Providence,ale35.xml,129,1,0,MOT,590,960,CHI
0,2,2,125,2.374905755,127,2,we,"('CHI', 'MOT')",Providence,ale35.xml,129,2,0,MOT,590,960,CHI
0,2,2,125,2.374905755,127,2,this,"('CHI', 'MOT')",Providence,ale35.xml,129,2,0,MOT,590,960,CHI
1,0,0,13,2.302585093,13,0,no,"('CHI', 'GRA')",Providence,ale35.xml,14,1,1,GRA,41,78,CHI
0,1,3,90,2.2300144,91,1,the,"('CHI', 'ENV')",Providence,ale35.xml,94,3,0,ENV,329,240,CHI
1,6,1,121,2.220755075,127,6,on,"('CHI', 'MOT')",Providence,ale35.xml,129,2,1,MOT,590,960,CHI
0,2,2,94,2.100060829,96,2,get,"('MOT', 'CHI')",Providence,ale35.xml,98,2,0,CHI,711,334,MOT
0,3,2,124,2.087223682,127,3,big,"('CHI', 'MOT')",Providence,ale35.xml,129,2,0,MOT,590,960,CHI
0,1,4,93,2.079441542,94,1,for,"('MOT', 'CHI')",Providence,ale35.xml,98,4,0,CHI,711,334,MOT
1,1,0,21,2.079441542,22,1,did,"('GRA', 'MOT')",Providence,ale35.xml,23,1,1,MOT,161,277,GRA
0,3,1,88,2.047692843,91,3,for,"('ENV', 'CHI')",Providence,ale35.xml,92,1,0,CHI,296,349,ENV
1,7,0,84,2.047692843,91,7,that,"('ENV', 'CHI')",Providence,ale35.xml,92,1,1,CHI,296,349,ENV
0,2,2,88,2.036881927,90,2,with,"('ENV', 'CHI')",Providence,ale35.xml,92,2,0,CHI,296,349,ENV
0,1,4,87,2.014903021,88,1,and,"('ENV', 'CHI')",Providence,ale35.xml,92,4,0,CHI,296,349,ENV
1,6,0,67,1.966112856,73,6,the,"('ENV', 'MOT')",Providence,ale35.xml,74,1,1,MOT,160,512,ENV
0,1,5,92,1.914819562,93,1,no,"('MOT', 'CHI')",Providence,ale35.xml,98,5,0,CHI,711,334,MOT
0,4,1,93,1.887069649,97,4,look,"('MOT', 'CHI')",Providence,ale35.xml,98,1,0,CHI,711,334,MOT
0,4,1,93,1.887069649,97,4,my,"('MOT', 'CHI')",Providence,ale35.xml,98,1,0,CHI,711,334,MOT
0,3,3,123,1.85629799,126,3,one,"('CHI', 'MOT')",Providence,ale35.xml,129,3,0,MOT,590,960,CHI
0,3,1,70,1.832581464,73,3,with,"('ENV', 'MOT')",Providence,ale35.xml,74,1,0,MOT,160,512,ENV
3,17,0,109,1.738514955,126,17,it,"('CHI', 'MOT')",Providence,ale35.xml,129,3,3,MOT,590,960,CHI
0,7,1,121,1.68948062,128,7,and,"('CHI', 'MOT')",Providence,ale35.xml,129,1,0,MOT,590,960,CHI
1,2,0,20,1.673976434,22,2,and,"('GRA', 'MOT')",Providence,ale35.xml,23,1,1,MOT,161,277,GRA
1,7,3,118,1.666133256,125,7,no,"('CHI', 'MOT')",Providence,ale35.xml,129,4,1,MOT,590,960,CHI
0,5,1,86,1.642227735,91,5,it,"('ENV', 'CHI')",Providence,ale35.xml,92,1,0,CHI,296,349,ENV
0,1,7,90,1.642227735,91,1,go,"('MOT', 'CHI')",Providence,ale35.xml,98,7,0,CHI,711,334,MOT
0,3,3,92,1.578978705,95,3,at,"('MOT', 'CHI')",Providence,ale35.xml,98,3,0,CHI,711,334,MOT
0,3,5,121,1.504077397,124,3,look,"('CHI', 'MOT')",Providence,ale35.xml,129,5,0,MOT,590,960,CHI
1,1,2,19,1.481604541,20,1,a,"('MOT', 'GRA')",Providence,ale35.xml,23,3,1,GRA,165,166,MOT
0,5,1,68,1.427116356,73,5,and,"('ENV', 'MOT')",Providence,ale35.xml,74,1,0,MOT,160,512,ENV
0,3,4,91,1.386294361,94,3,this,"('MOT', 'CHI')",Providence,ale35.xml,98,4,0,CHI,711,334,MOT
0,1,1,21,1.386294361,22,1,can,"('GRA', 'MOT')",Providence,ale35.xml,23,1,0,MOT,161,277,GRA
0,1,1,21,1.386294361,22,1,gonna,"('MOT', 'GRA')",Providence,ale35.xml,23,1,0,GRA,165,166,MOT
0,1,1,21,1.386294361,22,1,in,"('MOT', 'GRA')",Providence,ale35.xml,23,1,0,GRA,165,166,MOT
0,1,1,21,1.386294361,22,1,of,"('MOT', 'GRA')",Providence,ale35.xml,23,1,0,GRA,165,166,MOT
0,1,1,21,1.386294361,22,1,are,"('MOT', 'GRA')",Providence,ale35.xml,23,1,0,GRA,165,166,MOT
0,1,9,84,1.374865665,85,1,a,"('CHI', 'ENV')",Providence,ale35.xml,94,9,0,ENV,329,240,CHI
2,11,4,112,1.362577835,123,11,the,"('CHI', 'MOT')",Providence,ale35.xml,129,6,2,MOT,590,960,CHI
0,4,3,91,1.355835154,95,4,big,"('MOT', 'CHI')",Providence,ale35.xml,98,3,0,CHI,711,334,MOT
1,2,1,19,1.343734747,21,2,in,"('GRA', 'MOT')",Providence,ale35.xml,23,2,1,MOT,161,277,GRA
0,6,3,120,1.296682202,126,6,oh,"('CHI', 'MOT')",Providence,ale35.xml,129,3,0,MOT,590,960,CHI
0,4,3,85,1.291983682,89,4,the,"('ENV', 'CHI')",Providence,ale35.xml,92,3,0,CHI,296,349,ENV
0,6,1,67,1.272965676,73,6,oh,"('ENV', 'MOT')",Providence,ale35.xml,74,1,0,MOT,160,512,ENV
0,2,7,89,1.236762627,91,2,oh,"('MOT', 'CHI')",Providence,ale35.xml,98,7,0,CHI,711,334,MOT
0,2,7,89,1.236762627,91,2,it,"('MOT', 'CHI')",Providence,ale35.xml,98,7,0,CHI,711,334,MOT
0,1,7,58,1.220502106,59,1,the,"('MOT', 'ENV')",Providence,ale35.xml,66,7,0,ENV,373,145,MOT
4,19,4,102,1.123304901,121,19,a,"('CHI', 'MOT')",Providence,ale35.xml,129,8,4,MOT,590,960,CHI
0,1,1,15,1.098612289,16,1,a,"('GRA', 'CHI')",Providence,ale35.xml,17,1,0,CHI,145,54,GRA
0,1,1,15,1.098612289,16,1,that,"('GRA', 'CHI')",Providence,ale35.xml,17,1,0,CHI,145,54,GRA
0,5,5,119,1.098612289,124,5,to,"('CHI', 'MOT')",Providence,ale35.xml,129,5,0,MOT,590,960,CHI
1,2,2,18,1.076139433,20,2,that,"('GRA', 'MOT')",Providence,ale35.xml,23,3,1,MOT,161,277,GRA
1,2,2,18,1.076139433,20,2,oh,"('MOT', 'GRA')",Providence,ale35.xml,23,3,1,GRA,165,166,MOT
0,10,2,117,1.07562277,127,10,in,"('CHI', 'MOT')",Providence,ale35.xml,129,2,0,MOT,590,960,CHI
1,3,1,18,1.056052674,21,3,the,"('MOT', 'GRA')",Providence,ale35.xml,23,2,1,GRA,165,166,MOT
0,1,2,20,1.056052674,21,1,is,"('GRA', 'MOT')",Providence,ale35.xml,23,2,0,MOT,161,277,GRA
0,1,2,20,1.056052674,21,1,yeah,"('MOT', 'GRA')",Providence,ale35.xml,23,2,0,GRA,165,166,MOT
0,2,1,20,0.980829253,22,2,a,"('GRA', 'MOT')",Providence,ale35.xml,23,1,0,MOT,161,277,GRA
0,1,1,12,0.916290732,13,1,the,"('CHI', 'GRA')",Providence,ale35.xml,14,1,0,GRA,41,78,CHI
0,1,1,12,0.916290732,13,1,on,"('CHI', 'GRA')",Providence,ale35.xml,14,1,0,GRA,41,78,CHI
0,9,2,81,0.832909123,90,9,a,"('ENV', 'CHI')",Providence,ale35.xml,92,2,0,CHI,296,349,ENV
0,1,3,19,0.78845736,20,1,go,"('GRA', 'MOT')",Providence,ale35.xml,23,3,0,MOT,161,277,GRA
0,1,3,19,0.78845736,20,1,it,"('MOT', 'GRA')",Providence,ale35.xml,23,3,0,GRA,165,166,MOT
1,3,2,17,0.78845736,20,3,this,"('MOT', 'GRA')",Providence,ale35.xml,23,3,1,GRA,165,166,MOT
0,1,2,14,0.753771802,15,1,no,"('GRA', 'CHI')",Providence,ale35.xml,17,2,0,CHI,145,54,GRA
0,3,1,19,0.693147181,22,3,get,"('GRA', 'MOT')",Providence,ale35.xml,23,1,0,MOT,161,277,GRA
0,3,1,19,0.693147181,22,3,he,"('GRA', 'MOT')",Providence,ale35.xml,23,1,0,MOT,161,277,GRA
0,12,1,61,0.653926467,73,12,a,"('ENV', 'MOT')",Providence,ale35.xml,74,1,0,MOT,160,512,ENV
0,2,2,19,0.650587566,21,2,no,"('GRA', 'MOT')",Providence,ale35.xml,23,2,0,MOT,161,277,GRA
0,2,2,19,0.650587566,21,2,put,"('GRA', 'MOT')",Providence,ale35.xml,23,2,0,MOT,161,277,GRA
0,2,2,19,0.650587566,21,2,on,"('GRA', 'MOT')",Providence,ale35.xml,23,2,0,MOT,161,277,GRA
0,11,4,114,0.567520967,125,11,that,"('CHI', 'MOT')",Providence,ale35.xml,129,4,0,MOT,590,960,CHI
0,1,3,13,0.470003629,14,1,on,"('GRA', 'CHI')",Providence,ale35.xml,17,3,0,CHI,145,54,GRA
0,4,1,18,0.470003629,22,4,what,"('MOT', 'GRA')",Providence,ale35.xml,23,1,0,GRA,165,166,MOT
0,2,3,18,0.382992252,20,2,what,"('GRA', 'MOT')",Providence,ale35.xml,23,3,0,MOT,161,277,GRA
0,2,3,18,0.382992252,20,2,do,"('GRA', 'MOT')",Providence,ale35.xml,23,3,0,MOT,161,277,GRA
0,3,2,18,0.362905494,21,3,the,"('GRA', 'MOT')",Providence,ale35.xml,23,2,0,MOT,161,277,GRA
0,3,2,18,0.362905494,21,3,to,"('GRA', 'MOT')",Providence,ale35.xml,23,2,0,MOT,161,277,GRA
0,3,2,18,0.362905494,21,3,no,"('MOT', 'GRA')",Providence,ale35.xml,23,2,0,GRA,165,166,MOT
0,17,1,56,0.328504067,73,17,you,"('ENV', 'MOT')",Providence,ale35.xml,74,1,0,MOT,160,512,ENV
1,2,6,14,0.287682072,16,2,you,"('MOT', 'GRA')",Providence,ale35.xml,23,7,1,GRA,165,166,MOT
0,8,6,84,0.266628663,92,8,that,"('MOT', 'CHI')",Providence,ale35.xml,98,6,0,CHI,711,334,MOT
2,5,4,12,0.171850257,17,5,you,"('GRA', 'MOT')",Providence,ale35.xml,23,6,2,MOT,161,277,GRA
0,2,4,17,0.15415068,19,2,that,"('MOT', 'GRA')",Providence,ale35.xml,23,4,0,GRA,165,166,MOT
0,4,2,17,0.139761942,21,4,oh,"('GRA', 'MOT')",Providence,ale35.xml,23,2,0,MOT,161,277,GRA
1,8,2,12,-0.022472856,20,8,it,"('GRA', 'MOT')",Providence,ale35.xml,23,3,1,MOT,161,277,GRA
0,8,11,79,-0.273537565,87,8,a,"('MOT', 'CHI')",Providence,ale35.xml,98,11,0,CHI,711,334,MOT
0,3,5,15,-0.336472237,18,3,this,"('GRA', 'MOT')",Providence,ale35.xml,23,5,0,MOT,161,277,GRA
0,31,4,94,-0.413308286,125,31,you,"('CHI', 'MOT')",Providence,ale35.xml,129,4,0,MOT,590,960,CHI
1,0,4,463,4.889274437,463,0,did,"('MOT', 'CHI')",Providence,ale36.xml,468,5,1,CHI,4503,2193,MOT
1,0,19,448,3.71135231,448,0,some,"('MOT', 'CHI')",Providence,ale36.xml,468,20,1,CHI,4503,2193,MOT
2,2,15,449,3.171453146,451,2,look,"('MOT', 'CHI')",Providence,ale36.xml,468,17,2,CHI,4503,2193,MOT
0,1,9,458,3.04235559,459,1,of,"('MOT', 'CHI')",Providence,ale36.xml,468,9,0,CHI,4503,2193,MOT
0,1,10,457,2.953172659,458,1,yeah,"('MOT', 'CHI')",Providence,ale36.xml,468,10,0,CHI,4503,2193,MOT
0,1,13,454,2.723486009,455,1,what,"('MOT', 'CHI')",Providence,ale36.xml,468,13,0,CHI,4503,2193,MOT
0,1,13,454,2.723486009,455,1,at,"('MOT', 'CHI')",Providence,ale36.xml,468,13,0,CHI,4503,2193,MOT
0,1,14,453,2.656756907,454,1,all,"('MOT', 'CHI')",Providence,ale36.xml,468,14,0,CHI,4503,2193,MOT
0,3,7,458,2.554208116,461,3,up,"('MOT', 'CHI')",Providence,ale36.xml,468,7,0,CHI,4503,2193,MOT
1,3,16,448,2.478305966,451,3,have,"('MOT', 'CHI')",Providence,ale36.xml,468,17,1,CHI,4503,2193,MOT
0,7,3,458,2.457449804,465,7,my,"('MOT', 'CHI')",Providence,ale36.xml,468,3,0,CHI,4503,2193,MOT
0,1,18,449,2.424802726,450,1,is,"('MOT', 'CHI')",Providence,ale36.xml,468,18,0,CHI,4503,2193,MOT
0,1,20,447,2.325057949,448,1,not,"('MOT', 'CHI')",Providence,ale36.xml,468,20,0,CHI,4503,2193,MOT
0,2,14,452,2.251291799,454,2,do,"('MOT', 'CHI')",Providence,ale36.xml,468,14,0,CHI,4503,2193,MOT
0,1,22,445,2.233592222,446,1,can,"('MOT', 'CHI')",Providence,ale36.xml,468,22,0,CHI,4503,2193,MOT
0,2,16,450,2.129113151,452,2,for,"('MOT', 'CHI')",Providence,ale36.xml,468,16,0,CHI,4503,2193,MOT
1,10,7,450,2.128231706,460,10,big,"('MOT', 'CHI')",Providence,ale36.xml,468,8,1,CHI,4503,2193,MOT
0,5,10,453,1.85456037,458,5,where,"('MOT', 'CHI')",Providence,ale36.xml,468,10,0,CHI,4503,2193,MOT
0,1,1,34,1.819158443,35,1,in,"('CHI', 'MOT')",Providence,ale36.xml,36,1,0,MOT,152,280,CHI
0,1,1,34,1.819158443,35,1,it,"('CHI', 'MOT')",Providence,ale36.xml,36,1,0,MOT,152,280,CHI
0,1,1,34,1.819158443,35,1,at,"('CHI', 'MOT')",Providence,ale36.xml,36,1,0,MOT,152,280,CHI
1,6,18,443,1.814181933,449,6,go,"('MOT', 'CHI')",Providence,ale36.xml,468,19,1,CHI,4503,2193,MOT
3,11,20,434,1.785070481,445,11,on,"('MOT', 'CHI')",Providence,ale36.xml,468,23,3,CHI,4503,2193,MOT
3,15,16,434,1.680650541,449,15,get,"('MOT', 'CHI')",Providence,ale36.xml,468,19,3,CHI,4503,2193,MOT
1,0,0,6,1.673976434,6,0,go,"('MOT', 'OPE')",Providence,ale36.xml,7,1,1,OPE,42,42,MOT
3,12,22,431,1.62358242,443,12,in,"('MOT', 'CHI')",Providence,ale36.xml,468,25,3,CHI,4503,2193,MOT
0,6,13,449,1.470723041,455,6,are,"('MOT', 'CHI')",Providence,ale36.xml,468,13,0,CHI,4503,2193,MOT
0,2,1,33,1.413693335,35,2,oh,"('CHI', 'MOT')",Providence,ale36.xml,36,1,0,MOT,152,280,CHI
0,2,1,33,1.413693335,35,2,go,"('CHI', 'MOT')",Providence,ale36.xml,36,1,0,MOT,152,280,CHI
0,2,1,33,1.413693335,35,2,this,"('CHI', 'MOT')",Providence,ale36.xml,36,1,0,MOT,152,280,CHI
1,5,0,30,1.413693335,35,5,see,"('CHI', 'MOT')",Providence,ale36.xml,36,1,1,MOT,152,280,CHI
0,2,1,33,1.413693335,35,2,the,"('CHI', 'MOT')",Providence,ale36.xml,36,1,0,MOT,152,280,CHI
3,12,32,421,1.285773122,433,12,and,"('MOT', 'CHI')",Providence,ale36.xml,468,35,3,CHI,4503,2193,MOT
0,3,1,32,1.126011263,35,3,one,"('CHI', 'MOT')",Providence,ale36.xml,36,1,0,MOT,152,280,CHI
1,1,114,352,1.109943855,353,1,you,"('MOT', 'CHI')",Providence,ale36.xml,468,115,1,CHI,4503,2193,MOT
0,3,36,429,1.049164013,432,3,that,"('MOT', 'CHI')",Providence,ale36.xml,468,36,0,CHI,4503,2193,MOT
2,14,29,423,0.978553939,437,14,put,"('MOT', 'CHI')",Providence,ale36.xml,468,31,2,CHI,4503,2193,MOT
14,29,67,358,0.851591555,387,29,the,"('MOT', 'CHI')",Providence,ale36.xml,468,81,14,CHI,4503,2193,MOT
2,11,46,409,0.746687947,420,11,oh,"('MOT', 'CHI')",Providence,ale36.xml,468,48,2,CHI,4503,2193,MOT
0,5,1,30,0.720546155,35,5,look,"('CHI', 'MOT')",Providence,ale36.xml,36,1,0,MOT,152,280,CHI
6,28,42,392,0.711596628,420,28,one,"('MOT', 'CHI')",Providence,ale36.xml,468,48,6,CHI,4503,2193,MOT
1,28,14,425,0.612935425,453,28,there,"('MOT', 'CHI')",Providence,ale36.xml,468,15,1,CHI,4503,2193,MOT
0,4,51,413,0.458141094,417,4,to,"('MOT', 'CHI')",Providence,ale36.xml,468,51,0,CHI,4503,2193,MOT
2,0,2,1,0.405465108,1,0,the,"('OPE', 'CHI')",Providence,ale36.xml,5,4,2,CHI,54,35,OPE
3,27,40,398,0.304211374,425,27,it,"('MOT', 'CHI')",Providence,ale36.xml,468,43,3,CHI,4503,2193,MOT
0,1,1,5,0.287682072,6,1,oh,"('MOT', 'OPE')",Providence,ale36.xml,7,1,0,OPE,42,42,MOT
3,12,93,360,0.160633322,372,12,a,"('MOT', 'CHI')",Providence,ale36.xml,468,96,3,CHI,4503,2193,MOT
2,24,40,402,0.154670025,426,24,this,"('MOT', 'CHI')",Providence,ale36.xml,468,42,2,CHI,4503,2193,MOT
0,1,1,3,0,4,1,go,"('OPE', 'CHI')",Providence,ale36.xml,5,1,0,CHI,54,35,OPE
0,1,1,3,0,4,1,in,"('OPE', 'CHI')",Providence,ale36.xml,5,1,0,CHI,54,35,OPE
0,1,1,3,0,4,1,where,"('OPE', 'CHI')",Providence,ale36.xml,5,1,0,CHI,54,35,OPE
0,1,1,3,0,4,1,put,"('OPE', 'MOT')",Providence,ale36.xml,5,1,0,MOT,26,26,OPE
0,1,1,3,0,4,1,on,"('OPE', 'MOT')",Providence,ale36.xml,5,1,0,MOT,26,26,OPE
0,1,2,4,-0.133531393,5,1,the,"('MOT', 'OPE')",Providence,ale36.xml,7,2,0,OPE,42,42,MOT
3,37,47,381,-0.162280806,418,37,no,"('MOT', 'CHI')",Providence,ale36.xml,468,50,3,CHI,4503,2193,MOT
0,2,1,2,-0.405465108,4,2,it,"('OPE', 'MOT')",Providence,ale36.xml,5,1,0,MOT,26,26,OPE
0,1,2,2,-0.470003629,3,1,you,"('OPE', 'CHI')",Providence,ale36.xml,5,2,0,CHI,54,35,OPE
0,1,2,2,-0.470003629,3,1,go,"('OPE', 'MOT')",Providence,ale36.xml,5,2,0,MOT,26,26,OPE
1,0,3,303,4.621699488,303,0,little,"('MOT', 'CHI')",Providence,ale37.xml,307,4,1,CHI,1955,1637,MOT
1,1,4,301,3.771117552,302,1,up,"('MOT', 'CHI')",Providence,ale37.xml,307,5,1,CHI,1955,1637,MOT
1,0,12,294,3.675456434,294,0,like,"('MOT', 'CHI')",Providence,ale37.xml,307,13,1,CHI,1955,1637,MOT
0,1,2,304,3.647406206,305,1,with,"('MOT', 'CHI')",Providence,ale37.xml,307,2,0,CHI,1955,1637,MOT
0,1,2,304,3.647406206,305,1,did,"('MOT', 'CHI')",Providence,ale37.xml,307,2,0,CHI,1955,1637,MOT
0,1,2,304,3.647406206,305,1,at,"('MOT', 'CHI')",Providence,ale37.xml,307,2,0,CHI,1955,1637,MOT
1,2,0,149,3.526360525,151,2,all,"('CHI', 'MOT')",Providence,ale37.xml,152,1,1,MOT,791,1186,CHI
0,1,1,150,3.238678452,151,1,gonna,"('CHI', 'MOT')",Providence,ale37.xml,152,1,0,MOT,791,1186,CHI
0,1,1,150,3.238678452,151,1,make,"('CHI', 'MOT')",Providence,ale37.xml,152,1,0,MOT,791,1186,CHI
0,1,1,150,3.238678452,151,1,wanna,"('CHI', 'MOT')",Providence,ale37.xml,152,1,0,MOT,791,1186,CHI
0,1,1,150,3.238678452,151,1,he,"('CHI', 'MOT')",Providence,ale37.xml,152,1,0,MOT,791,1186,CHI
1,1,10,295,3.132144129,296,1,my,"('MOT', 'CHI')",Providence,ale37.xml,307,11,1,CHI,1955,1637,MOT
0,1,5,301,3.077970372,302,1,yeah,"('MOT', 'CHI')",Providence,ale37.xml,307,5,0,CHI,1955,1637,MOT
0,2,3,302,3.015534901,304,2,for,"('MOT', 'CHI')",Providence,ale37.xml,307,3,0,CHI,1955,1637,MOT
1,3,1,147,2.944438979,150,3,in,"('CHI', 'MOT')",Providence,ale37.xml,152,2,1,MOT,791,1186,CHI
1,3,1,147,2.944438979,150,3,with,"('CHI', 'MOT')",Providence,ale37.xml,152,2,1,MOT,791,1186,CHI
1,3,1,147,2.944438979,150,3,did,"('CHI', 'MOT')",Providence,ale37.xml,152,2,1,MOT,791,1186,CHI
0,1,2,149,2.944438979,150,1,big,"('CHI', 'MOT')",Providence,ale37.xml,152,2,0,MOT,791,1186,CHI
0,1,6,300,2.941144083,301,1,get,"('MOT', 'CHI')",Providence,ale37.xml,307,6,0,CHI,1955,1637,MOT
0,2,1,149,2.833213344,151,2,at,"('CHI', 'MOT')",Providence,ale37.xml,152,1,0,MOT,791,1186,CHI
4,8,4,291,2.816738507,299,8,there,"('MOT', 'CHI')",Providence,ale37.xml,307,8,4,CHI,1955,1637,MOT
0,3,3,301,2.727852828,304,3,wanna,"('MOT', 'CHI')",Providence,ale37.xml,307,3,0,CHI,1955,1637,MOT
1,4,1,146,2.721295428,150,4,up,"('CHI', 'MOT')",Providence,ale37.xml,152,2,1,MOT,791,1186,CHI
1,4,5,297,2.718000532,301,4,in,"('MOT', 'CHI')",Providence,ale37.xml,307,6,1,CHI,1955,1637,MOT
0,1,3,148,2.714694744,149,1,do,"('CHI', 'MOT')",Providence,ale37.xml,152,3,0,MOT,791,1186,CHI
0,1,8,298,2.711377991,299,1,are,"('MOT', 'CHI')",Providence,ale37.xml,307,8,0,CHI,1955,1637,MOT
1,1,17,288,2.677590994,289,1,and,"('MOT', 'CHI')",Providence,ale37.xml,307,18,1,CHI,1955,1637,MOT
1,3,8,295,2.612740021,298,3,look,"('MOT', 'CHI')",Providence,ale37.xml,307,9,1,CHI,1955,1637,MOT
0,3,4,300,2.542257946,303,3,where,"('MOT', 'CHI')",Providence,ale37.xml,307,4,0,CHI,1955,1637,MOT
2,7,1,142,2.427012671,149,7,and,"('CHI', 'MOT')",Providence,ale37.xml,152,3,2,MOT,791,1186,CHI
0,2,7,298,2.414590151,300,2,all,"('MOT', 'CHI')",Providence,ale37.xml,307,7,0,CHI,1955,1637,MOT
1,4,8,294,2.38959647,298,4,make,"('MOT', 'CHI')",Providence,ale37.xml,307,9,1,CHI,1955,1637,MOT
1,6,1,144,2.384823191,150,6,my,"('CHI', 'MOT')",Providence,ale37.xml,152,2,1,MOT,791,1186,CHI
0,4,1,147,2.32238772,151,4,look,"('CHI', 'MOT')",Providence,ale37.xml,152,1,0,MOT,791,1186,CHI
2,8,6,291,2.305912883,299,8,go,"('MOT', 'CHI')",Providence,ale37.xml,307,8,2,CHI,1955,1637,MOT
1,0,0,13,2.302585093,13,0,they,"('MOT', 'GRA')",Providence,ale37.xml,14,1,1,GRA,124,87,MOT
2,4,5,141,2.282382386,145,4,on,"('CHI', 'MOT')",Providence,ale37.xml,152,7,2,MOT,791,1186,CHI
0,3,2,147,2.251291799,150,3,are,"('CHI', 'MOT')",Providence,ale37.xml,152,2,0,MOT,791,1186,CHI
4,4,25,274,2.200802399,278,4,one,"('MOT', 'CHI')",Providence,ale37.xml,307,29,4,CHI,1955,1637,MOT
0,4,5,298,2.16167964,302,4,on,"('MOT', 'CHI')",Providence,ale37.xml,307,5,0,CHI,1955,1637,MOT
0,2,4,146,2.120263536,148,2,where,"('CHI', 'MOT')",Providence,ale37.xml,152,4,0,MOT,791,1186,CHI
1,0,0,9,1.992430165,9,0,in,"('GRA', 'MOT')",Providence,ale37.xml,10,1,1,MOT,63,70,GRA
0,6,1,145,1.985915484,151,6,like,"('CHI', 'MOT')",Providence,ale37.xml,152,1,0,MOT,791,1186,CHI
1,4,14,288,1.934075691,292,4,put,"('MOT', 'CHI')",Providence,ale37.xml,307,15,1,CHI,1955,1637,MOT
0,4,7,296,1.903764528,300,4,big,"('MOT', 'CHI')",Providence,ale37.xml,307,7,0,CHI,1955,1637,MOT
4,9,16,278,1.882237054,287,9,the,"('MOT', 'CHI')",Providence,ale37.xml,307,20,4,CHI,1955,1637,MOT
1,4,19,283,1.659093503,287,4,what,"('MOT', 'CHI')",Providence,ale37.xml,307,20,1,CHI,1955,1637,MOT
11,17,23,256,1.627787051,273,17,that,"('MOT', 'CHI')",Providence,ale37.xml,307,34,11,CHI,1955,1637,MOT
3,4,38,262,1.606643314,266,4,you,"('MOT', 'CHI')",Providence,ale37.xml,307,41,3,CHI,1955,1637,MOT
2,12,4,134,1.451433663,146,12,it,"('CHI', 'MOT')",Providence,ale37.xml,152,6,2,MOT,791,1186,CHI
0,4,5,143,1.448598244,147,4,go,"('CHI', 'MOT')",Providence,ale37.xml,152,5,0,MOT,791,1186,CHI
1,5,20,281,1.428853976,286,5,oh,"('MOT', 'CHI')",Providence,ale37.xml,307,21,1,CHI,1955,1637,MOT
0,5,4,143,1.427116356,148,5,there,"('CHI', 'MOT')",Providence,ale37.xml,152,4,0,MOT,791,1186,CHI
2,22,1,127,1.370959997,149,22,one,"('CHI', 'MOT')",Providence,ale37.xml,152,3,2,MOT,791,1186,CHI
2,1,1,10,1.360976553,11,1,that,"('CHI', 'GRA')",Providence,ale37.xml,14,3,2,GRA,74,83,CHI
0,9,2,141,1.335001067,150,9,get,"('CHI', 'MOT')",Providence,ale37.xml,152,2,0,MOT,791,1186,CHI
1,15,2,134,1.328400383,149,15,a,"('CHI', 'MOT')",Providence,ale37.xml,152,3,1,MOT,791,1186,CHI
6,15,10,121,1.210203354,136,15,this,"('CHI', 'MOT')",Providence,ale37.xml,152,16,6,MOT,791,1186,CHI
1,2,0,11,1.203972804,13,2,you,"('CHI', 'GRA')",Providence,ale37.xml,14,1,1,GRA,74,83,CHI
1,2,0,11,1.203972804,13,2,it,"('CHI', 'GRA')",Providence,ale37.xml,14,1,1,GRA,74,83,CHI
4,29,9,265,1.190549784,294,29,this,"('MOT', 'CHI')",Providence,ale37.xml,307,13,4,CHI,1955,1637,MOT
0,4,18,285,1.068153081,289,4,is,"('MOT', 'CHI')",Providence,ale37.xml,307,18,0,CHI,1955,1637,MOT
3,12,29,263,0.919001985,275,12,it,"('MOT', 'CHI')",Providence,ale37.xml,307,32,3,CHI,1955,1637,MOT
0,1,1,12,0.916290732,13,1,oh,"('MOT', 'GRA')",Providence,ale37.xml,14,1,0,GRA,124,87,MOT
0,1,1,12,0.916290732,13,1,gonna,"('MOT', 'GRA')",Providence,ale37.xml,14,1,0,GRA,124,87,MOT
0,1,1,12,0.916290732,13,1,is,"('MOT', 'GRA')",Providence,ale37.xml,14,1,0,GRA,124,87,MOT
0,1,1,12,0.916290732,13,1,some,"('MOT', 'GRA')",Providence,ale37.xml,14,1,0,GRA,124,87,MOT
1,10,8,133,0.874090377,143,10,that,"('CHI', 'MOT')",Providence,ale37.xml,152,9,1,MOT,791,1186,CHI
1,10,20,276,0.822718172,286,10,do,"('MOT', 'CHI')",Providence,ale37.xml,307,21,1,CHI,1955,1637,MOT
1,16,5,130,0.777704569,146,16,no,"('CHI', 'MOT')",Providence,ale37.xml,152,6,1,MOT,791,1186,CHI
4,22,9,117,0.714653386,139,22,the,"('CHI', 'MOT')",Providence,ale37.xml,152,13,4,MOT,791,1186,CHI
1,1,3,9,0.693147181,10,1,you,"('MOT', 'GRA')",Providence,ale37.xml,14,4,1,GRA,124,87,MOT
0,1,1,8,0.606135804,9,1,yeah,"('GRA', 'MOT')",Providence,ale37.xml,10,1,0,MOT,63,70,GRA
0,1,1,8,0.606135804,9,1,no,"('GRA', 'MOT')",Providence,ale37.xml,10,1,0,MOT,63,70,GRA
0,1,1,8,0.606135804,9,1,can,"('GRA', 'MOT')",Providence,ale37.xml,10,1,0,MOT,63,70,GRA
0,1,1,8,0.606135804,9,1,not,"('GRA', 'MOT')",Providence,ale37.xml,10,1,0,MOT,63,70,GRA
1,1,2,6,0.587786665,7,1,you,"('GRA', 'MOT')",Providence,ale37.xml,10,3,1,MOT,63,70,GRA
0,1,2,11,0.559615788,12,1,what,"('MOT', 'GRA')",Providence,ale37.xml,14,2,0,GRA,124,87,MOT
0,1,2,11,0.559615788,12,1,no,"('MOT', 'GRA')",Providence,ale37.xml,14,2,0,GRA,124,87,MOT
0,21,2,129,0.546543706,150,21,you,"('CHI', 'MOT')",Providence,ale37.xml,152,2,0,MOT,791,1186,CHI
0,6,10,136,0.538996501,142,6,put,"('CHI', 'MOT')",Providence,ale37.xml,152,10,0,MOT,791,1186,CHI
0,1,1,6,0.405465108,7,1,a,"('GRA', 'CHI')",Providence,ale37.xml,8,1,0,CHI,59,57,GRA
0,4,38,265,0.303801454,269,4,no,"('MOT', 'CHI')",Providence,ale37.xml,307,38,0,CHI,1955,1637,MOT
0,2,1,7,0.200670695,9,2,it,"('GRA', 'MOT')",Providence,ale37.xml,10,1,0,MOT,63,70,GRA
0,3,1,6,-0.087011377,9,3,the,"('GRA', 'MOT')",Providence,ale37.xml,10,1,0,MOT,63,70,GRA
0,3,1,4,-0.287682072,7,3,have,"('GRA', 'CHI')",Providence,ale37.xml,8,1,0,CHI,59,57,GRA
0,2,2,4,-0.405465108,6,2,it,"('GRA', 'CHI')",Providence,ale37.xml,8,2,0,CHI,59,57,GRA
0,13,31,263,-0.507943777,276,13,a,"('MOT', 'CHI')",Providence,ale37.xml,307,31,0,CHI,1955,1637,MOT
0,1,1,0,-0.693147181,1,1,the,"('OPE', 'MOT')",Providence,ale37.xml,2,1,0,MOT,13,16,OPE
0,2,1,308,3.54577861,310,2,was,"('CHI', 'MOT')",Providence,ale38.xml,311,1,0,MOT,1932,2873,CHI
1,6,1,303,3.100735583,309,6,yeah,"('CHI', 'MOT')",Providence,ale38.xml,311,2,1,MOT,1932,2873,CHI
0,4,2,305,2.744060639,309,4,all,"('CHI', 'MOT')",Providence,ale38.xml,311,2,0,MOT,1932,2873,CHI
0,4,2,305,2.744060639,309,4,where,"('CHI', 'MOT')",Providence,ale38.xml,311,2,0,MOT,1932,2873,CHI
0,3,3,305,2.740840024,308,3,he,"('CHI', 'MOT')",Providence,ale38.xml,311,3,0,MOT,1932,2873,CHI
1,13,0,297,2.69848075,310,13,like,"('CHI', 'MOT')",Providence,ale38.xml,311,1,1,MOT,1932,2873,CHI
1,0,1,24,2.564949357,24,0,have,"('MOT', 'CHI')",Providence,ale38.xml,26,2,1,CHI,218,145,MOT
0,8,1,302,2.447166322,310,8,have,"('CHI', 'MOT')",Providence,ale38.xml,311,1,0,MOT,1932,2873,CHI
1,8,4,298,2.280112237,306,8,up,"('CHI', 'MOT')",Providence,ale38.xml,311,5,1,MOT,1932,2873,CHI
3,9,8,291,2.229186928,300,9,in,"('CHI', 'MOT')",Providence,ale38.xml,311,11,3,MOT,1932,2873,CHI
1,1,29,280,2.179710995,281,1,my,"('CHI', 'MOT')",Providence,ale38.xml,311,30,1,MOT,1932,2873,CHI
0,12,1,298,2.079441542,310,12,we,"('CHI', 'MOT')",Providence,ale38.xml,311,1,0,MOT,1932,2873,CHI
0,12,1,298,2.079441542,310,12,are,"('CHI', 'MOT')",Providence,ale38.xml,311,1,0,MOT,1932,2873,CHI
0,9,2,300,2.050913458,309,9,do,"('CHI', 'MOT')",Providence,ale38.xml,311,2,0,MOT,1932,2873,CHI
0,15,1,295,1.871802177,310,15,can,"('CHI', 'MOT')",Providence,ale38.xml,311,1,0,MOT,1932,2873,CHI
3,18,5,285,1.859582066,303,18,see,"('CHI', 'MOT')",Providence,ale38.xml,311,8,3,MOT,1932,2873,CHI
0,16,1,294,1.811177555,310,16,not,"('CHI', 'MOT')",Providence,ale38.xml,311,1,0,MOT,1932,2873,CHI
1,0,0,7,1.791759469,7,0,one,"('FAT', 'CHI')",Providence,ale38.xml,8,1,1,CHI,51,43,FAT
1,0,0,7,1.791759469,7,0,gonna,"('GRA', 'MOT')",Providence,ale38.xml,8,1,1,MOT,33,56,GRA
1,0,0,7,1.791759469,7,0,like,"('GRA', 'MOT')",Providence,ale38.xml,8,1,1,MOT,33,56,GRA
0,12,2,297,1.788549194,309,12,of,"('CHI', 'MOT')",Providence,ale38.xml,311,2,0,MOT,1932,2873,CHI
0,6,6,299,1.701496057,305,6,did,"('CHI', 'MOT')",Providence,ale38.xml,311,6,0,MOT,1932,2873,CHI
0,14,2,295,1.64544835,309,14,gonna,"('CHI', 'MOT')",Providence,ale38.xml,311,2,0,MOT,1932,2873,CHI
1,1,2,22,1.609437912,23,1,get,"('MOT', 'CHI')",Providence,ale38.xml,26,3,1,CHI,218,145,MOT
0,15,2,294,1.580909829,309,15,put,"('CHI', 'MOT')",Providence,ale38.xml,311,2,0,MOT,1932,2873,CHI
0,7,6,298,1.567964664,305,7,oh,"('CHI', 'MOT')",Providence,ale38.xml,311,6,0,MOT,1932,2873,CHI
1,1,0,11,1.540445041,12,1,little,"('MOT', 'GRA')",Providence,ale38.xml,13,1,1,GRA,139,155,MOT
0,1,1,24,1.504077397,25,1,oh,"('MOT', 'CHI')",Providence,ale38.xml,26,1,0,CHI,218,145,MOT
0,1,1,24,1.504077397,25,1,go,"('MOT', 'CHI')",Providence,ale38.xml,26,1,0,CHI,218,145,MOT
0,1,1,24,1.504077397,25,1,see,"('MOT', 'CHI')",Providence,ale38.xml,26,1,0,CHI,218,145,MOT
0,18,2,291,1.409059572,309,18,to,"('CHI', 'MOT')",Providence,ale38.xml,311,2,0,MOT,1932,2873,CHI
0,10,5,296,1.386294361,306,10,get,"('CHI', 'MOT')",Providence,ale38.xml,311,5,0,MOT,1932,2873,CHI
1,0,1,6,1.386294361,6,0,get,"('FAT', 'CHI')",Providence,ale38.xml,8,2,1,CHI,51,43,FAT
0,1,2,23,1.178654996,24,1,no,"('MOT', 'CHI')",Providence,ale38.xml,26,2,0,CHI,218,145,MOT
0,1,2,23,1.178654996,24,1,the,"('MOT', 'CHI')",Providence,ale38.xml,26,2,0,CHI,218,145,MOT
0,11,7,293,1.041453875,304,11,and,"('CHI', 'MOT')",Providence,ale38.xml,311,7,0,MOT,1932,2873,CHI
1,9,18,283,1.029619417,292,9,big,"('CHI', 'MOT')",Providence,ale38.xml,311,19,1,MOT,1932,2873,CHI
1,19,8,283,1.016547336,302,19,is,"('CHI', 'MOT')",Providence,ale38.xml,311,9,1,MOT,1932,2873,CHI
1,0,0,2,0.980829253,2,0,that,"('CHI', 'ADU')",Providence,ale38.xml,3,1,1,ADU,29,19,CHI
8,20,35,248,0.944461609,268,20,there,"('CHI', 'MOT')",Providence,ale38.xml,311,43,8,MOT,1932,2873,CHI
0,1,3,22,0.916290732,23,1,it,"('MOT', 'CHI')",Providence,ale38.xml,26,3,0,CHI,218,145,MOT
0,1,3,22,0.916290732,23,1,one,"('MOT', 'CHI')",Providence,ale38.xml,26,3,0,CHI,218,145,MOT
0,1,1,11,0.84729786,12,1,get,"('MOT', 'GRA')",Providence,ale38.xml,13,1,0,GRA,139,155,MOT
0,1,1,11,0.84729786,12,1,for,"('MOT', 'GRA')",Providence,ale38.xml,13,1,0,GRA,139,155,MOT
0,1,1,11,0.84729786,12,1,is,"('MOT', 'GRA')",Providence,ale38.xml,13,1,0,GRA,139,155,MOT
0,1,1,11,0.84729786,12,1,put,"('MOT', 'GRA')",Providence,ale38.xml,13,1,0,GRA,139,155,MOT
1,3,0,9,0.84729786,12,3,can,"('MOT', 'GRA')",Providence,ale38.xml,13,1,1,GRA,139,155,MOT
1,2,1,9,0.773189888,11,2,a,"('MOT', 'GRA')",Providence,ale38.xml,13,2,1,GRA,139,155,MOT
1,2,1,9,0.773189888,11,2,but,"('MOT', 'GRA')",Providence,ale38.xml,13,2,1,GRA,139,155,MOT
0,2,2,22,0.773189888,24,2,for,"('MOT', 'CHI')",Providence,ale38.xml,26,2,0,CHI,218,145,MOT
0,2,2,22,0.773189888,24,2,there,"('MOT', 'CHI')",Providence,ale38.xml,26,2,0,CHI,218,145,MOT
4,13,39,255,0.762140052,268,13,go,"('CHI', 'MOT')",Providence,ale38.xml,311,43,4,MOT,1932,2873,CHI
0,24,4,283,0.722705983,307,24,on,"('CHI', 'MOT')",Providence,ale38.xml,311,4,0,MOT,1932,2873,CHI
1,1,1,5,0.693147181,6,1,you,"('GRA', 'MOT')",Providence,ale38.xml,8,2,1,MOT,33,56,GRA
6,46,14,245,0.684892703,291,46,the,"('CHI', 'MOT')",Providence,ale38.xml,311,20,6,MOT,1932,2873,CHI
12,35,38,226,0.602340733,261,35,this,"('CHI', 'MOT')",Providence,ale38.xml,311,50,12,MOT,1932,2873,CHI
4,3,1,5,0.579818495,8,3,it,"('MOT', 'GRA')",Providence,ale38.xml,13,5,4,GRA,139,155,MOT
1,37,7,266,0.473287704,303,37,a,"('CHI', 'MOT')",Providence,ale38.xml,311,8,1,MOT,1932,2873,CHI
4,41,16,250,0.46089845,291,41,it,"('CHI', 'MOT')",Providence,ale38.xml,311,20,4,MOT,1932,2873,CHI
3,44,12,252,0.443512014,296,44,that,"('CHI', 'MOT')",Providence,ale38.xml,311,15,3,MOT,1932,2873,CHI
0,2,1,10,0.441832752,12,2,in,"('MOT', 'GRA')",Providence,ale38.xml,13,1,0,GRA,139,155,MOT
1,0,1,1,0.405465108,1,0,see,"('CHI', 'OPE')",Providence,ale38.xml,3,2,1,OPE,20,11,CHI
1,1,1,3,0.405465108,4,1,you,"('MOT', 'FAT')",Providence,ale38.xml,6,2,1,FAT,72,23,MOT
0,1,1,6,0.405465108,7,1,you,"('FAT', 'CHI')",Providence,ale38.xml,8,1,0,CHI,51,43,FAT
0,1,1,6,0.405465108,7,1,was,"('GRA', 'MOT')",Providence,ale38.xml,8,1,0,MOT,33,56,GRA
2,22,22,265,0.371448223,287,22,no,"('CHI', 'MOT')",Providence,ale38.xml,311,24,2,MOT,1932,2873,CHI
2,3,2,6,0.318453731,9,3,you,"('MOT', 'GRA')",Providence,ale38.xml,13,4,2,GRA,139,155,MOT
0,1,3,9,0.182321557,10,1,oh,"('MOT', 'GRA')",Providence,ale38.xml,13,3,0,GRA,139,155,MOT
0,1,3,9,0.182321557,10,1,yeah,"('MOT', 'GRA')",Providence,ale38.xml,13,3,0,GRA,139,155,MOT
2,38,15,256,0.180971118,294,38,one,"('CHI', 'MOT')",Providence,ale38.xml,311,17,2,MOT,1932,2873,CHI
0,1,1,4,0.15415068,5,1,there,"('MOT', 'FAT')",Providence,ale38.xml,6,1,0,FAT,72,23,MOT
2,4,2,5,0.09531018,9,4,the,"('MOT', 'GRA')",Providence,ale38.xml,13,4,2,GRA,139,155,MOT
0,1,9,16,-0.146603474,17,1,you,"('MOT', 'CHI')",Providence,ale38.xml,26,9,0,CHI,218,145,MOT
0,1,1,2,-0.182321557,3,1,what,"('FAT', 'MOT')",Providence,ale38.xml,4,1,0,MOT,25,26,FAT
0,1,1,2,-0.182321557,3,1,oh,"('MOT', 'ADU')",Providence,ale38.xml,4,1,0,ADU,15,18,MOT
0,66,5,240,-0.420502985,306,66,you,"('CHI', 'MOT')",Providence,ale38.xml,311,5,0,MOT,1932,2873,CHI
0,1,1,147,3.218875825,148,1,want,"('MOT', 'CHI')",Providence,ale39.xml,149,1,0,CHI,1539,823,MOT
2,0,14,133,3.113515309,133,0,like,"('MOT', 'CHI')",Providence,ale39.xml,149,16,2,CHI,1539,823,MOT
1,0,0,31,3.091042453,31,0,where,"('CHI', 'GRA')",Providence,ale39.xml,32,1,1,GRA,173,195,CHI
0,1,1,125,3.060270795,126,1,some,"('CHI', 'MOT')",Providence,ale39.xml,127,1,0,MOT,688,1172,CHI
1,2,2,144,2.982309253,146,2,of,"('MOT', 'CHI')",Providence,ale39.xml,149,3,1,CHI,1539,823,MOT
0,1,2,146,2.924504764,147,1,little,"('MOT', 'CHI')",Providence,ale39.xml,149,2,0,CHI,1539,823,MOT
2,1,8,138,2.869318349,139,1,we,"('MOT', 'CHI')",Providence,ale39.xml,149,10,2,CHI,1539,823,MOT
0,2,1,146,2.813410717,148,2,he,"('MOT', 'CHI')",Providence,ale39.xml,149,1,0,CHI,1539,823,MOT
0,1,2,124,2.764745545,125,1,want,"('CHI', 'MOT')",Providence,ale39.xml,127,2,0,MOT,688,1172,CHI
0,1,2,124,2.764745545,125,1,little,"('CHI', 'MOT')",Providence,ale39.xml,127,2,0,MOT,688,1172,CHI
1,0,0,21,2.730029108,21,0,of,"('GRA', 'CHI')",Providence,ale39.xml,22,1,1,CHI,100,161,GRA
1,0,0,21,2.730029108,21,0,put,"('GRA', 'CHI')",Providence,ale39.xml,22,1,1,CHI,100,161,GRA
1,0,0,21,2.730029108,21,0,on,"('GRA', 'CHI')",Providence,ale39.xml,22,1,1,CHI,100,161,GRA
0,2,1,124,2.654805687,126,2,yeah,"('CHI', 'MOT')",Providence,ale39.xml,127,1,0,MOT,688,1172,CHI
2,6,0,119,2.610594865,125,6,go,"('CHI', 'MOT')",Providence,ale39.xml,127,2,2,MOT,688,1172,CHI
1,1,8,139,2.557931785,140,1,get,"('MOT', 'CHI')",Providence,ale39.xml,149,9,1,CHI,1539,823,MOT
1,3,2,121,2.533696814,124,3,see,"('CHI', 'MOT')",Providence,ale39.xml,127,3,1,MOT,688,1172,CHI
0,1,3,123,2.533696814,124,1,are,"('CHI', 'MOT')",Providence,ale39.xml,127,3,0,MOT,688,1172,CHI
1,5,1,142,2.519039656,147,5,big,"('MOT', 'CHI')",Providence,ale39.xml,149,2,1,CHI,1539,823,MOT
0,1,4,144,2.505525937,145,1,wanna,"('MOT', 'CHI')",Providence,ale39.xml,149,4,0,CHI,1539,823,MOT
3,2,11,133,2.435074276,135,2,and,"('MOT', 'CHI')",Providence,ale39.xml,149,14,3,CHI,1539,823,MOT
1,2,6,140,2.367123614,142,2,have,"('MOT', 'CHI')",Providence,ale39.xml,149,7,1,CHI,1539,823,MOT
1,6,1,141,2.364888976,147,6,where,"('MOT', 'CHI')",Providence,ale39.xml,149,2,1,CHI,1539,823,MOT
0,1,5,143,2.344549292,144,1,on,"('MOT', 'CHI')",Providence,ale39.xml,149,5,0,CHI,1539,823,MOT
0,1,4,122,2.343407088,123,1,my,"('CHI', 'MOT')",Providence,ale39.xml,127,4,0,MOT,688,1172,CHI
0,2,3,144,2.289162073,146,2,make,"('MOT', 'CHI')",Providence,ale39.xml,149,3,0,CHI,1539,823,MOT
0,3,2,144,2.231357584,147,3,with,"('MOT', 'CHI')",Providence,ale39.xml,149,2,0,CHI,1539,823,MOT
0,3,2,144,2.231357584,147,3,up,"('MOT', 'CHI')",Providence,ale39.xml,149,2,0,CHI,1539,823,MOT
1,0,1,16,2.197224577,16,0,little,"('GRA', 'MOT')",Providence,ale39.xml,18,2,1,MOT,149,137,GRA
1,0,1,16,2.197224577,16,0,to,"('GRA', 'MOT')",Providence,ale39.xml,18,2,1,MOT,149,137,GRA
2,2,12,133,2.147392204,135,2,to,"('MOT', 'CHI')",Providence,ale39.xml,149,14,2,CHI,1539,823,MOT
0,2,3,122,2.128231706,124,2,and,"('CHI', 'MOT')",Providence,ale39.xml,127,3,0,MOT,688,1172,CHI
0,2,4,143,2.100060829,145,2,can,"('MOT', 'CHI')",Providence,ale39.xml,149,4,0,CHI,1539,823,MOT
2,0,1,11,2.054123734,11,0,it,"('MOT', 'GRA')",Providence,ale39.xml,14,3,2,GRA,106,70,MOT
0,1,2,58,2.031432322,59,1,have,"('TOY', 'MOT')",Providence,ale39.xml,61,2,0,MOT,508,345,TOY
0,4,2,143,2.008214032,147,4,did,"('MOT', 'CHI')",Providence,ale39.xml,149,2,0,CHI,1539,823,MOT
1,0,1,12,1.945910149,12,0,that,"('MOT', 'GRA')",Providence,ale39.xml,14,2,1,GRA,106,70,MOT
0,2,1,58,1.929909808,60,2,that,"('TOY', 'MOT')",Providence,ale39.xml,61,1,0,MOT,508,345,TOY
0,1,9,139,1.864784604,140,1,put,"('MOT', 'CHI')",Providence,ale39.xml,149,9,0,CHI,1539,823,MOT
0,4,2,121,1.848454813,125,4,there,"('CHI', 'MOT')",Providence,ale39.xml,127,2,0,MOT,688,1172,CHI
1,1,0,16,1.84582669,17,1,put,"('GRA', 'MOT')",Providence,ale39.xml,18,1,1,MOT,149,137,GRA
0,6,1,120,1.807507826,126,6,can,"('CHI', 'MOT')",Providence,ale39.xml,127,1,0,MOT,688,1172,CHI
0,2,6,141,1.798679912,143,2,oh,"('MOT', 'CHI')",Providence,ale39.xml,149,6,0,CHI,1539,823,MOT
2,0,2,10,1.791759469,10,0,a,"('MOT', 'GRA')",Providence,ale39.xml,14,4,2,GRA,106,70,MOT
0,1,10,138,1.77070606,139,1,in,"('MOT', 'CHI')",Providence,ale39.xml,149,10,0,CHI,1539,823,MOT
0,1,1,30,1.704748092,31,1,yeah,"('CHI', 'GRA')",Providence,ale39.xml,32,1,0,GRA,173,195,CHI
0,1,1,30,1.704748092,31,1,of,"('CHI', 'GRA')",Providence,ale39.xml,32,1,0,GRA,173,195,CHI
0,1,1,30,1.704748092,31,1,look,"('CHI', 'GRA')",Providence,ale39.xml,32,1,0,GRA,173,195,CHI
0,1,1,30,1.704748092,31,1,at,"('CHI', 'GRA')",Providence,ale39.xml,32,1,0,GRA,173,195,CHI
1,0,4,17,1.691676011,17,0,what,"('GRA', 'CHI')",Providence,ale39.xml,22,5,1,CHI,100,161,GRA
1,0,3,14,1.673976434,14,0,oh,"('GRA', 'MOT')",Providence,ale39.xml,18,4,1,MOT,149,137,GRA
0,5,2,120,1.666133256,125,5,on,"('CHI', 'MOT')",Providence,ale39.xml,127,2,0,MOT,688,1172,CHI
1,11,1,114,1.666133256,125,11,what,"('CHI', 'MOT')",Providence,ale39.xml,127,2,1,MOT,688,1172,CHI
1,0,2,11,1.648658626,11,0,the,"('MOT', 'GRA')",Providence,ale39.xml,14,3,1,GRA,106,70,MOT
1,6,5,137,1.644529232,143,6,are,"('MOT', 'CHI')",Providence,ale39.xml,149,6,1,CHI,1539,823,MOT
0,1,1,27,1.609437912,28,1,and,"('TOY', 'CHI')",Providence,ale39.xml,29,1,0,CHI,215,96,TOY
0,2,8,139,1.561647249,141,2,there,"('MOT', 'CHI')",Providence,ale39.xml,149,8,0,CHI,1539,823,MOT
0,1,2,35,1.558144618,36,1,one,"('MOT', 'TOY')",Providence,ale39.xml,38,2,0,TOY,257,323,MOT
1,2,5,53,1.558144618,55,2,one,"('TOY', 'MOT')",Providence,ale39.xml,61,6,1,MOT,508,345,TOY
0,2,1,35,1.466337069,37,2,up,"('MOT', 'TOY')",Providence,ale39.xml,38,1,0,TOY,257,323,MOT
0,1,1,20,1.343734747,21,1,in,"('GRA', 'CHI')",Providence,ale39.xml,22,1,0,CHI,100,161,GRA
0,1,1,20,1.343734747,21,1,are,"('GRA', 'CHI')",Providence,ale39.xml,22,1,0,CHI,100,161,GRA
0,6,3,118,1.280933845,124,6,all,"('CHI', 'MOT')",Providence,ale39.xml,127,3,0,MOT,688,1172,CHI
0,1,17,131,1.26025364,132,1,what,"('MOT', 'CHI')",Providence,ale39.xml,149,17,0,CHI,1539,823,MOT
1,1,1,11,1.252762968,12,1,this,"('MOT', 'GRA')",Providence,ale39.xml,14,2,1,GRA,106,70,MOT
2,6,0,24,1.232143681,30,6,a,"('CHI', 'GRA')",Providence,ale39.xml,32,2,2,GRA,173,195,CHI
1,8,5,113,1.228665417,121,8,that,"('CHI', 'MOT')",Providence,ale39.xml,127,6,1,MOT,688,1172,CHI
0,10,2,137,1.219756672,147,10,my,"('MOT', 'CHI')",Providence,ale39.xml,149,2,0,CHI,1539,823,MOT
1,0,0,3,1.203972804,3,0,can,"('CHI', 'OPE')",Providence,ale39.xml,4,1,1,OPE,25,26,CHI
0,3,9,137,1.171637424,140,3,go,"('MOT', 'CHI')",Providence,ale39.xml,149,9,0,CHI,1539,823,MOT
2,1,3,12,1.16760516,13,1,the,"('GRA', 'MOT')",Providence,ale39.xml,18,5,2,MOT,149,137,GRA
0,1,1,16,1.15267951,17,1,in,"('GRA', 'MOT')",Providence,ale39.xml,18,1,0,MOT,149,137,GRA
0,1,1,16,1.15267951,17,1,with,"('GRA', 'MOT')",Providence,ale39.xml,18,1,0,MOT,149,137,GRA
0,1,1,16,1.15267951,17,1,are,"('GRA', 'MOT')",Providence,ale39.xml,18,1,0,MOT,149,137,GRA
0,7,3,117,1.147402453,124,7,oh,"('CHI', 'MOT')",Providence,ale39.xml,127,3,0,MOT,688,1172,CHI
1,3,6,51,1.134979933,54,3,to,"('TOY', 'MOT')",Providence,ale39.xml,61,7,1,MOT,508,345,TOY
1,6,10,132,1.123930097,138,6,no,"('MOT', 'CHI')",Providence,ale39.xml,149,11,1,CHI,1539,823,MOT
1,7,7,112,1.106911091,119,7,like,"('CHI', 'MOT')",Providence,ale39.xml,127,8,1,MOT,688,1172,CHI
0,3,3,55,1.098612289,58,3,this,"('TOY', 'MOT')",Providence,ale39.xml,61,3,0,MOT,508,345,TOY
1,16,2,108,1.086777831,124,16,get,"('CHI', 'MOT')",Providence,ale39.xml,127,3,1,MOT,688,1172,CHI
1,4,2,31,1.085189268,35,4,a,"('MOT', 'TOY')",Providence,ale39.xml,38,3,1,TOY,257,323,MOT
3,13,7,104,1.041453875,117,13,a,"('CHI', 'MOT')",Providence,ale39.xml,127,10,3,MOT,688,1172,CHI
0,3,1,28,1.011600912,31,3,oh,"('CHI', 'GRA')",Providence,ale39.xml,32,1,0,GRA,173,195,CHI
0,2,1,19,0.938269639,21,2,my,"('GRA', 'CHI')",Providence,ale39.xml,22,1,0,CHI,100,161,GRA
0,2,1,19,0.938269639,21,2,is,"('GRA', 'CHI')",Providence,ale39.xml,22,1,0,CHI,100,161,GRA
0,2,1,19,0.938269639,21,2,that,"('GRA', 'CHI')",Providence,ale39.xml,22,1,0,CHI,100,161,GRA
0,2,1,19,0.938269639,21,2,to,"('GRA', 'CHI')",Providence,ale39.xml,22,1,0,CHI,100,161,GRA
0,1,1,12,0.916290732,13,1,like,"('MOT', 'GRA')",Providence,ale39.xml,14,1,0,GRA,106,70,MOT
1,8,8,110,0.885519073,118,8,one,"('CHI', 'MOT')",Providence,ale39.xml,127,9,1,MOT,688,1172,CHI
0,2,2,25,0.88238918,27,2,one,"('TOY', 'CHI')",Providence,ale39.xml,29,2,0,CHI,215,96,TOY
1,5,16,127,0.854788532,132,5,one,"('MOT', 'CHI')",Providence,ale39.xml,149,17,1,CHI,1539,823,MOT
0,3,13,133,0.832909123,136,3,do,"('MOT', 'CHI')",Providence,ale39.xml,149,13,0,CHI,1539,823,MOT
1,2,2,13,0.818310324,15,2,that,"('GRA', 'MOT')",Providence,ale39.xml,18,3,1,MOT,149,137,GRA
0,1,4,24,0.810930216,25,1,a,"('TOY', 'CHI')",Providence,ale39.xml,29,4,0,CHI,215,96,TOY
0,1,4,24,0.810930216,25,1,is,"('TOY', 'CHI')",Providence,ale39.xml,29,4,0,CHI,215,96,TOY
0,4,1,27,0.78845736,31,4,what,"('CHI', 'GRA')",Providence,ale39.xml,32,1,0,GRA,173,195,CHI
0,2,1,15,0.747214402,17,2,what,"('GRA', 'MOT')",Providence,ale39.xml,18,1,0,MOT,149,137,GRA
0,2,1,15,0.747214402,17,2,he,"('GRA', 'MOT')",Providence,ale39.xml,18,1,0,MOT,149,137,GRA
0,2,1,15,0.747214402,17,2,and,"('GRA', 'MOT')",Providence,ale39.xml,18,1,0,MOT,149,137,GRA
0,1,3,18,0.741937345,19,1,it,"('GRA', 'CHI')",Providence,ale39.xml,22,3,0,CHI,100,161,GRA
1,5,18,125,0.739667196,130,5,that,"('MOT', 'CHI')",Providence,ale39.xml,149,19,1,CHI,1539,823,MOT
8,13,26,102,0.736822244,115,13,it,"('MOT', 'CHI')",Providence,ale39.xml,149,34,8,CHI,1539,823,MOT
2,10,1,25,0.702197016,35,10,what,"('MOT', 'TOY')",Providence,ale39.xml,38,3,2,TOY,257,323,MOT
0,2,4,32,0.693147181,34,2,you,"('MOT', 'TOY')",Providence,ale39.xml,38,4,0,TOY,257,323,MOT
1,0,1,2,0.693147181,2,0,you,"('OPE', 'CHI')",Providence,ale39.xml,4,2,1,CHI,16,26,OPE
1,4,3,24,0.693147181,28,4,it,"('CHI', 'GRA')",Providence,ale39.xml,32,4,1,GRA,173,195,CHI
0,3,2,27,0.693147181,30,3,no,"('CHI', 'GRA')",Providence,ale39.xml,32,2,0,GRA,173,195,CHI
0,6,7,114,0.660886318,120,6,to,"('CHI', 'MOT')",Providence,ale39.xml,127,7,0,MOT,688,1172,CHI
1,7,5,48,0.577315365,55,7,you,"('TOY', 'MOT')",Providence,ale39.xml,61,6,1,MOT,508,345,TOY
1,2,3,12,0.575364145,14,2,a,"('GRA', 'MOT')",Providence,ale39.xml,18,4,1,MOT,149,137,GRA
2,25,4,96,0.573258564,121,25,you,"('CHI', 'MOT')",Providence,ale39.xml,127,6,2,MOT,688,1172,CHI
1,3,5,23,0.559615788,26,3,is,"('CHI', 'GRA')",Providence,ale39.xml,32,6,1,GRA,173,195,CHI
2,23,5,97,0.527354926,120,23,it,"('CHI', 'MOT')",Providence,ale39.xml,127,7,2,MOT,688,1172,CHI
1,3,3,15,0.510825624,18,3,you,"('GRA', 'CHI')",Providence,ale39.xml,22,4,1,CHI,100,161,GRA
2,12,12,101,0.506006337,113,12,this,"('CHI', 'MOT')",Providence,ale39.xml,127,14,2,MOT,688,1172,CHI
0,5,10,112,0.502457374,117,5,is,"('CHI', 'MOT')",Providence,ale39.xml,127,10,0,MOT,688,1172,CHI
0,3,3,26,0.438254931,29,3,that,"('CHI', 'GRA')",Providence,ale39.xml,32,3,0,GRA,173,195,CHI
0,4,1,17,0.427444015,21,4,a,"('GRA', 'CHI')",Providence,ale39.xml,22,1,0,CHI,100,161,GRA
0,2,4,23,0.405465108,25,2,to,"('TOY', 'CHI')",Providence,ale39.xml,29,4,0,CHI,215,96,TOY
0,2,2,14,0.405465108,16,2,it,"('GRA', 'MOT')",Providence,ale39.xml,18,2,0,MOT,149,137,GRA
0,4,3,31,0.392042088,35,4,to,"('MOT', 'TOY')",Providence,ale39.xml,38,3,0,TOY,257,323,MOT
0,4,6,51,0.354171814,55,4,a,"('TOY', 'MOT')",Providence,ale39.xml,61,6,0,MOT,508,345,TOY
0,2,2,13,0.348306694,15,2,to,"('CHI', 'TOY')",Providence,ale39.xml,17,2,0,TOY,54,110,CHI
3,5,45,96,0.317240875,101,5,you,"('MOT', 'CHI')",Providence,ale39.xml,149,48,3,CHI,1539,823,MOT
1,3,2,8,0.262364264,11,3,you,"('MOT', 'GRA')",Providence,ale39.xml,14,3,1,GRA,106,70,MOT
0,1,3,10,0.262364264,11,1,of,"('MOT', 'GRA')",Providence,ale39.xml,14,3,0,GRA,106,70,MOT
0,1,3,10,0.262364264,11,1,is,"('MOT', 'GRA')",Providence,ale39.xml,14,3,0,GRA,106,70,MOT
0,4,1,13,0.236388778,17,4,no,"('GRA', 'MOT')",Providence,ale39.xml,18,1,0,MOT,149,137,GRA
2,17,14,116,0.223143551,133,17,a,"('MOT', 'CHI')",Providence,ale39.xml,149,16,2,CHI,1539,823,MOT
0,4,3,25,0.21511138,29,4,the,"('CHI', 'GRA')",Providence,ale39.xml,32,3,0,GRA,173,195,CHI
1,17,10,121,0.179468488,138,17,is,"('MOT', 'CHI')",Providence,ale39.xml,149,11,1,CHI,1539,823,MOT
3,14,23,109,0.174353387,123,14,the,"('MOT', 'CHI')",Providence,ale39.xml,149,26,3,CHI,1539,823,MOT
0,2,2,10,0.15415068,12,2,to,"('MOT', 'GRA')",Providence,ale39.xml,14,2,0,GRA,106,70,MOT
0,13,6,108,0.093685484,121,13,no,"('CHI', 'MOT')",Providence,ale39.xml,127,6,0,MOT,688,1172,CHI
0,3,3,16,0.048790164,19,3,the,"('GRA', 'CHI')",Providence,ale39.xml,22,3,0,CHI,100,161,GRA
0,1,19,41,0.046520016,42,1,the,"('TOY', 'MOT')",Providence,ale39.xml,61,19,0,MOT,508,345,TOY
0,2,14,45,0.020619287,47,2,is,"('TOY', 'MOT')",Providence,ale39.xml,61,14,0,MOT,508,345,TOY
2,20,15,112,0.007490672,132,20,this,"('MOT', 'CHI')",Providence,ale39.xml,149,17,2,CHI,1539,823,MOT
0,12,1,25,0,37,12,is,"('MOT', 'TOY')",Providence,ale39.xml,38,1,0,TOY,257,323,MOT
1,7,11,42,-0.093526058,49,7,what,"('TOY', 'MOT')",Providence,ale39.xml,61,12,1,MOT,508,345,TOY
0,2,4,12,-0.117783036,14,2,go,"('GRA', 'MOT')",Providence,ale39.xml,18,4,0,MOT,149,137,GRA
0,2,8,19,-0.265703166,21,2,the,"('TOY', 'CHI')",Providence,ale39.xml,29,8,0,CHI,215,96,TOY
0,17,7,103,-0.28357529,120,17,the,"('CHI', 'MOT')",Providence,ale39.xml,127,7,0,MOT,688,1172,CHI
0,1,2,1,-0.693147181,2,1,you,"('CHI', 'OPE')",Providence,ale39.xml,4,2,0,OPE,25,26,CHI
0,3,7,8,-1.018569581,11,3,you,"('GRA', 'MOT')",Providence,ale39.xml,18,7,0,MOT,149,137,GRA
0,16,4,18,-1.041453875,34,16,the,"('MOT', 'TOY')",Providence,ale39.xml,38,4,0,TOY,257,323,MOT
2,0,11,460,4.526126979,460,0,put,"('MOT', 'CHI')",Providence,ale40.xml,473,13,2,CHI,3845,2259,MOT
0,1,3,469,3.854393893,470,1,she,"('MOT', 'CHI')",Providence,ale40.xml,473,3,0,CHI,3845,2259,MOT
1,1,7,464,3.843744165,465,1,think,"('MOT', 'CHI')",Providence,ale40.xml,473,8,1,CHI,3845,2259,MOT
0,2,3,468,3.448928784,470,2,was,"('MOT', 'CHI')",Providence,ale40.xml,473,3,0,CHI,3845,2259,MOT
1,2,8,462,3.340825253,464,2,we,"('MOT', 'CHI')",Providence,ale40.xml,473,9,1,CHI,3845,2259,MOT
1,1,18,453,3.077970372,454,1,with,"('MOT', 'CHI')",Providence,ale40.xml,473,19,1,CHI,3845,2259,MOT
0,1,9,463,3.053143181,464,1,did,"('MOT', 'CHI')",Providence,ale40.xml,473,9,0,CHI,3845,2259,MOT
0,1,9,463,3.053143181,464,1,can,"('MOT', 'CHI')",Providence,ale40.xml,473,9,0,CHI,3845,2259,MOT
0,1,11,461,2.881788014,462,1,at,"('MOT', 'CHI')",Providence,ale40.xml,473,11,0,CHI,3845,2259,MOT
0,1,12,460,2.805522544,461,1,are,"('MOT', 'CHI')",Providence,ale40.xml,473,12,0,CHI,3845,2259,MOT
2,2,26,443,2.701361213,445,2,do,"('MOT', 'CHI')",Providence,ale40.xml,473,28,2,CHI,3845,2259,MOT
0,3,6,464,2.684866866,467,3,get,"('MOT', 'CHI')",Providence,ale40.xml,473,6,0,CHI,3845,2259,MOT
0,3,6,464,2.684866866,467,3,up,"('MOT', 'CHI')",Providence,ale40.xml,473,6,0,CHI,3845,2259,MOT
0,1,14,458,2.66766214,459,1,have,"('MOT', 'CHI')",Providence,ale40.xml,473,14,0,CHI,3845,2259,MOT
1,3,13,456,2.66766214,459,3,he,"('MOT', 'CHI')",Providence,ale40.xml,473,14,1,CHI,3845,2259,MOT
1,3,14,455,2.604865965,458,3,on,"('MOT', 'CHI')",Providence,ale40.xml,473,15,1,CHI,3845,2259,MOT
2,0,0,15,2.545531272,15,0,my,"('ENV', 'CHI')",Providence,ale40.xml,17,2,2,CHI,122,79,ENV
0,2,11,460,2.476322906,462,2,all,"('MOT', 'CHI')",Providence,ale40.xml,473,11,0,CHI,3845,2259,MOT
0,1,1,65,2.427748236,66,1,can,"('CHI', 'MOT')",Providence,ale40.xml,67,1,0,MOT,263,492,CHI
1,3,0,63,2.427748236,66,3,are,"('CHI', 'MOT')",Providence,ale40.xml,67,1,1,MOT,263,492,CHI
0,1,1,65,2.427748236,66,1,on,"('CHI', 'MOT')",Providence,ale40.xml,67,1,0,MOT,263,492,CHI
0,3,9,461,2.359996,464,3,where,"('MOT', 'CHI')",Providence,ale40.xml,473,9,0,CHI,3845,2259,MOT
0,6,5,462,2.260912397,468,6,but,"('MOT', 'CHI')",Providence,ale40.xml,473,5,0,CHI,3845,2259,MOT
0,1,22,450,2.244691115,451,1,like,"('MOT', 'CHI')",Providence,ale40.xml,473,22,0,CHI,3845,2259,MOT
1,1,45,426,2.190255908,427,1,to,"('MOT', 'CHI')",Providence,ale40.xml,473,46,1,CHI,3845,2259,MOT
3,14,10,446,2.10575885,460,14,there,"('MOT', 'CHI')",Providence,ale40.xml,473,13,3,CHI,3845,2259,MOT
1,5,16,451,2.083817916,456,5,go,"('MOT', 'CHI')",Providence,ale40.xml,473,17,1,CHI,3845,2259,MOT
0,2,1,64,2.022283128,66,2,get,"('CHI', 'MOT')",Providence,ale40.xml,67,1,0,MOT,263,492,CHI
0,9,5,459,1.904237453,468,9,my,"('MOT', 'CHI')",Providence,ale40.xml,473,5,0,CHI,3845,2259,MOT
1,0,1,10,1.791759469,10,0,you,"('CHI', 'ENV')",Providence,ale40.xml,12,2,1,ENV,35,75,CHI
3,6,37,427,1.778060625,433,6,it,"('MOT', 'CHI')",Providence,ale40.xml,473,40,3,CHI,3845,2259,MOT
0,2,24,447,1.754758513,449,2,little,"('MOT', 'CHI')",Providence,ale40.xml,473,24,0,CHI,3845,2259,MOT
0,3,1,63,1.734601055,66,3,the,"('CHI', 'MOT')",Providence,ale40.xml,67,1,0,MOT,263,492,CHI
0,2,2,63,1.71978597,65,2,oh,"('CHI', 'MOT')",Providence,ale40.xml,67,2,0,MOT,263,492,CHI
3,3,68,399,1.710955437,402,3,you,"('MOT', 'CHI')",Providence,ale40.xml,473,71,3,CHI,3845,2259,MOT
12,37,17,407,1.593694945,444,37,they,"('MOT', 'CHI')",Providence,ale40.xml,473,29,12,CHI,3845,2259,MOT
0,4,1,62,1.511457504,66,4,that,"('CHI', 'MOT')",Providence,ale40.xml,67,1,0,MOT,263,492,CHI
0,4,1,62,1.511457504,66,4,one,"('CHI', 'MOT')",Providence,ale40.xml,67,1,0,MOT,263,492,CHI
3,11,29,430,1.468596957,441,11,one,"('MOT', 'CHI')",Providence,ale40.xml,473,32,3,CHI,3845,2259,MOT
0,4,19,450,1.468532459,454,4,in,"('MOT', 'CHI')",Providence,ale40.xml,473,19,0,CHI,3845,2259,MOT
6,14,41,412,1.405162845,426,14,is,"('MOT', 'CHI')",Providence,ale40.xml,473,47,6,CHI,3845,2259,MOT
0,5,17,451,1.390670736,456,5,see,"('MOT', 'CHI')",Providence,ale40.xml,473,17,0,CHI,3845,2259,MOT
1,9,22,441,1.285368443,450,9,oh,"('MOT', 'CHI')",Providence,ale40.xml,473,23,1,CHI,3845,2259,MOT
1,5,38,429,1.265457888,434,5,that,"('MOT', 'CHI')",Providence,ale40.xml,473,39,1,CHI,3845,2259,MOT
0,4,2,61,1.208960346,65,4,is,"('CHI', 'MOT')",Providence,ale40.xml,67,2,0,MOT,263,492,CHI
0,4,2,61,1.208960346,65,4,where,"('CHI', 'MOT')",Providence,ale40.xml,67,2,0,MOT,263,492,CHI
1,5,4,57,1.114360646,62,5,this,"('CHI', 'MOT')",Providence,ale40.xml,67,5,1,MOT,263,492,CHI
0,1,1,15,1.098612289,16,1,is,"('ENV', 'CHI')",Providence,ale40.xml,17,1,0,CHI,122,79,ENV
3,11,43,416,1.091643619,427,11,what,"('MOT', 'CHI')",Providence,ale40.xml,473,46,3,CHI,3845,2259,MOT
0,5,2,60,1.026638789,65,5,a,"('CHI', 'MOT')",Providence,ale40.xml,67,2,0,MOT,263,492,CHI
13,40,48,372,0.80821651,412,40,this,"('MOT', 'CHI')",Providence,ale40.xml,473,61,13,CHI,3845,2259,MOT
1,1,2,8,0.78845736,9,1,you,"('MOT', 'ENV')",Providence,ale40.xml,12,3,1,ENV,65,132,MOT
0,1,1,10,0.773189888,11,1,it,"('MOT', 'ENV')",Providence,ale40.xml,12,1,0,ENV,65,132,MOT
0,1,1,10,0.773189888,11,1,is,"('MOT', 'ENV')",Providence,ale40.xml,12,1,0,ENV,65,132,MOT
0,1,1,10,0.773189888,11,1,one,"('MOT', 'ENV')",Providence,ale40.xml,12,1,0,ENV,65,132,MOT
0,2,8,57,0.709676483,59,2,no,"('CHI', 'MOT')",Providence,ale40.xml,67,8,0,MOT,263,492,CHI
12,31,68,362,0.671379972,393,31,a,"('MOT', 'CHI')",Providence,ale40.xml,473,80,12,CHI,3845,2259,MOT
2,16,2,47,0.648026745,63,16,you,"('CHI', 'MOT')",Providence,ale40.xml,67,4,2,MOT,263,492,CHI
2,19,2,44,0.485507816,63,19,it,"('CHI', 'MOT')",Providence,ale40.xml,67,4,2,MOT,263,492,CHI
0,5,45,423,0.421878138,428,5,and,"('MOT', 'CHI')",Providence,ale40.xml,473,45,0,CHI,3845,2259,MOT
0,2,1,9,0.36772478,11,2,the,"('MOT', 'ENV')",Providence,ale40.xml,12,1,0,ENV,65,132,MOT
5,80,20,368,0.210721031,448,80,no,"('MOT', 'CHI')",Providence,ale40.xml,473,25,5,CHI,3845,2259,MOT
0,4,1,12,0.182321557,16,4,this,"('ENV', 'CHI')",Providence,ale40.xml,17,1,0,CHI,122,79,ENV
5,20,90,358,0.112697306,378,20,the,"('MOT', 'CHI')",Providence,ale40.xml,473,95,5,CHI,3845,2259,MOT
0,3,1,8,0.080042708,11,3,what,"('MOT', 'ENV')",Providence,ale40.xml,12,1,0,ENV,65,132,MOT
0,3,1,8,0.080042708,11,3,to,"('MOT', 'ENV')",Providence,ale40.xml,12,1,0,ENV,65,132,MOT
0,1,1,3,0,4,1,a,"('ENV', 'MOT')",Providence,ale40.xml,5,1,0,MOT,27,27,ENV
0,1,1,3,0,4,1,the,"('ENV', 'MOT')",Providence,ale40.xml,5,1,0,MOT,27,27,ENV
0,4,1,7,-0.143100844,11,4,a,"('MOT', 'ENV')",Providence,ale40.xml,12,1,0,ENV,65,132,MOT
0,1,4,7,-0.182321557,8,1,this,"('MOT', 'ENV')",Providence,ale40.xml,12,4,0,ENV,65,132,MOT
1,0,2,435,5.163642463,435,0,think,"('MOT', 'CHI')",Providence,ale41.xml,438,3,1,CHI,3596,1750,MOT
1,0,3,434,4.979029955,434,0,make,"('MOT', 'CHI')",Providence,ale41.xml,438,4,1,CHI,3596,1750,MOT
0,1,1,436,4.292739944,437,1,wanna,"('MOT', 'CHI')",Providence,ale41.xml,438,1,0,CHI,3596,1750,MOT
1,0,9,428,4.272025739,428,0,where,"('MOT', 'CHI')",Providence,ale41.xml,438,10,1,CHI,3596,1750,MOT
3,1,14,420,3.79608038,421,1,for,"('MOT', 'CHI')",Providence,ale41.xml,438,17,3,CHI,3596,1750,MOT
1,0,20,417,3.595523885,417,0,get,"('MOT', 'CHI')",Providence,ale41.xml,438,21,1,CHI,3596,1750,MOT
0,1,4,433,3.592735594,434,1,gonna,"('MOT', 'CHI')",Providence,ale41.xml,438,4,0,CHI,3596,1750,MOT
0,2,4,432,3.187270485,434,2,look,"('MOT', 'CHI')",Providence,ale41.xml,438,4,0,CHI,3596,1750,MOT
0,2,5,431,3.030823593,433,2,we,"('MOT', 'CHI')",Providence,ale41.xml,438,5,0,CHI,3596,1750,MOT
0,1,9,428,2.975065637,429,1,have,"('MOT', 'CHI')",Providence,ale41.xml,438,9,0,CHI,3596,1750,MOT
3,4,13,418,2.936218146,422,4,all,"('MOT', 'CHI')",Providence,ale41.xml,438,16,3,CHI,3596,1750,MOT
0,3,4,431,2.899588413,434,3,want,"('MOT', 'CHI')",Providence,ale41.xml,438,4,0,CHI,3596,1750,MOT
0,3,4,431,2.899588413,434,3,yeah,"('MOT', 'CHI')",Providence,ale41.xml,438,4,0,CHI,3596,1750,MOT
1,3,9,425,2.885731378,428,3,of,"('MOT', 'CHI')",Providence,ale41.xml,438,10,1,CHI,3596,1750,MOT
1,2,14,421,2.813410717,423,2,go,"('MOT', 'CHI')",Providence,ale41.xml,438,15,1,CHI,3596,1750,MOT
0,1,11,426,2.803360381,427,1,they,"('MOT', 'CHI')",Providence,ale41.xml,438,11,0,CHI,3596,1750,MOT
0,1,11,426,2.803360381,427,1,my,"('MOT', 'CHI')",Providence,ale41.xml,438,11,0,CHI,3596,1750,MOT
3,2,33,400,2.651510791,402,2,like,"('MOT', 'CHI')",Providence,ale41.xml,438,36,3,CHI,3596,1750,MOT
6,1,90,341,2.508437147,342,1,you,"('MOT', 'CHI')",Providence,ale41.xml,438,96,6,CHI,3596,1750,MOT
1,11,3,423,2.494123305,434,11,big,"('MOT', 'CHI')",Providence,ale41.xml,438,4,1,CHI,3596,1750,MOT
0,2,10,426,2.48026627,428,2,can,"('MOT', 'CHI')",Providence,ale41.xml,438,10,0,CHI,3596,1750,MOT
0,1,16,421,2.466214517,422,1,oh,"('MOT', 'CHI')",Providence,ale41.xml,438,16,0,CHI,3596,1750,MOT
0,1,19,418,2.304963215,419,1,but,"('MOT', 'CHI')",Providence,ale41.xml,438,19,0,CHI,3596,1750,MOT
0,2,13,423,2.250121523,425,2,with,"('MOT', 'CHI')",Providence,ale41.xml,438,13,0,CHI,3596,1750,MOT
1,2,29,406,2.144956149,408,2,that,"('MOT', 'CHI')",Providence,ale41.xml,438,30,1,CHI,3596,1750,MOT
0,1,1,41,1.992430165,42,1,is,"('CHI', 'GRA')",Providence,ale41.xml,43,1,0,GRA,148,270,CHI
0,2,19,417,1.899498107,419,2,are,"('MOT', 'CHI')",Providence,ale41.xml,438,19,0,CHI,3596,1750,MOT
0,1,31,406,1.824060414,407,1,what,"('MOT', 'CHI')",Providence,ale41.xml,438,31,0,CHI,3596,1750,MOT
1,6,19,412,1.696449289,418,6,this,"('MOT', 'CHI')",Providence,ale41.xml,438,20,1,CHI,3596,1750,MOT
0,3,18,417,1.662978679,420,3,there,"('MOT', 'CHI')",Providence,ale41.xml,438,18,0,CHI,3596,1750,MOT
3,9,27,399,1.634130525,408,9,in,"('MOT', 'CHI')",Providence,ale41.xml,438,30,3,CHI,3596,1750,MOT
0,2,1,40,1.586965057,42,2,no,"('CHI', 'GRA')",Providence,ale41.xml,43,1,0,GRA,148,270,CHI
1,10,14,413,1.514127733,423,10,put,"('MOT', 'CHI')",Providence,ale41.xml,438,15,1,CHI,3596,1750,MOT
2,13,16,407,1.508828,420,13,no,"('MOT', 'CHI')",Providence,ale41.xml,438,18,2,CHI,3596,1750,MOT
1,4,1,37,1.458615023,41,4,are,"('CHI', 'GRA')",Providence,ale41.xml,43,2,1,GRA,148,270,CHI
0,1,3,39,1.435084525,40,1,the,"('CHI', 'GRA')",Providence,ale41.xml,43,3,0,GRA,148,270,CHI
0,3,23,412,1.427916036,415,3,is,"('MOT', 'CHI')",Providence,ale41.xml,438,23,0,CHI,3596,1750,MOT
3,11,28,396,1.418595306,407,11,it,"('MOT', 'CHI')",Providence,ale41.xml,438,31,3,CHI,3596,1750,MOT
4,10,38,386,1.413805011,396,10,to,"('MOT', 'CHI')",Providence,ale41.xml,438,42,4,CHI,3596,1750,MOT
0,3,28,407,1.233531607,410,3,and,"('MOT', 'CHI')",Providence,ale41.xml,438,28,0,CHI,3596,1750,MOT
0,4,1,38,1.076139433,42,4,oh,"('CHI', 'GRA')",Providence,ale41.xml,43,1,0,GRA,148,270,CHI
1,9,27,401,1.010388055,410,9,one,"('MOT', 'CHI')",Providence,ale41.xml,438,28,1,CHI,3596,1750,MOT
0,3,2,38,0.988611393,41,3,it,"('CHI', 'GRA')",Providence,ale41.xml,43,2,0,GRA,148,270,CHI
0,5,1,37,0.893817876,42,5,like,"('CHI', 'GRA')",Providence,ale41.xml,43,1,0,GRA,148,270,CHI
0,5,1,37,0.893817876,42,5,that,"('CHI', 'GRA')",Providence,ale41.xml,43,1,0,GRA,148,270,CHI
10,28,58,342,0.700998055,370,28,a,"('MOT', 'CHI')",Providence,ale41.xml,438,68,10,CHI,3596,1750,MOT
0,7,1,35,0.606135804,42,7,what,"('CHI', 'GRA')",Providence,ale41.xml,43,1,0,GRA,148,270,CHI
4,25,38,371,0.553603746,396,25,the,"('MOT', 'CHI')",Providence,ale41.xml,438,42,4,CHI,3596,1750,MOT
1,18,26,393,0.404859964,411,18,on,"('MOT', 'CHI')",Providence,ale41.xml,438,27,1,CHI,3596,1750,MOT
1,4,8,30,0.269332934,34,4,this,"('CHI', 'GRA')",Providence,ale41.xml,43,9,1,GRA,148,270,CHI
0,6,4,33,-0.024097552,39,6,a,"('CHI', 'GRA')",Providence,ale41.xml,43,4,0,GRA,148,270,CHI
0,4,1,7,-0.143100844,11,4,this,"('GRA', 'CHI')",Providence,ale41.xml,12,1,0,CHI,67,46,GRA
0,1,1,1,-0.405465108,2,1,yeah,"('CHI', 'MOT')",Providence,ale41.xml,3,1,0,MOT,7,6,CHI
0,1,2,501,4.143134726,502,1,wanna,"('CHI', 'MOT')",Providence,ale42.xml,504,2,0,MOT,2984,3686,CHI
0,4,1,499,3.516508228,503,4,want,"('CHI', 'MOT')",Providence,ale42.xml,504,1,0,MOT,2984,3686,CHI
0,4,1,499,3.516508228,503,4,was,"('CHI', 'MOT')",Providence,ale42.xml,504,1,0,MOT,2984,3686,CHI
2,8,3,491,3.172083663,499,8,of,"('CHI', 'MOT')",Providence,ale42.xml,504,5,2,MOT,2984,3686,CHI
0,7,1,496,3.046504599,503,7,think,"('CHI', 'MOT')",Providence,ale42.xml,504,1,0,MOT,2984,3686,CHI
3,9,5,487,2.991724252,496,9,they,"('CHI', 'MOT')",Providence,ale42.xml,504,8,3,MOT,2984,3686,CHI
0,8,1,495,2.928721563,503,8,but,"('CHI', 'MOT')",Providence,ale42.xml,504,1,0,MOT,2984,3686,CHI
0,6,2,496,2.890371758,502,6,all,"('CHI', 'MOT')",Providence,ale42.xml,504,2,0,MOT,2984,3686,CHI
1,6,5,492,2.882403588,498,6,up,"('CHI', 'MOT')",Providence,ale42.xml,504,6,1,MOT,2984,3686,CHI
1,8,4,491,2.766618555,499,8,for,"('CHI', 'MOT')",Providence,ale42.xml,504,5,1,MOT,2984,3686,CHI
2,14,3,485,2.66125804,499,14,little,"('CHI', 'MOT')",Providence,ale42.xml,504,5,2,MOT,2984,3686,CHI
0,11,1,492,2.641039491,503,11,at,"('CHI', 'MOT')",Providence,ale42.xml,504,1,0,MOT,2984,3686,CHI
0,8,2,494,2.63905733,502,8,have,"('CHI', 'MOT')",Providence,ale42.xml,504,2,0,MOT,2984,3686,CHI
0,12,1,491,2.560996783,503,12,not,"('CHI', 'MOT')",Providence,ale42.xml,504,1,0,MOT,2984,3686,CHI
2,12,5,485,2.54904445,497,12,big,"('CHI', 'MOT')",Providence,ale42.xml,504,7,2,MOT,2984,3686,CHI
2,9,8,485,2.517696473,494,9,can,"('CHI', 'MOT')",Providence,ale42.xml,504,10,2,MOT,2984,3686,CHI
0,8,3,493,2.41392768,501,8,yeah,"('CHI', 'MOT')",Providence,ale42.xml,504,3,0,MOT,2984,3686,CHI
0,11,2,491,2.351375257,502,11,we,"('CHI', 'MOT')",Providence,ale42.xml,504,2,0,MOT,2984,3686,CHI
0,12,2,490,2.271332549,502,12,with,"('CHI', 'MOT')",Providence,ale42.xml,504,2,0,MOT,2984,3686,CHI
1,12,6,485,2.143579342,497,12,get,"('CHI', 'MOT')",Providence,ale42.xml,504,7,1,MOT,2984,3686,CHI
1,20,3,480,2.075465393,500,20,like,"('CHI', 'MOT')",Providence,ale42.xml,504,4,1,MOT,2984,3686,CHI
0,10,5,489,1.872800679,499,10,did,"('CHI', 'MOT')",Providence,ale42.xml,504,5,0,MOT,2984,3686,CHI
1,17,6,480,1.818156941,497,17,do,"('CHI', 'MOT')",Providence,ale42.xml,504,7,1,MOT,2984,3686,CHI
2,18,11,473,1.646632282,491,18,where,"('CHI', 'MOT')",Providence,ale42.xml,504,13,2,MOT,2984,3686,CHI
1,22,6,475,1.573034483,497,22,to,"('CHI', 'MOT')",Providence,ale42.xml,504,7,1,MOT,2984,3686,CHI
0,13,6,485,1.496109227,498,13,he,"('CHI', 'MOT')",Providence,ale42.xml,504,6,0,MOT,2984,3686,CHI
0,22,3,479,1.475658042,501,22,put,"('CHI', 'MOT')",Providence,ale42.xml,504,3,0,MOT,2984,3686,CHI
5,24,20,455,1.452914048,479,24,in,"('CHI', 'MOT')",Providence,ale42.xml,504,25,5,MOT,2984,3686,CHI
3,18,19,464,1.445886458,482,18,on,"('CHI', 'MOT')",Providence,ale42.xml,504,22,3,MOT,2984,3686,CHI
5,70,6,423,1.168687997,493,70,you,"('CHI', 'MOT')",Providence,ale42.xml,504,11,5,MOT,2984,3686,CHI
0,17,7,480,1.125009761,497,17,are,"('CHI', 'MOT')",Providence,ale42.xml,504,7,0,MOT,2984,3686,CHI
1,1,2,12,1.098612289,13,1,no,"('MOT', 'CHI')",Providence,ale42.xml,16,3,1,CHI,117,99,MOT
0,33,3,468,1.084791733,501,33,that,"('CHI', 'MOT')",Providence,ale42.xml,504,3,0,MOT,2984,3686,CHI
0,13,10,481,1.082611947,494,13,look,"('CHI', 'MOT')",Providence,ale42.xml,504,10,0,MOT,2984,3686,CHI
2,23,17,462,1.064300144,485,23,go,"('CHI', 'MOT')",Providence,ale42.xml,504,19,2,MOT,2984,3686,CHI
2,29,14,459,1.00144854,488,29,there,"('CHI', 'MOT')",Providence,ale42.xml,504,16,2,MOT,2984,3686,CHI
4,27,27,446,0.944040645,473,27,it,"('CHI', 'MOT')",Providence,ale42.xml,504,31,4,MOT,2984,3686,CHI
1,27,11,465,0.924420858,492,27,what,"('CHI', 'MOT')",Providence,ale42.xml,504,12,1,MOT,2984,3686,CHI
3,35,17,449,0.897941593,484,35,one,"('CHI', 'MOT')",Providence,ale42.xml,504,20,3,MOT,2984,3686,CHI
9,46,31,418,0.858953507,464,46,a,"('CHI', 'MOT')",Providence,ale42.xml,504,40,9,MOT,2984,3686,CHI
1,13,28,462,0.787619137,475,13,my,"('CHI', 'MOT')",Providence,ale42.xml,504,29,1,MOT,2984,3686,CHI
0,33,5,466,0.744335427,499,33,see,"('CHI', 'MOT')",Providence,ale42.xml,504,5,0,MOT,2984,3686,CHI
2,27,22,453,0.686255355,480,27,is,"('CHI', 'MOT')",Providence,ale42.xml,504,24,2,MOT,2984,3686,CHI
0,2,1,13,0.635988767,15,2,and,"('MOT', 'CHI')",Providence,ale42.xml,16,1,0,CHI,117,99,MOT
10,67,29,398,0.611144759,465,67,the,"('CHI', 'MOT')",Providence,ale42.xml,504,39,10,MOT,2984,3686,CHI
8,32,56,408,0.602372156,440,32,this,"('CHI', 'MOT')",Providence,ale42.xml,504,64,8,MOT,2984,3686,CHI
1,2,3,10,0.441832752,12,2,a,"('MOT', 'CHI')",Providence,ale42.xml,16,4,1,CHI,117,99,MOT
0,1,3,12,0.405465108,13,1,this,"('MOT', 'CHI')",Providence,ale42.xml,16,3,0,CHI,117,99,MOT
0,2,2,12,0.287682072,14,2,is,"('MOT', 'CHI')",Providence,ale42.xml,16,2,0,CHI,117,99,MOT
1,45,14,444,0.227736568,489,45,oh,"('CHI', 'MOT')",Providence,ale42.xml,504,15,1,MOT,2984,3686,CHI
1,3,3,9,0.15415068,12,3,they,"('MOT', 'CHI')",Providence,ale42.xml,16,4,1,CHI,117,99,MOT
0,4,1,11,0.125163143,15,4,the,"('MOT', 'CHI')",Providence,ale42.xml,16,1,0,CHI,117,99,MOT
0,27,14,463,0.093685484,490,27,and,"('CHI', 'MOT')",Providence,ale42.xml,504,14,0,MOT,2984,3686,CHI
3,37,45,419,-0.03644562,456,37,no,"('CHI', 'MOT')",Providence,ale42.xml,504,48,3,MOT,2984,3686,CHI
1,0,4,354,4.622167762,354,0,want,"('MOT', 'CHI')",Providence,ale43.xml,359,5,1,CHI,3495,1719,MOT
1,0,6,352,4.365219516,352,0,up,"('MOT', 'CHI')",Providence,ale43.xml,359,7,1,CHI,3495,1719,MOT
0,1,2,356,3.803880847,357,1,gonna,"('MOT', 'CHI')",Providence,ale43.xml,359,2,0,CHI,3495,1719,MOT
0,3,2,354,3.110733666,357,3,where,"('MOT', 'CHI')",Providence,ale43.xml,359,2,0,CHI,3495,1719,MOT
2,2,12,343,3.076736058,345,2,all,"('MOT', 'CHI')",Providence,ale43.xml,359,14,2,CHI,3495,1719,MOT
1,1,15,342,2.953172659,343,1,are,"('MOT', 'CHI')",Providence,ale43.xml,359,16,1,CHI,3495,1719,MOT
0,1,8,350,2.870735783,351,1,yeah,"('MOT', 'CHI')",Providence,ale43.xml,359,8,0,CHI,3495,1719,MOT
0,1,8,350,2.870735783,351,1,have,"('MOT', 'CHI')",Providence,ale43.xml,359,8,0,CHI,3495,1719,MOT
0,2,7,350,2.573460047,352,2,we,"('MOT', 'CHI')",Providence,ale43.xml,359,7,0,CHI,3495,1719,MOT
0,2,7,350,2.573460047,352,2,little,"('MOT', 'CHI')",Providence,ale43.xml,359,7,0,CHI,3495,1719,MOT
0,3,5,351,2.542726221,354,3,put,"('MOT', 'CHI')",Providence,ale43.xml,359,5,0,CHI,3495,1719,MOT
0,5,3,351,2.479335605,356,5,my,"('MOT', 'CHI')",Providence,ale43.xml,359,3,0,CHI,3495,1719,MOT
0,3,7,349,2.285777975,352,3,on,"('MOT', 'CHI')",Providence,ale43.xml,359,7,0,CHI,3495,1719,MOT
0,3,8,348,2.177588603,351,3,he,"('MOT', 'CHI')",Providence,ale43.xml,359,8,0,CHI,3495,1719,MOT
0,1,18,340,2.148850993,341,1,get,"('MOT', 'CHI')",Providence,ale43.xml,359,18,0,CHI,3495,1719,MOT
1,3,18,337,2.097141119,340,3,see,"('MOT', 'CHI')",Providence,ale43.xml,359,19,1,CHI,3495,1719,MOT
3,15,6,335,2.079441542,350,15,big,"('MOT', 'CHI')",Providence,ale43.xml,359,9,3,CHI,3495,1719,MOT
0,1,24,334,1.868839212,335,1,can,"('MOT', 'CHI')",Providence,ale43.xml,359,24,0,CHI,3495,1719,MOT
0,5,8,346,1.772123495,351,5,with,"('MOT', 'CHI')",Providence,ale43.xml,359,8,0,CHI,3495,1719,MOT
0,4,10,345,1.766441661,349,4,go,"('MOT', 'CHI')",Providence,ale43.xml,359,10,0,CHI,3495,1719,MOT
0,3,17,339,1.509908317,342,3,do,"('MOT', 'CHI')",Providence,ale43.xml,359,17,0,CHI,3495,1719,MOT
0,2,26,331,1.383313733,333,2,to,"('MOT', 'CHI')",Providence,ale43.xml,359,26,0,CHI,3495,1719,MOT
0,2,32,325,1.171084937,327,2,like,"('MOT', 'CHI')",Providence,ale43.xml,359,32,0,CHI,3495,1719,MOT
0,8,11,340,1.09575922,348,8,in,"('MOT', 'CHI')",Providence,ale43.xml,359,11,0,CHI,3495,1719,MOT
0,6,15,338,1.067315282,344,6,make,"('MOT', 'CHI')",Providence,ale43.xml,359,15,0,CHI,3495,1719,MOT
0,4,23,332,0.994732158,336,4,what,"('MOT', 'CHI')",Providence,ale43.xml,359,23,0,CHI,3495,1719,MOT
1,7,28,323,0.984853403,330,7,one,"('MOT', 'CHI')",Providence,ale43.xml,359,29,1,CHI,3495,1719,MOT
0,1,1,11,0.84729786,12,1,oh,"('CHI', 'MOT')",Providence,ale43.xml,13,1,0,MOT,85,110,CHI
0,1,1,11,0.84729786,12,1,it,"('CHI', 'MOT')",Providence,ale43.xml,13,1,0,MOT,85,110,CHI
0,1,1,11,0.84729786,12,1,with,"('CHI', 'MOT')",Providence,ale43.xml,13,1,0,MOT,85,110,CHI
2,13,27,317,0.830702723,330,13,is,"('MOT', 'CHI')",Providence,ale43.xml,359,29,2,CHI,3495,1719,MOT
0,3,34,322,0.820146871,325,3,oh,"('MOT', 'CHI')",Providence,ale43.xml,359,34,0,CHI,3495,1719,MOT
1,6,39,313,0.781008536,319,6,it,"('MOT', 'CHI')",Providence,ale43.xml,359,40,1,CHI,3495,1719,MOT
1,16,16,326,0.756136515,342,16,no,"('MOT', 'CHI')",Providence,ale43.xml,359,17,1,CHI,3495,1719,MOT
6,19,45,289,0.716458259,308,19,this,"('MOT', 'CHI')",Providence,ale43.xml,359,51,6,CHI,3495,1719,MOT
6,21,42,290,0.689047881,311,21,the,"('MOT', 'CHI')",Providence,ale43.xml,359,48,6,CHI,3495,1719,MOT
1,11,27,320,0.615185639,331,11,and,"('MOT', 'CHI')",Providence,ale43.xml,359,28,1,CHI,3495,1719,MOT
1,25,12,321,0.579202921,346,25,look,"('MOT', 'CHI')",Providence,ale43.xml,359,13,1,CHI,3495,1719,MOT
0,1,2,10,0.485507816,11,1,on,"('CHI', 'MOT')",Providence,ale43.xml,13,2,0,MOT,85,110,CHI
11,29,59,260,0.480366416,289,29,a,"('MOT', 'CHI')",Providence,ale43.xml,359,70,11,CHI,3495,1719,MOT
1,9,46,303,0.248134775,312,9,that,"('MOT', 'CHI')",Providence,ale43.xml,359,47,1,CHI,3495,1719,MOT
0,15,16,328,0.180583937,343,15,there,"('MOT', 'CHI')",Providence,ale43.xml,359,16,0,CHI,3495,1719,MOT
0,4,2,7,-0.430782916,11,4,a,"('CHI', 'MOT')",Providence,ale43.xml,13,2,0,MOT,85,110,CHI
1,0,3,285,4.560869927,285,0,big,"('MOT', 'CHI')",Providence,ale44.xml,289,4,1,CHI,2177,2104,MOT
1,0,7,281,4.036008985,281,0,where,"('MOT', 'CHI')",Providence,ale44.xml,289,8,1,CHI,2177,2104,MOT
1,1,0,140,3.864232342,141,1,where,"('CHI', 'MOT')",Providence,ale44.xml,142,1,1,MOT,796,1566,CHI
0,2,1,286,3.472656346,288,2,wanna,"('MOT', 'CHI')",Providence,ale44.xml,289,1,0,CHI,2177,2104,MOT
0,1,3,285,3.360375387,286,1,there,"('MOT', 'CHI')",Providence,ale44.xml,289,3,0,CHI,2177,2104,MOT
1,1,7,280,3.342861805,281,1,can,"('MOT', 'CHI')",Providence,ale44.xml,289,8,1,CHI,2177,2104,MOT
1,3,0,138,3.171085161,141,3,did,"('CHI', 'MOT')",Providence,ale44.xml,142,1,1,MOT,796,1566,CHI
1,2,5,281,3.16758253,283,2,for,"('MOT', 'CHI')",Providence,ale44.xml,289,6,1,CHI,2177,2104,MOT
0,1,6,282,2.879900458,283,1,but,"('MOT', 'CHI')",Providence,ale44.xml,289,6,0,CHI,2177,2104,MOT
0,1,2,139,2.876385516,140,1,my,"('CHI', 'MOT')",Providence,ale44.xml,142,2,0,MOT,796,1566,CHI
1,2,8,278,2.83854669,280,2,have,"('MOT', 'CHI')",Providence,ale44.xml,289,9,1,CHI,2177,2104,MOT
0,2,4,283,2.769110458,285,2,little,"('MOT', 'CHI')",Providence,ale44.xml,289,4,0,CHI,2177,2104,MOT
0,2,1,139,2.765620053,141,2,gonna,"('CHI', 'MOT')",Providence,ale44.xml,142,1,0,MOT,796,1566,CHI
0,2,1,139,2.765620053,141,2,some,"('CHI', 'MOT')",Providence,ale44.xml,142,1,0,MOT,796,1566,CHI
0,2,1,139,2.765620053,141,2,at,"('CHI', 'MOT')",Providence,ale44.xml,142,1,0,MOT,796,1566,CHI
4,5,9,271,2.737249356,276,5,one,"('MOT', 'CHI')",Providence,ale44.xml,289,13,4,CHI,2177,2104,MOT
4,4,14,267,2.613739522,271,4,do,"('MOT', 'CHI')",Providence,ale44.xml,289,18,4,CHI,2177,2104,MOT
0,1,9,279,2.550864618,280,1,gonna,"('MOT', 'CHI')",Providence,ale44.xml,289,9,0,CHI,2177,2104,MOT
0,1,9,279,2.550864618,280,1,see,"('MOT', 'CHI')",Providence,ale44.xml,289,9,0,CHI,2177,2104,MOT
0,3,1,138,2.47793798,141,3,can,"('CHI', 'MOT')",Providence,ale44.xml,142,1,0,MOT,796,1566,CHI
3,5,11,270,2.445963676,275,5,all,"('MOT', 'CHI')",Providence,ale44.xml,289,14,3,CHI,2177,2104,MOT
0,3,5,281,2.323787301,284,3,with,"('MOT', 'CHI')",Providence,ale44.xml,289,5,0,CHI,2177,2104,MOT
0,3,5,281,2.323787301,284,3,up,"('MOT', 'CHI')",Providence,ale44.xml,289,5,0,CHI,2177,2104,MOT
0,4,1,137,2.254794429,141,4,with,"('CHI', 'MOT')",Providence,ale44.xml,142,1,0,MOT,796,1566,CHI
0,2,8,279,2.244249516,281,2,put,"('MOT', 'CHI')",Providence,ale44.xml,289,8,0,CHI,2177,2104,MOT
1,0,0,11,2.159484249,11,0,on,"('MOT', 'GRA')",Providence,ale44.xml,12,1,1,GRA,89,79,MOT
0,2,9,278,2.145399509,280,2,not,"('MOT', 'CHI')",Providence,ale44.xml,289,9,0,CHI,2177,2104,MOT
1,0,0,10,2.079441542,10,0,go,"('GRA', 'CHI')",Providence,ale44.xml,11,1,1,CHI,67,41,GRA
0,5,1,136,2.072472872,141,5,little,"('CHI', 'MOT')",Providence,ale44.xml,142,1,0,MOT,796,1566,CHI
0,4,2,136,1.960094784,140,4,see,"('CHI', 'MOT')",Providence,ale44.xml,142,2,0,MOT,796,1566,CHI
0,3,3,136,1.953027617,139,3,all,"('CHI', 'MOT')",Providence,ale44.xml,142,3,0,MOT,796,1566,CHI
0,1,8,133,1.916922612,134,1,look,"('CHI', 'MOT')",Providence,ale44.xml,142,8,0,MOT,796,1566,CHI
0,4,3,135,1.729884066,139,4,for,"('CHI', 'MOT')",Providence,ale44.xml,142,3,0,MOT,796,1566,CHI
0,4,9,276,1.634573886,280,4,get,"('MOT', 'CHI')",Providence,ale44.xml,289,9,0,CHI,2177,2104,MOT
0,6,6,277,1.62713749,283,6,we,"('MOT', 'CHI')",Providence,ale44.xml,289,6,0,CHI,2177,2104,MOT
1,2,32,254,1.592146415,256,2,what,"('MOT', 'CHI')",Providence,ale44.xml,289,33,1,CHI,2177,2104,MOT
0,9,1,132,1.561647249,141,9,go,"('CHI', 'MOT')",Providence,ale44.xml,142,1,0,MOT,796,1566,CHI
0,9,1,132,1.561647249,141,9,what,"('CHI', 'MOT')",Providence,ale44.xml,142,1,0,MOT,796,1566,CHI
2,9,5,126,1.518783544,135,9,one,"('CHI', 'MOT')",Providence,ale44.xml,142,7,2,MOT,796,1566,CHI
0,7,6,276,1.493606097,283,7,did,"('MOT', 'CHI')",Providence,ale44.xml,289,6,0,CHI,2177,2104,MOT
4,13,16,256,1.48145695,269,13,and,"('MOT', 'CHI')",Providence,ale44.xml,289,20,4,CHI,2177,2104,MOT
1,1,0,10,1.466337069,11,1,you,"('CHI', 'GRA')",Providence,ale44.xml,12,1,1,GRA,50,69,CHI
1,1,0,10,1.466337069,11,1,see,"('CHI', 'GRA')",Providence,ale44.xml,12,1,1,GRA,50,69,CHI
0,6,8,275,1.396951656,281,6,go,"('MOT', 'CHI')",Providence,ale44.xml,289,8,0,CHI,2177,2104,MOT
2,20,6,261,1.396951656,281,20,this,"('MOT', 'CHI')",Providence,ale44.xml,289,8,2,CHI,2177,2104,MOT
1,7,15,266,1.340104979,273,7,to,"('MOT', 'CHI')",Providence,ale44.xml,289,16,1,CHI,2177,2104,MOT
3,15,4,120,1.336461987,135,15,is,"('CHI', 'MOT')",Providence,ale44.xml,142,7,3,MOT,796,1566,CHI
0,9,2,131,1.266947603,140,9,put,"('CHI', 'MOT')",Providence,ale44.xml,142,2,0,MOT,796,1566,CHI
0,7,3,132,1.259880436,139,7,of,"('CHI', 'MOT')",Providence,ale44.xml,142,3,0,MOT,796,1566,CHI
2,14,12,261,1.241990872,275,14,in,"('MOT', 'CHI')",Providence,ale44.xml,289,14,2,CHI,2177,2104,MOT
1,13,9,266,1.20753787,279,13,on,"('MOT', 'CHI')",Providence,ale44.xml,289,10,1,CHI,2177,2104,MOT
0,10,2,130,1.171637424,140,10,there,"('CHI', 'MOT')",Providence,ale44.xml,142,2,0,MOT,796,1566,CHI
12,27,23,227,1.167004379,254,27,the,"('MOT', 'CHI')",Providence,ale44.xml,289,35,12,CHI,2177,2104,MOT
3,13,19,254,1.163894581,267,13,it,"('MOT', 'CHI')",Providence,ale44.xml,289,22,3,CHI,2177,2104,MOT
2,14,5,121,1.113318436,135,14,get,"('CHI', 'MOT')",Providence,ale44.xml,142,7,2,MOT,796,1566,CHI
0,13,5,271,1.071024332,284,13,my,"('MOT', 'CHI')",Providence,ale44.xml,289,5,0,CHI,2177,2104,MOT
2,13,6,121,1.069624752,134,13,and,"('CHI', 'MOT')",Providence,ale44.xml,142,8,2,MOT,796,1566,CHI
1,13,11,264,1.046244303,277,13,like,"('MOT', 'CHI')",Providence,ale44.xml,289,12,1,CHI,2177,2104,MOT
1,9,17,262,1.004301609,271,9,oh,"('MOT', 'CHI')",Providence,ale44.xml,289,18,1,CHI,2177,2104,MOT
0,3,23,263,0.985816795,266,3,are,"('MOT', 'CHI')",Providence,ale44.xml,289,23,0,CHI,2177,2104,MOT
0,8,10,271,0.956223442,279,8,look,"('MOT', 'CHI')",Providence,ale44.xml,289,10,0,CHI,2177,2104,MOT
3,16,22,248,0.84074046,264,16,a,"('MOT', 'CHI')",Providence,ale44.xml,289,25,3,CHI,2177,2104,MOT
2,9,30,248,0.826494733,257,9,that,"('MOT', 'CHI')",Providence,ale44.xml,289,32,2,CHI,2177,2104,MOT
0,6,16,267,0.780489191,273,6,is,"('MOT', 'CHI')",Providence,ale44.xml,289,16,0,CHI,2177,2104,MOT
0,12,3,127,0.77437262,139,12,that,"('CHI', 'MOT')",Providence,ale44.xml,142,3,0,MOT,796,1566,CHI
0,1,1,10,0.773189888,11,1,there,"('MOT', 'GRA')",Providence,ale44.xml,12,1,0,GRA,89,79,MOT
0,1,1,10,0.773189888,11,1,see,"('MOT', 'GRA')",Providence,ale44.xml,12,1,0,GRA,89,79,MOT
1,9,10,122,0.715961858,131,9,this,"('CHI', 'MOT')",Providence,ale44.xml,142,11,1,MOT,796,1566,CHI
6,49,11,223,0.702576271,272,49,no,"('MOT', 'CHI')",Providence,ale44.xml,289,17,6,CHI,2177,2104,MOT
0,11,4,127,0.664976304,138,11,in,"('CHI', 'MOT')",Providence,ale44.xml,142,4,0,MOT,796,1566,CHI
8,29,10,95,0.636576829,124,29,it,"('CHI', 'MOT')",Providence,ale44.xml,142,18,8,MOT,796,1566,CHI
0,14,3,125,0.631271777,139,14,on,"('CHI', 'MOT')",Providence,ale44.xml,142,3,0,MOT,796,1566,CHI
1,29,2,110,0.631271777,139,29,to,"('CHI', 'MOT')",Providence,ale44.xml,142,3,1,MOT,796,1566,CHI
1,18,5,118,0.596520345,136,18,like,"('CHI', 'MOT')",Providence,ale44.xml,142,6,1,MOT,796,1566,CHI
0,1,1,7,0.510825624,8,1,look,"('GRA', 'MOT')",Providence,ale44.xml,9,1,0,MOT,97,67,GRA
0,1,1,7,0.510825624,8,1,put,"('GRA', 'MOT')",Providence,ale44.xml,9,1,0,MOT,97,67,GRA
0,1,1,7,0.510825624,8,1,on,"('GRA', 'MOT')",Providence,ale44.xml,9,1,0,MOT,97,67,GRA
1,1,2,5,0.470003629,6,1,the,"('GRA', 'MOT')",Providence,ale44.xml,9,3,1,MOT,97,67,GRA
3,7,66,213,0.446850324,220,7,you,"('MOT', 'CHI')",Providence,ale44.xml,289,69,3,CHI,2177,2104,MOT
0,1,2,9,0.405465108,10,1,look,"('CHI', 'GRA')",Providence,ale44.xml,12,2,0,GRA,50,69,CHI
0,1,2,9,0.405465108,10,1,of,"('MOT', 'GRA')",Providence,ale44.xml,12,2,0,GRA,89,79,MOT
0,1,2,9,0.405465108,10,1,what,"('MOT', 'GRA')",Providence,ale44.xml,12,2,0,GRA,89,79,MOT
0,2,1,9,0.36772478,11,2,you,"('MOT', 'GRA')",Providence,ale44.xml,12,1,0,GRA,89,79,MOT
0,13,6,123,0.208754814,136,13,oh,"('CHI', 'MOT')",Providence,ale44.xml,142,6,0,MOT,796,1566,CHI
0,1,2,6,0.117783036,7,1,at,"('GRA', 'MOT')",Providence,ale44.xml,9,2,0,MOT,97,67,GRA
0,2,1,6,0.105360516,8,2,you,"('GRA', 'MOT')",Providence,ale44.xml,9,1,0,MOT,97,67,GRA
0,3,1,8,0.080042708,11,3,to,"('MOT', 'GRA')",Providence,ale44.xml,12,1,0,GRA,89,79,MOT
1,22,8,111,0.06503247,133,22,a,"('CHI', 'MOT')",Providence,ale44.xml,142,9,1,MOT,796,1566,CHI
0,16,6,120,0.014598799,136,16,no,"('CHI', 'MOT')",Providence,ale44.xml,142,6,0,MOT,796,1566,CHI
0,2,2,8,0,10,2,oh,"('MOT', 'GRA')",Providence,ale44.xml,12,2,0,GRA,89,79,MOT
2,25,13,102,-0.132885189,127,25,the,"('CHI', 'MOT')",Providence,ale44.xml,142,15,2,MOT,796,1566,CHI
2,48,7,85,-0.285828504,133,48,you,"('CHI', 'MOT')",Providence,ale44.xml,142,9,2,MOT,796,1566,CHI
1,1,0,100,3.5361167,101,1,big,"('MOT', 'CHI')",Providence,ale45.xml,102,1,1,CHI,861,600,MOT
1,0,3,98,3.506557897,98,0,go,"('MOT', 'CHI')",Providence,ale45.xml,102,4,1,CHI,861,600,MOT
0,4,1,335,3.123832276,339,4,wanna,"('CHI', 'MOT')",Providence,ale45.xml,340,1,0,MOT,2001,3231,CHI
0,4,1,335,3.123832276,339,4,on,"('CHI', 'MOT')",Providence,ale45.xml,340,1,0,MOT,2001,3231,CHI
0,3,2,335,3.056356895,338,3,my,"('CHI', 'MOT')",Providence,ale45.xml,340,2,0,MOT,2001,3231,CHI
0,5,1,334,2.941510719,339,5,they,"('CHI', 'MOT')",Providence,ale45.xml,340,1,0,MOT,2001,3231,CHI
0,1,1,100,2.842969519,101,1,in,"('MOT', 'CHI')",Providence,ale45.xml,102,1,0,CHI,861,600,MOT
0,1,1,100,2.842969519,101,1,for,"('MOT', 'CHI')",Providence,ale45.xml,102,1,0,CHI,861,600,MOT
0,1,1,100,2.842969519,101,1,did,"('MOT', 'CHI')",Providence,ale45.xml,102,1,0,CHI,861,600,MOT
0,1,1,100,2.842969519,101,1,wanna,"('MOT', 'CHI')",Providence,ale45.xml,102,1,0,CHI,861,600,MOT
0,5,2,333,2.650891787,338,5,get,"('CHI', 'MOT')",Providence,ale45.xml,340,2,0,MOT,2001,3231,CHI
0,1,2,99,2.545531272,100,1,not,"('MOT', 'CHI')",Providence,ale45.xml,102,2,0,CHI,861,600,MOT
0,8,1,331,2.536045611,339,8,gonna,"('CHI', 'MOT')",Providence,ale45.xml,340,1,0,MOT,2001,3231,CHI
1,3,12,324,2.394860369,327,3,big,"('CHI', 'MOT')",Providence,ale45.xml,340,13,1,MOT,2001,3231,CHI
0,1,3,98,2.312535424,99,1,make,"('MOT', 'CHI')",Providence,ale45.xml,102,3,0,CHI,861,600,MOT
0,1,3,98,2.312535424,99,1,on,"('MOT', 'CHI')",Providence,ale45.xml,102,3,0,CHI,861,600,MOT
1,6,0,95,2.283353731,101,6,look,"('MOT', 'CHI')",Providence,ale45.xml,102,1,1,CHI,861,600,MOT
0,11,1,328,2.248363539,339,11,see,"('CHI', 'MOT')",Providence,ale45.xml,340,1,0,MOT,2001,3231,CHI
0,11,1,328,2.248363539,339,11,put,"('CHI', 'MOT')",Providence,ale45.xml,340,1,0,MOT,2001,3231,CHI
0,12,1,327,2.168320831,339,12,are,"('CHI', 'MOT')",Providence,ale45.xml,340,1,0,MOT,2001,3231,CHI
3,25,1,311,2.159484249,336,25,do,"('CHI', 'MOT')",Providence,ale45.xml,340,4,3,MOT,2001,3231,CHI
1,0,0,11,2.159484249,11,0,put,"('MOT', 'ADU')",Providence,ale45.xml,12,1,1,ADU,104,84,MOT
1,0,0,11,2.159484249,11,0,are,"('MOT', 'ADU')",Providence,ale45.xml,12,1,1,ADU,104,84,MOT
0,1,4,97,2.120263536,98,1,are,"('MOT', 'CHI')",Providence,ale45.xml,102,4,0,CHI,861,600,MOT
0,13,1,326,2.094212859,339,13,all,"('CHI', 'MOT')",Providence,ale45.xml,340,1,0,MOT,2001,3231,CHI
0,13,1,326,2.094212859,339,13,at,"('CHI', 'MOT')",Providence,ale45.xml,340,1,0,MOT,2001,3231,CHI
0,8,3,329,2.019337618,337,8,did,"('CHI', 'MOT')",Providence,ale45.xml,340,3,0,MOT,2001,3231,CHI
0,4,7,329,2.007468042,333,4,with,"('CHI', 'MOT')",Providence,ale45.xml,340,7,0,MOT,2001,3231,CHI
1,12,4,323,2.002370604,335,12,go,"('CHI', 'MOT')",Providence,ale45.xml,340,5,1,MOT,2001,3231,CHI
1,15,3,321,1.951844885,336,15,can,"('CHI', 'MOT')",Providence,ale45.xml,340,4,1,MOT,2001,3231,CHI
1,0,0,8,1.897119985,8,0,go,"('GRA', 'ADU')",Providence,ale45.xml,9,1,1,ADU,48,56,GRA
0,12,2,326,1.877701899,338,12,what,"('CHI', 'MOT')",Providence,ale45.xml,340,2,0,MOT,2001,3231,CHI
5,18,9,308,1.867745376,326,18,little,"('CHI', 'MOT')",Providence,ale45.xml,340,14,5,MOT,2001,3231,CHI
0,13,2,325,1.803593927,338,13,there,"('CHI', 'MOT')",Providence,ale45.xml,340,2,0,MOT,2001,3231,CHI
6,9,28,297,1.789905901,306,9,look,"('CHI', 'MOT')",Providence,ale45.xml,340,34,6,MOT,2001,3231,CHI
0,1,7,94,1.684339221,95,1,to,"('MOT', 'CHI')",Providence,ale45.xml,102,7,0,CHI,861,600,MOT
1,0,0,6,1.673976434,6,0,he,"('GRA', 'MOT')",Providence,ale45.xml,7,1,1,MOT,42,34,GRA
0,2,5,95,1.550597412,97,2,that,"('MOT', 'CHI')",Providence,ale45.xml,102,5,0,CHI,861,600,MOT
1,0,0,5,1.540445041,5,0,make,"('CHI', 'ADU')",Providence,ale45.xml,6,1,1,ADU,61,36,CHI
0,1,9,92,1.462834438,93,1,do,"('MOT', 'CHI')",Providence,ale45.xml,102,9,0,CHI,861,600,MOT
1,6,4,91,1.396446733,97,6,and,"('MOT', 'CHI')",Providence,ale45.xml,102,5,1,CHI,861,600,MOT
0,16,3,321,1.383348851,337,16,for,"('CHI', 'MOT')",Providence,ale45.xml,340,3,0,MOT,2001,3231,CHI
7,8,11,76,1.340831987,84,8,a,"('MOT', 'CHI')",Providence,ale45.xml,102,18,7,CHI,861,600,MOT
0,11,6,323,1.252762968,334,11,in,"('CHI', 'MOT')",Providence,ale45.xml,340,6,0,MOT,2001,3231,CHI
1,1,21,79,1.228665417,80,1,the,"('MOT', 'CHI')",Providence,ale45.xml,102,22,1,CHI,861,600,MOT
1,0,0,3,1.203972804,3,0,did,"('ADU', 'GRA')",Providence,ale45.xml,4,1,1,GRA,15,23,ADU
1,1,0,6,1.098612289,7,1,it,"('ADU', 'MOT')",Providence,ale45.xml,8,1,1,MOT,48,40,ADU
2,0,1,3,1.098612289,3,0,a,"('CHI', 'ADU')",Providence,ale45.xml,6,3,2,ADU,61,36,CHI
5,23,22,290,0.998982448,313,23,and,"('CHI', 'MOT')",Providence,ale45.xml,340,27,5,MOT,2001,3231,CHI
6,44,11,279,0.978633862,323,44,it,"('CHI', 'MOT')",Providence,ale45.xml,340,17,6,MOT,2001,3231,CHI
0,21,4,315,0.940243973,336,21,is,"('CHI', 'MOT')",Providence,ale45.xml,340,4,0,MOT,2001,3231,CHI
1,0,1,3,0.916290732,3,0,a,"('ADU', 'CHI')",Providence,ale45.xml,5,2,1,CHI,36,15,ADU
2,3,21,76,0.887891257,79,3,you,"('MOT', 'CHI')",Providence,ale45.xml,102,23,2,CHI,861,600,MOT
0,6,4,92,0.867500568,98,6,it,"('MOT', 'CHI')",Providence,ale45.xml,102,4,0,CHI,861,600,MOT
0,1,17,84,0.828321959,85,1,is,"('MOT', 'CHI')",Providence,ale45.xml,102,17,0,CHI,861,600,MOT
2,7,45,286,0.814325805,293,7,no,"('CHI', 'MOT')",Providence,ale45.xml,340,47,2,MOT,2001,3231,CHI
1,1,1,6,0.810930216,7,1,on,"('GRA', 'ADU')",Providence,ale45.xml,9,2,1,ADU,48,56,GRA
0,1,1,10,0.773189888,11,1,get,"('MOT', 'ADU')",Providence,ale45.xml,12,1,0,ADU,104,84,MOT
0,1,1,10,0.773189888,11,1,it,"('MOT', 'ADU')",Providence,ale45.xml,12,1,0,ADU,104,84,MOT
0,1,1,10,0.773189888,11,1,for,"('MOT', 'ADU')",Providence,ale45.xml,12,1,0,ADU,104,84,MOT
2,18,20,300,0.744440475,318,18,make,"('CHI', 'MOT')",Providence,ale45.xml,340,22,2,MOT,2001,3231,CHI
0,4,8,90,0.652325186,94,4,oh,"('MOT', 'CHI')",Providence,ale45.xml,102,8,0,CHI,861,600,MOT
1,12,5,84,0.63372376,96,12,one,"('MOT', 'CHI')",Providence,ale45.xml,102,6,1,CHI,861,600,MOT
0,1,1,8,0.606135804,9,1,a,"('GRA', 'CHI')",Providence,ale45.xml,10,1,0,CHI,39,45,GRA
0,1,1,8,0.606135804,9,1,one,"('GRA', 'CHI')",Providence,ale45.xml,10,1,0,CHI,39,45,GRA
0,7,5,90,0.569768159,97,7,no,"('MOT', 'CHI')",Providence,ale45.xml,102,5,0,CHI,861,600,MOT
5,41,19,275,0.558044696,316,41,the,"('CHI', 'MOT')",Providence,ale45.xml,340,24,5,MOT,2001,3231,CHI
1,9,8,84,0.546543706,93,9,like,"('MOT', 'CHI')",Providence,ale45.xml,102,9,1,CHI,861,600,MOT
0,1,1,6,0.405465108,7,1,are,"('ADU', 'MOT')",Providence,ale45.xml,8,1,0,MOT,48,40,ADU
0,1,1,6,0.405465108,7,1,oh,"('CHI', 'GRA')",Providence,ale45.xml,8,1,0,GRA,27,65,CHI
0,1,2,9,0.405465108,10,1,like,"('MOT', 'ADU')",Providence,ale45.xml,12,2,0,ADU,104,84,MOT
0,1,2,9,0.405465108,10,1,this,"('MOT', 'ADU')",Providence,ale45.xml,12,2,0,ADU,104,84,MOT
5,47,22,266,0.305835267,313,47,one,"('CHI', 'MOT')",Providence,ale45.xml,340,27,5,MOT,2001,3231,CHI
3,98,5,234,0.299730411,332,98,you,"('CHI', 'MOT')",Providence,ale45.xml,340,8,3,MOT,2001,3231,CHI
0,1,1,5,0.287682072,6,1,it,"('GRA', 'MOT')",Providence,ale45.xml,7,1,0,MOT,42,34,GRA
0,1,1,5,0.287682072,6,1,see,"('GRA', 'MOT')",Providence,ale45.xml,7,1,0,MOT,42,34,GRA
0,1,1,5,0.287682072,6,1,the,"('GRA', 'MOT')",Providence,ale45.xml,7,1,0,MOT,42,34,GRA
1,45,8,286,0.274753001,331,45,like,"('CHI', 'MOT')",Providence,ale45.xml,340,9,1,MOT,2001,3231,CHI
8,37,45,250,0.21873192,287,37,a,"('CHI', 'MOT')",Providence,ale45.xml,340,53,8,MOT,2001,3231,CHI
0,38,5,297,0.210611135,335,38,that,"('CHI', 'MOT')",Providence,ale45.xml,340,5,0,MOT,2001,3231,CHI
0,2,1,7,0.200670695,9,2,my,"('GRA', 'CHI')",Providence,ale45.xml,10,1,0,CHI,39,45,GRA
0,1,2,6,0.117783036,7,1,you,"('GRA', 'ADU')",Providence,ale45.xml,9,2,0,ADU,48,56,GRA
1,2,3,6,0.105360516,8,2,you,"('MOT', 'ADU')",Providence,ale45.xml,12,4,1,ADU,104,84,MOT
0,44,5,291,0.067510292,335,44,to,"('CHI', 'MOT')",Providence,ale45.xml,340,5,0,MOT,2001,3231,CHI
0,2,2,8,0,10,2,a,"('MOT', 'ADU')",Providence,ale45.xml,12,2,0,ADU,104,84,MOT
4,54,26,256,-0.120627988,310,54,this,"('CHI', 'MOT')",Providence,ale45.xml,340,30,4,MOT,2001,3231,CHI
1,36,17,286,-0.13275949,322,36,oh,"('CHI', 'MOT')",Providence,ale45.xml,340,18,1,MOT,2001,3231,CHI
0,1,1,2,-0.182321557,3,1,you,"('ADU', 'GRA')",Providence,ale45.xml,4,1,0,GRA,15,23,ADU
3,14,24,61,-0.345246248,75,14,this,"('MOT', 'CHI')",Providence,ale45.xml,102,27,3,CHI,861,600,MOT
0,1,3,4,-0.356674944,5,1,look,"('CHI', 'GRA')",Providence,ale45.xml,8,3,0,GRA,27,65,CHI
0,2,2,4,-0.405465108,6,2,you,"('ADU', 'MOT')",Providence,ale45.xml,8,2,0,MOT,48,40,ADU
0,1,2,2,-0.470003629,3,1,a,"('MOT', 'GRA')",Providence,ale45.xml,5,2,0,GRA,39,21,MOT
1,0,1,203,4.629862799,203,0,of,"('MOT', 'CHI')",Providence,ale46.xml,205,2,1,CHI,2035,988,MOT
1,3,0,182,3.439349148,185,3,all,"('CHI', 'MOT')",Providence,ale46.xml,186,1,1,MOT,1071,1583,CHI
0,1,2,202,3.243568437,203,1,big,"('MOT', 'CHI')",Providence,ale46.xml,205,2,0,CHI,2035,988,MOT
1,3,1,181,3.146305132,184,3,they,"('CHI', 'MOT')",Providence,ale46.xml,186,2,1,MOT,1071,1583,CHI
0,2,1,202,3.130651591,204,2,where,"('MOT', 'CHI')",Providence,ale46.xml,205,1,0,CHI,2035,988,MOT
0,2,1,183,3.03388404,185,2,some,"('CHI', 'MOT')",Providence,ale46.xml,186,1,0,MOT,1071,1583,CHI
0,1,3,201,3.015534901,202,1,all,"('MOT', 'CHI')",Providence,ale46.xml,205,3,0,CHI,2035,988,MOT
0,1,3,201,3.015534901,202,1,some,"('MOT', 'CHI')",Providence,ale46.xml,205,3,0,CHI,2035,988,MOT
2,2,7,194,2.890371758,196,2,see,"('MOT', 'CHI')",Providence,ale46.xml,205,9,2,CHI,2035,988,MOT
1,2,4,179,2.858110896,181,2,put,"('CHI', 'MOT')",Providence,ale46.xml,186,5,1,MOT,1071,1583,CHI
0,1,4,200,2.828299329,201,1,with,"('MOT', 'CHI')",Providence,ale46.xml,205,4,0,CHI,2035,988,MOT
0,1,4,200,2.828299329,201,1,he,"('MOT', 'CHI')",Providence,ale46.xml,205,4,0,CHI,2035,988,MOT
0,3,1,182,2.746201967,185,3,want,"('CHI', 'MOT')",Providence,ale46.xml,186,1,0,MOT,1071,1583,CHI
0,2,2,182,2.740840024,184,2,little,"('CHI', 'MOT')",Providence,ale46.xml,186,2,0,MOT,1071,1583,CHI
0,1,4,181,2.730029108,182,1,was,"('CHI', 'MOT')",Providence,ale46.xml,186,4,0,MOT,1071,1583,CHI
1,3,3,179,2.730029108,182,3,where,"('CHI', 'MOT')",Providence,ale46.xml,186,4,1,MOT,1071,1583,CHI
1,4,2,179,2.694627181,183,4,are,"('CHI', 'MOT')",Providence,ale46.xml,186,3,1,MOT,1071,1583,CHI
0,1,5,199,2.669210368,200,1,gonna,"('MOT', 'CHI')",Providence,ale46.xml,205,5,0,CHI,2035,988,MOT
0,1,5,199,2.669210368,200,1,we,"('MOT', 'CHI')",Providence,ale46.xml,205,5,0,CHI,2035,988,MOT
1,0,0,17,2.538973871,17,0,to,"('GRA', 'MOT')",Providence,ale46.xml,18,1,1,MOT,100,143,GRA
0,4,1,181,2.523058416,185,4,gonna,"('CHI', 'MOT')",Providence,ale46.xml,186,1,0,MOT,1071,1583,CHI
0,4,1,181,2.523058416,185,4,can,"('CHI', 'MOT')",Providence,ale46.xml,186,1,0,MOT,1071,1583,CHI
1,1,14,189,2.424282028,190,1,what,"('MOT', 'CHI')",Providence,ale46.xml,205,15,1,CHI,2035,988,MOT
2,2,13,188,2.424282028,190,2,that,"('MOT', 'CHI')",Providence,ale46.xml,205,15,2,CHI,2035,988,MOT
0,2,4,199,2.422834221,201,2,yeah,"('MOT', 'CHI')",Providence,ale46.xml,205,4,0,CHI,2035,988,MOT
1,0,2,26,2.415913778,26,0,it,"('MOT', 'GRA')",Providence,ale46.xml,29,3,1,GRA,290,149,MOT
0,1,7,197,2.407945609,198,1,for,"('MOT', 'CHI')",Providence,ale46.xml,205,7,0,CHI,2035,988,MOT
0,5,1,180,2.340736859,185,5,get,"('CHI', 'MOT')",Providence,ale46.xml,186,1,0,MOT,1071,1583,CHI
0,5,1,180,2.340736859,185,5,she,"('CHI', 'MOT')",Providence,ale46.xml,186,1,0,MOT,1071,1583,CHI
1,1,0,27,2.302585093,28,1,with,"('MOT', 'GRA')",Providence,ale46.xml,29,1,1,GRA,290,149,MOT
0,1,8,196,2.297572551,197,1,are,"('MOT', 'CHI')",Providence,ale46.xml,205,8,0,CHI,2035,988,MOT
0,6,1,198,2.283353731,204,6,want,"('MOT', 'CHI')",Providence,ale46.xml,205,1,0,CHI,2035,988,MOT
0,4,2,180,2.2300144,184,4,big,"('CHI', 'MOT')",Providence,ale46.xml,186,2,0,MOT,1071,1583,CHI
1,0,3,25,2.197224577,25,0,get,"('MOT', 'GRA')",Providence,ale46.xml,29,4,1,GRA,290,149,MOT
0,6,1,179,2.186586179,185,6,do,"('CHI', 'MOT')",Providence,ale46.xml,186,1,0,MOT,1071,1583,CHI
0,2,6,197,2.125251078,199,2,on,"('MOT', 'CHI')",Providence,ale46.xml,205,6,0,CHI,2035,988,MOT
0,2,7,196,2.002480501,198,2,get,"('MOT', 'CHI')",Providence,ale46.xml,205,7,0,CHI,2035,988,MOT
0,4,3,179,2.00148,183,4,did,"('CHI', 'MOT')",Providence,ale46.xml,186,3,0,MOT,1071,1583,CHI
0,6,2,178,1.893542164,184,6,like,"('CHI', 'MOT')",Providence,ale46.xml,186,2,0,MOT,1071,1583,CHI
0,4,4,178,1.813738376,182,4,at,"('CHI', 'MOT')",Providence,ale46.xml,186,4,0,MOT,1071,1583,CHI
1,9,3,173,1.813738376,182,9,what,"('CHI', 'MOT')",Providence,ale46.xml,186,4,1,MOT,1071,1583,CHI
3,6,14,182,1.742969305,188,6,in,"('MOT', 'CHI')",Providence,ale46.xml,205,17,3,CHI,2035,988,MOT
1,1,2,25,1.722766598,26,1,oh,"('MOT', 'GRA')",Providence,ale46.xml,29,3,1,GRA,290,149,MOT
1,10,3,172,1.718428196,182,10,one,"('CHI', 'MOT')",Providence,ale46.xml,186,4,1,MOT,1071,1583,CHI
0,2,10,193,1.69968479,195,2,there,"('MOT', 'CHI')",Providence,ale46.xml,205,10,0,CHI,2035,988,MOT
0,6,3,177,1.665007764,183,6,for,"('CHI', 'MOT')",Providence,ale46.xml,186,3,0,MOT,1071,1583,CHI
0,1,1,27,1.609437912,28,1,a,"('MOT', 'GRA')",Providence,ale46.xml,29,1,0,GRA,290,149,MOT
0,1,1,27,1.609437912,28,1,can,"('MOT', 'GRA')",Providence,ale46.xml,29,1,0,GRA,290,149,MOT
5,8,18,174,1.590594825,182,8,little,"('MOT', 'CHI')",Providence,ale46.xml,205,23,5,CHI,2035,988,MOT
1,2,1,25,1.575536361,27,2,on,"('MOT', 'GRA')",Providence,ale46.xml,29,2,1,GRA,290,149,MOT
0,6,4,176,1.477266139,182,6,up,"('CHI', 'MOT')",Providence,ale46.xml,186,4,0,MOT,1071,1583,CHI
0,6,4,176,1.477266139,182,6,he,"('CHI', 'MOT')",Providence,ale46.xml,186,4,0,MOT,1071,1583,CHI
6,4,43,152,1.467241637,156,4,you,"('MOT', 'CHI')",Providence,ale46.xml,205,49,6,CHI,2035,988,MOT
3,8,16,178,1.380989309,186,8,to,"('MOT', 'CHI')",Providence,ale46.xml,205,19,3,CHI,2035,988,MOT
0,7,4,175,1.343734747,182,7,on,"('CHI', 'MOT')",Providence,ale46.xml,186,4,0,MOT,1071,1583,CHI
0,5,6,175,1.332805676,180,5,my,"('CHI', 'MOT')",Providence,ale46.xml,186,6,0,MOT,1071,1583,CHI
0,1,2,26,1.287854288,27,1,have,"('MOT', 'GRA')",Providence,ale46.xml,29,2,0,GRA,290,149,MOT
2,9,12,182,1.286128662,191,9,my,"('MOT', 'CHI')",Providence,ale46.xml,205,14,2,CHI,2035,988,MOT
0,3,12,190,1.247647868,193,3,do,"('MOT', 'CHI')",Providence,ale46.xml,205,12,0,CHI,2035,988,MOT
0,8,4,174,1.225951711,182,8,with,"('CHI', 'MOT')",Providence,ale46.xml,186,4,0,MOT,1071,1583,CHI
1,1,2,14,1.223775432,15,1,see,"('GRA', 'MOT')",Providence,ale46.xml,18,3,1,MOT,100,143,GRA
0,2,1,26,1.203972804,28,2,this,"('MOT', 'GRA')",Providence,ale46.xml,29,1,0,GRA,290,149,MOT
0,2,1,26,1.203972804,28,2,up,"('MOT', 'GRA')",Providence,ale46.xml,29,1,0,GRA,290,149,MOT
0,2,1,26,1.203972804,28,2,do,"('MOT', 'GRA')",Providence,ale46.xml,29,1,0,GRA,290,149,MOT
4,17,9,156,1.175801927,173,17,a,"('CHI', 'MOT')",Providence,ale46.xml,186,13,4,MOT,1071,1583,CHI
0,1,1,16,1.15267951,17,1,like,"('GRA', 'MOT')",Providence,ale46.xml,18,1,0,MOT,100,143,GRA
0,1,1,16,1.15267951,17,1,look,"('GRA', 'MOT')",Providence,ale46.xml,18,1,0,MOT,100,143,GRA
0,1,1,16,1.15267951,17,1,there,"('GRA', 'MOT')",Providence,ale46.xml,18,1,0,MOT,100,143,GRA
0,1,1,16,1.15267951,17,1,big,"('GRA', 'MOT')",Providence,ale46.xml,18,1,0,MOT,100,143,GRA
0,2,18,185,1.147402453,187,2,like,"('MOT', 'CHI')",Providence,ale46.xml,205,18,0,CHI,2035,988,MOT
1,12,6,167,1.129470277,179,12,and,"('CHI', 'MOT')",Providence,ale46.xml,186,7,1,MOT,1071,1583,CHI
0,9,4,173,1.120591195,182,9,there,"('CHI', 'MOT')",Providence,ale46.xml,186,4,0,MOT,1071,1583,CHI
1,7,13,184,1.103807106,191,7,it,"('MOT', 'CHI')",Providence,ale46.xml,205,14,1,CHI,2035,988,MOT
0,1,1,15,1.098612289,16,1,is,"('GRA', 'CHI')",Providence,ale46.xml,17,1,0,CHI,87,69,GRA
2,11,11,162,1.070441412,173,11,no,"('CHI', 'MOT')",Providence,ale46.xml,186,13,2,MOT,1071,1583,CHI
0,10,4,172,1.025281016,182,10,see,"('CHI', 'MOT')",Providence,ale46.xml,186,4,0,MOT,1071,1583,CHI
0,10,4,172,1.025281016,182,10,to,"('CHI', 'MOT')",Providence,ale46.xml,186,4,0,MOT,1071,1583,CHI
2,15,8,161,1.022900467,176,15,this,"('CHI', 'MOT')",Providence,ale46.xml,186,10,2,MOT,1071,1583,CHI
0,17,2,167,0.949080555,184,17,that,"('CHI', 'MOT')",Providence,ale46.xml,186,2,0,MOT,1071,1583,CHI
0,8,6,172,0.927340568,180,8,go,"('CHI', 'MOT')",Providence,ale46.xml,186,6,0,MOT,1071,1583,CHI
0,2,2,25,0.88238918,27,2,gonna,"('MOT', 'GRA')",Providence,ale46.xml,29,2,0,GRA,290,149,MOT
0,5,12,188,0.84218276,193,5,one,"('MOT', 'CHI')",Providence,ale46.xml,205,12,0,CHI,2035,988,MOT
2,2,6,19,0.832909123,21,2,you,"('MOT', 'GRA')",Providence,ale46.xml,29,8,2,GRA,290,149,MOT
0,1,4,24,0.810930216,25,1,of,"('MOT', 'GRA')",Providence,ale46.xml,29,4,0,GRA,290,149,MOT
0,1,4,24,0.810930216,25,1,what,"('MOT', 'GRA')",Providence,ale46.xml,29,4,0,GRA,290,149,MOT
0,1,4,24,0.810930216,25,1,that,"('MOT', 'GRA')",Providence,ale46.xml,29,4,0,GRA,290,149,MOT
0,9,7,189,0.798507696,198,9,go,"('MOT', 'CHI')",Providence,ale46.xml,205,7,0,CHI,2035,988,MOT
8,19,26,152,0.77126496,171,19,the,"('MOT', 'CHI')",Providence,ale46.xml,205,34,8,CHI,2035,988,MOT
0,1,2,14,0.753771802,15,1,in,"('GRA', 'CHI')",Providence,ale46.xml,17,2,0,CHI,87,69,GRA
0,1,2,14,0.753771802,15,1,one,"('GRA', 'CHI')",Providence,ale46.xml,17,2,0,CHI,87,69,GRA
0,2,1,15,0.747214402,17,2,that,"('GRA', 'MOT')",Providence,ale46.xml,18,1,0,MOT,100,143,GRA
0,1,5,23,0.619039208,24,1,the,"('MOT', 'GRA')",Providence,ale46.xml,29,5,0,GRA,290,149,MOT
0,3,2,24,0.594707108,27,3,in,"('MOT', 'GRA')",Providence,ale46.xml,29,2,0,GRA,290,149,MOT
0,7,12,186,0.554500687,193,7,is,"('MOT', 'CHI')",Providence,ale46.xml,205,12,0,CHI,2035,988,MOT
2,12,19,153,0.516162528,165,12,look,"('CHI', 'MOT')",Providence,ale46.xml,186,21,2,MOT,1071,1583,CHI
0,1,1,7,0.510825624,8,1,you,"('MOT', 'OPE')",Providence,ale46.xml,9,1,0,OPE,60,27,MOT
0,1,1,7,0.510825624,8,1,no,"('MOT', 'OPE')",Providence,ale46.xml,9,1,0,OPE,60,27,MOT
2,37,5,142,0.462298583,179,37,you,"('CHI', 'MOT')",Providence,ale46.xml,186,7,2,MOT,1071,1583,CHI
0,2,4,23,0.405465108,25,2,no,"('MOT', 'GRA')",Providence,ale46.xml,29,4,0,GRA,290,149,MOT
0,1,1,6,0.405465108,7,1,and,"('CHI', 'GRA')",Providence,ale46.xml,8,1,0,GRA,22,30,CHI
0,2,2,14,0.405465108,16,2,go,"('GRA', 'MOT')",Providence,ale46.xml,18,2,0,MOT,100,143,GRA
0,11,9,185,0.405465108,196,11,no,"('MOT', 'CHI')",Providence,ale46.xml,205,9,0,CHI,2035,988,MOT
0,9,10,167,0.394291808,176,9,in,"('CHI', 'MOT')",Providence,ale46.xml,186,10,0,MOT,1071,1583,CHI
1,12,15,158,0.385320542,170,12,is,"('CHI', 'MOT')",Providence,ale46.xml,186,16,1,MOT,1071,1583,CHI
0,2,2,13,0.348306694,15,2,the,"('GRA', 'CHI')",Providence,ale46.xml,17,2,0,CHI,87,69,GRA
0,2,2,13,0.348306694,15,2,to,"('GRA', 'CHI')",Providence,ale46.xml,17,2,0,CHI,87,69,GRA
3,22,16,145,0.336176422,167,22,it,"('CHI', 'MOT')",Providence,ale46.xml,186,19,3,MOT,1071,1583,CHI
0,10,11,184,0.315270029,194,10,look,"('MOT', 'CHI')",Providence,ale46.xml,205,11,0,CHI,2035,988,MOT
0,2,1,8,0.287682072,10,2,is,"('MOT', 'TOY')",Providence,ale46.xml,11,1,0,TOY,156,43,MOT
0,10,12,183,0.236046956,193,10,this,"('MOT', 'CHI')",Providence,ale46.xml,205,12,0,CHI,2035,988,MOT
0,1,4,12,0.223143551,13,1,go,"('GRA', 'CHI')",Providence,ale46.xml,17,4,0,CHI,87,69,GRA
0,13,10,182,0.159239749,195,13,and,"('MOT', 'CHI')",Providence,ale46.xml,205,10,0,CHI,2035,988,MOT
1,6,38,160,0.157628944,166,6,a,"('MOT', 'CHI')",Providence,ale46.xml,205,39,1,CHI,2035,988,MOT
0,2,3,13,0.125163143,15,2,yeah,"('GRA', 'MOT')",Providence,ale46.xml,18,3,0,MOT,100,143,GRA
1,34,7,144,0.028170877,178,34,oh,"('CHI', 'MOT')",Providence,ale46.xml,186,8,1,MOT,1071,1583,CHI
0,7,21,177,0.010810916,184,7,oh,"('MOT', 'CHI')",Providence,ale46.xml,205,21,0,CHI,2035,988,MOT
3,28,19,136,-0.047067511,164,28,the,"('CHI', 'MOT')",Providence,ale46.xml,186,22,3,MOT,1071,1583,CHI
0,4,2,12,-0.105360516,16,4,the,"('GRA', 'MOT')",Providence,ale46.xml,18,2,0,MOT,100,143,GRA
0,1,1,2,-0.182321557,3,1,oh,"('OPE', 'MOT')",Providence,ale46.xml,4,1,0,MOT,10,45,OPE
0,4,5,20,-0.297251523,24,4,go,"('MOT', 'GRA')",Providence,ale46.xml,29,5,0,GRA,290,149,MOT
0,3,4,11,-0.405465108,14,3,oh,"('GRA', 'MOT')",Providence,ale46.xml,18,4,0,MOT,100,143,GRA
0,3,3,5,-0.693147181,8,3,my,"('MOT', 'TOY')",Providence,ale46.xml,11,3,0,TOY,156,43,MOT
0,5,4,9,-0.810930216,14,5,you,"('GRA', 'MOT')",Providence,ale46.xml,18,4,0,MOT,100,143,GRA
1,5,1,471,3.684704083,476,5,did,"('CHI', 'MOT')",Providence,ale47.xml,478,2,1,MOT,2128,4000,CHI
0,5,1,472,3.28132884,477,5,gonna,"('CHI', 'MOT')",Providence,ale47.xml,478,1,0,MOT,2128,4000,CHI
1,9,1,467,3.173878459,476,9,we,"('CHI', 'MOT')",Providence,ale47.xml,478,2,1,MOT,2128,4000,CHI
1,7,3,467,2.987364024,474,7,look,"('CHI', 'MOT')",Providence,ale47.xml,478,4,1,MOT,2128,4000,CHI
0,8,1,469,2.875863731,477,8,all,"('CHI', 'MOT')",Providence,ale47.xml,478,1,0,MOT,2128,4000,CHI
0,8,2,468,2.586091794,476,8,my,"('CHI', 'MOT')",Providence,ale47.xml,478,2,0,MOT,2128,4000,CHI
0,8,2,468,2.586091794,476,8,at,"('CHI', 'MOT')",Providence,ale47.xml,478,2,0,MOT,2128,4000,CHI
0,8,2,468,2.586091794,476,8,where,"('CHI', 'MOT')",Providence,ale47.xml,478,2,0,MOT,2128,4000,CHI
0,12,1,465,2.508138951,477,12,was,"('CHI', 'MOT')",Providence,ale47.xml,478,1,0,MOT,2128,4000,CHI
1,15,2,460,2.478637037,475,15,in,"('CHI', 'MOT')",Providence,ale47.xml,478,3,1,MOT,2128,4000,CHI
0,13,1,464,2.434030979,477,13,some,"('CHI', 'MOT')",Providence,ale47.xml,478,1,0,MOT,2128,4000,CHI
1,11,5,461,2.290006311,472,11,make,"('CHI', 'MOT')",Providence,ale47.xml,478,6,1,MOT,2128,4000,CHI
0,6,5,467,2.271494506,473,6,put,"('CHI', 'MOT')",Providence,ale47.xml,478,5,0,MOT,2128,4000,CHI
0,4,8,466,2.24495598,470,4,big,"('CHI', 'MOT')",Providence,ale47.xml,478,8,0,MOT,2128,4000,CHI
0,17,1,460,2.182716551,477,17,are,"('CHI', 'MOT')",Providence,ale47.xml,478,1,0,MOT,2128,4000,CHI
0,8,4,466,2.176433808,474,8,little,"('CHI', 'MOT')",Providence,ale47.xml,478,4,0,MOT,2128,4000,CHI
1,15,4,458,2.137963113,473,15,go,"('CHI', 'MOT')",Providence,ale47.xml,478,5,1,MOT,2128,4000,CHI
0,21,1,456,1.982045855,477,21,of,"('CHI', 'MOT')",Providence,ale47.xml,478,1,0,MOT,2128,4000,CHI
1,1,2,31,1.916922612,32,1,have,"('MOT', 'CHI')",Providence,ale47.xml,35,3,1,CHI,303,157,MOT
1,1,2,31,1.916922612,32,1,the,"('MOT', 'CHI')",Providence,ale47.xml,35,3,1,CHI,303,157,MOT
1,17,5,455,1.884541203,472,17,for,"('CHI', 'MOT')",Providence,ale47.xml,478,6,1,MOT,2128,4000,CHI
0,18,2,458,1.838877392,476,18,get,"('CHI', 'MOT')",Providence,ale47.xml,478,2,0,MOT,2128,4000,CHI
0,10,5,463,1.819509382,473,10,with,"('CHI', 'MOT')",Providence,ale47.xml,478,5,0,MOT,2128,4000,CHI
1,0,0,7,1.791759469,7,0,what,"('ADU', 'MOT')",Providence,ale47.xml,8,1,1,MOT,37,108,ADU
0,1,1,33,1.791759469,34,1,look,"('MOT', 'CHI')",Providence,ale47.xml,35,1,0,CHI,303,157,MOT
0,1,1,33,1.791759469,34,1,is,"('MOT', 'CHI')",Providence,ale47.xml,35,1,0,CHI,303,157,MOT
0,1,1,33,1.791759469,34,1,put,"('MOT', 'CHI')",Providence,ale47.xml,35,1,0,CHI,303,157,MOT
0,26,1,451,1.777251443,477,26,do,"('CHI', 'MOT')",Providence,ale47.xml,478,1,0,MOT,2128,4000,CHI
0,27,1,450,1.740883799,477,27,on,"('CHI', 'MOT')",Providence,ale47.xml,478,1,0,MOT,2128,4000,CHI
0,15,4,459,1.601069663,474,15,there,"('CHI', 'MOT')",Providence,ale47.xml,478,4,0,MOT,2128,4000,CHI
0,13,5,460,1.578347325,473,13,yeah,"('CHI', 'MOT')",Providence,ale47.xml,478,5,0,MOT,2128,4000,CHI
2,26,7,443,1.559738244,469,26,oh,"('CHI', 'MOT')",Providence,ale47.xml,478,9,2,MOT,2128,4000,CHI
2,43,3,430,1.53182731,473,43,it,"('CHI', 'MOT')",Providence,ale47.xml,478,5,2,MOT,2128,4000,CHI
0,1,2,32,1.47590652,33,1,on,"('MOT', 'CHI')",Providence,ale47.xml,35,2,0,CHI,303,157,MOT
0,2,1,32,1.386294361,34,2,in,"('MOT', 'CHI')",Providence,ale47.xml,35,1,0,CHI,303,157,MOT
0,1,3,31,1.223775432,32,1,one,"('MOT', 'CHI')",Providence,ale47.xml,35,3,0,CHI,303,157,MOT
1,18,13,446,1.120305113,464,18,like,"('CHI', 'MOT')",Providence,ale47.xml,478,14,1,MOT,2128,4000,CHI
1,50,5,422,0.843087328,472,50,what,"('CHI', 'MOT')",Providence,ale47.xml,478,6,1,MOT,2128,4000,CHI
0,51,2,425,0.832072653,476,51,is,"('CHI', 'MOT')",Providence,ale47.xml,478,2,0,MOT,2128,4000,CHI
1,1,1,5,0.693147181,6,1,the,"('ADU', 'MOT')",Providence,ale47.xml,8,2,1,MOT,37,108,ADU
3,74,9,392,0.578217214,466,74,the,"('CHI', 'MOT')",Providence,ale47.xml,478,12,3,MOT,2128,4000,CHI
1,25,17,435,0.57488326,460,25,and,"('CHI', 'MOT')",Providence,ale47.xml,478,18,1,MOT,2128,4000,CHI
11,49,48,370,0.504642614,419,49,a,"('CHI', 'MOT')",Providence,ale47.xml,478,59,11,MOT,2128,4000,CHI
0,2,5,28,0.421213465,30,2,this,"('MOT', 'CHI')",Providence,ale47.xml,35,5,0,CHI,303,157,MOT
0,1,1,6,0.405465108,7,1,yeah,"('ADU', 'MOT')",Providence,ale47.xml,8,1,0,MOT,37,108,ADU
1,3,0,4,0.405465108,7,3,you,"('ADU', 'MOT')",Providence,ale47.xml,8,1,1,MOT,37,108,ADU
1,26,20,431,0.390866309,457,26,no,"('CHI', 'MOT')",Providence,ale47.xml,478,21,1,MOT,2128,4000,CHI
1,9,2,23,0.3074847,32,9,no,"('MOT', 'CHI')",Providence,ale47.xml,35,3,1,CHI,303,157,MOT
6,50,37,385,0.287355222,435,50,this,"('CHI', 'MOT')",Providence,ale47.xml,478,43,6,MOT,2128,4000,CHI
4,70,19,385,0.252565601,455,70,one,"('CHI', 'MOT')",Providence,ale47.xml,478,23,4,MOT,2128,4000,CHI
0,40,7,431,0.248298744,471,40,to,"('CHI', 'MOT')",Providence,ale47.xml,478,7,0,MOT,2128,4000,CHI
1,68,8,401,0.216003497,469,68,that,"('CHI', 'MOT')",Providence,ale47.xml,478,9,1,MOT,2128,4000,CHI
1,76,7,394,0.203735651,470,76,you,"('CHI', 'MOT')",Providence,ale47.xml,478,8,1,MOT,2128,4000,CHI
0,3,1,4,-0.287682072,7,3,oh,"('ADU', 'MOT')",Providence,ale47.xml,8,1,0,MOT,37,108,ADU
0,1,1,0,-0.693147181,1,1,you,"('OPE', 'MOT')",Providence,ale47.xml,2,1,0,MOT,9,17,OPE
1,0,2,161,4.177459469,161,0,big,"('MOT', 'CHI')",Providence,ale48.xml,164,3,1,CHI,1738,923,MOT
1,0,3,160,3.988984047,160,0,of,"('MOT', 'CHI')",Providence,ale48.xml,164,4,1,CHI,1738,923,MOT
0,1,1,135,3.135494216,136,1,think,"('CHI', 'MOT')",Providence,ale48.xml,137,1,0,MOT,832,1134,CHI
1,1,3,132,3.113515309,133,1,make,"('CHI', 'MOT')",Providence,ale48.xml,137,4,1,MOT,832,1134,CHI
0,1,2,161,3.020424886,162,1,yeah,"('MOT', 'CHI')",Providence,ale48.xml,164,2,0,CHI,1738,923,MOT
0,1,2,161,3.020424886,162,1,did,"('MOT', 'CHI')",Providence,ale48.xml,164,2,0,CHI,1738,923,MOT
1,1,5,157,2.995732274,158,1,my,"('MOT', 'CHI')",Providence,ale48.xml,164,6,1,CHI,1738,923,MOT
1,1,6,156,2.871679625,157,1,see,"('MOT', 'CHI')",Providence,ale48.xml,164,7,1,CHI,1738,923,MOT
0,1,2,134,2.840539384,135,1,yeah,"('CHI', 'MOT')",Providence,ale48.xml,137,2,0,MOT,832,1134,CHI
0,1,3,160,2.791165108,161,1,little,"('MOT', 'CHI')",Providence,ale48.xml,164,3,0,CHI,1738,923,MOT
0,2,2,160,2.614959778,162,2,gonna,"('MOT', 'CHI')",Providence,ale48.xml,164,2,0,CHI,1738,923,MOT
0,2,2,160,2.614959778,162,2,wanna,"('MOT', 'CHI')",Providence,ale48.xml,164,2,0,CHI,1738,923,MOT
2,5,1,129,2.610069793,134,5,up,"('CHI', 'MOT')",Providence,ale48.xml,137,3,2,MOT,832,1134,CHI
0,1,4,159,2.602689685,160,1,at,"('MOT', 'CHI')",Providence,ale48.xml,164,4,0,CHI,1738,923,MOT
0,1,5,158,2.442347035,159,1,was,"('MOT', 'CHI')",Providence,ale48.xml,164,5,0,CHI,1738,923,MOT
1,5,1,130,2.435074276,135,5,is,"('CHI', 'MOT')",Providence,ale48.xml,137,2,1,MOT,832,1134,CHI
1,1,11,151,2.397895273,152,1,go,"('MOT', 'CHI')",Providence,ale48.xml,164,12,1,CHI,1738,923,MOT
1,4,3,156,2.379546134,160,4,make,"('MOT', 'CHI')",Providence,ale48.xml,164,4,1,CHI,1738,923,MOT
0,1,6,157,2.302585093,158,1,are,"('MOT', 'CHI')",Providence,ale48.xml,164,6,0,CHI,1738,923,MOT
0,2,3,132,2.204604685,134,2,get,"('CHI', 'MOT')",Providence,ale48.xml,137,3,0,MOT,832,1134,CHI
0,3,2,132,2.147392204,135,3,want,"('CHI', 'MOT')",Providence,ale48.xml,137,2,0,MOT,832,1134,CHI
0,3,2,132,2.147392204,135,3,go,"('CHI', 'MOT')",Providence,ale48.xml,137,2,0,MOT,832,1134,CHI
3,3,15,143,2.00148,146,3,it,"('MOT', 'CHI')",Providence,ale48.xml,164,18,3,CHI,1738,923,MOT
4,4,14,142,2.00148,146,4,is,"('MOT', 'CHI')",Providence,ale48.xml,164,18,4,CHI,1738,923,MOT
0,6,1,130,1.882731247,136,6,in,"('CHI', 'MOT')",Providence,ale48.xml,137,1,0,MOT,832,1134,CHI
0,6,1,130,1.882731247,136,6,are,"('CHI', 'MOT')",Providence,ale48.xml,137,1,0,MOT,832,1134,CHI
3,3,18,140,1.841239526,143,3,that,"('MOT', 'CHI')",Providence,ale48.xml,164,21,3,CHI,1738,923,MOT
5,7,8,117,1.840549633,124,7,and,"('CHI', 'MOT')",Providence,ale48.xml,137,13,5,MOT,832,1134,CHI
2,2,16,117,1.800058272,119,2,no,"('CHI', 'MOT')",Providence,ale48.xml,137,18,2,MOT,832,1134,CHI
0,6,2,156,1.767661918,162,6,want,"('MOT', 'CHI')",Providence,ale48.xml,164,2,0,CHI,1738,923,MOT
0,5,2,130,1.741927095,135,5,put,"('CHI', 'MOT')",Providence,ale48.xml,137,2,0,MOT,832,1134,CHI
0,5,2,130,1.741927095,135,5,on,"('CHI', 'MOT')",Providence,ale48.xml,137,2,0,MOT,832,1134,CHI
1,2,15,146,1.714798428,148,2,and,"('MOT', 'CHI')",Providence,ale48.xml,164,16,1,CHI,1738,923,MOT
1,8,4,151,1.631416819,159,8,look,"('MOT', 'CHI')",Providence,ale48.xml,164,5,1,CHI,1738,923,MOT
0,3,6,155,1.609437912,158,3,on,"('MOT', 'CHI')",Providence,ale48.xml,164,6,0,CHI,1738,923,MOT
0,6,2,129,1.587776416,135,6,do,"('CHI', 'MOT')",Providence,ale48.xml,137,2,0,MOT,832,1134,CHI
0,2,9,153,1.559738244,155,2,put,"('MOT', 'CHI')",Providence,ale48.xml,164,9,0,CHI,1738,923,MOT
0,4,4,129,1.504077397,133,4,this,"('CHI', 'MOT')",Providence,ale48.xml,137,4,0,MOT,832,1134,CHI
0,2,10,152,1.466337069,154,2,what,"('MOT', 'CHI')",Providence,ale48.xml,164,10,0,CHI,1738,923,MOT
0,5,4,128,1.32175584,133,5,have,"('CHI', 'MOT')",Providence,ale48.xml,137,4,0,MOT,832,1134,CHI
2,7,9,119,1.306251653,126,7,they,"('CHI', 'MOT')",Providence,ale48.xml,137,11,2,MOT,832,1134,CHI
0,12,1,124,1.263692039,136,12,like,"('CHI', 'MOT')",Providence,ale48.xml,137,1,0,MOT,832,1134,CHI
0,8,3,126,1.105992396,134,8,that,"('CHI', 'MOT')",Providence,ale48.xml,137,3,0,MOT,832,1134,CHI
0,3,11,150,1.092181398,153,3,like,"('MOT', 'CHI')",Providence,ale48.xml,164,11,0,CHI,1738,923,MOT
3,8,18,135,1.03030931,143,8,the,"('MOT', 'CHI')",Providence,ale48.xml,164,21,3,CHI,1738,923,MOT
1,5,12,119,1.029619417,124,5,oh,"('CHI', 'MOT')",Providence,ale48.xml,137,13,1,MOT,832,1134,CHI
1,13,4,119,1.006019502,132,13,what,"('CHI', 'MOT')",Providence,ale48.xml,137,5,1,MOT,832,1134,CHI
1,0,0,2,0.980829253,2,0,that,"('ADU', 'MOT')",Providence,ale48.xml,3,1,1,MOT,25,26,ADU
3,10,13,111,0.910211686,121,10,a,"('CHI', 'MOT')",Providence,ale48.xml,137,16,3,MOT,832,1134,CHI
0,9,5,150,0.832909123,159,9,do,"('MOT', 'CHI')",Providence,ale48.xml,164,5,0,CHI,1738,923,MOT
1,10,11,142,0.693147181,152,10,this,"('MOT', 'CHI')",Providence,ale48.xml,164,12,1,CHI,1738,923,MOT
0,7,8,149,0.680568398,156,7,they,"('MOT', 'CHI')",Providence,ale48.xml,164,8,0,CHI,1738,923,MOT
1,34,1,101,0.671485684,135,34,you,"('CHI', 'MOT')",Providence,ale48.xml,137,2,1,MOT,832,1134,CHI
0,5,13,146,0.530628251,151,5,to,"('MOT', 'CHI')",Providence,ale48.xml,164,13,0,CHI,1738,923,MOT
0,3,17,117,0.473287704,120,3,look,"('CHI', 'MOT')",Providence,ale48.xml,137,17,0,MOT,832,1134,CHI
0,14,4,119,0.405465108,133,14,to,"('CHI', 'MOT')",Providence,ale48.xml,137,4,0,MOT,832,1134,CHI
4,24,14,122,0.392042088,146,24,no,"('MOT', 'CHI')",Providence,ale48.xml,164,18,4,CHI,1738,923,MOT
1,13,10,113,0.341170757,126,13,the,"('CHI', 'MOT')",Providence,ale48.xml,137,11,1,MOT,832,1134,CHI
1,1,0,1,0.287682072,2,1,oh,"('CHI', 'GRA')",Providence,ale48.xml,3,1,1,GRA,15,15,CHI
0,5,17,142,0.267747858,147,5,one,"('MOT', 'CHI')",Providence,ale48.xml,164,17,0,CHI,1738,923,MOT
2,4,50,108,0.236388778,112,4,you,"('MOT', 'CHI')",Providence,ale48.xml,164,52,2,CHI,1738,923,MOT
4,13,33,114,0.166631341,127,13,a,"('MOT', 'CHI')",Providence,ale48.xml,164,37,4,CHI,1738,923,MOT
0,12,7,118,0.120627988,130,12,one,"('CHI', 'MOT')",Providence,ale48.xml,137,7,0,MOT,832,1134,CHI
0,15,8,141,-0.012578782,156,15,oh,"('MOT', 'CHI')",Providence,ale48.xml,164,8,0,CHI,1738,923,MOT
0,1,1,1,-0.405465108,2,1,you,"('ADU', 'MOT')",Providence,ale48.xml,3,1,0,MOT,25,26,ADU
0,1,1,1,-0.405465108,2,1,are,"('ADU', 'MOT')",Providence,ale48.xml,3,1,0,MOT,25,26,ADU
0,1,1,1,-0.405465108,2,1,the,"('ADU', 'MOT')",Providence,ale48.xml,3,1,0,MOT,25,26,ADU
0,25,9,103,-0.78845736,128,25,it,"('CHI', 'MOT')",Providence,ale48.xml,137,9,0,MOT,832,1134,CHI
1,0,9,423,4.2603297,423,0,of,"('MOT', 'CHI')",Providence,ale49.xml,433,10,1,CHI,3842,2453,MOT
3,4,4,422,3.638755067,426,4,big,"('MOT', 'CHI')",Providence,ale49.xml,433,7,3,CHI,3842,2453,MOT
0,3,1,429,3.588137884,432,3,wanna,"('MOT', 'CHI')",Providence,ale49.xml,433,1,0,CHI,3842,2453,MOT
1,1,9,422,3.567182519,423,1,up,"('MOT', 'CHI')",Providence,ale49.xml,433,10,1,CHI,3842,2453,MOT
0,1,5,427,3.424727879,428,1,but,"('MOT', 'CHI')",Providence,ale49.xml,433,5,0,CHI,3842,2453,MOT
0,1,6,426,3.288868197,427,1,my,"('MOT', 'CHI')",Providence,ale49.xml,433,6,0,CHI,3842,2453,MOT
0,2,4,427,3.175736332,429,2,gonna,"('MOT', 'CHI')",Providence,ale49.xml,433,4,0,CHI,3842,2453,MOT
0,1,7,425,3.168751438,426,1,where,"('MOT', 'CHI')",Providence,ale49.xml,433,7,0,CHI,3842,2453,MOT
1,1,16,415,3.091042453,416,1,do,"('MOT', 'CHI')",Providence,ale49.xml,433,17,1,CHI,3842,2453,MOT
4,3,18,408,3.068537314,411,3,for,"('MOT', 'CHI')",Providence,ale49.xml,433,22,4,CHI,3842,2453,MOT
0,5,2,426,2.892683898,431,5,want,"('MOT', 'CHI')",Providence,ale49.xml,433,2,0,CHI,3842,2453,MOT
0,2,7,424,2.76328633,426,2,are,"('MOT', 'CHI')",Providence,ale49.xml,433,7,0,CHI,3842,2453,MOT
1,1,28,403,2.572365955,404,1,like,"('MOT', 'CHI')",Providence,ale49.xml,433,29,1,CHI,3842,2453,MOT
1,3,15,414,2.454351981,417,3,get,"('MOT', 'CHI')",Providence,ale49.xml,433,16,1,CHI,3842,2453,MOT
0,1,16,416,2.454351981,417,1,we,"('MOT', 'CHI')",Providence,ale49.xml,433,16,0,CHI,3842,2453,MOT
0,1,17,415,2.397895273,416,1,what,"('MOT', 'CHI')",Providence,ale49.xml,433,17,0,CHI,3842,2453,MOT
1,7,7,418,2.367904559,425,7,yeah,"('MOT', 'CHI')",Providence,ale49.xml,433,8,1,CHI,3842,2453,MOT
1,2,24,406,2.314855186,408,2,go,"('MOT', 'CHI')",Providence,ale49.xml,433,25,1,CHI,3842,2453,MOT
0,2,13,418,2.238342824,420,2,little,"('MOT', 'CHI')",Providence,ale49.xml,433,13,0,CHI,3842,2453,MOT
0,3,12,418,2.022020488,421,3,not,"('MOT', 'CHI')",Providence,ale49.xml,433,12,0,CHI,3842,2453,MOT
0,3,13,417,1.950660752,420,3,have,"('MOT', 'CHI')",Providence,ale49.xml,433,13,0,CHI,3842,2453,MOT
0,5,10,418,1.77542305,423,5,make,"('MOT', 'CHI')",Providence,ale49.xml,433,10,0,CHI,3842,2453,MOT
0,3,16,414,1.761204801,417,3,with,"('MOT', 'CHI')",Providence,ale49.xml,433,16,0,CHI,3842,2453,MOT
1,7,18,407,1.599868461,414,7,oh,"('MOT', 'CHI')",Providence,ale49.xml,433,19,1,CHI,3842,2453,MOT
0,3,20,410,1.550941706,413,3,put,"('MOT', 'CHI')",Providence,ale49.xml,433,20,0,CHI,3842,2453,MOT
4,13,26,390,1.508531747,403,13,and,"('MOT', 'CHI')",Providence,ale49.xml,433,30,4,CHI,3842,2453,MOT
1,4,33,395,1.494151757,399,4,to,"('MOT', 'CHI')",Providence,ale49.xml,433,34,1,CHI,3842,2453,MOT
1,7,22,403,1.415853163,410,7,see,"('MOT', 'CHI')",Providence,ale49.xml,433,23,1,CHI,3842,2453,MOT
6,14,46,367,1.196910891,381,14,it,"('MOT', 'CHI')",Providence,ale49.xml,433,52,6,CHI,3842,2453,MOT
0,9,11,413,1.182199005,422,9,at,"('MOT', 'CHI')",Providence,ale49.xml,433,11,0,CHI,3842,2453,MOT
13,20,68,332,1.044991197,352,20,you,"('MOT', 'CHI')",Providence,ale49.xml,433,81,13,CHI,3842,2453,MOT
1,7,36,389,0.936595998,396,7,there,"('MOT', 'CHI')",Providence,ale49.xml,433,37,1,CHI,3842,2453,MOT
1,10,27,395,0.902867712,405,10,is,"('MOT', 'CHI')",Providence,ale49.xml,433,28,1,CHI,3842,2453,MOT
9,18,66,340,0.900444723,358,18,the,"('MOT', 'CHI')",Providence,ale49.xml,433,75,9,CHI,3842,2453,MOT
10,19,68,336,0.897872146,355,19,a,"('MOT', 'CHI')",Providence,ale49.xml,433,78,10,CHI,3842,2453,MOT
3,21,36,373,0.563094052,394,21,one,"('MOT', 'CHI')",Providence,ale49.xml,433,39,3,CHI,3842,2453,MOT
2,25,23,383,0.560836044,408,25,can,"('MOT', 'CHI')",Providence,ale49.xml,433,25,2,CHI,3842,2453,MOT
0,12,18,403,0.472404591,415,12,look,"('MOT', 'CHI')",Providence,ale49.xml,433,18,0,CHI,3842,2453,MOT
7,48,37,341,0.327687407,389,48,this,"('MOT', 'CHI')",Providence,ale49.xml,433,44,7,CHI,3842,2453,MOT
0,6,42,385,0.243709829,391,6,that,"('MOT', 'CHI')",Providence,ale49.xml,433,42,0,CHI,3842,2453,MOT
2,33,47,351,-0.403736499,384,33,no,"('MOT', 'CHI')",Providence,ale49.xml,433,49,2,CHI,3842,2453,MOT
0,1,1,433,4.285882774,434,1,she,"('MOT', 'CHI')",Providence,ale50.xml,435,1,0,CHI,3704,2352,MOT
1,1,3,430,4.278978259,431,1,with,"('MOT', 'CHI')",Providence,ale50.xml,435,4,1,CHI,3704,2352,MOT
0,1,3,431,3.770459441,432,1,at,"('MOT', 'CHI')",Providence,ale50.xml,435,3,0,CHI,3704,2352,MOT
1,1,8,425,3.661227923,426,1,up,"('MOT', 'CHI')",Providence,ale50.xml,435,9,1,CHI,3704,2352,MOT
0,1,4,430,3.585831078,431,1,gonna,"('MOT', 'CHI')",Providence,ale50.xml,435,4,0,CHI,3704,2352,MOT
0,1,6,428,3.293519368,429,1,he,"('MOT', 'CHI')",Providence,ale50.xml,435,6,0,CHI,3704,2352,MOT
1,1,14,419,3.21179197,420,1,see,"('MOT', 'CHI')",Providence,ale50.xml,435,15,1,CHI,3704,2352,MOT
0,1,7,427,3.173413451,428,1,but,"('MOT', 'CHI')",Providence,ale50.xml,435,7,0,CHI,3704,2352,MOT
0,1,7,427,3.173413451,428,1,where,"('MOT', 'CHI')",Providence,ale50.xml,435,7,0,CHI,3704,2352,MOT
0,2,6,427,2.88805426,429,2,was,"('MOT', 'CHI')",Providence,ale50.xml,435,6,0,CHI,3704,2352,MOT
0,1,11,423,2.796342808,424,1,are,"('MOT', 'CHI')",Providence,ale50.xml,435,11,0,CHI,3704,2352,MOT
0,2,7,426,2.767948343,428,2,did,"('MOT', 'CHI')",Providence,ale50.xml,435,7,0,CHI,3704,2352,MOT
1,3,11,420,2.719884659,423,3,go,"('MOT', 'CHI')",Providence,ale50.xml,435,12,1,CHI,3704,2352,MOT
1,3,11,420,2.719884659,423,3,in,"('MOT', 'CHI')",Providence,ale50.xml,435,12,1,CHI,3704,2352,MOT
1,2,17,415,2.636673538,417,2,of,"('MOT', 'CHI')",Providence,ale50.xml,435,18,1,CHI,3704,2352,MOT
0,2,9,424,2.562615634,426,2,yeah,"('MOT', 'CHI')",Providence,ale50.xml,435,9,0,CHI,3704,2352,MOT
0,4,6,425,2.377228636,429,4,wanna,"('MOT', 'CHI')",Providence,ale50.xml,435,6,0,CHI,3704,2352,MOT
0,3,8,424,2.372577465,427,3,all,"('MOT', 'CHI')",Providence,ale50.xml,435,8,0,CHI,3704,2352,MOT
2,3,26,404,2.324835702,407,3,put,"('MOT', 'CHI')",Providence,ale50.xml,435,28,2,CHI,3704,2352,MOT
0,1,19,415,2.297811814,416,1,have,"('MOT', 'CHI')",Providence,ale50.xml,435,19,0,CHI,3704,2352,MOT
1,3,18,413,2.297811814,416,3,on,"('MOT', 'CHI')",Providence,ale50.xml,435,19,1,CHI,3704,2352,MOT
1,8,8,418,2.157150526,426,8,my,"('MOT', 'CHI')",Providence,ale50.xml,435,9,1,CHI,3704,2352,MOT
0,5,7,423,2.074801162,428,5,look,"('MOT', 'CHI')",Providence,ale50.xml,435,7,0,CHI,3704,2352,MOT
1,4,18,412,2.074668263,416,4,little,"('MOT', 'CHI')",Providence,ale50.xml,435,19,1,CHI,3704,2352,MOT
0,4,9,422,2.05179001,426,4,we,"('MOT', 'CHI')",Providence,ale50.xml,435,9,0,CHI,3704,2352,MOT
1,3,25,406,1.993241524,409,3,like,"('MOT', 'CHI')",Providence,ale50.xml,435,26,1,CHI,3704,2352,MOT
0,6,9,420,1.715317774,426,6,big,"('MOT', 'CHI')",Providence,ale50.xml,435,9,0,CHI,3704,2352,MOT
0,2,25,408,1.626574195,410,2,what,"('MOT', 'CHI')",Providence,ale50.xml,435,25,0,CHI,3704,2352,MOT
1,10,15,409,1.447512984,419,10,there,"('MOT', 'CHI')",Providence,ale50.xml,435,16,1,CHI,3704,2352,MOT
2,14,18,401,1.332605856,415,14,and,"('MOT', 'CHI')",Providence,ale50.xml,435,20,2,CHI,3704,2352,MOT
0,11,8,416,1.273965176,427,11,want,"('MOT', 'CHI')",Providence,ale50.xml,435,8,0,CHI,3704,2352,MOT
1,3,52,379,1.250162187,382,3,that,"('MOT', 'CHI')",Providence,ale50.xml,435,53,1,CHI,3704,2352,MOT
4,14,34,383,1.201469674,397,14,the,"('MOT', 'CHI')",Providence,ale50.xml,435,38,4,CHI,3704,2352,MOT
0,6,19,410,1.045048846,416,6,make,"('MOT', 'CHI')",Providence,ale50.xml,435,19,0,CHI,3704,2352,MOT
1,0,0,2,0.980829253,2,0,a,"('CHI', 'MOT')",Providence,ale50.xml,3,1,1,MOT,28,27,CHI
0,5,24,406,0.973591586,411,5,do,"('MOT', 'CHI')",Providence,ale50.xml,435,24,0,CHI,3704,2352,MOT
1,8,32,394,0.94198942,402,8,one,"('MOT', 'CHI')",Providence,ale50.xml,435,33,1,CHI,3704,2352,MOT
5,30,27,373,0.835298807,403,30,this,"('MOT', 'CHI')",Providence,ale50.xml,435,32,5,CHI,3704,2352,MOT
1,12,26,396,0.777059153,408,12,is,"('MOT', 'CHI')",Providence,ale50.xml,435,27,1,CHI,3704,2352,MOT
1,0,1,2,0.693147181,2,0,is,"('GRA', 'CHI')",Providence,ale50.xml,4,2,1,CHI,34,36,GRA
2,29,17,387,0.688373902,416,29,no,"('MOT', 'CHI')",Providence,ale50.xml,435,19,2,CHI,3704,2352,MOT
5,18,54,358,0.671340822,376,18,it,"('MOT', 'CHI')",Providence,ale50.xml,435,59,5,CHI,3704,2352,MOT
0,7,25,403,0.645744942,410,7,to,"('MOT', 'CHI')",Providence,ale50.xml,435,25,0,CHI,3704,2352,MOT
15,41,61,318,0.567088236,359,41,a,"('MOT', 'CHI')",Providence,ale50.xml,435,76,15,CHI,3704,2352,MOT
0,24,8,403,0.539996001,427,24,some,"('MOT', 'CHI')",Providence,ale50.xml,435,8,0,CHI,3704,2352,MOT
1,21,22,391,0.409094876,412,21,oh,"('MOT', 'CHI')",Providence,ale50.xml,435,23,1,CHI,3704,2352,MOT
2,9,81,343,0.222672852,352,9,you,"('MOT', 'CHI')",Providence,ale50.xml,435,83,2,CHI,3704,2352,MOT
1,3,0,0,-0.182321557,3,3,the,"('GRA', 'CHI')",Providence,ale50.xml,4,1,1,CHI,34,36,GRA
0,5,1,389,3.091042453,394,5,but,"('CHI', 'MOT')",Providence,ale51.xml,395,1,0,MOT,2596,3806,CHI
0,5,1,389,3.091042453,394,5,did,"('CHI', 'MOT')",Providence,ale51.xml,395,1,0,MOT,2596,3806,CHI
0,6,1,388,2.936891774,394,6,he,"('CHI', 'MOT')",Providence,ale51.xml,395,1,0,MOT,2596,3806,CHI
1,5,4,385,2.926739402,390,5,at,"('CHI', 'MOT')",Providence,ale51.xml,395,5,1,MOT,2596,3806,CHI
0,9,1,385,2.58021683,394,9,up,"('CHI', 'MOT')",Providence,ale51.xml,395,1,0,MOT,2596,3806,CHI
1,11,3,380,2.390290673,391,11,with,"('CHI', 'MOT')",Providence,ale51.xml,395,4,1,MOT,2596,3806,CHI
0,7,3,385,2.287471455,392,7,they,"('CHI', 'MOT')",Providence,ale51.xml,395,3,0,MOT,2596,3806,CHI
3,6,21,365,2.103866094,371,6,make,"('CHI', 'MOT')",Providence,ale51.xml,395,24,3,MOT,2596,3806,CHI
2,9,12,372,1.971473463,381,9,look,"('CHI', 'MOT')",Providence,ale51.xml,395,14,2,MOT,2596,3806,CHI
0,7,5,383,1.945910149,390,7,for,"('CHI', 'MOT')",Providence,ale51.xml,395,5,0,MOT,2596,3806,CHI
1,22,2,370,1.924565961,392,22,can,"('CHI', 'MOT')",Providence,ale51.xml,395,3,1,MOT,2596,3806,CHI
1,20,3,371,1.830674885,391,20,see,"('CHI', 'MOT')",Providence,ale51.xml,395,4,1,MOT,2596,3806,CHI
0,10,4,381,1.78415487,391,10,get,"('CHI', 'MOT')",Providence,ale51.xml,395,4,0,MOT,2596,3806,CHI
3,10,18,364,1.782494016,374,10,yeah,"('CHI', 'MOT')",Providence,ale51.xml,395,21,3,MOT,2596,3806,CHI
2,20,6,367,1.715084102,387,20,little,"('CHI', 'MOT')",Providence,ale51.xml,395,8,2,MOT,2596,3806,CHI
2,9,18,366,1.63722993,375,9,want,"('CHI', 'MOT')",Providence,ale51.xml,395,20,2,MOT,2596,3806,CHI
1,11,10,373,1.599128543,384,11,there,"('CHI', 'MOT')",Providence,ale51.xml,395,11,1,MOT,2596,3806,CHI
3,15,15,362,1.55550957,377,15,some,"('CHI', 'MOT')",Providence,ale51.xml,395,18,3,MOT,2596,3806,CHI
0,16,3,376,1.533699653,392,16,are,"('CHI', 'MOT')",Providence,ale51.xml,395,3,0,MOT,2596,3806,CHI
2,16,11,366,1.507991296,382,16,is,"('CHI', 'MOT')",Providence,ale51.xml,395,13,2,MOT,2596,3806,CHI
0,14,4,377,1.473999942,391,14,go,"('CHI', 'MOT')",Providence,ale51.xml,395,4,0,MOT,2596,3806,CHI
0,14,4,377,1.473999942,391,14,we,"('CHI', 'MOT')",Providence,ale51.xml,395,4,0,MOT,2596,3806,CHI
1,17,7,370,1.463769673,387,17,what,"('CHI', 'MOT')",Providence,ale51.xml,395,8,1,MOT,2596,3806,CHI
1,22,5,367,1.446918983,389,22,put,"('CHI', 'MOT')",Providence,ale51.xml,395,6,1,MOT,2596,3806,CHI
0,19,3,373,1.371180723,392,19,on,"('CHI', 'MOT')",Providence,ale51.xml,395,3,0,MOT,2596,3806,CHI
0,9,8,378,1.358409158,387,9,big,"('CHI', 'MOT')",Providence,ale51.xml,395,8,0,MOT,2596,3806,CHI
5,24,20,346,1.195940633,370,24,oh,"('CHI', 'MOT')",Providence,ale51.xml,395,25,5,MOT,2596,3806,CHI
0,16,6,373,1.056052674,389,16,do,"('CHI', 'MOT')",Providence,ale51.xml,395,6,0,MOT,2596,3806,CHI
2,31,10,352,0.947062391,383,31,one,"('CHI', 'MOT')",Providence,ale51.xml,395,12,2,MOT,2596,3806,CHI
2,34,9,350,0.934152239,384,34,to,"('CHI', 'MOT')",Providence,ale51.xml,395,11,2,MOT,2596,3806,CHI
0,25,4,366,0.923953605,391,25,all,"('CHI', 'MOT')",Providence,ale51.xml,395,4,0,MOT,2596,3806,CHI
1,8,31,355,0.869459432,363,8,wanna,"('CHI', 'MOT')",Providence,ale51.xml,395,32,1,MOT,2596,3806,CHI
0,11,12,372,0.829279355,383,11,my,"('CHI', 'MOT')",Providence,ale51.xml,395,12,0,MOT,2596,3806,CHI
0,16,8,371,0.827780907,387,16,not,"('CHI', 'MOT')",Providence,ale51.xml,395,8,0,MOT,2596,3806,CHI
1,25,10,359,0.825938655,384,25,that,"('CHI', 'MOT')",Providence,ale51.xml,395,11,1,MOT,2596,3806,CHI
16,47,43,289,0.674184364,336,47,a,"('CHI', 'MOT')",Providence,ale51.xml,395,59,16,MOT,2596,3806,CHI
2,28,16,349,0.67312039,377,28,like,"('CHI', 'MOT')",Providence,ale51.xml,395,18,2,MOT,2596,3806,CHI
3,46,14,332,0.531879033,378,46,it,"('CHI', 'MOT')",Providence,ale51.xml,395,17,3,MOT,2596,3806,CHI
5,25,44,321,0.454039778,346,25,no,"('CHI', 'MOT')",Providence,ale51.xml,395,49,5,MOT,2596,3806,CHI
7,40,40,308,0.331982331,348,40,this,"('CHI', 'MOT')",Providence,ale51.xml,395,47,7,MOT,2596,3806,CHI
9,89,20,277,0.276871156,366,89,you,"('CHI', 'MOT')",Providence,ale51.xml,395,29,9,MOT,2596,3806,CHI
0,29,8,358,0.259796869,387,29,in,"('CHI', 'MOT')",Providence,ale51.xml,395,8,0,MOT,2596,3806,CHI
0,14,30,351,-0.268424256,365,14,and,"('CHI', 'MOT')",Providence,ale51.xml,395,30,0,MOT,2596,3806,CHI
3,72,33,287,-0.652873281,359,72,the,"('CHI', 'MOT')",Providence,ale51.xml,395,36,3,MOT,2596,3806,CHI
1,0,6,560,4.827424453,560,0,was,"('MOT', 'CHI')",Providence,ale52.xml,567,7,1,CHI,4047,3692,MOT
0,1,1,565,4.550361949,566,1,he,"('MOT', 'CHI')",Providence,ale52.xml,567,1,0,CHI,4047,3692,MOT
3,1,11,552,4.239526572,553,1,think,"('MOT', 'CHI')",Providence,ale52.xml,567,14,3,CHI,4047,3692,MOT
1,1,6,559,4.134277273,560,1,some,"('MOT', 'CHI')",Providence,ale52.xml,567,7,1,CHI,4047,3692,MOT
1,3,6,557,3.441130092,560,3,at,"('MOT', 'CHI')",Providence,ale52.xml,567,7,1,CHI,4047,3692,MOT
0,5,2,560,3.162305473,565,5,where,"('MOT', 'CHI')",Providence,ale52.xml,567,2,0,CHI,4047,3692,MOT
0,4,3,560,3.119718253,564,4,my,"('MOT', 'CHI')",Providence,ale52.xml,567,3,0,CHI,4047,3692,MOT
0,2,8,557,2.928523524,559,2,little,"('MOT', 'CHI')",Providence,ale52.xml,567,8,0,CHI,4047,3692,MOT
1,1,0,45,2.772588722,46,1,for,"('CHI', 'MOT')",Providence,ale52.xml,47,1,1,MOT,285,416,CHI
0,3,7,557,2.747982911,560,3,of,"('MOT', 'CHI')",Providence,ale52.xml,567,7,0,CHI,4047,3692,MOT
0,3,9,555,2.54374715,558,3,gonna,"('MOT', 'CHI')",Providence,ale52.xml,567,9,0,CHI,4047,3692,MOT
2,7,14,544,2.444156991,551,7,for,"('MOT', 'CHI')",Providence,ale52.xml,567,16,2,CHI,4047,3692,MOT
6,8,31,522,2.361767415,530,8,a,"('MOT', 'CHI')",Providence,ale52.xml,567,37,6,CHI,4047,3692,MOT
2,7,16,542,2.335173283,549,7,in,"('MOT', 'CHI')",Providence,ale52.xml,567,18,2,CHI,4047,3692,MOT
0,7,5,555,2.309702561,562,7,want,"('MOT', 'CHI')",Providence,ale52.xml,567,5,0,CHI,4047,3692,MOT
0,3,12,552,2.297213549,555,3,but,"('MOT', 'CHI')",Providence,ale52.xml,567,12,0,CHI,4047,3692,MOT
0,3,13,551,2.226423732,554,3,did,"('MOT', 'CHI')",Providence,ale52.xml,567,13,0,CHI,4047,3692,MOT
1,5,17,544,2.217390247,549,5,big,"('MOT', 'CHI')",Providence,ale52.xml,567,18,1,CHI,4047,3692,MOT
0,12,3,552,2.164206808,564,12,wanna,"('MOT', 'CHI')",Providence,ale52.xml,567,3,0,CHI,4047,3692,MOT
0,1,1,45,2.079441542,46,1,is,"('CHI', 'MOT')",Providence,ale52.xml,47,1,0,MOT,285,416,CHI
1,23,3,540,2.060159612,563,23,yeah,"('MOT', 'CHI')",Providence,ale52.xml,567,4,1,CHI,4047,3692,MOT
0,5,10,552,2.049483354,557,5,we,"('MOT', 'CHI')",Providence,ale52.xml,567,10,0,CHI,4047,3692,MOT
0,5,12,550,1.891748441,555,5,with,"('MOT', 'CHI')",Providence,ale52.xml,567,12,0,CHI,4047,3692,MOT
1,11,11,544,1.891748441,555,11,look,"('MOT', 'CHI')",Providence,ale52.xml,567,12,1,CHI,4047,3692,MOT
1,2,2,42,1.813738376,44,2,like,"('CHI', 'MOT')",Providence,ale52.xml,47,3,1,MOT,285,416,CHI
2,4,1,40,1.70837786,44,4,see,"('CHI', 'MOT')",Providence,ale52.xml,47,3,2,MOT,285,416,CHI
1,0,1,9,1.704748092,9,0,no,"('FAT', 'CHI')",Providence,ale52.xml,11,2,1,CHI,58,67,FAT
0,7,11,549,1.679968063,556,7,all,"('MOT', 'CHI')",Providence,ale52.xml,567,11,0,CHI,4047,3692,MOT
0,5,16,546,1.633226774,551,5,are,"('MOT', 'CHI')",Providence,ale52.xml,567,16,0,CHI,4047,3692,MOT
1,13,13,540,1.600469242,553,13,there,"('MOT', 'CHI')",Providence,ale52.xml,567,14,1,CHI,4047,3692,MOT
0,10,9,548,1.532146238,558,10,up,"('MOT', 'CHI')",Providence,ale52.xml,567,9,0,CHI,4047,3692,MOT
0,3,1,43,1.386294361,46,3,get,"('CHI', 'MOT')",Providence,ale52.xml,47,1,0,MOT,285,416,CHI
0,6,18,543,1.370092387,549,6,get,"('MOT', 'CHI')",Providence,ale52.xml,567,18,0,CHI,4047,3692,MOT
1,5,1,40,1.365240952,45,5,no,"('CHI', 'MOT')",Providence,ale52.xml,47,2,1,MOT,285,416,CHI
5,30,20,512,1.360884646,542,30,like,"('MOT', 'CHI')",Providence,ale52.xml,567,25,5,CHI,4047,3692,MOT
0,9,13,545,1.310133,554,9,see,"('MOT', 'CHI')",Providence,ale52.xml,567,13,0,CHI,4047,3692,MOT
1,0,3,9,1.299282984,9,0,you,"('MOT', 'FAT')",Providence,ale52.xml,13,4,1,FAT,127,88,MOT
0,7,17,543,1.289667525,550,7,put,"('MOT', 'CHI')",Providence,ale52.xml,567,17,0,CHI,4047,3692,MOT
5,18,39,505,1.282077356,523,18,on,"('MOT', 'CHI')",Providence,ale52.xml,567,44,5,CHI,4047,3692,MOT
1,1,1,10,1.178654996,11,1,a,"('MOT', 'FAT')",Providence,ale52.xml,13,2,1,FAT,127,88,MOT
1,2,6,38,1.134979933,40,2,this,"('CHI', 'MOT')",Providence,ale52.xml,47,7,1,MOT,285,416,CHI
0,2,3,42,1.120591195,44,2,can,"('CHI', 'MOT')",Providence,ale52.xml,47,3,0,MOT,285,416,CHI
0,2,3,42,1.120591195,44,2,on,"('CHI', 'MOT')",Providence,ale52.xml,47,3,0,MOT,285,416,CHI
0,4,34,529,1.089309896,533,4,what,"('MOT', 'CHI')",Providence,ale52.xml,567,34,0,CHI,4047,3692,MOT
1,9,36,521,1.003643931,530,9,to,"('MOT', 'CHI')",Providence,ale52.xml,567,37,1,CHI,4047,3692,MOT
15,43,51,458,0.989481553,501,43,the,"('MOT', 'CHI')",Providence,ale52.xml,567,66,15,CHI,4047,3692,MOT
3,20,35,509,0.927654491,529,20,oh,"('MOT', 'CHI')",Providence,ale52.xml,567,38,3,CHI,4047,3692,MOT
0,1,1,11,0.84729786,12,1,for,"('MOT', 'FAT')",Providence,ale52.xml,13,1,0,FAT,127,88,MOT
0,1,1,11,0.84729786,12,1,no,"('MOT', 'FAT')",Providence,ale52.xml,13,1,0,FAT,127,88,MOT
0,1,1,11,0.84729786,12,1,at,"('MOT', 'FAT')",Providence,ale52.xml,13,1,0,FAT,127,88,MOT
0,1,1,11,0.84729786,12,1,one,"('MOT', 'FAT')",Providence,ale52.xml,13,1,0,FAT,127,88,MOT
0,6,1,40,0.826678573,46,6,look,"('CHI', 'MOT')",Providence,ale52.xml,47,1,0,MOT,285,416,CHI
3,39,19,506,0.823809879,545,39,and,"('MOT', 'CHI')",Providence,ale52.xml,567,22,3,CHI,4047,3692,MOT
0,13,16,538,0.785928914,551,13,is,"('MOT', 'CHI')",Providence,ale52.xml,567,16,0,CHI,4047,3692,MOT
1,2,1,9,0.773189888,11,2,go,"('MOT', 'FAT')",Providence,ale52.xml,13,2,1,FAT,127,88,MOT
2,51,12,502,0.693747962,553,51,can,"('MOT', 'CHI')",Providence,ale52.xml,567,14,2,CHI,4047,3692,MOT
0,1,1,9,0.693147181,10,1,my,"('FAT', 'CHI')",Providence,ale52.xml,11,1,0,CHI,58,67,FAT
0,1,1,9,0.693147181,10,1,the,"('FAT', 'CHI')",Providence,ale52.xml,11,1,0,CHI,58,67,FAT
1,11,1,34,0.672093771,45,11,you,"('CHI', 'MOT')",Providence,ale52.xml,47,2,1,MOT,285,416,CHI
1,5,5,36,0.583146285,41,5,the,"('CHI', 'MOT')",Providence,ale52.xml,47,6,1,MOT,285,416,CHI
5,49,29,484,0.578484272,533,49,one,"('MOT', 'CHI')",Providence,ale52.xml,567,34,5,CHI,4047,3692,MOT
3,21,51,492,0.514067118,513,21,that,"('MOT', 'CHI')",Providence,ale52.xml,567,54,3,CHI,4047,3692,MOT
0,2,1,10,0.441832752,12,2,look,"('MOT', 'FAT')",Providence,ale52.xml,13,1,0,FAT,127,88,MOT
0,2,1,10,0.441832752,12,2,this,"('MOT', 'FAT')",Providence,ale52.xml,13,1,0,FAT,127,88,MOT
2,25,38,502,0.373834564,527,25,go,"('MOT', 'CHI')",Providence,ale52.xml,567,40,2,CHI,4047,3692,MOT
9,110,23,425,0.352692462,535,110,this,"('MOT', 'CHI')",Providence,ale52.xml,567,32,9,CHI,4047,3692,MOT
0,15,24,528,0.270100534,543,15,do,"('MOT', 'CHI')",Providence,ale52.xml,567,24,0,CHI,4047,3692,MOT
0,1,1,4,0.15415068,5,1,you,"('CHI', 'FAT')",Providence,ale52.xml,6,1,0,FAT,26,34,CHI
4,33,59,471,0.135226787,504,33,it,"('MOT', 'CHI')",Providence,ale52.xml,567,63,4,CHI,4047,3692,MOT
2,4,2,5,0.09531018,9,4,the,"('MOT', 'FAT')",Providence,ale52.xml,13,4,2,FAT,127,88,MOT
0,9,3,35,-0.083381609,44,9,it,"('CHI', 'MOT')",Providence,ale52.xml,47,3,0,MOT,285,416,CHI
0,1,1,2,-0.182321557,3,1,oh,"('MOT', 'OPE')",Providence,ale52.xml,4,1,0,OPE,42,11,MOT
0,3,2,8,-0.207639365,11,3,on,"('MOT', 'FAT')",Providence,ale52.xml,13,2,0,FAT,127,88,MOT
1,2,4,4,-0.271933715,6,2,you,"('FAT', 'CHI')",Providence,ale52.xml,11,5,1,CHI,58,67,FAT
11,59,108,389,-0.295980875,448,59,you,"('MOT', 'CHI')",Providence,ale52.xml,567,119,11,CHI,4047,3692,MOT
0,21,34,512,-0.392294645,533,21,no,"('MOT', 'CHI')",Providence,ale52.xml,567,34,0,CHI,4047,3692,MOT
2,0,16,84,2.557227311,84,0,up,"('MOT', 'CHI')",Providence,eth03.xml,102,18,2,CHI,4572,261,MOT
0,1,1,1,-0.405465108,2,1,in,"('MOT', 'OPE')",Providence,eth03.xml,3,1,0,OPE,16,25,MOT
1,0,4,217,4.136308761,217,0,little,"('MOT', 'CHI')",Providence,eth04.xml,222,5,1,CHI,3806,621,MOT
5,2,14,201,2.971634722,203,2,up,"('MOT', 'CHI')",Providence,eth04.xml,222,19,5,CHI,3806,621,MOT
1,1,34,186,1.630829102,187,1,yeah,"('MOT', 'CHI')",Providence,eth04.xml,222,35,1,CHI,3806,621,MOT
0,2,21,199,1.079099474,201,2,that,"('MOT', 'CHI')",Providence,eth04.xml,222,21,0,CHI,3806,621,MOT
0,3,18,201,0.945849534,204,3,this,"('MOT', 'CHI')",Providence,eth04.xml,222,18,0,CHI,3806,621,MOT
3,6,53,160,0.503905181,166,6,a,"('MOT', 'CHI')",Providence,eth04.xml,222,56,3,CHI,3806,621,MOT
0,1,72,149,0.026668247,150,1,the,"('MOT', 'CHI')",Providence,eth04.xml,222,72,0,CHI,3806,621,MOT
0,2,1,133,2.722756348,135,2,big,"('CHI', 'MOT')",Providence,eth05.xml,136,1,0,MOT,371,1777,CHI
11,7,3,115,2.453157951,122,7,up,"('CHI', 'MOT')",Providence,eth05.xml,136,14,11,MOT,371,1777,CHI
1,3,6,90,1.663505134,93,3,up,"('MOT', 'CHI')",Providence,eth05.xml,100,7,1,CHI,1801,251,MOT
0,8,1,127,1.62414406,135,8,what,"('CHI', 'MOT')",Providence,eth05.xml,136,1,0,MOT,371,1777,CHI
0,11,1,124,1.336461987,135,11,this,"('CHI', 'MOT')",Providence,eth05.xml,136,1,0,MOT,371,1777,CHI
0,29,1,106,0.420171255,135,29,a,"('CHI', 'MOT')",Providence,eth05.xml,136,1,0,MOT,371,1777,CHI
0,2,30,68,-0.287682072,70,2,a,"('MOT', 'CHI')",Providence,eth05.xml,100,30,0,CHI,1801,251,MOT
1,1,20,308,2.604298696,309,1,on,"('MOT', 'CHI')",Providence,eth06.xml,330,21,1,CHI,2471,996,MOT
6,12,2,92,1.741814793,104,12,up,"('CHI', 'MOT')",Providence,eth06.xml,112,8,6,MOT,329,1146,CHI
0,10,1,101,1.230880257,111,10,go,"('CHI', 'MOT')",Providence,eth06.xml,112,1,0,MOT,329,1146,CHI
0,1,42,287,1.192544109,288,1,a,"('MOT', 'CHI')",Providence,eth06.xml,330,42,0,CHI,2471,996,MOT
14,18,0,238,2.543982085,256,18,up,"('CHI', 'MOT')",Providence,eth07.xml,270,14,14,MOT,694,4098,CHI
7,8,3,448,3.524179499,456,8,up,"('CHI', 'MOT')",Providence,eth08.xml,466,10,7,MOT,1269,4849,CHI
2,29,1,434,2.2300144,463,29,on,"('CHI', 'MOT')",Providence,eth08.xml,466,3,2,MOT,1269,4849,CHI
0,18,1,447,2.10327799,465,18,see,"('CHI', 'MOT')",Providence,eth08.xml,466,1,0,MOT,1269,4849,CHI
0,14,2,450,2.049841072,464,14,no,"('CHI', 'MOT')",Providence,eth08.xml,466,2,0,MOT,1269,4849,CHI
0,26,1,439,1.751880103,465,26,go,"('CHI', 'MOT')",Providence,eth08.xml,466,1,0,MOT,1269,4849,CHI
5,40,5,416,1.720149937,456,40,in,"('CHI', 'MOT')",Providence,eth08.xml,466,10,5,MOT,1269,4849,CHI
1,74,0,391,1.423376036,465,74,a,"('CHI', 'MOT')",Providence,eth08.xml,466,1,1,MOT,1269,4849,CHI
0,39,1,426,1.358837515,465,39,that,"('CHI', 'MOT')",Providence,eth08.xml,466,1,0,MOT,1269,4849,CHI
1,74,1,390,1.13355034,464,74,yeah,"('CHI', 'MOT')",Providence,eth08.xml,466,2,1,MOT,1269,4849,CHI
1,6,0,372,3.588795996,378,6,big,"('CHI', 'MOT')",Providence,eth09.xml,379,1,1,MOT,1135,3797,CHI
0,3,1,375,3.455264603,378,3,little,"('CHI', 'MOT')",Providence,eth09.xml,379,1,0,MOT,1135,3797,CHI
1,7,0,371,3.455264603,378,7,he,"('CHI', 'MOT')",Providence,eth09.xml,379,1,1,MOT,1135,3797,CHI
1,9,0,369,3.232121052,378,9,we,"('CHI', 'MOT')",Providence,eth09.xml,379,1,1,MOT,1135,3797,CHI
0,4,1,374,3.232121052,378,4,look,"('CHI', 'MOT')",Providence,eth09.xml,379,1,0,MOT,1135,3797,CHI
2,9,1,367,3.121483479,376,9,no,"('CHI', 'MOT')",Providence,eth09.xml,379,3,2,MOT,1135,3797,CHI
0,6,1,372,2.895648815,378,6,my,"('CHI', 'MOT')",Providence,eth09.xml,379,1,0,MOT,1135,3797,CHI
0,7,1,371,2.762117422,378,7,make,"('CHI', 'MOT')",Providence,eth09.xml,379,1,0,MOT,1135,3797,CHI
8,14,5,352,2.689207113,366,14,up,"('CHI', 'MOT')",Providence,eth09.xml,379,13,8,MOT,1135,3797,CHI
1,19,0,359,2.538973871,378,19,in,"('CHI', 'MOT')",Providence,eth09.xml,379,1,1,MOT,1135,3797,CHI
0,10,1,368,2.443663691,378,10,at,"('CHI', 'MOT')",Providence,eth09.xml,379,1,0,MOT,1135,3797,CHI
0,17,1,361,1.951187206,378,17,on,"('CHI', 'MOT')",Providence,eth09.xml,379,1,0,MOT,1135,3797,CHI
0,20,1,358,1.797036526,378,20,do,"('CHI', 'MOT')",Providence,eth09.xml,379,1,0,MOT,1135,3797,CHI
0,24,1,354,1.622683139,378,24,what,"('CHI', 'MOT')",Providence,eth09.xml,379,1,0,MOT,1135,3797,CHI
0,38,1,340,1.177997318,378,38,and,"('CHI', 'MOT')",Providence,eth09.xml,379,1,0,MOT,1135,3797,CHI
0,29,2,348,1.150044462,377,29,yeah,"('CHI', 'MOT')",Providence,eth09.xml,379,2,0,MOT,1135,3797,CHI
1,73,1,304,0.940323931,377,73,the,"('CHI', 'MOT')",Providence,eth09.xml,379,2,1,MOT,1135,3797,CHI
1,106,0,272,0.86187731,378,106,you,"('CHI', 'MOT')",Providence,eth09.xml,379,1,1,MOT,1135,3797,CHI
1,71,3,304,0.55696678,375,71,a,"('CHI', 'MOT')",Providence,eth09.xml,379,4,1,MOT,1135,3797,CHI
2,5,1,336,3.535145354,341,5,up,"('CHI', 'MOT')",Providence,eth10.xml,344,3,2,MOT,1151,3833,CHI
1,7,1,335,3.068052935,342,7,little,"('CHI', 'MOT')",Providence,eth10.xml,344,2,1,MOT,1151,3833,CHI
1,7,1,335,3.068052935,342,7,big,"('CHI', 'MOT')",Providence,eth10.xml,344,2,1,MOT,1151,3833,CHI
2,12,0,330,2.988010227,342,12,my,"('CHI', 'MOT')",Providence,eth10.xml,344,2,2,MOT,1151,3833,CHI
1,8,1,334,2.950269899,342,8,oh,"('CHI', 'MOT')",Providence,eth10.xml,344,2,1,MOT,1151,3833,CHI
3,10,3,328,2.737903164,338,10,no,"('CHI', 'MOT')",Providence,eth10.xml,344,6,3,MOT,1151,3833,CHI
0,7,1,336,2.665490587,343,7,for,"('CHI', 'MOT')",Providence,eth10.xml,344,1,0,MOT,1151,3833,CHI
8,2,15,102,2.543175558,104,2,it,"('MOT', 'CHI')",Providence,eth10.xml,127,23,8,CHI,1166,449,MOT
0,1,3,123,2.533696814,124,1,up,"('MOT', 'CHI')",Providence,eth10.xml,127,3,0,CHI,1166,449,MOT
1,2,4,120,2.468906308,122,2,no,"('MOT', 'CHI')",Providence,eth10.xml,127,5,1,CHI,1166,449,MOT
2,25,0,317,2.294863047,342,25,that,"('CHI', 'MOT')",Providence,eth10.xml,344,2,2,MOT,1151,3833,CHI
1,1,9,116,2.294216843,117,1,in,"('MOT', 'CHI')",Providence,eth10.xml,127,10,1,CHI,1166,449,MOT
1,0,22,104,2.13771045,104,0,a,"('MOT', 'CHI')",Providence,eth10.xml,127,23,1,CHI,1166,449,MOT
1,0,28,98,1.864330162,98,0,the,"('MOT', 'CHI')",Providence,eth10.xml,127,29,1,CHI,1166,449,MOT
1,22,2,319,1.785945499,341,22,there,"('CHI', 'MOT')",Providence,eth10.xml,344,3,1,MOT,1151,3833,CHI
1,27,2,314,1.589235205,341,27,it,"('CHI', 'MOT')",Providence,eth10.xml,344,3,1,MOT,1151,3833,CHI
1,1,20,105,1.546637011,106,1,yeah,"('MOT', 'CHI')",Providence,eth10.xml,127,21,1,CHI,1166,449,MOT
0,3,5,119,1.488077055,122,3,big,"('MOT', 'CHI')",Providence,eth10.xml,127,5,0,CHI,1166,449,MOT
0,1,12,114,1.429969425,115,1,and,"('MOT', 'CHI')",Providence,eth10.xml,127,12,0,CHI,1166,449,MOT
0,21,2,321,1.363304843,342,21,on,"('CHI', 'MOT')",Providence,eth10.xml,344,2,0,MOT,1151,3833,CHI
0,30,1,313,1.310944924,343,30,in,"('CHI', 'MOT')",Providence,eth10.xml,344,1,0,MOT,1151,3833,CHI
0,30,1,313,1.310944924,343,30,is,"('CHI', 'MOT')",Providence,eth10.xml,344,1,0,MOT,1151,3833,CHI
0,4,5,118,1.264933504,122,4,little,"('MOT', 'CHI')",Providence,eth10.xml,127,5,0,CHI,1166,449,MOT
0,49,1,294,0.832909123,343,49,yeah,"('CHI', 'MOT')",Providence,eth10.xml,344,1,0,MOT,1151,3833,CHI
0,53,1,290,0.755948082,343,53,a,"('CHI', 'MOT')",Providence,eth10.xml,344,1,0,MOT,1151,3833,CHI
1,108,0,235,0.746731427,343,108,you,"('CHI', 'MOT')",Providence,eth10.xml,344,1,1,MOT,1151,3833,CHI
1,1,0,2,0.510825624,3,1,you,"('CHI', 'OPE')",Providence,eth10.xml,4,1,1,OPE,19,28,CHI
0,1,1,6,0.405465108,7,1,like,"('MOT', 'OPE')",Providence,eth10.xml,8,1,0,OPE,79,70,MOT
0,1,1,6,0.405465108,7,1,but,"('MOT', 'OPE')",Providence,eth10.xml,8,1,0,OPE,79,70,MOT
0,1,1,6,0.405465108,7,1,all,"('MOT', 'OPE')",Providence,eth10.xml,8,1,0,OPE,79,70,MOT
0,1,1,6,0.405465108,7,1,that,"('MOT', 'OPE')",Providence,eth10.xml,8,1,0,OPE,79,70,MOT
0,83,1,260,0.31411533,343,83,the,"('CHI', 'MOT')",Providence,eth10.xml,344,1,0,MOT,1151,3833,CHI
0,1,2,5,0,6,1,of,"('MOT', 'OPE')",Providence,eth10.xml,8,2,0,OPE,79,70,MOT
0,1,2,5,0,6,1,a,"('MOT', 'OPE')",Providence,eth10.xml,8,2,0,OPE,79,70,MOT
0,2,1,5,0,7,2,the,"('MOT', 'OPE')",Providence,eth10.xml,8,1,0,OPE,79,70,MOT
0,2,1,5,0,7,2,to,"('MOT', 'OPE')",Providence,eth10.xml,8,1,0,OPE,79,70,MOT
0,2,2,4,-0.405465108,6,2,you,"('MOT', 'OPE')",Providence,eth10.xml,8,2,0,OPE,79,70,MOT
2,2,0,404,4.624972813,406,2,at,"('CHI', 'MOT')",Providence,eth11.xml,408,2,2,MOT,1596,3347,CHI
2,5,0,401,3.931825633,406,5,look,"('CHI', 'MOT')",Providence,eth11.xml,408,2,2,MOT,1596,3347,CHI
1,4,1,402,3.708682081,406,4,this,"('CHI', 'MOT')",Providence,eth11.xml,408,2,1,MOT,1596,3347,CHI
2,5,1,400,3.706228092,405,5,little,"('CHI', 'MOT')",Providence,eth11.xml,408,3,2,MOT,1596,3347,CHI
8,6,4,390,3.598709104,396,6,big,"('CHI', 'MOT')",Providence,eth11.xml,408,12,8,MOT,1596,3347,CHI
0,4,1,403,3.305664955,407,4,where,"('CHI', 'MOT')",Providence,eth11.xml,408,1,0,MOT,1596,3347,CHI
1,11,0,396,3.123343398,407,11,put,"('CHI', 'MOT')",Providence,eth11.xml,408,1,1,MOT,1596,3347,CHI
2,9,2,395,3.010620886,404,9,not,"('CHI', 'MOT')",Providence,eth11.xml,408,4,2,MOT,1596,3347,CHI
0,6,1,401,2.969192718,407,6,he,"('CHI', 'MOT')",Providence,eth11.xml,408,1,0,MOT,1596,3347,CHI
2,10,2,394,2.915310706,404,10,do,"('CHI', 'MOT')",Providence,eth11.xml,408,4,2,MOT,1596,3347,CHI
6,11,6,385,2.808398175,396,11,up,"('CHI', 'MOT')",Providence,eth11.xml,408,12,6,MOT,1596,3347,CHI
5,15,3,385,2.713037743,400,15,oh,"('CHI', 'MOT')",Providence,eth11.xml,408,8,5,MOT,1596,3347,CHI
6,16,4,382,2.619254702,398,16,no,"('CHI', 'MOT')",Providence,eth11.xml,408,10,6,MOT,1596,3347,CHI
0,10,1,397,2.517207595,407,10,get,"('CHI', 'MOT')",Providence,eth11.xml,408,1,0,MOT,1596,3347,CHI
0,10,1,397,2.517207595,407,10,that,"('CHI', 'MOT')",Providence,eth11.xml,408,1,0,MOT,1596,3347,CHI
1,24,0,383,2.389374223,407,24,yeah,"('CHI', 'MOT')",Providence,eth11.xml,408,1,1,MOT,1596,3347,CHI
1,14,2,391,2.384472252,405,14,there,"('CHI', 'MOT')",Providence,eth11.xml,408,3,1,MOT,1596,3347,CHI
0,15,1,392,2.142514145,407,15,go,"('CHI', 'MOT')",Providence,eth11.xml,408,1,0,MOT,1596,3347,CHI
0,17,1,390,2.024731109,407,17,on,"('CHI', 'MOT')",Providence,eth11.xml,408,1,0,MOT,1596,3347,CHI
0,18,1,389,1.970663888,407,18,in,"('CHI', 'MOT')",Providence,eth11.xml,408,1,0,MOT,1596,3347,CHI
0,18,1,389,1.970663888,407,18,and,"('CHI', 'MOT')",Providence,eth11.xml,408,1,0,MOT,1596,3347,CHI
2,18,5,383,1.955885294,401,18,it,"('CHI', 'MOT')",Providence,eth11.xml,408,7,2,MOT,1596,3347,CHI
0,20,1,387,1.87058043,407,20,to,"('CHI', 'MOT')",Providence,eth11.xml,408,1,0,MOT,1596,3347,CHI
3,65,0,340,1.596014892,405,65,you,"('CHI', 'MOT')",Providence,eth11.xml,408,3,3,MOT,1596,3347,CHI
0,41,1,366,1.177433249,407,41,is,"('CHI', 'MOT')",Providence,eth11.xml,408,1,0,MOT,1596,3347,CHI
2,94,1,311,0.94411067,405,94,the,"('CHI', 'MOT')",Providence,eth11.xml,408,3,2,MOT,1596,3347,CHI
2,58,4,344,0.943048181,402,58,a,"('CHI', 'MOT')",Providence,eth11.xml,408,6,2,MOT,1596,3347,CHI
1,1,0,4,0.84729786,5,1,it,"('OPE', 'MOT')",Providence,eth11.xml,6,1,1,MOT,28,96,OPE
1,0,0,1,0.693147181,1,0,it,"('MOT', 'CHI')",Providence,eth11.xml,2,1,1,CHI,10,5,MOT
0,2,1,3,-0.251314428,5,2,there,"('OPE', 'MOT')",Providence,eth11.xml,6,1,0,MOT,28,96,OPE
2,8,0,358,3.423176288,366,8,this,"('CHI', 'MOT')",Providence,eth12.xml,368,2,2,MOT,1367,3783,CHI
1,5,1,361,3.423176288,366,5,big,"('CHI', 'MOT')",Providence,eth12.xml,368,2,1,MOT,1367,3783,CHI
5,8,1,354,3.412247218,362,8,little,"('CHI', 'MOT')",Providence,eth12.xml,368,6,5,MOT,1367,3783,CHI
0,4,1,363,3.202746443,367,4,my,"('CHI', 'MOT')",Providence,eth12.xml,368,1,0,MOT,1367,3783,CHI
2,17,0,349,2.730029108,366,17,do,"('CHI', 'MOT')",Providence,eth12.xml,368,2,2,MOT,1367,3783,CHI
1,16,0,351,2.672118192,367,16,like,"('CHI', 'MOT')",Providence,eth12.xml,368,1,1,MOT,1367,3783,CHI
5,22,0,341,2.610252458,363,22,in,"('CHI', 'MOT')",Providence,eth12.xml,368,5,5,MOT,1367,3783,CHI
7,11,9,341,2.573460047,352,11,no,"('CHI', 'MOT')",Providence,eth12.xml,368,16,7,MOT,1367,3783,CHI
1,16,1,350,2.381722414,366,16,oh,"('CHI', 'MOT')",Providence,eth12.xml,368,2,1,MOT,1367,3783,CHI
1,24,0,343,2.286455711,367,24,it,"('CHI', 'MOT')",Providence,eth12.xml,368,1,1,MOT,1367,3783,CHI
1,24,0,343,2.286455711,367,24,that,"('CHI', 'MOT')",Providence,eth12.xml,368,1,1,MOT,1367,3783,CHI
1,24,0,343,2.286455711,367,24,and,"('CHI', 'MOT')",Providence,eth12.xml,368,1,1,MOT,1367,3783,CHI
3,11,8,346,2.219760742,357,11,up,"('CHI', 'MOT')",Providence,eth12.xml,368,11,3,MOT,1367,3783,CHI
0,14,1,353,2.104134154,367,14,put,"('CHI', 'MOT')",Providence,eth12.xml,368,1,0,MOT,1367,3783,CHI
0,37,1,330,1.174598196,367,37,is,"('CHI', 'MOT')",Providence,eth12.xml,368,1,0,MOT,1367,3783,CHI
1,76,0,291,1.161526114,367,76,the,"('CHI', 'MOT')",Providence,eth12.xml,368,1,1,MOT,1367,3783,CHI
6,80,2,280,1.140520113,360,80,a,"('CHI', 'MOT')",Providence,eth12.xml,368,8,6,MOT,1367,3783,CHI
3,112,0,253,0.954830478,365,112,you,"('CHI', 'MOT')",Providence,eth12.xml,368,3,3,MOT,1367,3783,CHI
0,1,1,2,-0.182321557,3,1,the,"('OPE', 'MOT')",Providence,eth12.xml,4,1,0,MOT,23,37,OPE
1,0,9,245,3.717628867,245,0,get,"('MOT', 'CHI')",Providence,eth13.xml,255,10,1,CHI,3392,924,MOT
0,2,4,249,2.643017731,251,2,not,"('MOT', 'CHI')",Providence,eth13.xml,255,4,0,CHI,3392,924,MOT
0,1,7,247,2.63108916,248,1,no,"('MOT', 'CHI')",Providence,eth13.xml,255,7,0,CHI,3392,924,MOT
1,3,11,240,2.1690537,243,3,up,"('MOT', 'CHI')",Providence,eth13.xml,255,12,1,CHI,3392,924,MOT
1,2,21,231,1.876066576,233,2,it,"('MOT', 'CHI')",Providence,eth13.xml,255,22,1,CHI,3392,924,MOT
0,3,8,244,1.828573442,247,3,my,"('MOT', 'CHI')",Providence,eth13.xml,255,8,0,CHI,3392,924,MOT
6,7,26,216,1.756208485,223,7,on,"('MOT', 'CHI')",Providence,eth13.xml,255,32,6,CHI,3392,924,MOT
0,2,15,238,1.557112093,240,2,see,"('MOT', 'CHI')",Providence,eth13.xml,255,15,0,CHI,3392,924,MOT
0,1,26,228,1.41706602,229,1,in,"('MOT', 'CHI')",Providence,eth13.xml,255,26,0,CHI,3392,924,MOT
0,5,14,236,0.928713252,241,5,little,"('MOT', 'CHI')",Providence,eth13.xml,255,14,0,CHI,3392,924,MOT
0,1,42,212,0.893301214,213,1,and,"('MOT', 'CHI')",Providence,eth13.xml,255,42,0,CHI,3392,924,MOT
1,5,61,188,0.015504187,193,5,a,"('MOT', 'CHI')",Providence,eth13.xml,255,62,1,CHI,3392,924,MOT
0,2,67,186,-0.085694721,188,2,the,"('MOT', 'CHI')",Providence,eth13.xml,255,67,0,CHI,3392,924,MOT
0,4,48,203,-0.179126666,207,4,you,"('MOT', 'CHI')",Providence,eth13.xml,255,48,0,CHI,3392,924,MOT
0,1,1,397,4.199705078,398,1,but,"('CHI', 'MOT')",Providence,eth14.xml,399,1,0,MOT,1768,4312,CHI
3,6,0,390,3.817398305,396,6,at,"('CHI', 'MOT')",Providence,eth14.xml,399,3,3,MOT,1768,4312,CHI
1,5,0,393,3.79423997,398,5,gonna,"('CHI', 'MOT')",Providence,eth14.xml,399,1,1,MOT,1768,4312,CHI
0,2,1,396,3.79423997,398,2,my,"('CHI', 'MOT')",Providence,eth14.xml,399,1,0,MOT,1768,4312,CHI
1,6,0,392,3.64008929,398,6,not,"('CHI', 'MOT')",Providence,eth14.xml,399,1,1,MOT,1768,4312,CHI
2,5,2,390,3.499029631,395,5,no,"('CHI', 'MOT')",Providence,eth14.xml,399,4,2,MOT,1768,4312,CHI
2,10,0,387,3.303384072,397,10,see,"('CHI', 'MOT')",Providence,eth14.xml,399,2,2,MOT,1768,4312,CHI
0,4,1,394,3.283414346,398,4,look,"('CHI', 'MOT')",Providence,eth14.xml,399,1,0,MOT,1768,4312,CHI
2,5,4,388,3.206297043,393,5,one,"('CHI', 'MOT')",Providence,eth14.xml,399,6,2,MOT,1768,4312,CHI
6,9,4,380,3.127125966,389,9,little,"('CHI', 'MOT')",Providence,eth14.xml,399,10,6,MOT,1768,4312,CHI
1,12,0,386,3.021050082,398,12,are,"('CHI', 'MOT')",Providence,eth14.xml,399,1,1,MOT,1768,4312,CHI
5,10,4,380,2.967230763,390,10,have,"('CHI', 'MOT')",Providence,eth14.xml,399,9,5,MOT,1768,4312,CHI
12,11,8,368,2.931799629,379,11,up,"('CHI', 'MOT')",Providence,eth14.xml,399,20,12,MOT,1768,4312,CHI
1,9,2,387,2.76757618,396,9,that,"('CHI', 'MOT')",Providence,eth14.xml,399,3,1,MOT,1768,4312,CHI
0,8,1,390,2.695627681,398,8,get,"('CHI', 'MOT')",Providence,eth14.xml,399,1,0,MOT,1768,4312,CHI
0,9,1,389,2.590267165,398,9,this,"('CHI', 'MOT')",Providence,eth14.xml,399,1,0,MOT,1768,4312,CHI
0,9,1,389,2.590267165,398,9,all,"('CHI', 'MOT')",Providence,eth14.xml,399,1,0,MOT,1768,4312,CHI
0,11,1,387,2.407945609,398,11,oh,"('CHI', 'MOT')",Providence,eth14.xml,399,1,0,MOT,1768,4312,CHI
2,18,2,377,2.346350121,395,18,want,"('CHI', 'MOT')",Providence,eth14.xml,399,4,2,MOT,1768,4312,CHI
2,29,1,367,2.074429,396,29,is,"('CHI', 'MOT')",Providence,eth14.xml,399,3,2,MOT,1768,4312,CHI
1,25,1,372,2.037717698,397,25,to,"('CHI', 'MOT')",Providence,eth14.xml,399,2,1,MOT,1768,4312,CHI
3,25,4,367,1.907324155,392,25,go,"('CHI', 'MOT')",Providence,eth14.xml,399,7,3,MOT,1768,4312,CHI
8,41,3,347,1.860752341,388,41,it,"('CHI', 'MOT')",Providence,eth14.xml,399,11,8,MOT,1768,4312,CHI
3,30,3,363,1.85175138,393,30,in,"('CHI', 'MOT')",Providence,eth14.xml,399,6,3,MOT,1768,4312,CHI
3,35,2,359,1.838279485,394,35,there,"('CHI', 'MOT')",Providence,eth14.xml,399,5,3,MOT,1768,4312,CHI
1,22,3,373,1.749829776,395,22,put,"('CHI', 'MOT')",Providence,eth14.xml,399,4,1,MOT,1768,4312,CHI
5,26,8,360,1.748877742,386,26,on,"('CHI', 'MOT')",Providence,eth14.xml,399,13,5,MOT,1768,4312,CHI
2,56,0,341,1.658228077,397,56,and,"('CHI', 'MOT')",Providence,eth14.xml,399,2,2,MOT,1768,4312,CHI
1,30,2,366,1.636174069,396,30,what,"('CHI', 'MOT')",Providence,eth14.xml,399,3,1,MOT,1768,4312,CHI
0,22,2,375,1.46717284,397,22,do,"('CHI', 'MOT')",Providence,eth14.xml,399,2,0,MOT,1768,4312,CHI
1,70,0,328,1.323319562,398,70,you,"('CHI', 'MOT')",Providence,eth14.xml,399,1,1,MOT,1768,4312,CHI
5,66,4,324,1.160433417,390,66,a,"('CHI', 'MOT')",Providence,eth14.xml,399,9,5,MOT,1768,4312,CHI
2,113,0,284,0.965080896,397,113,the,"('CHI', 'MOT')",Providence,eth14.xml,399,2,2,MOT,1768,4312,CHI
1,4,0,260,3.568593288,264,4,no,"('CHI', 'MOT')",Providence,eth15.xml,265,1,1,MOT,1207,2332,CHI
1,4,0,260,3.568593288,264,4,not,"('CHI', 'MOT')",Providence,eth15.xml,265,1,1,MOT,1207,2332,CHI
4,4,3,254,3.363457054,258,4,for,"('CHI', 'MOT')",Providence,eth15.xml,265,7,4,MOT,1207,2332,CHI
3,1,4,118,3.291713149,119,1,little,"('MOT', 'CHI')",Providence,eth15.xml,126,7,3,CHI,1058,586,MOT
1,6,0,258,3.232121052,264,6,want,"('CHI', 'MOT')",Providence,eth15.xml,265,1,1,MOT,1207,2332,CHI
3,1,7,115,2.978925155,116,1,go,"('MOT', 'CHI')",Providence,eth15.xml,126,10,3,CHI,1058,586,MOT
0,1,5,259,2.929287174,260,1,my,"('CHI', 'MOT')",Providence,eth15.xml,265,5,0,MOT,1207,2332,CHI
4,12,0,249,2.824883118,261,12,on,"('CHI', 'MOT')",Providence,eth15.xml,265,4,4,MOT,1207,2332,CHI
2,2,11,111,2.036881927,113,2,and,"('MOT', 'CHI')",Providence,eth15.xml,126,13,2,CHI,1058,586,MOT
0,1,6,119,2.031432322,120,1,oh,"('MOT', 'CHI')",Providence,eth15.xml,126,6,0,CHI,1058,586,MOT
0,11,1,253,1.99997737,264,11,go,"('CHI', 'MOT')",Providence,eth15.xml,265,1,0,MOT,1207,2332,CHI
0,5,1,120,1.953815329,125,5,my,"('MOT', 'CHI')",Providence,eth15.xml,126,1,0,CHI,1058,586,MOT
0,1,7,118,1.905418788,119,1,yeah,"('MOT', 'CHI')",Providence,eth15.xml,126,7,0,CHI,1058,586,MOT
0,2,5,119,1.767661918,121,2,no,"('MOT', 'CHI')",Providence,eth15.xml,126,5,0,CHI,1058,586,MOT
4,26,3,232,1.6770581,258,26,and,"('CHI', 'MOT')",Providence,eth15.xml,265,7,4,MOT,1207,2332,CHI
6,33,3,223,1.574613937,256,33,it,"('CHI', 'MOT')",Providence,eth15.xml,265,9,6,MOT,1207,2332,CHI
0,13,2,250,1.554378135,263,13,up,"('CHI', 'MOT')",Providence,eth15.xml,265,2,0,MOT,1207,2332,CHI
1,42,0,222,1.416831085,264,42,the,"('CHI', 'MOT')",Providence,eth15.xml,265,1,1,MOT,1207,2332,CHI
3,58,1,203,1.08915148,261,58,you,"('CHI', 'MOT')",Providence,eth15.xml,265,4,3,MOT,1207,2332,CHI
3,51,8,203,0.41527873,254,51,a,"('CHI', 'MOT')",Providence,eth15.xml,265,11,3,MOT,1207,2332,CHI
1,2,1,425,4.26969745,427,2,where,"('CHI', 'MOT')",Providence,eth16.xml,429,2,1,MOT,2315,3885,CHI
1,5,1,422,3.576550269,427,5,for,"('CHI', 'MOT')",Providence,eth16.xml,429,2,1,MOT,2315,3885,CHI
1,4,2,422,3.533394551,426,4,my,"('CHI', 'MOT')",Providence,eth16.xml,429,3,1,MOT,2315,3885,CHI
0,4,1,424,3.355735008,428,4,get,"('CHI', 'MOT')",Providence,eth16.xml,429,1,0,MOT,2315,3885,CHI
0,4,1,424,3.355735008,428,4,he,"('CHI', 'MOT')",Providence,eth16.xml,429,1,0,MOT,2315,3885,CHI
0,3,2,424,3.288868197,427,3,go,"('CHI', 'MOT')",Providence,eth16.xml,429,2,0,MOT,2315,3885,CHI
2,9,1,417,3.245712479,426,9,at,"('CHI', 'MOT')",Providence,eth16.xml,429,3,2,MOT,2315,3885,CHI
2,10,1,416,3.150402299,426,10,put,"('CHI', 'MOT')",Providence,eth16.xml,429,3,2,MOT,2315,3885,CHI
1,12,0,416,3.093370743,428,12,see,"('CHI', 'MOT')",Providence,eth16.xml,429,1,1,MOT,2315,3885,CHI
3,13,1,412,3.012261576,425,13,oh,"('CHI', 'MOT')",Providence,eth16.xml,429,4,3,MOT,2315,3885,CHI
11,14,5,399,2.914763211,413,14,up,"('CHI', 'MOT')",Providence,eth16.xml,429,16,11,MOT,2315,3885,CHI
0,7,1,421,2.885731378,428,7,they,"('CHI', 'MOT')",Providence,eth16.xml,429,1,0,MOT,2315,3885,CHI
2,12,2,413,2.798687475,425,12,all,"('CHI', 'MOT')",Providence,eth16.xml,429,4,2,MOT,2315,3885,CHI
1,18,0,410,2.713881121,428,18,do,"('CHI', 'MOT')",Providence,eth16.xml,429,1,1,MOT,2315,3885,CHI
1,22,0,406,2.522825885,428,22,what,"('CHI', 'MOT')",Providence,eth16.xml,429,1,1,MOT,2315,3885,CHI
1,8,5,415,2.46857023,423,8,no,"('CHI', 'MOT')",Providence,eth16.xml,429,6,1,MOT,2315,3885,CHI
3,15,4,407,2.466214517,422,15,there,"('CHI', 'MOT')",Providence,eth16.xml,429,7,3,MOT,2315,3885,CHI
0,12,1,416,2.400223563,428,12,this,"('CHI', 'MOT')",Providence,eth16.xml,429,1,0,MOT,2315,3885,CHI
14,34,7,374,2.033365083,408,34,it,"('CHI', 'MOT')",Providence,eth16.xml,429,21,14,MOT,2315,3885,CHI
0,18,1,410,2.020733941,428,18,are,"('CHI', 'MOT')",Providence,eth16.xml,429,1,0,MOT,2315,3885,CHI
2,34,1,392,1.99294951,426,34,is,"('CHI', 'MOT')",Providence,eth16.xml,429,3,2,MOT,2315,3885,CHI
0,19,1,409,1.969440646,428,19,to,"('CHI', 'MOT')",Providence,eth16.xml,429,1,0,MOT,2315,3885,CHI
15,32,11,371,1.947763718,403,32,in,"('CHI', 'MOT')",Providence,eth16.xml,429,26,15,MOT,2315,3885,CHI
0,10,4,415,1.867129271,425,10,not,"('CHI', 'MOT')",Providence,eth16.xml,429,4,0,MOT,2315,3885,CHI
0,7,7,415,1.773067336,422,7,little,"('CHI', 'MOT')",Providence,eth16.xml,429,7,0,MOT,2315,3885,CHI
9,30,13,377,1.704259214,407,30,and,"('CHI', 'MOT')",Providence,eth16.xml,429,22,9,MOT,2315,3885,CHI
3,33,5,388,1.604720923,421,33,on,"('CHI', 'MOT')",Providence,eth16.xml,429,8,3,MOT,2315,3885,CHI
17,93,2,317,1.323577887,410,93,the,"('CHI', 'MOT')",Providence,eth16.xml,429,19,17,MOT,2315,3885,CHI
7,81,5,336,1.071535885,417,81,you,"('CHI', 'MOT')",Providence,eth16.xml,429,12,7,MOT,2315,3885,CHI
6,85,13,325,0.468063764,410,85,a,"('CHI', 'MOT')",Providence,eth16.xml,429,19,6,MOT,2315,3885,CHI
1,0,1,1,0.405465108,1,0,you,"('MOT', 'FAT')",Providence,eth16.xml,3,2,1,FAT,19,16,MOT
0,1,1,3,0,4,1,a,"('FAT', 'MOT')",Providence,eth16.xml,5,1,0,MOT,36,21,FAT
2,0,13,261,3.837552977,261,0,go,"('MOT', 'CHI')",Providence,eth17.xml,276,15,2,CHI,3089,1566,MOT
0,1,1,274,3.832258037,275,1,they,"('MOT', 'CHI')",Providence,eth17.xml,276,1,0,CHI,3089,1566,MOT
0,1,3,272,3.314186005,273,1,get,"('MOT', 'CHI')",Providence,eth17.xml,276,3,0,CHI,3089,1566,MOT
0,2,3,271,2.908720897,273,2,make,"('MOT', 'CHI')",Providence,eth17.xml,276,3,0,CHI,3089,1566,MOT
0,1,6,269,2.833213344,270,1,have,"('MOT', 'CHI')",Providence,eth17.xml,276,6,0,CHI,3089,1566,MOT
4,3,18,251,2.590267165,254,3,and,"('MOT', 'CHI')",Providence,eth17.xml,276,22,4,CHI,3089,1566,MOT
0,2,5,269,2.564949357,271,2,look,"('MOT', 'CHI')",Providence,eth17.xml,276,5,0,CHI,3089,1566,MOT
4,5,12,255,2.495651189,260,5,no,"('MOT', 'CHI')",Providence,eth17.xml,276,16,4,CHI,3089,1566,MOT
2,3,13,258,2.451258616,261,3,put,"('MOT', 'CHI')",Providence,eth17.xml,276,15,2,CHI,3089,1566,MOT
0,1,11,264,2.32915212,265,1,want,"('MOT', 'CHI')",Providence,eth17.xml,276,11,0,CHI,3089,1566,MOT
1,3,11,261,2.251291799,264,3,this,"('MOT', 'CHI')",Providence,eth17.xml,276,12,1,CHI,3089,1566,MOT
0,2,8,266,2.197224577,268,2,oh,"('MOT', 'CHI')",Providence,eth17.xml,276,8,0,CHI,3089,1566,MOT
1,1,27,247,2.120263536,248,1,is,"('MOT', 'CHI')",Providence,eth17.xml,276,28,1,CHI,3089,1566,MOT
0,1,14,261,2.1102132,262,1,to,"('MOT', 'CHI')",Providence,eth17.xml,276,14,0,CHI,3089,1566,MOT
2,7,9,258,2.041470048,265,7,up,"('MOT', 'CHI')",Providence,eth17.xml,276,11,2,CHI,3089,1566,MOT
1,2,22,251,1.916922612,253,2,there,"('MOT', 'CHI')",Providence,eth17.xml,276,23,1,CHI,3089,1566,MOT
0,3,8,265,1.909542505,268,3,like,"('MOT', 'CHI')",Providence,eth17.xml,276,8,0,CHI,3089,1566,MOT
1,6,13,256,1.550597412,262,6,that,"('MOT', 'CHI')",Providence,eth17.xml,276,14,1,CHI,3089,1566,MOT
4,6,31,235,1.545671294,241,6,in,"('MOT', 'CHI')",Providence,eth17.xml,276,35,4,CHI,3089,1566,MOT
0,3,13,260,1.485385264,263,3,do,"('MOT', 'CHI')",Providence,eth17.xml,276,13,0,CHI,3089,1566,MOT
0,2,18,256,1.466337069,258,2,see,"('MOT', 'CHI')",Providence,eth17.xml,276,18,0,CHI,3089,1566,MOT
11,7,74,184,1.202247178,191,7,the,"('MOT', 'CHI')",Providence,eth17.xml,276,85,11,CHI,3089,1566,MOT
8,19,29,220,1.022727591,239,19,on,"('MOT', 'CHI')",Providence,eth17.xml,276,37,8,CHI,3089,1566,MOT
5,11,39,221,0.933532538,232,11,it,"('MOT', 'CHI')",Providence,eth17.xml,276,44,5,CHI,3089,1566,MOT
5,7,64,200,0.791972302,207,7,you,"('MOT', 'CHI')",Providence,eth17.xml,276,69,5,CHI,3089,1566,MOT
10,19,52,195,0.618558324,214,19,a,"('MOT', 'CHI')",Providence,eth17.xml,276,62,10,CHI,3089,1566,MOT
1,0,6,204,3.823798772,204,0,think,"('MOT', 'CHI')",Providence,eth18.xml,211,7,1,CHI,2795,809,MOT
1,0,12,198,3.283414346,198,0,he,"('MOT', 'CHI')",Providence,eth18.xml,211,13,1,CHI,2795,809,MOT
0,1,1,155,3.270835564,156,1,big,"('CHI', 'MOT')",Providence,eth18.xml,157,1,0,MOT,571,1564,CHI
1,3,0,153,3.270835564,156,3,not,"('CHI', 'MOT')",Providence,eth18.xml,157,1,1,MOT,571,1564,CHI
5,5,0,147,3.091042453,152,5,all,"('CHI', 'MOT')",Providence,eth18.xml,157,5,5,MOT,571,1564,CHI
1,4,0,152,3.047692012,156,4,see,"('CHI', 'MOT')",Providence,eth18.xml,157,1,1,MOT,571,1564,CHI
0,1,3,207,3.044522438,208,1,some,"('MOT', 'CHI')",Providence,eth18.xml,211,3,0,CHI,2795,809,MOT
4,5,1,147,2.908720897,152,5,one,"('CHI', 'MOT')",Providence,eth18.xml,157,5,4,MOT,571,1564,CHI
0,1,5,205,2.69848075,206,1,wanna,"('MOT', 'CHI')",Providence,eth18.xml,211,5,0,CHI,2795,809,MOT
3,4,6,198,2.69708117,202,4,this,"('MOT', 'CHI')",Providence,eth18.xml,211,9,3,CHI,2795,809,MOT
1,7,0,149,2.577688383,156,7,on,"('CHI', 'MOT')",Providence,eth18.xml,157,1,1,MOT,571,1564,CHI
0,1,6,204,2.560130071,205,1,my,"('MOT', 'CHI')",Providence,eth18.xml,211,6,0,CHI,2795,809,MOT
2,7,1,147,2.459588842,154,7,want,"('CHI', 'MOT')",Providence,eth18.xml,157,3,2,MOT,571,1564,CHI
0,1,7,203,2.437504411,204,1,go,"('MOT', 'CHI')",Providence,eth18.xml,211,7,0,CHI,2795,809,MOT
0,4,1,152,2.354544832,156,4,go,"('CHI', 'MOT')",Providence,eth18.xml,157,1,0,MOT,571,1564,CHI
0,1,9,201,2.22707754,202,1,see,"('MOT', 'CHI')",Providence,eth18.xml,211,9,0,CHI,2795,809,MOT
1,4,6,200,2.21436086,204,4,at,"('MOT', 'CHI')",Providence,eth18.xml,211,7,1,CHI,2795,809,MOT
0,5,1,151,2.172223275,156,5,this,"('CHI', 'MOT')",Providence,eth18.xml,157,1,0,MOT,571,1564,CHI
0,2,6,203,2.154664963,205,2,like,"('MOT', 'CHI')",Providence,eth18.xml,211,6,0,CHI,2795,809,MOT
0,1,11,199,2.050171159,200,1,do,"('MOT', 'CHI')",Providence,eth18.xml,211,11,0,CHI,2795,809,MOT
0,2,7,202,2.032039303,204,2,want,"('MOT', 'CHI')",Providence,eth18.xml,211,7,0,CHI,2795,809,MOT
1,4,8,198,2.003933989,202,4,look,"('MOT', 'CHI')",Providence,eth18.xml,211,9,1,CHI,2795,809,MOT
0,1,12,198,1.971100398,199,1,of,"('MOT', 'CHI')",Providence,eth18.xml,211,12,0,CHI,2795,809,MOT
0,1,12,198,1.971100398,199,1,there,"('MOT', 'CHI')",Providence,eth18.xml,211,12,0,CHI,2795,809,MOT
0,2,8,201,1.921812597,203,2,we,"('MOT', 'CHI')",Providence,eth18.xml,211,8,0,CHI,2795,809,MOT
0,2,8,201,1.921812597,203,2,one,"('MOT', 'CHI')",Providence,eth18.xml,211,8,0,CHI,2795,809,MOT
3,3,23,182,1.898904107,185,3,it,"('MOT', 'CHI')",Providence,eth18.xml,211,26,3,CHI,2795,809,MOT
2,2,26,181,1.819158443,183,2,that,"('MOT', 'CHI')",Providence,eth18.xml,211,28,2,CHI,2795,809,MOT
1,6,5,145,1.698233411,151,6,in,"('CHI', 'MOT')",Providence,eth18.xml,157,6,1,MOT,571,1564,CHI
2,4,18,187,1.660822112,191,4,in,"('MOT', 'CHI')",Providence,eth18.xml,211,20,2,CHI,2795,809,MOT
5,11,14,181,1.530188541,192,11,up,"('MOT', 'CHI')",Providence,eth18.xml,211,19,5,CHI,2795,809,MOT
0,11,1,145,1.479076095,156,11,is,"('CHI', 'MOT')",Providence,eth18.xml,157,1,0,MOT,571,1564,CHI
0,5,4,148,1.459906178,153,5,no,"('CHI', 'MOT')",Providence,eth18.xml,157,4,0,MOT,571,1564,CHI
0,12,1,144,1.399033387,156,12,can,"('CHI', 'MOT')",Providence,eth18.xml,157,1,0,MOT,571,1564,CHI
0,3,12,196,1.277953217,199,3,to,"('MOT', 'CHI')",Providence,eth18.xml,211,12,0,CHI,2795,809,MOT
1,22,1,133,1.227604409,155,22,it,"('CHI', 'MOT')",Providence,eth18.xml,157,2,1,MOT,571,1564,CHI
1,1,46,163,1.22016749,164,1,a,"('MOT', 'CHI')",Providence,eth18.xml,211,47,1,CHI,2795,809,MOT
4,27,4,122,0.991928146,149,27,the,"('CHI', 'MOT')",Providence,eth18.xml,157,8,4,MOT,571,1564,CHI
2,28,3,124,0.822358912,152,28,a,"('CHI', 'MOT')",Providence,eth18.xml,157,5,2,MOT,571,1564,CHI
1,4,30,176,0.791208394,180,4,and,"('MOT', 'CHI')",Providence,eth18.xml,211,31,1,CHI,2795,809,MOT
0,31,1,125,0.498246842,156,31,that,"('CHI', 'MOT')",Providence,eth18.xml,157,1,0,MOT,571,1564,CHI
2,5,49,155,0.424157241,160,5,the,"('MOT', 'CHI')",Providence,eth18.xml,211,51,2,CHI,2795,809,MOT
0,3,36,172,0.152269212,175,3,you,"('MOT', 'CHI')",Providence,eth18.xml,211,36,0,CHI,2795,809,MOT
2,0,5,308,4.637960009,308,0,get,"('MOT', 'CHI')",Providence,eth19.xml,315,7,2,CHI,4009,1464,MOT
1,0,14,300,3.570360854,300,0,little,"('MOT', 'CHI')",Providence,eth19.xml,315,15,1,CHI,4009,1464,MOT
3,1,13,298,3.509885687,299,1,one,"('MOT', 'CHI')",Providence,eth19.xml,315,16,3,CHI,4009,1464,MOT
0,1,3,311,3.446807893,312,1,my,"('MOT', 'CHI')",Providence,eth19.xml,315,3,0,CHI,4009,1464,MOT
0,1,5,309,3.103945858,310,1,no,"('MOT', 'CHI')",Providence,eth19.xml,315,5,0,CHI,4009,1464,MOT
0,1,5,309,3.103945858,310,1,he,"('MOT', 'CHI')",Providence,eth19.xml,315,5,0,CHI,4009,1464,MOT
1,0,25,289,3.034265938,289,0,and,"('MOT', 'CHI')",Providence,eth19.xml,315,26,1,CHI,4009,1464,MOT
0,1,7,307,2.84620054,308,1,where,"('MOT', 'CHI')",Providence,eth19.xml,315,7,0,CHI,4009,1464,MOT
2,1,29,283,2.564949357,284,1,that,"('MOT', 'CHI')",Providence,eth19.xml,315,31,2,CHI,4009,1464,MOT
0,2,6,307,2.561739082,309,2,look,"('MOT', 'CHI')",Providence,eth19.xml,315,6,0,CHI,4009,1464,MOT
0,1,10,304,2.548793917,305,1,some,"('MOT', 'CHI')",Providence,eth19.xml,315,10,0,CHI,4009,1464,MOT
0,1,12,302,2.388107266,303,1,are,"('MOT', 'CHI')",Providence,eth19.xml,315,12,0,CHI,4009,1464,MOT
0,1,16,298,2.123591326,299,1,oh,"('MOT', 'CHI')",Providence,eth19.xml,315,16,0,CHI,4009,1464,MOT
1,3,20,291,1.861718058,294,3,for,"('MOT', 'CHI')",Providence,eth19.xml,315,21,1,CHI,4009,1464,MOT
0,1,21,293,1.861718058,294,1,there,"('MOT', 'CHI')",Providence,eth19.xml,315,21,0,CHI,4009,1464,MOT
1,4,16,294,1.843052764,298,4,put,"('MOT', 'CHI')",Providence,eth19.xml,315,17,1,CHI,4009,1464,MOT
2,6,20,287,1.661623666,293,6,go,"('MOT', 'CHI')",Providence,eth19.xml,315,22,2,CHI,4009,1464,MOT
0,3,13,299,1.622683139,302,3,like,"('MOT', 'CHI')",Providence,eth19.xml,315,13,0,CHI,4009,1464,MOT
1,7,13,294,1.554849722,301,7,up,"('MOT', 'CHI')",Providence,eth19.xml,315,14,1,CHI,4009,1464,MOT
0,1,29,285,1.535826095,286,1,do,"('MOT', 'CHI')",Providence,eth19.xml,315,29,0,CHI,4009,1464,MOT
2,4,34,275,1.489942886,279,4,to,"('MOT', 'CHI')",Providence,eth19.xml,315,36,2,CHI,4009,1464,MOT
2,6,28,279,1.346448453,285,6,is,"('MOT', 'CHI')",Providence,eth19.xml,315,30,2,CHI,4009,1464,MOT
1,5,24,285,1.282304648,290,5,in,"('MOT', 'CHI')",Providence,eth19.xml,315,25,1,CHI,4009,1464,MOT
2,5,40,268,1.139434283,273,5,on,"('MOT', 'CHI')",Providence,eth19.xml,315,42,2,CHI,4009,1464,MOT
0,5,19,291,0.86081158,296,5,this,"('MOT', 'CHI')",Providence,eth19.xml,315,19,0,CHI,4009,1464,MOT
1,2,74,238,0.739667196,240,2,you,"('MOT', 'CHI')",Providence,eth19.xml,315,75,1,CHI,4009,1464,MOT
10,15,70,220,0.686647444,235,15,a,"('MOT', 'CHI')",Providence,eth19.xml,315,80,10,CHI,4009,1464,MOT
0,5,24,286,0.630316602,291,5,what,"('MOT', 'CHI')",Providence,eth19.xml,315,24,0,CHI,4009,1464,MOT
5,26,35,249,0.382270491,275,26,it,"('MOT', 'CHI')",Providence,eth19.xml,315,40,5,CHI,4009,1464,MOT
4,10,82,219,0.176623536,229,10,the,"('MOT', 'CHI')",Providence,eth19.xml,315,86,4,CHI,4009,1464,MOT
1,1,3,335,4.031286426,336,1,like,"('MOT', 'CHI')",Providence,eth20.xml,340,4,1,CHI,3112,1743,MOT
0,1,4,335,3.338139246,336,1,was,"('MOT', 'CHI')",Providence,eth20.xml,340,4,0,CHI,3112,1743,MOT
0,1,6,333,3.044522438,334,1,they,"('MOT', 'CHI')",Providence,eth20.xml,340,6,0,CHI,3112,1743,MOT
0,2,4,334,2.932674138,336,2,big,"('MOT', 'CHI')",Providence,eth20.xml,340,4,0,CHI,3112,1743,MOT
0,1,7,332,2.923758774,333,1,want,"('MOT', 'CHI')",Providence,eth20.xml,340,7,0,CHI,3112,1743,MOT
2,2,16,320,2.785011242,322,2,are,"('MOT', 'CHI')",Providence,eth20.xml,340,18,2,CHI,3112,1743,MOT
0,1,9,330,2.717100037,331,1,we,"('MOT', 'CHI')",Providence,eth20.xml,340,9,0,CHI,3112,1743,MOT
1,3,8,328,2.717100037,331,3,not,"('MOT', 'CHI')",Providence,eth20.xml,340,9,1,CHI,3112,1743,MOT
0,1,10,329,2.627081139,330,1,with,"('MOT', 'CHI')",Providence,eth20.xml,340,10,0,CHI,3112,1743,MOT
0,4,3,333,2.607124283,337,4,look,"('MOT', 'CHI')",Providence,eth20.xml,340,3,0,CHI,3112,1743,MOT
0,1,12,327,2.466888144,328,1,yeah,"('MOT', 'CHI')",Providence,eth20.xml,340,12,0,CHI,3112,1743,MOT
0,1,12,327,2.466888144,328,1,of,"('MOT', 'CHI')",Providence,eth20.xml,340,12,0,CHI,3112,1743,MOT
0,2,8,330,2.409943611,332,2,he,"('MOT', 'CHI')",Providence,eth20.xml,340,8,0,CHI,3112,1743,MOT
1,3,13,323,2.327277706,326,3,gonna,"('MOT', 'CHI')",Providence,eth20.xml,340,14,1,CHI,3112,1743,MOT
0,2,9,329,2.311634929,331,2,can,"('MOT', 'CHI')",Providence,eth20.xml,340,9,0,CHI,3112,1743,MOT
1,5,8,326,2.311634929,331,5,do,"('MOT', 'CHI')",Providence,eth20.xml,340,9,1,CHI,3112,1743,MOT
2,6,11,321,2.240709689,327,6,up,"('MOT', 'CHI')",Providence,eth20.xml,340,13,2,CHI,3112,1743,MOT
1,8,5,326,2.233592222,334,8,little,"('MOT', 'CHI')",Providence,eth20.xml,340,6,1,CHI,3112,1743,MOT
0,2,10,328,2.22161603,330,2,all,"('MOT', 'CHI')",Providence,eth20.xml,340,10,0,CHI,3112,1743,MOT
0,1,17,322,2.146239023,323,1,what,"('MOT', 'CHI')",Providence,eth20.xml,340,17,0,CHI,3112,1743,MOT
1,4,13,322,2.104134154,326,4,this,"('MOT', 'CHI')",Providence,eth20.xml,340,14,1,CHI,3112,1743,MOT
9,12,20,299,2.049851722,311,12,go,"('MOT', 'CHI')",Providence,eth20.xml,340,29,9,CHI,3112,1743,MOT
0,2,14,324,1.921812597,326,2,oh,"('MOT', 'CHI')",Providence,eth20.xml,340,14,0,CHI,3112,1743,MOT
5,3,56,276,1.900685051,279,3,you,"('MOT', 'CHI')",Providence,eth20.xml,340,61,5,CHI,3112,1743,MOT
0,1,23,316,1.853168097,317,1,on,"('MOT', 'CHI')",Providence,eth20.xml,340,23,0,CHI,3112,1743,MOT
2,3,33,302,1.828247762,305,3,and,"('MOT', 'CHI')",Providence,eth20.xml,340,35,2,CHI,3112,1743,MOT
2,8,15,315,1.740773914,323,8,in,"('MOT', 'CHI')",Providence,eth20.xml,340,17,2,CHI,3112,1743,MOT
1,0,1,9,1.704748092,9,0,no,"('CHI', 'MOT')",Providence,eth20.xml,11,2,1,MOT,54,81,CHI
1,5,18,316,1.634517597,321,5,is,"('MOT', 'CHI')",Providence,eth20.xml,340,19,1,CHI,3112,1743,MOT
0,3,14,323,1.634130525,326,3,get,"('MOT', 'CHI')",Providence,eth20.xml,340,14,0,CHI,3112,1743,MOT
0,3,15,322,1.570452466,325,3,that,"('MOT', 'CHI')",Providence,eth20.xml,340,15,0,CHI,3112,1743,MOT
1,9,11,319,1.550597412,328,9,for,"('MOT', 'CHI')",Providence,eth20.xml,340,12,1,CHI,3112,1743,MOT
0,2,23,315,1.447702989,317,2,to,"('MOT', 'CHI')",Providence,eth20.xml,340,23,0,CHI,3112,1743,MOT
2,8,29,301,1.144673062,309,8,a,"('MOT', 'CHI')",Providence,eth20.xml,340,31,2,CHI,3112,1743,MOT
4,8,53,275,0.987165071,283,8,it,"('MOT', 'CHI')",Providence,eth20.xml,340,57,4,CHI,3112,1743,MOT
4,9,61,266,0.726177706,275,9,the,"('MOT', 'CHI')",Providence,eth20.xml,340,65,4,CHI,3112,1743,MOT
0,1,1,9,0.693147181,10,1,the,"('CHI', 'MOT')",Providence,eth20.xml,11,1,0,MOT,54,81,CHI
0,2,1,8,0.287682072,10,2,in,"('CHI', 'MOT')",Providence,eth20.xml,11,1,0,MOT,54,81,CHI
0,1,5,250,2.894332159,251,1,gonna,"('MOT', 'CHI')",Providence,eth21.xml,256,5,0,CHI,4212,1102,MOT
0,1,6,249,2.756840365,250,1,he,"('MOT', 'CHI')",Providence,eth21.xml,256,6,0,CHI,4212,1102,MOT
0,1,6,249,2.756840365,250,1,think,"('MOT', 'CHI')",Providence,eth21.xml,256,6,0,CHI,4212,1102,MOT
2,1,21,232,2.646174797,233,1,on,"('MOT', 'CHI')",Providence,eth21.xml,256,23,2,CHI,4212,1102,MOT
0,1,8,247,2.525728644,248,1,have,"('MOT', 'CHI')",Providence,eth21.xml,256,8,0,CHI,4212,1102,MOT
0,1,8,247,2.525728644,248,1,they,"('MOT', 'CHI')",Providence,eth21.xml,256,8,0,CHI,4212,1102,MOT
0,1,10,245,2.335374916,246,1,little,"('MOT', 'CHI')",Providence,eth21.xml,256,10,0,CHI,4212,1102,MOT
2,2,19,233,2.332565925,235,2,in,"('MOT', 'CHI')",Providence,eth21.xml,256,21,2,CHI,4212,1102,MOT
0,2,7,247,2.229616073,249,2,at,"('MOT', 'CHI')",Providence,eth21.xml,256,7,0,CHI,4212,1102,MOT
0,1,12,243,2.173127026,244,1,but,"('MOT', 'CHI')",Providence,eth21.xml,256,12,0,CHI,4212,1102,MOT
0,1,12,243,2.173127026,244,1,one,"('MOT', 'CHI')",Providence,eth21.xml,256,12,0,CHI,4212,1102,MOT
0,1,14,241,2.031432322,242,1,some,"('MOT', 'CHI')",Providence,eth21.xml,256,14,0,CHI,4212,1102,MOT
1,4,12,239,1.876917278,243,4,up,"('MOT', 'CHI')",Providence,eth21.xml,256,13,1,CHI,4212,1102,MOT
0,1,20,235,1.68808104,236,1,see,"('MOT', 'CHI')",Providence,eth21.xml,256,20,0,CHI,4212,1102,MOT
0,1,22,233,1.592630794,234,1,do,"('MOT', 'CHI')",Providence,eth21.xml,256,22,0,CHI,4212,1102,MOT
0,2,15,239,1.561235811,241,2,can,"('MOT', 'CHI')",Providence,eth21.xml,256,15,0,CHI,4212,1102,MOT
0,1,23,232,1.547562509,233,1,of,"('MOT', 'CHI')",Providence,eth21.xml,256,23,0,CHI,4212,1102,MOT
1,7,12,236,1.406913648,243,7,no,"('MOT', 'CHI')",Providence,eth21.xml,256,13,1,CHI,4212,1102,MOT
0,2,18,236,1.386294361,238,2,like,"('MOT', 'CHI')",Providence,eth21.xml,256,18,0,CHI,4212,1102,MOT
0,3,14,239,1.338285142,242,3,for,"('MOT', 'CHI')",Providence,eth21.xml,256,14,0,CHI,4212,1102,MOT
0,4,12,240,1.256836294,244,4,look,"('MOT', 'CHI')",Providence,eth21.xml,256,12,0,CHI,4212,1102,MOT
0,3,16,237,1.212271607,240,3,there,"('MOT', 'CHI')",Providence,eth21.xml,256,16,0,CHI,4212,1102,MOT
1,3,41,211,0.897941593,214,3,is,"('MOT', 'CHI')",Providence,eth21.xml,256,42,1,CHI,4212,1102,MOT
0,2,32,222,0.795562186,224,2,and,"('MOT', 'CHI')",Providence,eth21.xml,256,32,0,CHI,4212,1102,MOT
0,5,17,234,0.748598485,239,5,go,"('MOT', 'CHI')",Providence,eth21.xml,256,17,0,CHI,4212,1102,MOT
2,7,41,206,0.583146285,213,7,it,"('MOT', 'CHI')",Providence,eth21.xml,256,43,2,CHI,4212,1102,MOT
4,8,72,172,0.259511195,180,8,a,"('MOT', 'CHI')",Providence,eth21.xml,256,76,4,CHI,4212,1102,MOT
3,7,68,178,0.247501995,185,7,the,"('MOT', 'CHI')",Providence,eth21.xml,256,71,3,CHI,4212,1102,MOT
1,7,45,203,0.099090903,210,7,that,"('MOT', 'CHI')",Providence,eth21.xml,256,46,1,CHI,4212,1102,MOT
3,7,79,167,0.046520016,174,7,you,"('MOT', 'CHI')",Providence,eth21.xml,256,82,3,CHI,4212,1102,MOT
3,2,0,169,3.831535755,171,2,get,"('CHI', 'MOT')",Providence,eth22.xml,174,3,3,MOT,781,2522,CHI
1,2,0,171,3.660708577,173,2,but,"('CHI', 'MOT')",Providence,eth22.xml,174,1,1,MOT,781,2522,CHI
1,4,0,169,3.149882953,173,4,no,"('CHI', 'MOT')",Providence,eth22.xml,174,1,1,MOT,781,2522,CHI
1,3,1,169,3.079613758,172,3,not,"('CHI', 'MOT')",Providence,eth22.xml,174,2,1,MOT,781,2522,CHI
1,4,1,168,2.856470206,172,4,little,"('CHI', 'MOT')",Providence,eth22.xml,174,2,1,MOT,781,2522,CHI
0,3,1,170,2.679879324,173,3,at,"('CHI', 'MOT')",Providence,eth22.xml,174,1,0,MOT,781,2522,CHI
1,3,4,166,2.502606227,169,3,my,"('CHI', 'MOT')",Providence,eth22.xml,174,5,1,MOT,781,2522,CHI
1,5,2,166,2.445241393,171,5,look,"('CHI', 'MOT')",Providence,eth22.xml,174,3,1,MOT,781,2522,CHI
1,4,3,166,2.439444276,170,4,want,"('CHI', 'MOT')",Providence,eth22.xml,174,4,1,MOT,781,2522,CHI
3,9,1,161,2.439444276,170,9,of,"('CHI', 'MOT')",Providence,eth22.xml,174,4,3,MOT,781,2522,CHI
3,8,2,161,2.384823191,169,8,for,"('CHI', 'MOT')",Providence,eth22.xml,174,5,3,MOT,781,2522,CHI
2,7,2,163,2.374905755,170,7,go,"('CHI', 'MOT')",Providence,eth22.xml,174,4,2,MOT,781,2522,CHI
2,12,0,160,2.306423869,172,12,on,"('CHI', 'MOT')",Providence,eth22.xml,174,2,2,MOT,781,2522,CHI
3,9,2,160,2.279462676,169,9,up,"('CHI', 'MOT')",Providence,eth22.xml,174,5,3,MOT,781,2522,CHI
1,8,1,164,2.268683541,172,8,see,"('CHI', 'MOT')",Providence,eth22.xml,174,2,1,MOT,781,2522,CHI
3,12,1,158,2.177080011,170,12,like,"('CHI', 'MOT')",Providence,eth22.xml,174,4,3,MOT,781,2522,CHI
1,13,0,160,2.120263536,173,13,yeah,"('CHI', 'MOT')",Providence,eth22.xml,174,1,1,MOT,781,2522,CHI
1,10,1,162,2.068012846,172,10,to,"('CHI', 'MOT')",Providence,eth22.xml,174,2,1,MOT,781,2522,CHI
1,14,0,159,2.051270665,173,14,one,"('CHI', 'MOT')",Providence,eth22.xml,174,1,1,MOT,781,2522,CHI
1,9,2,162,1.93441577,171,9,this,"('CHI', 'MOT')",Providence,eth22.xml,174,3,1,MOT,781,2522,CHI
0,8,1,165,1.868949108,173,8,with,"('CHI', 'MOT')",Providence,eth22.xml,174,1,0,MOT,781,2522,CHI
3,15,2,154,1.809459046,169,15,in,"('CHI', 'MOT')",Providence,eth22.xml,174,5,3,MOT,781,2522,CHI
0,11,1,162,1.581267035,173,11,have,"('CHI', 'MOT')",Providence,eth22.xml,174,1,0,MOT,781,2522,CHI
10,20,6,138,1.538174892,158,20,it,"('CHI', 'MOT')",Providence,eth22.xml,174,16,10,MOT,781,2522,CHI
0,9,2,163,1.470175845,172,9,are,"('CHI', 'MOT')",Providence,eth22.xml,174,2,0,MOT,781,2522,CHI
1,23,1,149,1.287854288,172,23,what,"('CHI', 'MOT')",Providence,eth22.xml,174,2,1,MOT,781,2522,CHI
9,38,3,124,1.099832545,162,38,you,"('CHI', 'MOT')",Providence,eth22.xml,174,12,9,MOT,781,2522,CHI
10,42,2,120,1.097504255,162,42,the,"('CHI', 'MOT')",Providence,eth22.xml,174,12,10,MOT,781,2522,CHI
1,30,1,142,1.031920914,172,30,that,"('CHI', 'MOT')",Providence,eth22.xml,174,2,1,MOT,781,2522,CHI
17,32,12,113,0.950309579,145,32,a,"('CHI', 'MOT')",Providence,eth22.xml,174,29,17,MOT,781,2522,CHI
0,16,4,154,0.522521664,170,16,and,"('CHI', 'MOT')",Providence,eth22.xml,174,4,0,MOT,781,2522,CHI
1,2,0,37,2.20949467,39,2,what,"('CHI', 'MOT')",Providence,eth23.xml,40,1,1,MOT,217,532,CHI
1,3,1,35,1.609437912,38,3,a,"('CHI', 'MOT')",Providence,eth23.xml,40,2,1,MOT,217,532,CHI
0,2,1,37,1.516347489,39,2,want,"('CHI', 'MOT')",Providence,eth23.xml,40,1,0,MOT,217,532,CHI
0,2,1,37,1.516347489,39,2,no,"('CHI', 'MOT')",Providence,eth23.xml,40,1,0,MOT,217,532,CHI
3,7,0,30,1.360976553,37,7,it,"('CHI', 'MOT')",Providence,eth23.xml,40,3,3,MOT,217,532,CHI
3,7,0,30,1.360976553,37,7,on,"('CHI', 'MOT')",Providence,eth23.xml,40,3,3,MOT,217,532,CHI
1,0,0,2,0.980829253,2,0,you,"('MOT', 'OPE')",Providence,eth23.xml,3,1,1,OPE,24,16,MOT
1,0,0,2,0.980829253,2,0,go,"('MOT', 'OPE')",Providence,eth23.xml,3,1,1,OPE,24,16,MOT
1,0,0,2,0.980829253,2,0,there,"('MOT', 'OPE')",Providence,eth23.xml,3,1,1,OPE,24,16,MOT
1,15,0,24,0.535518236,39,15,you,"('CHI', 'MOT')",Providence,eth23.xml,40,1,1,MOT,217,532,CHI
0,9,3,28,-0.248461359,37,9,the,"('CHI', 'MOT')",Providence,eth23.xml,40,3,0,MOT,217,532,CHI
2,2,0,365,4.524502283,367,2,some,"('CHI', 'MOT')",Providence,eth24.xml,369,2,2,MOT,1732,4862,CHI
0,2,1,366,3.716278428,368,2,make,"('CHI', 'MOT')",Providence,eth24.xml,369,1,0,MOT,1732,4862,CHI
1,4,1,363,3.608211551,367,4,want,"('CHI', 'MOT')",Providence,eth24.xml,369,2,1,MOT,1732,4862,CHI
3,7,0,359,3.605497845,366,7,one,"('CHI', 'MOT')",Providence,eth24.xml,369,3,3,MOT,1732,4862,CHI
1,7,0,361,3.428596356,368,7,at,"('CHI', 'MOT')",Providence,eth24.xml,369,1,1,MOT,1732,4862,CHI
2,8,0,359,3.425889994,367,8,see,"('CHI', 'MOT')",Providence,eth24.xml,369,2,2,MOT,1732,4862,CHI
3,5,3,358,3.414990704,363,5,look,"('CHI', 'MOT')",Providence,eth24.xml,369,6,3,MOT,1732,4862,CHI
2,9,0,358,3.320529479,367,9,all,"('CHI', 'MOT')",Providence,eth24.xml,369,2,2,MOT,1732,4862,CHI
1,8,0,360,3.31081332,368,8,have,"('CHI', 'MOT')",Providence,eth24.xml,369,1,1,MOT,1732,4862,CHI
3,8,1,357,3.302672163,365,8,not,"('CHI', 'MOT')",Providence,eth24.xml,369,4,3,MOT,1732,4862,CHI
6,11,2,350,3.052821241,361,11,put,"('CHI', 'MOT')",Providence,eth24.xml,369,8,6,MOT,1732,4862,CHI
2,10,1,356,2.999362042,366,10,big,"('CHI', 'MOT')",Providence,eth24.xml,369,3,2,MOT,1732,4862,CHI
0,6,1,362,2.868980568,368,6,oh,"('CHI', 'MOT')",Providence,eth24.xml,369,1,0,MOT,1732,4862,CHI
2,8,3,356,2.858110896,364,8,no,"('CHI', 'MOT')",Providence,eth24.xml,369,5,2,MOT,1732,4862,CHI
5,15,1,348,2.839626559,363,15,up,"('CHI', 'MOT')",Providence,eth24.xml,369,6,5,MOT,1732,4862,CHI
0,7,1,361,2.735449175,368,7,get,"('CHI', 'MOT')",Providence,eth24.xml,369,1,0,MOT,1732,4862,CHI
2,18,0,349,2.678675592,367,18,we,"('CHI', 'MOT')",Providence,eth24.xml,369,2,2,MOT,1732,4862,CHI
4,19,1,345,2.570428823,364,19,like,"('CHI', 'MOT')",Providence,eth24.xml,369,5,4,MOT,1732,4862,CHI
1,19,0,349,2.512305624,368,19,of,"('CHI', 'MOT')",Providence,eth24.xml,369,1,1,MOT,1732,4862,CHI
1,15,1,352,2.445060741,367,15,was,"('CHI', 'MOT')",Providence,eth24.xml,369,2,1,MOT,1732,4862,CHI
4,15,4,346,2.428666931,361,15,are,"('CHI', 'MOT')",Providence,eth24.xml,369,8,4,MOT,1732,4862,CHI
9,22,3,335,2.411355936,357,22,in,"('CHI', 'MOT')",Providence,eth24.xml,369,12,9,MOT,1732,4862,CHI
3,13,5,348,2.339054773,361,13,go,"('CHI', 'MOT')",Providence,eth24.xml,369,8,3,MOT,1732,4862,CHI
0,11,1,357,2.329984067,368,11,wanna,"('CHI', 'MOT')",Providence,eth24.xml,369,1,0,MOT,1732,4862,CHI
6,18,5,340,2.322625844,358,18,he,"('CHI', 'MOT')",Providence,eth24.xml,369,11,6,MOT,1732,4862,CHI
8,22,4,335,2.30599542,357,22,that,"('CHI', 'MOT')",Providence,eth24.xml,369,12,8,MOT,1732,4862,CHI
3,18,3,345,2.262311194,363,18,gonna,"('CHI', 'MOT')",Providence,eth24.xml,369,6,3,MOT,1732,4862,CHI
3,16,4,346,2.253010307,362,16,for,"('CHI', 'MOT')",Providence,eth24.xml,369,7,3,MOT,1732,4862,CHI
8,36,1,324,2.080055604,360,36,on,"('CHI', 'MOT')",Providence,eth24.xml,369,9,8,MOT,1732,4862,CHI
0,15,1,353,2.042301995,368,15,little,"('CHI', 'MOT')",Providence,eth24.xml,369,1,0,MOT,1732,4862,CHI
1,16,3,349,1.973536215,365,16,do,"('CHI', 'MOT')",Providence,eth24.xml,369,4,1,MOT,1732,4862,CHI
9,38,2,320,1.960178121,358,38,and,"('CHI', 'MOT')",Providence,eth24.xml,369,11,9,MOT,1732,4862,CHI
2,39,0,328,1.934235117,367,39,what,"('CHI', 'MOT')",Providence,eth24.xml,369,2,2,MOT,1732,4862,CHI
0,15,2,352,1.751913561,367,15,there,"('CHI', 'MOT')",Providence,eth24.xml,369,2,0,MOT,1732,4862,CHI
13,38,7,311,1.745239454,349,38,it,"('CHI', 'MOT')",Providence,eth24.xml,369,20,13,MOT,1732,4862,CHI
0,24,1,344,1.596014892,368,24,this,"('CHI', 'MOT')",Providence,eth24.xml,369,1,0,MOT,1732,4862,CHI
3,24,8,334,1.48857321,358,24,to,"('CHI', 'MOT')",Providence,eth24.xml,369,11,3,MOT,1732,4862,CHI
25,60,6,278,1.47966073,338,60,a,"('CHI', 'MOT')",Providence,eth24.xml,369,31,25,MOT,1732,4862,CHI
4,36,8,321,1.242785059,357,36,is,"('CHI', 'MOT')",Providence,eth24.xml,369,12,4,MOT,1732,4862,CHI
16,68,8,277,1.190335081,345,68,you,"('CHI', 'MOT')",Providence,eth24.xml,369,24,16,MOT,1732,4862,CHI
25,75,11,258,1.10390757,333,75,the,"('CHI', 'MOT')",Providence,eth24.xml,369,36,25,MOT,1732,4862,CHI
1,0,3,366,4.80947065,366,0,she,"('MOT', 'CHI')",Providence,eth25.xml,370,4,1,CHI,3865,1986,MOT
1,0,15,354,3.677706154,354,0,oh,"('MOT', 'CHI')",Providence,eth25.xml,370,16,1,CHI,3865,1986,MOT
2,2,6,360,3.594568775,362,2,was,"('MOT', 'CHI')",Providence,eth25.xml,370,8,2,CHI,3865,1986,MOT
0,1,5,364,3.266304518,365,1,they,"('MOT', 'CHI')",Providence,eth25.xml,370,5,0,CHI,3865,1986,MOT
0,1,5,364,3.266304518,365,1,one,"('MOT', 'CHI')",Providence,eth25.xml,370,5,0,CHI,3865,1986,MOT
1,1,14,354,3.044522438,355,1,want,"('MOT', 'CHI')",Providence,eth25.xml,370,15,1,CHI,3865,1986,MOT
0,1,7,362,3.009525596,363,1,get,"('MOT', 'CHI')",Providence,eth25.xml,370,7,0,CHI,3865,1986,MOT
3,6,6,355,2.936891774,361,6,big,"('MOT', 'CHI')",Providence,eth25.xml,370,9,3,CHI,3865,1986,MOT
2,2,16,350,2.87356464,352,2,are,"('MOT', 'CHI')",Providence,eth25.xml,370,18,2,CHI,3865,1986,MOT
1,2,11,356,2.841581594,358,2,up,"('MOT', 'CHI')",Providence,eth25.xml,370,12,1,CHI,3865,1986,MOT
0,1,9,360,2.803360381,361,1,my,"('MOT', 'CHI')",Providence,eth25.xml,370,9,0,CHI,3865,1986,MOT
1,5,5,359,2.724579503,364,5,look,"('MOT', 'CHI')",Providence,eth25.xml,370,6,1,CHI,3865,1986,MOT
0,2,7,361,2.604060488,363,2,no,"('MOT', 'CHI')",Providence,eth25.xml,370,7,0,CHI,3865,1986,MOT
0,1,12,357,2.553899521,358,1,little,"('MOT', 'CHI')",Providence,eth25.xml,370,12,0,CHI,3865,1986,MOT
1,3,11,355,2.553899521,358,3,put,"('MOT', 'CHI')",Providence,eth25.xml,370,12,1,CHI,3865,1986,MOT
0,3,7,360,2.316378415,363,3,not,"('MOT', 'CHI')",Providence,eth25.xml,370,7,0,CHI,3865,1986,MOT
1,3,17,349,2.180417459,352,3,do,"('MOT', 'CHI')",Providence,eth25.xml,370,18,1,CHI,3865,1986,MOT
0,1,19,350,2.128798439,351,1,we,"('MOT', 'CHI')",Providence,eth25.xml,370,19,0,CHI,3865,1986,MOT
0,5,7,358,1.910913307,363,5,at,"('MOT', 'CHI')",Providence,eth25.xml,370,7,0,CHI,3865,1986,MOT
3,9,16,342,1.905654887,351,9,he,"('MOT', 'CHI')",Providence,eth25.xml,370,19,3,CHI,3865,1986,MOT
0,4,9,357,1.887069649,361,4,all,"('MOT', 'CHI')",Providence,eth25.xml,370,9,0,CHI,3865,1986,MOT
1,2,34,333,1.80369991,335,2,is,"('MOT', 'CHI')",Providence,eth25.xml,370,35,1,CHI,3865,1986,MOT
0,3,13,354,1.788977826,357,3,have,"('MOT', 'CHI')",Providence,eth25.xml,370,13,0,CHI,3865,1986,MOT
3,9,19,339,1.763588592,348,9,make,"('MOT', 'CHI')",Providence,eth25.xml,370,22,3,CHI,3865,1986,MOT
0,1,29,340,1.710596062,341,1,what,"('MOT', 'CHI')",Providence,eth25.xml,370,29,0,CHI,3865,1986,MOT
0,6,8,356,1.648658626,362,6,of,"('MOT', 'CHI')",Providence,eth25.xml,370,8,0,CHI,3865,1986,MOT
0,2,24,344,1.495493653,346,2,gonna,"('MOT', 'CHI')",Providence,eth25.xml,370,24,0,CHI,3865,1986,MOT
0,6,10,354,1.460827413,360,6,this,"('MOT', 'CHI')",Providence,eth25.xml,370,10,0,CHI,3865,1986,MOT
0,3,20,347,1.386294361,350,3,that,"('MOT', 'CHI')",Providence,eth25.xml,370,20,0,CHI,3865,1986,MOT
4,9,38,319,1.32175584,328,9,to,"('MOT', 'CHI')",Providence,eth25.xml,370,42,4,CHI,3865,1986,MOT
0,6,12,352,1.301136553,358,6,like,"('MOT', 'CHI')",Providence,eth25.xml,370,12,0,CHI,3865,1986,MOT
3,8,40,319,1.178465045,327,8,and,"('MOT', 'CHI')",Providence,eth25.xml,370,43,3,CHI,3865,1986,MOT
0,4,20,346,1.16315081,350,4,wanna,"('MOT', 'CHI')",Providence,eth25.xml,370,20,0,CHI,3865,1986,MOT
0,4,24,342,0.984668029,346,4,on,"('MOT', 'CHI')",Providence,eth25.xml,370,24,0,CHI,3865,1986,MOT
0,7,17,346,0.848237269,353,7,for,"('MOT', 'CHI')",Providence,eth25.xml,370,17,0,CHI,3865,1986,MOT
14,24,67,265,0.743657036,289,24,the,"('MOT', 'CHI')",Providence,eth25.xml,370,81,14,CHI,3865,1986,MOT
0,6,22,342,0.733969175,348,6,there,"('MOT', 'CHI')",Providence,eth25.xml,370,22,0,CHI,3865,1986,MOT
12,28,53,277,0.719808656,305,28,it,"('MOT', 'CHI')",Providence,eth25.xml,370,65,12,CHI,3865,1986,MOT
19,24,99,228,0.526698973,252,24,you,"('MOT', 'CHI')",Providence,eth25.xml,370,118,19,CHI,3865,1986,MOT
0,9,24,337,0.291520849,346,9,go,"('MOT', 'CHI')",Providence,eth25.xml,370,24,0,CHI,3865,1986,MOT
0,11,24,335,0.109199292,346,11,in,"('MOT', 'CHI')",Providence,eth25.xml,370,24,0,CHI,3865,1986,MOT
9,39,64,258,-0.003338901,297,39,a,"('MOT', 'CHI')",Providence,eth25.xml,370,73,9,CHI,3865,1986,MOT
1,0,0,215,4.974432245,215,0,at,"('CHI', 'MOT')",Providence,eth26.xml,216,1,1,MOT,1032,2441,CHI
2,3,0,211,3.701301974,214,3,big,"('CHI', 'MOT')",Providence,eth26.xml,216,2,2,MOT,1032,2441,CHI
4,3,1,208,3.638525568,211,3,my,"('CHI', 'MOT')",Providence,eth26.xml,216,5,4,MOT,1032,2441,CHI
1,1,2,151,3.42751469,152,1,big,"('MOT', 'CHI')",Providence,eth26.xml,155,3,1,CHI,2225,754,MOT
2,1,4,148,3.343303403,149,1,he,"('MOT', 'CHI')",Providence,eth26.xml,155,6,2,CHI,2225,754,MOT
0,1,1,153,3.258096538,154,1,make,"('MOT', 'CHI')",Providence,eth26.xml,155,1,0,CHI,2225,754,MOT
0,2,1,213,3.182672776,215,2,make,"('CHI', 'MOT')",Providence,eth26.xml,216,1,0,MOT,1032,2441,CHI
1,5,0,210,3.182672776,215,5,are,"('CHI', 'MOT')",Providence,eth26.xml,216,1,1,MOT,1032,2441,CHI
1,1,4,149,3.077970372,150,1,of,"('MOT', 'CHI')",Providence,eth26.xml,155,5,1,CHI,2225,754,MOT
5,8,0,203,3.009916909,211,8,like,"('CHI', 'MOT')",Providence,eth26.xml,216,5,5,MOT,1032,2441,CHI
1,0,12,142,2.954910279,142,0,wanna,"('MOT', 'CHI')",Providence,eth26.xml,155,13,1,CHI,2225,754,MOT
0,3,1,212,2.894990704,215,3,oh,"('CHI', 'MOT')",Providence,eth26.xml,216,1,0,MOT,1032,2441,CHI
0,2,2,212,2.890371758,214,2,get,"('CHI', 'MOT')",Providence,eth26.xml,216,2,0,MOT,1032,2441,CHI
1,5,1,209,2.890371758,214,5,up,"('CHI', 'MOT')",Providence,eth26.xml,216,2,1,MOT,1032,2441,CHI
0,2,2,212,2.890371758,214,2,no,"('CHI', 'MOT')",Providence,eth26.xml,216,2,0,MOT,1032,2441,CHI
4,9,1,202,2.722234836,211,9,for,"('CHI', 'MOT')",Providence,eth26.xml,216,5,4,MOT,1032,2441,CHI
3,6,3,204,2.717528945,210,6,have,"('CHI', 'MOT')",Providence,eth26.xml,216,6,3,MOT,1032,2441,CHI
2,10,0,204,2.689701062,214,10,what,"('CHI', 'MOT')",Providence,eth26.xml,216,2,2,MOT,1032,2441,CHI
3,9,1,203,2.657925814,212,9,of,"('CHI', 'MOT')",Providence,eth26.xml,216,4,3,MOT,1032,2441,CHI
2,9,1,204,2.557227311,213,9,put,"('CHI', 'MOT')",Providence,eth26.xml,216,3,2,MOT,1032,2441,CHI
0,1,4,150,2.545531272,151,1,was,"('MOT', 'CHI')",Providence,eth26.xml,155,4,0,CHI,2225,754,MOT
0,1,4,150,2.545531272,151,1,no,"('MOT', 'CHI')",Providence,eth26.xml,155,4,0,CHI,2225,754,MOT
2,7,3,204,2.434552764,211,7,want,"('CHI', 'MOT')",Providence,eth26.xml,216,5,2,MOT,1032,2441,CHI
0,6,1,209,2.335374916,215,6,they,"('CHI', 'MOT')",Providence,eth26.xml,216,1,0,MOT,1032,2441,CHI
1,10,1,204,2.284235954,214,10,in,"('CHI', 'MOT')",Providence,eth26.xml,216,2,1,MOT,1032,2441,CHI
1,10,1,204,2.284235954,214,10,one,"('CHI', 'MOT')",Providence,eth26.xml,216,2,1,MOT,1032,2441,CHI
1,0,1,17,2.251291799,17,0,have,"('TOY', 'MOT')",Providence,eth26.xml,19,2,1,MOT,191,170,TOY
2,5,4,144,2.244691115,149,5,have,"('MOT', 'CHI')",Providence,eth26.xml,155,6,2,CHI,2225,754,MOT
0,7,1,208,2.201843523,215,7,gonna,"('CHI', 'MOT')",Providence,eth26.xml,216,1,0,MOT,1032,2441,CHI
2,11,2,201,2.187922185,212,11,we,"('CHI', 'MOT')",Providence,eth26.xml,216,4,2,MOT,1032,2441,CHI
0,1,7,147,2.120263536,148,1,one,"('MOT', 'CHI')",Providence,eth26.xml,155,7,0,CHI,2225,754,MOT
0,8,1,207,2.084060488,215,8,this,"('CHI', 'MOT')",Providence,eth26.xml,216,1,0,MOT,1032,2441,CHI
0,2,5,148,1.979358083,150,2,some,"('MOT', 'CHI')",Providence,eth26.xml,155,5,0,CHI,2225,754,MOT
1,14,1,200,1.974081026,214,14,that,"('CHI', 'MOT')",Providence,eth26.xml,216,2,1,MOT,1032,2441,CHI
3,10,6,197,1.932838067,207,10,there,"('CHI', 'MOT')",Providence,eth26.xml,216,9,3,MOT,1032,2441,CHI
0,1,9,145,1.90616982,146,1,my,"('MOT', 'CHI')",Providence,eth26.xml,155,9,0,CHI,2225,754,MOT
0,2,6,147,1.839226006,149,2,in,"('MOT', 'CHI')",Providence,eth26.xml,155,6,0,CHI,2225,754,MOT
2,12,5,197,1.688296487,209,12,is,"('CHI', 'MOT')",Providence,eth26.xml,216,7,2,MOT,1032,2441,CHI
2,1,1,15,1.686398954,16,1,to,"('TOY', 'MOT')",Providence,eth26.xml,19,3,2,MOT,191,170,TOY
1,3,11,140,1.644529232,143,3,is,"('MOT', 'CHI')",Providence,eth26.xml,155,12,1,CHI,2225,754,MOT
2,15,4,195,1.603168299,210,15,see,"('CHI', 'MOT')",Providence,eth26.xml,216,6,2,MOT,1032,2441,CHI
0,2,8,145,1.602748924,147,2,want,"('MOT', 'CHI')",Providence,eth26.xml,155,8,0,CHI,2225,754,MOT
1,1,1,16,1.558144618,17,1,can,"('TOY', 'MOT')",Providence,eth26.xml,19,2,1,MOT,191,170,TOY
4,4,22,125,1.542992813,129,4,on,"('MOT', 'CHI')",Providence,eth26.xml,155,26,4,CHI,2225,754,MOT
3,21,4,188,1.449885464,209,21,go,"('CHI', 'MOT')",Providence,eth26.xml,216,7,3,MOT,1032,2441,CHI
17,32,6,161,1.44798793,193,32,a,"('CHI', 'MOT')",Providence,eth26.xml,216,23,17,MOT,1032,2441,CHI
0,3,7,145,1.427116356,148,3,for,"('MOT', 'CHI')",Providence,eth26.xml,155,7,0,CHI,2225,754,MOT
1,1,1,13,1.386294361,14,1,can,"('MOT', 'TOY')",Providence,eth26.xml,16,2,1,TOY,182,176,MOT
1,22,2,191,1.31885308,213,22,on,"('CHI', 'MOT')",Providence,eth26.xml,216,3,1,MOT,1032,2441,CHI
2,3,25,125,1.212556548,128,3,to,"('MOT', 'CHI')",Providence,eth26.xml,155,27,2,CHI,2225,754,MOT
0,1,1,17,1.203972804,18,1,in,"('TOY', 'MOT')",Providence,eth26.xml,19,1,0,MOT,191,170,TOY
0,1,1,17,1.203972804,18,1,with,"('TOY', 'MOT')",Providence,eth26.xml,19,1,0,MOT,191,170,TOY
0,1,1,17,1.203972804,18,1,this,"('TOY', 'MOT')",Providence,eth26.xml,19,1,0,MOT,191,170,TOY
0,1,1,17,1.203972804,18,1,see,"('TOY', 'MOT')",Providence,eth26.xml,19,1,0,MOT,191,170,TOY
1,21,3,191,1.176321273,212,21,and,"('CHI', 'MOT')",Providence,eth26.xml,216,4,1,MOT,1032,2441,CHI
0,2,13,140,1.16315081,142,2,see,"('MOT', 'CHI')",Providence,eth26.xml,155,13,0,CHI,2225,754,MOT
0,1,20,134,1.135791292,135,1,we,"('MOT', 'CHI')",Providence,eth26.xml,155,20,0,CHI,2225,754,MOT
0,6,5,144,1.132060223,150,6,there,"('MOT', 'CHI')",Providence,eth26.xml,155,5,0,CHI,2225,754,MOT
0,3,10,142,1.119231576,145,3,like,"('MOT', 'CHI')",Providence,eth26.xml,155,10,0,CHI,2225,754,MOT
3,32,4,177,1.044420356,209,32,it,"('CHI', 'MOT')",Providence,eth26.xml,216,7,3,MOT,1032,2441,CHI
0,1,1,14,1.041453875,15,1,with,"('MOT', 'TOY')",Providence,eth26.xml,16,1,0,TOY,182,176,MOT
2,22,6,186,1.00764051,208,22,to,"('CHI', 'MOT')",Providence,eth26.xml,216,8,2,MOT,1032,2441,CHI
0,19,2,195,0.993251773,214,19,do,"('CHI', 'MOT')",Providence,eth26.xml,216,2,0,MOT,1032,2441,CHI
7,1,5,6,0.944461609,7,1,a,"('TOY', 'MOT')",Providence,eth26.xml,19,12,7,MOT,191,170,TOY
1,6,14,134,0.869850745,140,6,do,"('MOT', 'CHI')",Providence,eth26.xml,155,15,1,CHI,2225,754,MOT
0,1,2,16,0.864997437,17,1,of,"('TOY', 'MOT')",Providence,eth26.xml,19,2,0,MOT,191,170,TOY
0,1,2,16,0.864997437,17,1,at,"('TOY', 'MOT')",Providence,eth26.xml,19,2,0,MOT,191,170,TOY
1,4,0,11,0.818310324,15,4,have,"('MOT', 'TOY')",Providence,eth26.xml,16,1,1,TOY,182,176,MOT
0,4,11,140,0.809219352,144,4,go,"('MOT', 'CHI')",Providence,eth26.xml,155,11,0,CHI,2225,754,MOT
3,8,22,122,0.77603484,130,8,and,"('MOT', 'CHI')",Providence,eth26.xml,155,25,3,CHI,2225,754,MOT
1,2,3,13,0.635988767,15,2,go,"('TOY', 'MOT')",Providence,eth26.xml,19,4,1,MOT,191,170,TOY
3,9,23,120,0.626702081,129,9,it,"('MOT', 'CHI')",Providence,eth26.xml,155,26,3,CHI,2225,754,MOT
2,5,1,11,0.587786665,16,5,you,"('TOY', 'MOT')",Providence,eth26.xml,19,3,2,MOT,191,170,TOY
0,3,18,134,0.552447298,137,3,that,"('MOT', 'CHI')",Providence,eth26.xml,155,18,0,CHI,2225,754,MOT
11,50,14,141,0.51993434,191,50,the,"('CHI', 'MOT')",Providence,eth26.xml,216,25,11,MOT,1032,2441,CHI
0,1,1,6,0.405465108,7,1,to,"('TOY', 'CHI')",Providence,eth26.xml,8,1,0,CHI,82,25,TOY
0,1,1,6,0.405465108,7,1,on,"('TOY', 'CHI')",Providence,eth26.xml,8,1,0,CHI,82,25,TOY
0,1,4,14,0.348306694,15,1,and,"('TOY', 'MOT')",Providence,eth26.xml,19,4,0,MOT,191,170,TOY
3,11,29,112,0.203340924,123,11,a,"('MOT', 'CHI')",Providence,eth26.xml,155,32,3,CHI,2225,754,MOT
6,4,3,3,0.135801541,7,4,the,"('MOT', 'TOY')",Providence,eth26.xml,16,9,6,TOY,182,176,MOT
0,2,3,11,0,13,2,what,"('MOT', 'TOY')",Providence,eth26.xml,16,3,0,TOY,182,176,MOT
0,5,1,10,-0.057158414,15,5,and,"('MOT', 'TOY')",Providence,eth26.xml,16,1,0,TOY,182,176,MOT
1,3,5,10,-0.064538521,13,3,the,"('TOY', 'MOT')",Providence,eth26.xml,19,6,1,MOT,191,170,TOY
0,4,2,10,-0.223143551,14,4,a,"('MOT', 'TOY')",Providence,eth26.xml,16,2,0,TOY,182,176,MOT
3,69,11,133,-0.316669609,202,69,you,"('CHI', 'MOT')",Providence,eth26.xml,216,14,3,MOT,1032,2441,CHI
1,0,6,1,-0.405465108,1,0,the,"('TOY', 'CHI')",Providence,eth26.xml,8,7,1,CHI,82,25,TOY
0,1,1,1,-0.405465108,2,1,go,"('CHI', 'TOY')",Providence,eth26.xml,3,1,0,TOY,17,16,CHI
0,1,1,1,-0.405465108,2,1,the,"('CHI', 'TOY')",Providence,eth26.xml,3,1,0,TOY,17,16,CHI
0,1,1,1,-0.405465108,2,1,and,"('CHI', 'TOY')",Providence,eth26.xml,3,1,0,TOY,17,16,CHI
3,12,47,93,-0.45706988,105,12,you,"('MOT', 'CHI')",Providence,eth26.xml,155,50,3,CHI,2225,754,MOT
5,17,49,84,-0.489234991,101,17,the,"('MOT', 'CHI')",Providence,eth26.xml,155,54,5,CHI,2225,754,MOT
0,4,3,9,-0.510825624,13,4,to,"('MOT', 'TOY')",Providence,eth26.xml,16,3,0,TOY,182,176,MOT
0,3,4,9,-0.538996501,12,3,on,"('MOT', 'TOY')",Providence,eth26.xml,16,4,0,TOY,182,176,MOT
0,6,2,8,-0.559615788,14,6,go,"('MOT', 'TOY')",Providence,eth26.xml,16,2,0,TOY,182,176,MOT
1,2,9,4,-0.810930216,6,2,you,"('MOT', 'TOY')",Providence,eth26.xml,16,10,1,TOY,182,176,MOT
1,1,0,191,4.16924587,192,1,where,"('CHI', 'MOT')",Providence,eth27.xml,193,1,1,MOT,1069,3263,CHI
1,3,2,187,2.954910279,190,3,no,"('CHI', 'MOT')",Providence,eth27.xml,193,3,1,MOT,1069,3263,CHI
1,7,0,185,2.782951509,192,7,what,"('CHI', 'MOT')",Providence,eth27.xml,193,1,1,MOT,1069,3263,CHI
2,7,1,183,2.667228207,190,7,for,"('CHI', 'MOT')",Providence,eth27.xml,193,3,2,MOT,1069,3263,CHI
1,8,0,184,2.665168474,192,8,have,"('CHI', 'MOT')",Providence,eth27.xml,193,1,1,MOT,1069,3263,CHI
1,8,0,184,2.665168474,192,8,he,"('CHI', 'MOT')",Providence,eth27.xml,193,1,1,MOT,1069,3263,CHI
4,8,2,179,2.574518808,187,8,like,"('CHI', 'MOT')",Providence,eth27.xml,193,6,4,MOT,1069,3263,CHI
0,4,1,188,2.559807958,192,4,but,"('CHI', 'MOT')",Providence,eth27.xml,193,1,0,MOT,1069,3263,CHI
1,7,1,184,2.490101467,191,7,oh,"('CHI', 'MOT')",Providence,eth27.xml,193,2,1,MOT,1069,3263,CHI
3,11,1,178,2.36190167,189,11,go,"('CHI', 'MOT')",Providence,eth27.xml,193,4,3,MOT,1069,3263,CHI
10,12,4,167,2.258854224,179,12,make,"('CHI', 'MOT')",Providence,eth27.xml,193,14,10,MOT,1069,3263,CHI
0,6,1,186,2.223335721,192,6,see,"('CHI', 'MOT')",Providence,eth27.xml,193,1,0,MOT,1069,3263,CHI
1,10,1,181,2.171647736,191,10,little,"('CHI', 'MOT')",Providence,eth27.xml,193,2,1,MOT,1069,3263,CHI
2,13,1,177,2.107612419,190,13,can,"('CHI', 'MOT')",Providence,eth27.xml,193,3,2,MOT,1069,3263,CHI
0,5,2,186,2.084636359,191,5,at,"('CHI', 'MOT')",Providence,eth27.xml,193,2,0,MOT,1069,3263,CHI
3,11,3,176,2.063693185,187,11,in,"('CHI', 'MOT')",Providence,eth27.xml,193,6,3,MOT,1069,3263,CHI
2,12,2,177,1.99417689,189,12,up,"('CHI', 'MOT')",Providence,eth27.xml,193,4,2,MOT,1069,3263,CHI
3,14,2,174,1.979358083,188,14,put,"('CHI', 'MOT')",Providence,eth27.xml,193,5,3,MOT,1069,3263,CHI
0,8,1,184,1.972021293,192,8,my,"('CHI', 'MOT')",Providence,eth27.xml,193,1,0,MOT,1069,3263,CHI
0,8,1,184,1.972021293,192,8,not,"('CHI', 'MOT')",Providence,eth27.xml,193,1,0,MOT,1069,3263,CHI
1,15,1,176,1.796954286,191,15,some,"('CHI', 'MOT')",Providence,eth27.xml,193,2,1,MOT,1069,3263,CHI
4,19,2,168,1.776011112,187,19,of,"('CHI', 'MOT')",Providence,eth27.xml,193,6,4,MOT,1069,3263,CHI
0,10,1,182,1.771350598,192,10,this,"('CHI', 'MOT')",Providence,eth27.xml,193,1,0,MOT,1069,3263,CHI
2,19,1,171,1.750937475,190,19,on,"('CHI', 'MOT')",Providence,eth27.xml,193,3,2,MOT,1069,3263,CHI
0,11,1,181,1.684339221,192,11,all,"('CHI', 'MOT')",Providence,eth27.xml,193,1,0,MOT,1069,3263,CHI
0,8,2,183,1.67917125,191,8,do,"('CHI', 'MOT')",Providence,eth27.xml,193,2,0,MOT,1069,3263,CHI
1,19,1,172,1.573810735,191,19,that,"('CHI', 'MOT')",Providence,eth27.xml,193,2,1,MOT,1069,3263,CHI
0,4,6,183,1.552867561,187,4,look,"('CHI', 'MOT')",Providence,eth27.xml,193,6,0,MOT,1069,3263,CHI
1,10,5,177,1.457557381,187,10,one,"('CHI', 'MOT')",Providence,eth27.xml,193,6,1,MOT,1069,3263,CHI
0,15,1,177,1.396657148,192,15,there,"('CHI', 'MOT')",Providence,eth27.xml,193,1,0,MOT,1069,3263,CHI
26,26,13,128,1.336283941,154,26,a,"('CHI', 'MOT')",Providence,eth27.xml,193,39,26,MOT,1069,3263,CHI
3,23,5,162,1.136764055,185,23,and,"('CHI', 'MOT')",Providence,eth27.xml,193,8,3,MOT,1069,3263,CHI
0,16,2,175,1.043182484,191,16,yeah,"('CHI', 'MOT')",Providence,eth27.xml,193,2,0,MOT,1069,3263,CHI
0,23,1,169,0.99119204,192,23,wanna,"('CHI', 'MOT')",Providence,eth27.xml,193,1,0,MOT,1069,3263,CHI
17,40,9,127,0.974493896,167,40,it,"('CHI', 'MOT')",Providence,eth27.xml,193,26,17,MOT,1069,3263,CHI
18,49,5,121,0.961034626,170,49,the,"('CHI', 'MOT')",Providence,eth27.xml,193,23,18,MOT,1069,3263,CHI
14,55,3,121,0.920043081,176,55,you,"('CHI', 'MOT')",Providence,eth27.xml,193,17,14,MOT,1069,3263,CHI
0,27,1,165,0.83704136,192,27,we,"('CHI', 'MOT')",Providence,eth27.xml,193,1,0,MOT,1069,3263,CHI
0,10,6,177,0.764410201,187,10,is,"('CHI', 'MOT')",Providence,eth27.xml,193,6,0,MOT,1069,3263,CHI
4,30,8,151,0.745879531,181,30,to,"('CHI', 'MOT')",Providence,eth27.xml,193,12,4,MOT,1069,3263,CHI
0,11,7,175,0.554310736,186,11,want,"('CHI', 'MOT')",Providence,eth27.xml,193,7,0,MOT,1069,3263,CHI
1,0,2,98,3.688879454,98,0,was,"('MOT', 'CHI')",Providence,eth28.xml,101,3,1,CHI,1580,426,MOT
4,4,2,251,3.469634543,255,4,not,"('CHI', 'MOT')",Providence,eth28.xml,261,6,4,MOT,1286,3015,CHI
1,5,0,255,3.371119926,260,5,get,"('CHI', 'MOT')",Providence,eth28.xml,261,1,1,MOT,1286,3015,CHI
0,2,1,258,3.371119926,260,2,she,"('CHI', 'MOT')",Providence,eth28.xml,261,1,0,MOT,1286,3015,CHI
1,0,4,96,3.33220451,96,0,she,"('MOT', 'CHI')",Providence,eth28.xml,101,5,1,CHI,1580,426,MOT
2,7,0,252,3.197396793,259,7,all,"('CHI', 'MOT')",Providence,eth28.xml,261,2,2,MOT,1286,3015,CHI
1,7,0,253,3.083437854,260,7,no,"('CHI', 'MOT')",Providence,eth28.xml,261,1,1,MOT,1286,3015,CHI
3,7,1,250,3.071921412,257,7,for,"('CHI', 'MOT')",Providence,eth28.xml,261,4,3,MOT,1286,3015,CHI
1,0,6,94,3.060270795,94,0,go,"('MOT', 'CHI')",Providence,eth28.xml,101,7,1,CHI,1580,426,MOT
1,0,6,94,3.060270795,94,0,there,"('MOT', 'CHI')",Providence,eth28.xml,101,7,1,CHI,1580,426,MOT
2,1,3,95,3.044522438,96,1,one,"('MOT', 'CHI')",Providence,eth28.xml,101,5,2,CHI,1580,426,MOT
2,8,1,250,2.85263143,258,8,did,"('CHI', 'MOT')",Providence,eth28.xml,261,3,2,MOT,1286,3015,CHI
0,5,1,255,2.677972746,260,5,where,"('CHI', 'MOT')",Providence,eth28.xml,261,1,0,MOT,1286,3015,CHI
2,10,1,248,2.651960734,258,10,like,"('CHI', 'MOT')",Providence,eth28.xml,261,3,2,MOT,1286,3015,CHI
1,12,0,248,2.597930038,260,12,oh,"('CHI', 'MOT')",Providence,eth28.xml,261,1,1,MOT,1286,3015,CHI
1,0,11,89,2.564949357,89,0,like,"('MOT', 'CHI')",Providence,eth28.xml,101,12,1,CHI,1580,426,MOT
0,1,2,98,2.535678975,99,1,not,"('MOT', 'CHI')",Providence,eth28.xml,101,2,0,CHI,1580,426,MOT
2,6,5,248,2.500655007,254,6,was,"('CHI', 'MOT')",Providence,eth28.xml,261,7,2,MOT,1286,3015,CHI
2,8,4,247,2.371022255,255,8,one,"('CHI', 'MOT')",Providence,eth28.xml,261,6,2,MOT,1286,3015,CHI
2,10,3,246,2.307766452,256,10,see,"('CHI', 'MOT')",Providence,eth28.xml,261,5,2,MOT,1286,3015,CHI
0,1,3,97,2.302585093,98,1,are,"('MOT', 'CHI')",Providence,eth28.xml,101,3,0,CHI,1580,426,MOT
1,3,2,95,2.302585093,98,3,up,"('MOT', 'CHI')",Providence,eth28.xml,101,3,1,CHI,1580,426,MOT
1,17,0,243,2.272507638,260,17,can,"('CHI', 'MOT')",Providence,eth28.xml,261,1,1,MOT,1286,3015,CHI
6,17,3,235,2.194977385,252,17,he,"('CHI', 'MOT')",Providence,eth28.xml,261,9,6,MOT,1286,3015,CHI
1,20,0,240,2.118356958,260,20,what,"('CHI', 'MOT')",Providence,eth28.xml,261,1,1,MOT,1286,3015,CHI
3,17,2,239,2.102972039,256,17,is,"('CHI', 'MOT')",Providence,eth28.xml,261,5,3,MOT,1286,3015,CHI
2,11,4,244,2.083340182,255,11,make,"('CHI', 'MOT')",Providence,eth28.xml,261,6,2,MOT,1286,3015,CHI
1,16,1,243,2.038159883,259,16,yeah,"('CHI', 'MOT')",Providence,eth28.xml,261,2,1,MOT,1286,3015,CHI
1,16,1,243,2.038159883,259,16,are,"('CHI', 'MOT')",Providence,eth28.xml,261,2,1,MOT,1286,3015,CHI
1,22,0,238,2.02738518,260,22,we,"('CHI', 'MOT')",Providence,eth28.xml,261,1,1,MOT,1286,3015,CHI
3,16,3,239,2.02271556,255,16,that,"('CHI', 'MOT')",Providence,eth28.xml,261,6,3,MOT,1286,3015,CHI
0,1,5,95,1.945910149,96,1,want,"('MOT', 'CHI')",Providence,eth28.xml,101,5,0,CHI,1580,426,MOT
2,18,2,239,1.919241902,257,18,go,"('CHI', 'MOT')",Providence,eth28.xml,261,4,2,MOT,1286,3015,CHI
0,12,1,248,1.904782858,260,12,have,"('CHI', 'MOT')",Providence,eth28.xml,261,1,0,MOT,1286,3015,CHI
0,9,2,250,1.875640953,259,9,up,"('CHI', 'MOT')",Providence,eth28.xml,261,2,0,MOT,1286,3015,CHI
1,1,11,88,1.871802177,89,1,have,"('MOT', 'CHI')",Providence,eth28.xml,101,12,1,CHI,1580,426,MOT
0,1,6,94,1.802122256,95,1,they,"('MOT', 'CHI')",Providence,eth28.xml,101,6,0,CHI,1580,426,MOT
0,10,2,249,1.780330773,259,10,on,"('CHI', 'MOT')",Providence,eth28.xml,261,2,0,MOT,1286,3015,CHI
1,1,13,86,1.716047647,87,1,on,"('MOT', 'CHI')",Providence,eth28.xml,101,14,1,CHI,1580,426,MOT
0,2,4,95,1.704748092,97,2,yeah,"('MOT', 'CHI')",Providence,eth28.xml,101,4,0,CHI,1580,426,MOT
1,15,3,242,1.685627051,257,15,there,"('CHI', 'MOT')",Providence,eth28.xml,261,4,1,MOT,1286,3015,CHI
0,1,7,93,1.673976434,94,1,what,"('MOT', 'CHI')",Providence,eth28.xml,101,7,0,CHI,1580,426,MOT
4,21,5,231,1.657834453,252,21,and,"('CHI', 'MOT')",Providence,eth28.xml,261,9,4,MOT,1286,3015,CHI
0,9,3,249,1.648658626,258,9,with,"('CHI', 'MOT')",Providence,eth28.xml,261,3,0,MOT,1286,3015,CHI
1,16,3,241,1.625002429,257,16,in,"('CHI', 'MOT')",Providence,eth28.xml,261,4,1,MOT,1286,3015,CHI
2,0,36,63,1.584120104,63,0,you,"('MOT', 'CHI')",Providence,eth28.xml,101,38,2,CHI,1580,426,MOT
0,17,1,243,1.579360457,260,17,little,"('CHI', 'MOT')",Providence,eth28.xml,261,1,0,MOT,1286,3015,CHI
0,1,8,92,1.558144618,93,1,in,"('MOT', 'CHI')",Providence,eth28.xml,101,8,0,CHI,1580,426,MOT
1,18,3,239,1.513776794,257,18,this,"('CHI', 'MOT')",Providence,eth28.xml,261,4,1,MOT,1286,3015,CHI
0,15,2,244,1.405637324,259,15,wanna,"('CHI', 'MOT')",Providence,eth28.xml,261,2,0,MOT,1286,3015,CHI
0,10,4,247,1.36717332,257,10,of,"('CHI', 'MOT')",Providence,eth28.xml,261,4,0,MOT,1286,3015,CHI
2,21,5,233,1.355522702,254,21,to,"('CHI', 'MOT')",Providence,eth28.xml,261,7,2,MOT,1286,3015,CHI
0,1,10,90,1.354545663,91,1,that,"('MOT', 'CHI')",Providence,eth28.xml,101,10,0,CHI,1580,426,MOT
8,32,8,213,1.319733595,245,32,it,"('CHI', 'MOT')",Providence,eth28.xml,261,16,8,MOT,1286,3015,CHI
1,2,15,83,1.170071253,85,2,to,"('MOT', 'CHI')",Providence,eth28.xml,101,16,1,CHI,1580,426,MOT
0,1,13,87,1.098612289,88,1,and,"('MOT', 'CHI')",Providence,eth28.xml,101,13,0,CHI,1580,426,MOT
20,55,9,177,1.040504658,232,55,a,"('CHI', 'MOT')",Providence,eth28.xml,261,29,20,MOT,1286,3015,CHI
7,68,2,184,0.984774031,252,68,you,"('CHI', 'MOT')",Providence,eth28.xml,261,9,7,MOT,1286,3015,CHI
0,2,11,88,0.858226931,90,2,do,"('MOT', 'CHI')",Providence,eth28.xml,101,11,0,CHI,1580,426,MOT
2,2,29,68,0.780158558,70,2,the,"('MOT', 'CHI')",Providence,eth28.xml,101,31,2,CHI,1580,426,MOT
16,63,14,168,0.659632811,231,63,the,"('CHI', 'MOT')",Providence,eth28.xml,261,30,16,MOT,1286,3015,CHI
2,5,18,76,0.634650974,81,5,it,"('MOT', 'CHI')",Providence,eth28.xml,101,20,2,CHI,1580,426,MOT
1,4,18,78,0.470003629,82,4,he,"('MOT', 'CHI')",Providence,eth28.xml,101,19,1,CHI,1580,426,MOT
3,4,31,63,0.427444015,67,4,a,"('MOT', 'CHI')",Providence,eth28.xml,101,34,3,CHI,1580,426,MOT
1,0,1,114,4.060443011,114,0,he,"('MOT', 'CHI')",Providence,eth29.xml,116,2,1,CHI,1624,490,MOT
1,1,2,112,3.135494216,113,1,for,"('MOT', 'CHI')",Providence,eth29.xml,116,3,1,CHI,1624,490,MOT
0,1,2,113,2.674148649,114,1,not,"('MOT', 'CHI')",Providence,eth29.xml,116,2,0,CHI,1624,490,MOT
1,0,12,103,2.63905733,103,0,to,"('MOT', 'CHI')",Providence,eth29.xml,116,13,1,CHI,1624,490,MOT
0,1,6,109,1.945910149,110,1,my,"('MOT', 'CHI')",Providence,eth29.xml,116,6,0,CHI,1624,490,MOT
1,2,8,105,1.887987501,107,2,want,"('MOT', 'CHI')",Providence,eth29.xml,116,9,1,CHI,1624,490,MOT
1,6,2,107,1.882731247,113,6,have,"('MOT', 'CHI')",Providence,eth29.xml,116,3,1,CHI,1624,490,MOT
2,0,2,11,1.871802177,11,0,the,"('CHI', 'MOT')",Providence,eth29.xml,15,4,2,MOT,68,181,CHI
0,1,7,108,1.819158443,109,1,of,"('MOT', 'CHI')",Providence,eth29.xml,116,7,0,CHI,1624,490,MOT
1,1,17,97,1.609437912,98,1,put,"('MOT', 'CHI')",Providence,eth29.xml,116,18,1,CHI,1624,490,MOT
0,1,10,105,1.504077397,106,1,in,"('MOT', 'CHI')",Providence,eth29.xml,116,10,0,CHI,1624,490,MOT
2,2,19,93,1.439216763,95,2,on,"('MOT', 'CHI')",Providence,eth29.xml,116,21,2,CHI,1624,490,MOT
4,4,17,91,1.439216763,95,4,like,"('MOT', 'CHI')",Providence,eth29.xml,116,21,4,CHI,1624,490,MOT
0,1,11,104,1.414732296,105,1,see,"('MOT', 'CHI')",Providence,eth29.xml,116,11,0,CHI,1624,490,MOT
0,2,7,107,1.413693335,109,2,look,"('MOT', 'CHI')",Providence,eth29.xml,116,7,0,CHI,1624,490,MOT
1,1,1,12,1.32175584,13,1,a,"('CHI', 'MOT')",Providence,eth29.xml,15,2,1,MOT,68,181,CHI
1,2,0,12,1.268511325,14,2,see,"('CHI', 'MOT')",Providence,eth29.xml,15,1,1,MOT,68,181,CHI
6,5,22,83,1.252762968,88,5,it,"('MOT', 'CHI')",Providence,eth29.xml,116,28,6,CHI,1624,490,MOT
0,2,9,105,1.194840321,107,2,that,"('MOT', 'CHI')",Providence,eth29.xml,116,9,0,CHI,1624,490,MOT
1,4,10,101,1.191588745,105,4,and,"('MOT', 'CHI')",Providence,eth29.xml,116,11,1,CHI,1624,490,MOT
2,5,12,97,1.178654996,102,5,one,"('MOT', 'CHI')",Providence,eth29.xml,116,14,2,CHI,1624,490,MOT
1,3,0,11,0.980829253,14,3,is,"('CHI', 'MOT')",Providence,eth29.xml,15,1,1,MOT,68,181,CHI
0,1,1,13,0.980829253,14,1,want,"('CHI', 'MOT')",Providence,eth29.xml,15,1,0,MOT,68,181,CHI
0,1,1,13,0.980829253,14,1,have,"('CHI', 'MOT')",Providence,eth29.xml,15,1,0,MOT,68,181,CHI
0,1,1,13,0.980829253,14,1,to,"('CHI', 'MOT')",Providence,eth29.xml,15,1,0,MOT,68,181,CHI
2,2,34,78,0.769133088,80,2,the,"('MOT', 'CHI')",Providence,eth29.xml,116,36,2,CHI,1624,490,MOT
6,8,27,75,0.635988767,83,8,a,"('MOT', 'CHI')",Providence,eth29.xml,116,33,6,CHI,1624,490,MOT
0,4,10,102,0.587786665,106,4,is,"('MOT', 'CHI')",Providence,eth29.xml,116,10,0,CHI,1624,490,MOT
0,2,41,73,-0.516006983,75,2,you,"('MOT', 'CHI')",Providence,eth29.xml,116,41,0,CHI,1624,490,MOT
0,1,4,290,3.195265959,291,1,all,"('MOT', 'CHI')",Providence,eth30.xml,295,4,0,CHI,4189,1497,MOT
0,1,5,289,3.037696473,290,1,make,"('MOT', 'CHI')",Providence,eth30.xml,295,5,0,CHI,4189,1497,MOT
0,1,5,289,3.037696473,290,1,at,"('MOT', 'CHI')",Providence,eth30.xml,295,5,0,CHI,4189,1497,MOT
1,5,3,286,2.789800851,291,5,look,"('MOT', 'CHI')",Providence,eth30.xml,295,4,1,CHI,4189,1497,MOT
0,1,7,287,2.779509165,288,1,they,"('MOT', 'CHI')",Providence,eth30.xml,295,7,0,CHI,4189,1497,MOT
0,1,7,287,2.779509165,288,1,big,"('MOT', 'CHI')",Providence,eth30.xml,295,7,0,CHI,4189,1497,MOT
3,3,13,276,2.747982911,279,3,up,"('MOT', 'CHI')",Providence,eth30.xml,295,16,3,CHI,4189,1497,MOT
0,1,9,285,2.571918027,286,1,get,"('MOT', 'CHI')",Providence,eth30.xml,295,9,0,CHI,4189,1497,MOT
0,1,10,284,2.481428385,285,1,he,"('MOT', 'CHI')",Providence,eth30.xml,295,10,0,CHI,4189,1497,MOT
1,2,13,279,2.467393067,281,2,oh,"('MOT', 'CHI')",Providence,eth30.xml,295,14,1,CHI,4189,1497,MOT
0,2,7,286,2.374044057,288,2,was,"('MOT', 'CHI')",Providence,eth30.xml,295,7,0,CHI,4189,1497,MOT
1,2,15,277,2.342517803,279,2,want,"('MOT', 'CHI')",Providence,eth30.xml,295,16,1,CHI,4189,1497,MOT
1,2,16,276,2.284885516,278,2,of,"('MOT', 'CHI')",Providence,eth30.xml,295,17,1,CHI,4189,1497,MOT
0,1,13,281,2.247776856,282,1,with,"('MOT', 'CHI')",Providence,eth30.xml,295,13,0,CHI,4189,1497,MOT
1,3,12,279,2.247776856,282,3,one,"('MOT', 'CHI')",Providence,eth30.xml,295,13,1,CHI,4189,1497,MOT
0,1,17,277,1.997203443,278,1,put,"('MOT', 'CHI')",Providence,eth30.xml,295,17,0,CHI,4189,1497,MOT
0,4,7,284,1.863218433,288,4,have,"('MOT', 'CHI')",Providence,eth30.xml,295,7,0,CHI,4189,1497,MOT
0,2,13,280,1.842311748,282,2,little,"('MOT', 'CHI')",Providence,eth30.xml,295,13,0,CHI,4189,1497,MOT
0,1,20,274,1.839827872,275,1,are,"('MOT', 'CHI')",Providence,eth30.xml,295,20,0,CHI,4189,1497,MOT
3,7,17,268,1.839827872,275,7,in,"('MOT', 'CHI')",Providence,eth30.xml,295,20,3,CHI,4189,1497,MOT
0,1,21,273,1.791759469,274,1,see,"('MOT', 'CHI')",Providence,eth30.xml,295,21,0,CHI,4189,1497,MOT
0,2,15,278,1.710081438,280,2,not,"('MOT', 'CHI')",Providence,eth30.xml,295,15,0,CHI,4189,1497,MOT
0,1,23,271,1.701105101,272,1,can,"('MOT', 'CHI')",Providence,eth30.xml,295,23,0,CHI,4189,1497,MOT
0,2,17,276,1.591738335,278,2,what,"('MOT', 'CHI')",Providence,eth30.xml,295,17,0,CHI,4189,1497,MOT
1,3,25,266,1.57676713,269,3,and,"('MOT', 'CHI')",Providence,eth30.xml,295,26,1,CHI,4189,1497,MOT
1,5,18,271,1.484486387,276,5,like,"('MOT', 'CHI')",Providence,eth30.xml,295,19,1,CHI,4189,1497,MOT
3,5,41,246,1.299282984,251,5,there,"('MOT', 'CHI')",Providence,eth30.xml,295,44,3,CHI,4189,1497,MOT
1,4,27,263,1.277223266,267,4,do,"('MOT', 'CHI')",Providence,eth30.xml,295,28,1,CHI,4189,1497,MOT
4,9,32,250,1.233787067,259,9,on,"('MOT', 'CHI')",Providence,eth30.xml,295,36,4,CHI,4189,1497,MOT
16,14,73,192,0.951841716,206,14,the,"('MOT', 'CHI')",Providence,eth30.xml,295,89,16,CHI,4189,1497,MOT
0,2,37,256,0.798507696,258,2,we,"('MOT', 'CHI')",Providence,eth30.xml,295,37,0,CHI,4189,1497,MOT
7,14,49,225,0.795745264,239,14,it,"('MOT', 'CHI')",Providence,eth30.xml,295,56,7,CHI,4189,1497,MOT
0,6,18,271,0.689569359,277,6,no,"('MOT', 'CHI')",Providence,eth30.xml,295,18,0,CHI,4189,1497,MOT
0,11,11,273,0.606135804,284,11,this,"('MOT', 'CHI')",Providence,eth30.xml,295,11,0,CHI,4189,1497,MOT
4,3,121,167,0.526450942,170,3,you,"('MOT', 'CHI')",Providence,eth30.xml,295,125,4,CHI,4189,1497,MOT
0,5,39,251,0.047628049,256,5,go,"('MOT', 'CHI')",Providence,eth30.xml,295,39,0,CHI,4189,1497,MOT
0,12,19,264,0.018149319,276,12,is,"('MOT', 'CHI')",Providence,eth30.xml,295,19,0,CHI,4189,1497,MOT
0,11,25,259,-0.174941449,270,11,that,"('MOT', 'CHI')",Providence,eth30.xml,295,25,0,CHI,4189,1497,MOT
1,18,51,225,-0.739017635,243,18,a,"('MOT', 'CHI')",Providence,eth30.xml,295,52,1,CHI,4189,1497,MOT
0,13,41,241,-0.855080001,254,13,to,"('MOT', 'CHI')",Providence,eth30.xml,295,41,0,CHI,4189,1497,MOT
1,0,7,326,4.183575696,326,0,did,"('MOT', 'CHI')",Providence,eth31.xml,334,8,1,CHI,4067,2117,MOT
1,0,7,326,4.183575696,326,0,at,"('MOT', 'CHI')",Providence,eth31.xml,334,8,1,CHI,4067,2117,MOT
1,0,8,325,4.085212079,325,0,little,"('MOT', 'CHI')",Providence,eth31.xml,334,9,1,CHI,4067,2117,MOT
1,3,2,328,3.505557397,331,3,big,"('MOT', 'CHI')",Providence,eth31.xml,334,3,1,CHI,4067,2117,MOT
1,3,3,327,3.320228319,330,3,but,"('MOT', 'CHI')",Providence,eth31.xml,334,4,1,CHI,4067,2117,MOT
1,2,5,326,3.314186005,328,2,for,"('MOT', 'CHI')",Providence,eth31.xml,334,6,1,CHI,4067,2117,MOT
1,2,6,325,3.193368065,327,2,some,"('MOT', 'CHI')",Providence,eth31.xml,334,7,1,CHI,4067,2117,MOT
1,2,7,324,3.084963407,326,2,see,"('MOT', 'CHI')",Providence,eth31.xml,334,8,1,CHI,4067,2117,MOT
0,1,7,326,2.905685993,327,1,get,"('MOT', 'CHI')",Providence,eth31.xml,334,7,0,CHI,4067,2117,MOT
1,3,8,322,2.698917718,325,3,where,"('MOT', 'CHI')",Providence,eth31.xml,334,9,1,CHI,4067,2117,MOT
3,2,27,302,2.545531272,304,2,in,"('MOT', 'CHI')",Providence,eth31.xml,334,30,3,CHI,4067,2117,MOT
0,1,11,322,2.525728644,323,1,they,"('MOT', 'CHI')",Providence,eth31.xml,334,11,0,CHI,4067,2117,MOT
0,2,7,325,2.500220885,327,2,have,"('MOT', 'CHI')",Providence,eth31.xml,334,7,0,CHI,4067,2117,MOT
0,1,12,321,2.448539006,322,1,yeah,"('MOT', 'CHI')",Providence,eth31.xml,334,12,0,CHI,4067,2117,MOT
1,2,18,313,2.308914228,315,2,all,"('MOT', 'CHI')",Providence,eth31.xml,334,19,1,CHI,4067,2117,MOT
1,4,12,317,2.15331139,321,4,one,"('MOT', 'CHI')",Providence,eth31.xml,334,13,1,CHI,4067,2117,MOT
1,6,10,317,1.966112856,323,6,not,"('MOT', 'CHI')",Providence,eth31.xml,334,11,1,CHI,4067,2117,MOT
0,5,6,323,1.927891644,328,5,no,"('MOT', 'CHI')",Providence,eth31.xml,334,6,0,CHI,4067,2117,MOT
0,2,14,318,1.903350535,320,2,put,"('MOT', 'CHI')",Providence,eth31.xml,334,14,0,CHI,4067,2117,MOT
1,3,23,307,1.791759469,310,3,up,"('MOT', 'CHI')",Providence,eth31.xml,334,24,1,CHI,4067,2117,MOT
0,3,12,319,1.755391825,322,3,this,"('MOT', 'CHI')",Providence,eth31.xml,334,12,0,CHI,4067,2117,MOT
0,2,17,315,1.722139835,317,2,oh,"('MOT', 'CHI')",Providence,eth31.xml,334,17,0,CHI,4067,2117,MOT
0,2,17,315,1.722139835,317,2,like,"('MOT', 'CHI')",Providence,eth31.xml,334,17,0,CHI,4067,2117,MOT
2,6,30,296,1.343369316,302,6,go,"('MOT', 'CHI')",Providence,eth31.xml,334,32,2,CHI,4067,2117,MOT
0,10,6,318,1.32175584,328,10,was,"('MOT', 'CHI')",Providence,eth31.xml,334,6,0,CHI,4067,2117,MOT
1,6,22,305,1.274564397,311,6,can,"('MOT', 'CHI')",Providence,eth31.xml,334,23,1,CHI,4067,2117,MOT
0,2,28,304,1.230290113,306,2,of,"('MOT', 'CHI')",Providence,eth31.xml,334,28,0,CHI,4067,2117,MOT
0,4,17,313,1.211314211,317,4,gonna,"('MOT', 'CHI')",Providence,eth31.xml,334,17,0,CHI,4067,2117,MOT
3,9,36,286,1.06386934,295,9,to,"('MOT', 'CHI')",Providence,eth31.xml,334,39,3,CHI,4067,2117,MOT
0,5,17,312,1.028992654,317,5,what,"('MOT', 'CHI')",Providence,eth31.xml,334,17,0,CHI,4067,2117,MOT
9,14,58,253,0.955139767,267,14,a,"('MOT', 'CHI')",Providence,eth31.xml,334,67,9,CHI,4067,2117,MOT
2,7,40,285,0.91856088,292,7,on,"('MOT', 'CHI')",Providence,eth31.xml,334,42,2,CHI,4067,2117,MOT
0,3,29,302,0.906566182,305,3,do,"('MOT', 'CHI')",Providence,eth31.xml,334,29,0,CHI,4067,2117,MOT
9,22,45,258,0.783646257,280,22,it,"('MOT', 'CHI')",Providence,eth31.xml,334,54,9,CHI,4067,2117,MOT
0,6,21,307,0.671168274,313,6,that,"('MOT', 'CHI')",Providence,eth31.xml,334,21,0,CHI,4067,2117,MOT
0,4,31,299,0.614366303,303,4,there,"('MOT', 'CHI')",Providence,eth31.xml,334,31,0,CHI,4067,2117,MOT
7,34,29,264,0.590289795,298,34,he,"('MOT', 'CHI')",Providence,eth31.xml,334,36,7,CHI,4067,2117,MOT
0,8,19,307,0.517154759,315,8,and,"('MOT', 'CHI')",Providence,eth31.xml,334,19,0,CHI,4067,2117,MOT
3,8,68,255,0.478340169,263,8,you,"('MOT', 'CHI')",Providence,eth31.xml,334,71,3,CHI,4067,2117,MOT
3,20,34,277,0.378653851,297,20,is,"('MOT', 'CHI')",Providence,eth31.xml,334,37,3,CHI,4067,2117,MOT
20,30,104,180,0.130839601,210,30,the,"('MOT', 'CHI')",Providence,eth31.xml,334,124,20,CHI,4067,2117,MOT
1,1,0,206,4.243721963,207,1,at,"('CHI', 'MOT')",Providence,eth32.xml,208,1,1,MOT,1090,2461,CHI
2,4,0,202,3.440418095,206,4,up,"('CHI', 'MOT')",Providence,eth32.xml,208,2,2,MOT,1090,2461,CHI
1,3,1,203,3.258096538,206,3,are,"('CHI', 'MOT')",Providence,eth32.xml,208,2,1,MOT,1090,2461,CHI
0,2,1,205,3.145109675,207,2,where,"('CHI', 'MOT')",Providence,eth32.xml,208,1,0,MOT,1090,2461,CHI
4,7,1,196,2.907096201,203,7,he,"('CHI', 'MOT')",Providence,eth32.xml,208,5,4,MOT,1090,2461,CHI
0,3,1,204,2.857427602,207,3,with,"('CHI', 'MOT')",Providence,eth32.xml,208,1,0,MOT,1090,2461,CHI
0,2,2,204,2.85263143,206,2,some,"('CHI', 'MOT')",Providence,eth32.xml,208,2,0,MOT,1090,2461,CHI
1,4,2,201,2.806990149,205,4,was,"('CHI', 'MOT')",Providence,eth32.xml,208,3,1,MOT,1090,2461,CHI
2,6,2,198,2.688818839,204,6,there,"('CHI', 'MOT')",Providence,eth32.xml,208,4,2,MOT,1090,2461,CHI
2,11,0,195,2.564949357,206,11,one,"('CHI', 'MOT')",Providence,eth32.xml,208,2,2,MOT,1090,2461,CHI
2,9,1,196,2.519308077,205,9,not,"('CHI', 'MOT')",Providence,eth32.xml,208,3,2,MOT,1090,2461,CHI
1,6,2,199,2.470517912,205,6,all,"('CHI', 'MOT')",Providence,eth32.xml,208,3,1,MOT,1090,2461,CHI
2,8,2,196,2.437504411,204,8,go,"('CHI', 'MOT')",Providence,eth32.xml,208,4,2,MOT,1090,2461,CHI
2,10,1,195,2.423997897,205,10,like,"('CHI', 'MOT')",Providence,eth32.xml,208,3,2,MOT,1090,2461,CHI
1,9,1,197,2.341805806,206,9,my,"('CHI', 'MOT')",Providence,eth32.xml,208,2,1,MOT,1090,2461,CHI
0,3,3,202,2.33698652,205,3,see,"('CHI', 'MOT')",Providence,eth32.xml,208,3,0,MOT,1090,2461,CHI
3,15,1,189,2.149822338,204,15,and,"('CHI', 'MOT')",Providence,eth32.xml,208,4,3,MOT,1090,2461,CHI
3,7,7,191,2.120263536,198,7,oh,"('CHI', 'MOT')",Providence,eth32.xml,208,10,3,MOT,1090,2461,CHI
4,17,1,186,2.096165985,203,17,of,"('CHI', 'MOT')",Providence,eth32.xml,208,5,4,MOT,1090,2461,CHI
0,8,1,199,2.046497386,207,8,can,"('CHI', 'MOT')",Providence,eth32.xml,208,1,0,MOT,1090,2461,CHI
3,17,1,187,2.032039303,204,17,on,"('CHI', 'MOT')",Providence,eth32.xml,208,4,3,MOT,1090,2461,CHI
4,19,1,184,1.990805469,203,19,in,"('CHI', 'MOT')",Providence,eth32.xml,208,5,4,MOT,1090,2461,CHI
0,3,5,200,1.990805469,203,3,they,"('CHI', 'MOT')",Providence,eth32.xml,208,5,0,MOT,1090,2461,CHI
0,9,1,198,1.94113687,207,9,have,"('CHI', 'MOT')",Providence,eth32.xml,208,1,0,MOT,1090,2461,CHI
0,9,1,198,1.94113687,207,9,do,"('CHI', 'MOT')",Providence,eth32.xml,208,1,0,MOT,1090,2461,CHI
1,9,3,195,1.926678787,204,9,gonna,"('CHI', 'MOT')",Providence,eth32.xml,208,4,1,MOT,1090,2461,CHI
2,14,3,189,1.767661918,203,14,that,"('CHI', 'MOT')",Providence,eth32.xml,208,5,2,MOT,1090,2461,CHI
0,8,2,198,1.754019141,206,8,want,"('CHI', 'MOT')",Providence,eth32.xml,208,2,0,MOT,1090,2461,CHI
4,23,2,179,1.670062534,202,23,it,"('CHI', 'MOT')",Providence,eth32.xml,208,6,4,MOT,1090,2461,CHI
0,9,3,196,1.420695788,205,9,this,"('CHI', 'MOT')",Providence,eth32.xml,208,3,0,MOT,1090,2461,CHI
0,7,5,196,1.297658288,203,7,yeah,"('CHI', 'MOT')",Providence,eth32.xml,208,5,0,MOT,1090,2461,CHI
12,39,4,153,1.253556305,192,39,the,"('CHI', 'MOT')",Providence,eth32.xml,208,16,12,MOT,1090,2461,CHI
2,20,5,181,1.170071253,201,20,is,"('CHI', 'MOT')",Providence,eth32.xml,208,7,2,MOT,1090,2461,CHI
2,41,1,164,1.084223551,205,41,you,"('CHI', 'MOT')",Providence,eth32.xml,208,3,2,MOT,1090,2461,CHI
4,39,3,162,1.03653986,201,39,a,"('CHI', 'MOT')",Providence,eth32.xml,208,7,4,MOT,1090,2461,CHI
0,8,7,193,0.918756824,201,8,no,"('CHI', 'MOT')",Providence,eth32.xml,208,7,0,MOT,1090,2461,CHI
2,1,12,288,3.306199653,289,1,are,"('MOT', 'CHI')",Providence,eth33.xml,303,14,2,CHI,4397,1650,MOT
1,0,20,282,3.206627203,282,0,can,"('MOT', 'CHI')",Providence,eth33.xml,303,21,1,CHI,4397,1650,MOT
5,4,10,284,3.018989136,288,4,was,"('MOT', 'CHI')",Providence,eth33.xml,303,15,5,CHI,4397,1650,MOT
0,2,3,298,3.002376816,300,2,where,"('MOT', 'CHI')",Providence,eth33.xml,303,3,0,CHI,4397,1650,MOT
1,1,12,289,2.968703601,290,1,go,"('MOT', 'CHI')",Providence,eth33.xml,303,13,1,CHI,4397,1650,MOT
2,2,14,285,2.77605493,287,2,with,"('MOT', 'CHI')",Providence,eth33.xml,303,16,2,CHI,4397,1650,MOT
2,2,15,284,2.718521501,286,2,some,"('MOT', 'CHI')",Providence,eth33.xml,303,17,2,CHI,4397,1650,MOT
2,5,7,289,2.599317001,294,5,no,"('MOT', 'CHI')",Providence,eth33.xml,303,9,2,CHI,4397,1650,MOT
0,1,10,292,2.508921526,293,1,my,"('MOT', 'CHI')",Providence,eth33.xml,303,10,0,CHI,4397,1650,MOT
0,1,13,289,2.275556421,290,1,all,"('MOT', 'CHI')",Providence,eth33.xml,303,13,0,CHI,4397,1650,MOT
1,3,14,285,2.143520398,288,3,up,"('MOT', 'CHI')",Providence,eth33.xml,303,15,1,CHI,4397,1650,MOT
1,1,30,271,2.116620545,272,1,what,"('MOT', 'CHI')",Providence,eth33.xml,303,31,1,CHI,4397,1650,MOT
1,2,20,280,2.108014914,282,2,do,"('MOT', 'CHI')",Providence,eth33.xml,303,21,1,CHI,4397,1650,MOT
0,1,16,286,2.08290775,287,1,have,"('MOT', 'CHI')",Providence,eth33.xml,303,16,0,CHI,4397,1650,MOT
2,6,12,283,2.053436685,289,6,they,"('MOT', 'CHI')",Providence,eth33.xml,303,14,2,CHI,4397,1650,MOT
0,2,11,290,2.020018121,292,2,not,"('MOT', 'CHI')",Providence,eth33.xml,303,11,0,CHI,4397,1650,MOT
0,2,13,288,1.870091312,290,2,this,"('MOT', 'CHI')",Providence,eth33.xml,303,13,0,CHI,4397,1650,MOT
0,3,10,290,1.815774345,293,3,look,"('MOT', 'CHI')",Providence,eth33.xml,303,10,0,CHI,4397,1650,MOT
2,4,24,273,1.788181648,277,4,of,"('MOT', 'CHI')",Providence,eth33.xml,303,26,2,CHI,4397,1650,MOT
0,4,8,291,1.781709133,295,4,one,"('MOT', 'CHI')",Providence,eth33.xml,303,8,0,CHI,4397,1650,MOT
3,6,23,271,1.739391484,277,6,in,"('MOT', 'CHI')",Providence,eth33.xml,303,26,3,CHI,4397,1650,MOT
2,6,19,276,1.666182162,282,6,is,"('MOT', 'CHI')",Providence,eth33.xml,303,21,2,CHI,4397,1650,MOT
0,3,13,287,1.58240924,290,3,at,"('MOT', 'CHI')",Providence,eth33.xml,303,13,0,CHI,4397,1650,MOT
9,13,29,252,1.561896968,265,13,it,"('MOT', 'CHI')",Providence,eth33.xml,303,38,9,CHI,4397,1650,MOT
0,3,14,286,1.514440184,289,3,there,"('MOT', 'CHI')",Providence,eth33.xml,303,14,0,CHI,4397,1650,MOT
0,2,20,281,1.462834438,283,2,oh,"('MOT', 'CHI')",Providence,eth33.xml,303,20,0,CHI,4397,1650,MOT
1,4,24,274,1.422662005,278,4,that,"('MOT', 'CHI')",Providence,eth33.xml,303,25,1,CHI,4397,1650,MOT
5,11,28,259,1.357306824,270,11,and,"('MOT', 'CHI')",Providence,eth33.xml,303,33,5,CHI,4397,1650,MOT
4,11,25,263,1.310944924,274,11,like,"('MOT', 'CHI')",Providence,eth33.xml,303,29,4,CHI,4397,1650,MOT
0,5,12,286,1.24935581,291,5,put,"('MOT', 'CHI')",Providence,eth33.xml,303,12,0,CHI,4397,1650,MOT
17,17,65,204,0.976354973,221,17,the,"('MOT', 'CHI')",Providence,eth33.xml,303,82,17,CHI,4397,1650,MOT
12,8,97,186,0.936309238,194,8,you,"('MOT', 'CHI')",Providence,eth33.xml,303,109,12,CHI,4397,1650,MOT
1,8,22,272,0.918953849,280,8,he,"('MOT', 'CHI')",Providence,eth33.xml,303,23,1,CHI,4397,1650,MOT
6,9,64,224,0.826244451,233,9,a,"('MOT', 'CHI')",Providence,eth33.xml,303,70,6,CHI,4397,1650,MOT
0,3,30,270,0.764740834,273,3,we,"('MOT', 'CHI')",Providence,eth33.xml,303,30,0,CHI,4397,1650,MOT
0,11,12,280,0.55620863,291,11,but,"('MOT', 'CHI')",Providence,eth33.xml,303,12,0,CHI,4397,1650,MOT
0,4,31,268,0.507182632,272,4,to,"('MOT', 'CHI')",Providence,eth33.xml,303,31,0,CHI,4397,1650,MOT
2,5,1,282,3.363841595,287,5,put,"('CHI', 'MOT')",Providence,eth34.xml,290,3,2,MOT,1482,4586,CHI
1,7,1,281,2.897292201,288,7,where,"('CHI', 'MOT')",Providence,eth34.xml,290,2,1,MOT,1482,4586,CHI
2,8,2,278,2.772588722,286,8,at,"('CHI', 'MOT')",Providence,eth34.xml,290,4,2,MOT,1482,4586,CHI
2,4,7,277,2.736726001,281,4,no,"('CHI', 'MOT')",Providence,eth34.xml,290,9,2,MOT,1482,4586,CHI
1,12,0,277,2.702908802,289,12,not,"('CHI', 'MOT')",Providence,eth34.xml,290,1,1,MOT,1482,4586,CHI
6,14,1,269,2.693124551,283,14,they,"('CHI', 'MOT')",Providence,eth34.xml,290,7,6,MOT,1482,4586,CHI
0,6,1,283,2.628800829,289,6,make,"('CHI', 'MOT')",Providence,eth34.xml,290,1,0,MOT,1482,4586,CHI
2,16,0,272,2.548985506,288,16,go,"('CHI', 'MOT')",Providence,eth34.xml,290,2,2,MOT,1482,4586,CHI
1,11,1,277,2.491827093,288,11,he,"('CHI', 'MOT')",Providence,eth34.xml,290,2,1,MOT,1482,4586,CHI
1,12,1,276,2.411784385,288,12,like,"('CHI', 'MOT')",Providence,eth34.xml,290,2,1,MOT,1482,4586,CHI
1,13,1,275,2.337676413,288,13,with,"('CHI', 'MOT')",Providence,eth34.xml,290,2,1,MOT,1482,4586,CHI
3,19,1,267,2.261763098,286,19,one,"('CHI', 'MOT')",Providence,eth34.xml,290,4,3,MOT,1482,4586,CHI
7,14,7,262,2.226423732,276,14,that,"('CHI', 'MOT')",Providence,eth34.xml,290,14,7,MOT,1482,4586,CHI
0,10,1,279,2.176815706,289,10,all,"('CHI', 'MOT')",Providence,eth34.xml,290,1,0,MOT,1482,4586,CHI
0,6,3,281,2.111078627,287,6,oh,"('CHI', 'MOT')",Providence,eth34.xml,290,3,0,MOT,1482,4586,CHI
2,14,3,271,2.104134154,285,14,can,"('CHI', 'MOT')",Providence,eth34.xml,290,5,2,MOT,1482,4586,CHI
0,11,1,278,2.089804329,289,11,see,"('CHI', 'MOT')",Providence,eth34.xml,290,1,0,MOT,1482,4586,CHI
0,12,1,277,2.009761621,289,12,have,"('CHI', 'MOT')",Providence,eth34.xml,290,1,0,MOT,1482,4586,CHI
6,26,2,256,1.996462428,282,26,in,"('CHI', 'MOT')",Providence,eth34.xml,290,8,6,MOT,1482,4586,CHI
1,9,5,275,1.967112357,284,9,up,"('CHI', 'MOT')",Providence,eth34.xml,290,6,1,MOT,1482,4586,CHI
0,13,1,276,1.935653649,289,13,get,"('CHI', 'MOT')",Providence,eth34.xml,290,1,0,MOT,1482,4586,CHI
2,17,3,268,1.921812597,285,17,we,"('CHI', 'MOT')",Providence,eth34.xml,290,5,2,MOT,1482,4586,CHI
0,6,5,279,1.767661918,285,6,look,"('CHI', 'MOT')",Providence,eth34.xml,290,5,0,MOT,1482,4586,CHI
2,29,1,258,1.754403683,287,29,there,"('CHI', 'MOT')",Providence,eth34.xml,290,3,2,MOT,1482,4586,CHI
2,18,4,266,1.730723579,284,18,this,"('CHI', 'MOT')",Providence,eth34.xml,290,6,2,MOT,1482,4586,CHI
0,12,2,276,1.718637204,288,12,my,"('CHI', 'MOT')",Providence,eth34.xml,290,2,0,MOT,1482,4586,CHI
1,20,2,267,1.705613519,287,20,of,"('CHI', 'MOT')",Providence,eth34.xml,290,3,1,MOT,1482,4586,CHI
1,27,1,261,1.644529232,288,27,do,"('CHI', 'MOT')",Providence,eth34.xml,290,2,1,MOT,1482,4586,CHI
3,34,3,250,1.407496569,284,34,on,"('CHI', 'MOT')",Providence,eth34.xml,290,6,3,MOT,1482,4586,CHI
3,28,5,254,1.365387676,282,28,to,"('CHI', 'MOT')",Providence,eth34.xml,290,8,3,MOT,1482,4586,CHI
2,27,5,256,1.221672381,283,27,are,"('CHI', 'MOT')",Providence,eth34.xml,290,7,2,MOT,1482,4586,CHI
8,41,8,233,1.189584067,274,41,it,"('CHI', 'MOT')",Providence,eth34.xml,290,16,8,MOT,1482,4586,CHI
14,61,5,210,1.145865174,271,61,the,"('CHI', 'MOT')",Providence,eth34.xml,290,19,14,MOT,1482,4586,CHI
0,19,3,268,1.061256502,287,19,want,"('CHI', 'MOT')",Providence,eth34.xml,290,3,0,MOT,1482,4586,CHI
1,24,5,260,1.050821625,284,24,what,"('CHI', 'MOT')",Providence,eth34.xml,290,6,1,MOT,1482,4586,CHI
1,25,5,259,1.011600912,284,25,is,"('CHI', 'MOT')",Providence,eth34.xml,290,6,1,MOT,1482,4586,CHI
7,58,5,220,0.997636371,278,58,a,"('CHI', 'MOT')",Providence,eth34.xml,290,12,7,MOT,1482,4586,CHI
6,90,1,193,0.890315245,283,90,you,"('CHI', 'MOT')",Providence,eth34.xml,290,7,6,MOT,1482,4586,CHI
0,45,6,239,-0.252091127,284,45,and,"('CHI', 'MOT')",Providence,eth34.xml,290,6,0,MOT,1482,4586,CHI
1,1,0,179,4.105394398,180,1,she,"('CHI', 'MOT')",Providence,eth35.xml,181,1,1,MOT,1176,2852,CHI
1,1,0,152,3.944812828,153,1,get,"('MOT', 'CHI')",Providence,eth35.xml,154,1,1,CHI,1799,861,MOT
1,1,1,178,3.81220267,179,1,make,"('CHI', 'MOT')",Providence,eth35.xml,181,2,1,MOT,1176,2852,CHI
2,1,2,149,3.63758616,150,1,he,"('MOT', 'CHI')",Providence,eth35.xml,154,4,2,CHI,1799,861,MOT
2,0,9,143,3.510396674,143,0,go,"('MOT', 'CHI')",Providence,eth35.xml,154,11,2,CHI,1799,861,MOT
1,0,6,147,3.499868909,147,0,of,"('MOT', 'CHI')",Providence,eth35.xml,154,7,1,CHI,1799,861,MOT
0,1,1,152,3.251665648,153,1,with,"('MOT', 'CHI')",Providence,eth35.xml,154,1,0,CHI,1799,861,MOT
0,1,1,152,3.251665648,153,1,was,"('MOT', 'CHI')",Providence,eth35.xml,154,1,0,CHI,1799,861,MOT
1,1,3,149,3.232121052,150,1,some,"('MOT', 'CHI')",Providence,eth35.xml,154,4,1,CHI,1799,861,MOT
0,1,2,178,3.11905549,179,1,want,"('CHI', 'MOT')",Providence,eth35.xml,181,2,0,MOT,1176,2852,CHI
1,5,0,175,3.00678211,180,5,little,"('CHI', 'MOT')",Providence,eth35.xml,181,1,1,MOT,1176,2852,CHI
1,5,0,175,3.00678211,180,5,big,"('CHI', 'MOT')",Providence,eth35.xml,181,1,1,MOT,1176,2852,CHI
0,1,2,151,2.957511061,152,1,gonna,"('MOT', 'CHI')",Providence,eth35.xml,154,2,0,CHI,1799,861,MOT
0,1,2,151,2.957511061,152,1,look,"('MOT', 'CHI')",Providence,eth35.xml,154,2,0,CHI,1799,861,MOT
3,5,2,171,2.830408293,176,5,oh,"('CHI', 'MOT')",Providence,eth35.xml,181,5,3,MOT,1176,2852,CHI
0,1,3,150,2.727852828,151,1,oh,"('MOT', 'CHI')",Providence,eth35.xml,154,3,0,CHI,1799,861,MOT
0,1,3,150,2.727852828,151,1,they,"('MOT', 'CHI')",Providence,eth35.xml,154,3,0,CHI,1799,861,MOT
0,1,3,150,2.727852828,151,1,up,"('MOT', 'CHI')",Providence,eth35.xml,154,3,0,CHI,1799,861,MOT
0,3,1,177,2.719100037,180,3,with,"('CHI', 'MOT')",Providence,eth35.xml,181,1,0,MOT,1176,2852,CHI
4,10,0,167,2.607168976,177,10,we,"('CHI', 'MOT')",Providence,eth35.xml,181,4,4,MOT,1176,2852,CHI
1,1,8,144,2.592537314,145,1,have,"('MOT', 'CHI')",Providence,eth35.xml,154,9,1,CHI,1799,861,MOT
0,1,4,149,2.538973871,150,1,my,"('MOT', 'CHI')",Providence,eth35.xml,154,4,0,CHI,1799,861,MOT
3,1,17,133,2.514759613,134,1,in,"('MOT', 'CHI')",Providence,eth35.xml,154,20,3,CHI,1799,861,MOT
0,4,1,176,2.495956486,180,4,gonna,"('CHI', 'MOT')",Providence,eth35.xml,181,1,0,MOT,1176,2852,CHI
0,4,1,176,2.495956486,180,4,look,"('CHI', 'MOT')",Providence,eth35.xml,181,1,0,MOT,1176,2852,CHI
1,9,0,171,2.495956486,180,9,have,"('CHI', 'MOT')",Providence,eth35.xml,181,1,1,MOT,1176,2852,CHI
1,5,2,173,2.48490665,178,5,some,"('CHI', 'MOT')",Providence,eth35.xml,181,3,1,MOT,1176,2852,CHI
0,1,5,148,2.378222507,149,1,are,"('MOT', 'CHI')",Providence,eth35.xml,154,5,0,CHI,1799,861,MOT
1,6,2,172,2.33075597,178,6,this,"('CHI', 'MOT')",Providence,eth35.xml,181,3,1,MOT,1176,2852,CHI
0,2,3,149,2.32238772,151,2,at,"('MOT', 'CHI')",Providence,eth35.xml,154,3,0,CHI,1799,861,MOT
0,5,1,175,2.313634929,180,5,for,"('CHI', 'MOT')",Providence,eth35.xml,181,1,0,MOT,1176,2852,CHI
0,1,6,147,2.238046572,148,1,but,"('MOT', 'CHI')",Providence,eth35.xml,154,6,0,CHI,1799,861,MOT
0,4,2,175,2.202764758,179,4,where,"('CHI', 'MOT')",Providence,eth35.xml,181,2,0,MOT,1176,2852,CHI
1,9,1,170,2.202764758,179,9,think,"('CHI', 'MOT')",Providence,eth35.xml,181,2,1,MOT,1176,2852,CHI
6,9,6,160,2.145931283,169,9,up,"('CHI', 'MOT')",Providence,eth35.xml,181,12,6,MOT,1176,2852,CHI
1,5,4,171,2.137261113,176,5,but,"('CHI', 'MOT')",Providence,eth35.xml,181,5,1,MOT,1176,2852,CHI
1,8,2,170,2.079441542,178,8,do,"('CHI', 'MOT')",Providence,eth35.xml,181,3,1,MOT,1176,2852,CHI
1,8,2,170,2.079441542,178,8,not,"('CHI', 'MOT')",Providence,eth35.xml,181,3,1,MOT,1176,2852,CHI
1,11,1,168,2.020443201,179,11,all,"('CHI', 'MOT')",Providence,eth35.xml,181,2,1,MOT,1176,2852,CHI
0,1,8,145,2.00148,146,1,wanna,"('MOT', 'CHI')",Providence,eth35.xml,154,8,0,CHI,1799,861,MOT
0,1,8,145,2.00148,146,1,think,"('MOT', 'CHI')",Providence,eth35.xml,154,8,0,CHI,1799,861,MOT
0,1,9,144,1.899390133,145,1,there,"('MOT', 'CHI')",Providence,eth35.xml,154,9,0,CHI,1799,861,MOT
0,1,9,144,1.899390133,145,1,see,"('MOT', 'CHI')",Providence,eth35.xml,154,9,0,CHI,1799,861,MOT
0,2,6,146,1.832581464,148,2,put,"('MOT', 'CHI')",Providence,eth35.xml,154,6,0,CHI,1799,861,MOT
6,17,3,155,1.816698418,172,17,in,"('CHI', 'MOT')",Providence,eth35.xml,181,9,6,MOT,1176,2852,CHI
0,5,3,173,1.791759469,178,5,see,"('CHI', 'MOT')",Providence,eth35.xml,181,3,0,MOT,1176,2852,CHI
2,14,2,163,1.786188424,177,14,can,"('CHI', 'MOT')",Providence,eth35.xml,181,4,2,MOT,1176,2852,CHI
3,14,3,161,1.774952351,175,14,go,"('CHI', 'MOT')",Providence,eth35.xml,181,6,3,MOT,1176,2852,CHI
1,8,4,168,1.731796004,176,8,one,"('CHI', 'MOT')",Providence,eth35.xml,181,5,1,MOT,1176,2852,CHI
4,22,1,154,1.709817098,176,22,is,"('CHI', 'MOT')",Providence,eth35.xml,181,5,4,MOT,1176,2852,CHI
1,2,15,136,1.645805557,138,2,we,"('MOT', 'CHI')",Providence,eth35.xml,154,16,1,CHI,1799,861,MOT
0,11,1,169,1.620487749,180,11,are,"('CHI', 'MOT')",Providence,eth35.xml,181,1,0,MOT,1176,2852,CHI
0,8,2,171,1.614978093,179,8,on,"('CHI', 'MOT')",Providence,eth35.xml,181,2,0,MOT,1176,2852,CHI
1,3,12,138,1.561647249,141,3,to,"('MOT', 'CHI')",Providence,eth35.xml,154,13,1,CHI,1799,861,MOT
1,12,3,165,1.52382416,177,12,was,"('CHI', 'MOT')",Providence,eth35.xml,181,4,1,MOT,1176,2852,CHI
5,15,7,154,1.521776974,169,15,it,"('CHI', 'MOT')",Providence,eth35.xml,181,12,5,MOT,1176,2852,CHI
5,18,5,153,1.515705435,171,18,to,"('CHI', 'MOT')",Providence,eth35.xml,181,10,5,MOT,1176,2852,CHI
0,2,9,143,1.493925025,145,2,want,"('MOT', 'CHI')",Providence,eth35.xml,154,9,0,CHI,1799,861,MOT
0,2,9,143,1.493925025,145,2,on,"('MOT', 'CHI')",Providence,eth35.xml,154,9,0,CHI,1799,861,MOT
3,23,2,153,1.444113932,176,23,what,"('CHI', 'MOT')",Providence,eth35.xml,181,5,3,MOT,1176,2852,CHI
4,11,11,155,1.415281898,166,11,they,"('CHI', 'MOT')",Providence,eth35.xml,181,15,4,MOT,1176,2852,CHI
1,4,11,138,1.414465238,142,4,do,"('MOT', 'CHI')",Providence,eth35.xml,154,12,1,CHI,1799,861,MOT
6,35,2,138,1.224592092,173,35,you,"('CHI', 'MOT')",Providence,eth35.xml,181,8,6,MOT,1176,2852,CHI
3,22,4,152,1.224059563,174,22,that,"('CHI', 'MOT')",Providence,eth35.xml,181,7,3,MOT,1176,2852,CHI
0,4,7,143,1.197283816,147,4,this,"('MOT', 'CHI')",Providence,eth35.xml,154,7,0,CHI,1799,861,MOT
0,11,2,141,1.165751592,152,11,no,"('MOT', 'CHI')",Providence,eth35.xml,154,2,0,CHI,1799,861,MOT
0,3,10,141,1.112405611,144,3,what,"('MOT', 'CHI')",Providence,eth35.xml,154,10,0,CHI,1799,861,MOT
0,11,3,167,1.098612289,178,11,no,"('CHI', 'MOT')",Providence,eth35.xml,181,3,0,MOT,1176,2852,CHI
9,23,13,136,1.027881797,159,23,he,"('CHI', 'MOT')",Providence,eth35.xml,181,22,9,MOT,1176,2852,CHI
0,12,3,166,1.018569581,178,12,like,"('CHI', 'MOT')",Providence,eth35.xml,181,3,0,MOT,1176,2852,CHI
2,2,38,112,1.015920573,114,2,you,"('MOT', 'CHI')",Providence,eth35.xml,154,40,2,CHI,1799,861,MOT
0,16,2,163,0.978989326,179,16,there,"('CHI', 'MOT')",Providence,eth35.xml,181,2,0,MOT,1176,2852,CHI
2,1,2,7,0.916290732,8,1,a,"('MOT', 'TO2')",Providence,eth35.xml,12,4,2,TO2,87,55,MOT
1,4,19,130,0.905321701,134,4,and,"('MOT', 'CHI')",Providence,eth35.xml,154,20,1,CHI,1799,861,MOT
16,36,11,118,0.904855609,154,36,the,"('CHI', 'MOT')",Providence,eth35.xml,181,27,16,MOT,1176,2852,CHI
0,24,1,156,0.886518574,180,24,yeah,"('CHI', 'MOT')",Providence,eth35.xml,181,1,0,MOT,1176,2852,CHI
3,4,35,112,0.858661619,116,4,a,"('MOT', 'CHI')",Providence,eth35.xml,154,38,3,CHI,1799,861,MOT
0,20,2,159,0.767680232,179,20,of,"('CHI', 'MOT')",Providence,eth35.xml,181,2,0,MOT,1176,2852,CHI
9,35,13,124,0.622416689,159,35,a,"('CHI', 'MOT')",Providence,eth35.xml,181,22,9,MOT,1176,2852,CHI
1,7,18,128,0.489164127,135,7,it,"('MOT', 'CHI')",Providence,eth35.xml,154,19,1,CHI,1799,861,MOT
0,3,19,132,0.489164127,135,3,that,"('MOT', 'CHI')",Providence,eth35.xml,154,19,0,CHI,1799,861,MOT
6,33,13,129,0.474893615,162,33,and,"('CHI', 'MOT')",Providence,eth35.xml,181,19,6,MOT,1176,2852,CHI
0,4,16,134,0.441832752,138,4,is,"('MOT', 'CHI')",Providence,eth35.xml,154,16,0,CHI,1799,861,MOT
1,6,25,122,0.282566972,128,6,the,"('MOT', 'CHI')",Providence,eth35.xml,154,26,1,CHI,1799,861,MOT
0,6,15,133,0.169636397,139,6,one,"('MOT', 'CHI')",Providence,eth35.xml,154,15,0,CHI,1799,861,MOT
0,3,1,8,0.080042708,11,3,to,"('MOT', 'TO2')",Providence,eth35.xml,12,1,0,TO2,87,55,MOT
1,1,1,1,0,2,1,the,"('TO2', 'CHI')",Providence,eth35.xml,4,2,1,CHI,44,32,TO2
0,3,1,6,-0.087011377,9,3,it,"('MOT', 'TO1')",Providence,eth35.xml,10,1,0,TO1,84,58,MOT
1,0,11,299,3.761200116,299,0,get,"('MOT', 'CHI')",Providence,eth36.xml,311,12,1,CHI,4578,1777,MOT
1,1,6,303,3.526360525,304,1,where,"('MOT', 'CHI')",Providence,eth36.xml,311,7,1,CHI,4578,1777,MOT
0,2,2,307,3.254886262,309,2,she,"('MOT', 'CHI')",Providence,eth36.xml,311,2,0,CHI,4578,1777,MOT
0,1,4,306,3.248434627,307,1,but,"('MOT', 'CHI')",Providence,eth36.xml,311,4,0,CHI,4578,1777,MOT
0,1,5,305,3.091042453,306,1,my,"('MOT', 'CHI')",Providence,eth36.xml,311,5,0,CHI,4578,1777,MOT
0,1,5,305,3.091042453,306,1,not,"('MOT', 'CHI')",Providence,eth36.xml,311,5,0,CHI,4578,1777,MOT
1,2,11,297,2.662587827,299,2,with,"('MOT', 'CHI')",Providence,eth36.xml,311,12,1,CHI,4578,1777,MOT
0,1,9,301,2.625985248,302,1,at,"('MOT', 'CHI')",Providence,eth36.xml,311,9,0,CHI,4578,1777,MOT
0,2,6,303,2.548793917,305,2,did,"('MOT', 'CHI')",Providence,eth36.xml,311,6,0,CHI,4578,1777,MOT
1,1,20,289,2.541259586,290,1,on,"('MOT', 'CHI')",Providence,eth36.xml,311,21,1,CHI,4578,1777,MOT
1,4,7,299,2.501435952,303,4,no,"('MOT', 'CHI')",Providence,eth36.xml,311,8,1,CHI,4578,1777,MOT
3,4,15,289,2.468099531,293,4,they,"('MOT', 'CHI')",Providence,eth36.xml,311,18,3,CHI,4578,1777,MOT
1,2,16,292,2.340455367,294,2,are,"('MOT', 'CHI')",Providence,eth36.xml,311,17,1,CHI,4578,1777,MOT
1,4,11,295,2.151762203,299,4,put,"('MOT', 'CHI')",Providence,eth36.xml,311,12,1,CHI,4578,1777,MOT
1,3,15,292,2.1102132,295,3,go,"('MOT', 'CHI')",Providence,eth36.xml,311,16,1,CHI,4578,1777,MOT
1,3,16,291,2.052773295,294,3,wanna,"('MOT', 'CHI')",Providence,eth36.xml,311,17,1,CHI,4578,1777,MOT
1,6,9,295,1.976063187,301,6,want,"('MOT', 'CHI')",Providence,eth36.xml,311,10,1,CHI,4578,1777,MOT
0,2,12,297,1.969440646,299,2,all,"('MOT', 'CHI')",Providence,eth36.xml,311,12,0,CHI,4578,1777,MOT
7,10,23,271,1.861257264,281,10,like,"('MOT', 'CHI')",Providence,eth36.xml,311,30,7,CHI,4578,1777,MOT
3,4,35,269,1.704748092,273,4,see,"('MOT', 'CHI')",Providence,eth36.xml,311,38,3,CHI,4578,1777,MOT
3,7,22,279,1.673976434,286,7,one,"('MOT', 'CHI')",Providence,eth36.xml,311,25,3,CHI,4578,1777,MOT
0,2,17,292,1.647308186,294,2,some,"('MOT', 'CHI')",Providence,eth36.xml,311,17,0,CHI,4578,1777,MOT
2,10,13,286,1.564597158,296,10,make,"('MOT', 'CHI')",Providence,eth36.xml,311,15,2,CHI,4578,1777,MOT
0,2,20,289,1.490517867,291,2,for,"('MOT', 'CHI')",Providence,eth36.xml,311,20,0,CHI,4578,1777,MOT
1,9,11,290,1.458615023,299,9,oh,"('MOT', 'CHI')",Providence,eth36.xml,311,12,1,CHI,4578,1777,MOT
3,7,28,273,1.452252329,280,7,what,"('MOT', 'CHI')",Providence,eth36.xml,311,31,3,CHI,4578,1777,MOT
0,2,21,288,1.442647298,290,2,little,"('MOT', 'CHI')",Providence,eth36.xml,311,21,0,CHI,4578,1777,MOT
1,4,26,280,1.372405249,284,4,do,"('MOT', 'CHI')",Providence,eth36.xml,311,27,1,CHI,4578,1777,MOT
0,3,18,290,1.304948722,293,3,gonna,"('MOT', 'CHI')",Providence,eth36.xml,311,18,0,CHI,4578,1777,MOT
0,4,15,292,1.25444223,296,4,up,"('MOT', 'CHI')",Providence,eth36.xml,311,15,0,CHI,4578,1777,MOT
6,12,35,258,1.225562742,270,12,he,"('MOT', 'CHI')",Providence,eth36.xml,311,41,6,CHI,4578,1777,MOT
10,15,44,242,1.156782922,257,15,it,"('MOT', 'CHI')",Providence,eth36.xml,311,54,10,CHI,4578,1777,MOT
0,3,23,285,1.064710737,288,3,yeah,"('MOT', 'CHI')",Providence,eth36.xml,311,23,0,CHI,4578,1777,MOT
1,10,17,283,0.986494991,293,10,look,"('MOT', 'CHI')",Providence,eth36.xml,311,18,1,CHI,4578,1777,MOT
0,4,20,287,0.979692243,291,4,in,"('MOT', 'CHI')",Providence,eth36.xml,311,20,0,CHI,4578,1777,MOT
0,2,34,275,0.949080555,277,2,can,"('MOT', 'CHI')",Providence,eth36.xml,311,34,0,CHI,4578,1777,MOT
0,2,36,273,0.887819058,275,2,we,"('MOT', 'CHI')",Providence,eth36.xml,311,36,0,CHI,4578,1777,MOT
0,3,28,280,0.864997437,283,3,of,"('MOT', 'CHI')",Providence,eth36.xml,311,28,0,CHI,4578,1777,MOT
3,23,17,268,0.797370686,291,23,this,"('MOT', 'CHI')",Providence,eth36.xml,311,20,3,CHI,4578,1777,MOT
1,6,33,271,0.794929875,277,6,to,"('MOT', 'CHI')",Providence,eth36.xml,311,34,1,CHI,4578,1777,MOT
0,7,15,289,0.784438601,296,7,was,"('MOT', 'CHI')",Providence,eth36.xml,311,15,0,CHI,4578,1777,MOT
3,13,37,258,0.619039208,271,13,is,"('MOT', 'CHI')",Providence,eth36.xml,311,40,3,CHI,4578,1777,MOT
9,12,82,208,0.607713624,220,12,you,"('MOT', 'CHI')",Providence,eth36.xml,311,91,9,CHI,4578,1777,MOT
12,16,79,204,0.601813902,220,16,a,"('MOT', 'CHI')",Providence,eth36.xml,311,91,12,CHI,4578,1777,MOT
0,4,30,277,0.570273082,281,4,there,"('MOT', 'CHI')",Providence,eth36.xml,311,30,0,CHI,4578,1777,MOT
6,21,42,242,0.522574516,263,21,that,"('MOT', 'CHI')",Providence,eth36.xml,311,48,6,CHI,4578,1777,MOT
8,16,92,195,0.100330586,211,16,the,"('MOT', 'CHI')",Providence,eth36.xml,311,100,8,CHI,4578,1777,MOT
0,14,22,275,-0.212780764,289,14,and,"('MOT', 'CHI')",Providence,eth36.xml,311,22,0,CHI,4578,1777,MOT
1,3,0,191,3.48635519,194,3,but,"('CHI', 'MOT')",Providence,eth37.xml,195,1,1,MOT,1099,2488,CHI
1,4,0,190,3.263211639,194,4,get,"('CHI', 'MOT')",Providence,eth37.xml,195,1,1,MOT,1099,2488,CHI
1,2,2,190,3.252955139,192,2,where,"('CHI', 'MOT')",Providence,eth37.xml,195,3,1,MOT,1099,2488,CHI
0,1,1,137,3.149882953,138,1,big,"('MOT', 'CHI')",Providence,eth37.xml,139,1,0,CHI,2329,798,MOT
1,5,0,189,3.080890082,194,5,gonna,"('CHI', 'MOT')",Providence,eth37.xml,195,1,1,MOT,1099,2488,CHI
1,5,0,189,3.080890082,194,5,look,"('CHI', 'MOT')",Providence,eth37.xml,195,1,1,MOT,1099,2488,CHI
1,4,1,189,2.970414466,193,4,with,"('CHI', 'MOT')",Providence,eth37.xml,195,2,1,MOT,1099,2488,CHI
1,0,11,127,2.913902255,127,0,like,"('MOT', 'CHI')",Providence,eth37.xml,139,12,1,CHI,2329,798,MOT
1,5,1,188,2.788092909,193,5,not,"('CHI', 'MOT')",Providence,eth37.xml,195,2,1,MOT,1099,2488,CHI
3,7,1,184,2.777783539,191,7,have,"('CHI', 'MOT')",Providence,eth37.xml,195,4,3,MOT,1099,2488,CHI
1,1,6,131,2.700615223,132,1,this,"('MOT', 'CHI')",Providence,eth37.xml,139,7,1,CHI,2329,798,MOT
1,0,14,124,2.696215743,124,0,to,"('MOT', 'CHI')",Providence,eth37.xml,139,15,1,CHI,2329,798,MOT
1,0,15,123,2.63108916,123,0,my,"('MOT', 'CHI')",Providence,eth37.xml,139,16,1,CHI,2329,798,MOT
0,1,3,135,2.624668592,136,1,make,"('MOT', 'CHI')",Providence,eth37.xml,139,3,0,CHI,2329,798,MOT
0,1,3,135,2.624668592,136,1,are,"('MOT', 'CHI')",Providence,eth37.xml,139,3,0,CHI,2329,798,MOT
2,10,0,183,2.587422213,193,10,see,"('CHI', 'MOT')",Providence,eth37.xml,195,2,2,MOT,1099,2488,CHI
0,4,1,190,2.570064458,194,4,was,"('CHI', 'MOT')",Providence,eth37.xml,195,1,0,MOT,1099,2488,CHI
1,9,0,185,2.570064458,194,9,make,"('CHI', 'MOT')",Providence,eth37.xml,195,1,1,MOT,1099,2488,CHI
3,11,0,181,2.559807958,192,11,all,"('CHI', 'MOT')",Providence,eth37.xml,195,3,3,MOT,1099,2488,CHI
1,5,2,187,2.559807958,192,5,some,"('CHI', 'MOT')",Providence,eth37.xml,195,3,1,MOT,1099,2488,CHI
2,2,8,127,2.390290673,129,2,with,"('MOT', 'CHI')",Providence,eth37.xml,139,10,2,CHI,2329,798,MOT
0,5,1,189,2.387742901,194,5,this,"('CHI', 'MOT')",Providence,eth37.xml,195,1,0,MOT,1099,2488,CHI
0,5,1,189,2.387742901,194,5,did,"('CHI', 'MOT')",Providence,eth37.xml,195,1,0,MOT,1099,2488,CHI
2,2,9,126,2.302585093,128,2,do,"('MOT', 'CHI')",Providence,eth37.xml,139,11,2,CHI,2329,798,MOT
1,1,10,127,2.302585093,128,1,see,"('MOT', 'CHI')",Providence,eth37.xml,139,11,1,CHI,2329,798,MOT
1,9,1,184,2.277267285,193,9,what,"('CHI', 'MOT')",Providence,eth37.xml,195,2,1,MOT,1099,2488,CHI
0,1,5,133,2.273597556,134,1,up,"('MOT', 'CHI')",Providence,eth37.xml,139,5,0,CHI,2329,798,MOT
0,1,5,133,2.273597556,134,1,all,"('MOT', 'CHI')",Providence,eth37.xml,139,5,0,CHI,2329,798,MOT
2,9,2,182,2.266957915,191,9,one,"('CHI', 'MOT')",Providence,eth37.xml,195,4,2,MOT,1099,2488,CHI
0,6,1,188,2.233592222,194,6,think,"('CHI', 'MOT')",Providence,eth37.xml,195,1,0,MOT,1099,2488,CHI
0,2,3,134,2.219203484,136,2,for,"('MOT', 'CHI')",Providence,eth37.xml,139,3,0,CHI,2329,798,MOT
2,13,1,179,2.117975206,192,13,in,"('CHI', 'MOT')",Providence,eth37.xml,195,3,2,MOT,1099,2488,CHI
3,18,0,174,2.100275629,192,18,we,"('CHI', 'MOT')",Providence,eth37.xml,195,3,3,MOT,1099,2488,CHI
1,15,0,179,2.100060829,194,15,they,"('CHI', 'MOT')",Providence,eth37.xml,195,1,1,MOT,1099,2488,CHI
1,6,4,184,2.058822254,190,6,want,"('CHI', 'MOT')",Providence,eth37.xml,195,5,1,MOT,1099,2488,CHI
0,2,4,133,2.029609168,135,2,they,"('MOT', 'CHI')",Providence,eth37.xml,139,4,0,CHI,2329,798,MOT
0,8,1,186,1.982277793,194,8,are,"('CHI', 'MOT')",Providence,eth37.xml,195,1,0,MOT,1099,2488,CHI
3,11,4,177,1.951187206,188,11,up,"('CHI', 'MOT')",Providence,eth37.xml,195,7,3,MOT,1099,2488,CHI
2,2,14,121,1.937941979,123,2,of,"('MOT', 'CHI')",Providence,eth37.xml,139,16,2,CHI,2329,798,MOT
2,13,2,178,1.930485679,191,13,wanna,"('CHI', 'MOT')",Providence,eth37.xml,195,4,2,MOT,1099,2488,CHI
1,11,2,181,1.866660777,192,11,no,"('CHI', 'MOT')",Providence,eth37.xml,195,3,1,MOT,1099,2488,CHI
2,3,11,123,1.85629799,126,3,want,"('MOT', 'CHI')",Providence,eth37.xml,139,13,2,CHI,2329,798,MOT
0,7,2,186,1.807263656,193,7,put,"('CHI', 'MOT')",Providence,eth37.xml,195,2,0,MOT,1099,2488,CHI
0,1,9,129,1.791759469,130,1,at,"('MOT', 'CHI')",Providence,eth37.xml,139,9,0,CHI,2329,798,MOT
4,12,6,173,1.790690522,185,12,is,"('CHI', 'MOT')",Providence,eth37.xml,195,10,4,MOT,1099,2488,CHI
0,10,1,184,1.781607098,194,10,like,"('CHI', 'MOT')",Providence,eth37.xml,195,1,0,MOT,1099,2488,CHI
0,3,4,132,1.741927095,135,3,some,"('MOT', 'CHI')",Providence,eth37.xml,139,4,0,CHI,2329,798,MOT
0,1,10,128,1.697143493,129,1,wanna,"('MOT', 'CHI')",Providence,eth37.xml,139,10,0,CHI,2329,798,MOT
1,3,9,126,1.697143493,129,3,put,"('MOT', 'CHI')",Providence,eth37.xml,139,10,1,CHI,2329,798,MOT
1,11,3,180,1.67917125,191,11,can,"('CHI', 'MOT')",Providence,eth37.xml,195,4,1,MOT,1099,2488,CHI
4,20,3,168,1.61471497,188,20,there,"('CHI', 'MOT')",Providence,eth37.xml,195,7,4,MOT,1099,2488,CHI
1,1,21,116,1.601069663,117,1,in,"('MOT', 'CHI')",Providence,eth37.xml,139,22,1,CHI,2329,798,MOT
3,5,12,119,1.597603455,124,5,what,"('MOT', 'CHI')",Providence,eth37.xml,139,15,3,CHI,2329,798,MOT
5,20,4,166,1.585783722,186,20,go,"('CHI', 'MOT')",Providence,eth37.xml,195,9,5,MOT,1099,2488,CHI
0,3,5,131,1.580450376,134,3,oh,"('MOT', 'CHI')",Providence,eth37.xml,139,5,0,CHI,2329,798,MOT
5,26,2,162,1.545722098,188,26,it,"('CHI', 'MOT')",Providence,eth37.xml,195,7,5,MOT,1099,2488,CHI
5,12,11,167,1.534935385,179,12,he,"('CHI', 'MOT')",Providence,eth37.xml,195,16,5,MOT,1099,2488,CHI
4,13,9,169,1.477266139,182,13,and,"('CHI', 'MOT')",Providence,eth37.xml,195,13,4,MOT,1099,2488,CHI
4,15,8,168,1.418147686,183,15,to,"('CHI', 'MOT')",Providence,eth37.xml,195,12,4,MOT,1099,2488,CHI
11,27,8,149,1.289963252,176,27,a,"('CHI', 'MOT')",Providence,eth37.xml,195,19,11,MOT,1099,2488,CHI
0,2,11,126,1.203972804,128,2,have,"('MOT', 'CHI')",Providence,eth37.xml,139,11,0,CHI,2329,798,MOT
2,7,12,118,1.090769111,125,7,and,"('MOT', 'CHI')",Providence,eth37.xml,139,14,2,CHI,2329,798,MOT
2,5,17,115,1.066351426,120,5,on,"('MOT', 'CHI')",Providence,eth37.xml,139,19,2,CHI,2329,798,MOT
2,7,13,117,1.02223931,124,7,is,"('MOT', 'CHI')",Providence,eth37.xml,139,15,2,CHI,2329,798,MOT
2,5,19,113,0.958850346,118,5,that,"('MOT', 'CHI')",Providence,eth37.xml,139,21,2,CHI,2329,798,MOT
0,14,3,178,0.950370046,192,14,that,"('CHI', 'MOT')",Providence,eth37.xml,195,3,0,MOT,1099,2488,CHI
1,21,4,169,0.91368995,190,21,of,"('CHI', 'MOT')",Providence,eth37.xml,195,5,1,MOT,1099,2488,CHI
3,6,23,107,0.85311183,113,6,it,"('MOT', 'CHI')",Providence,eth37.xml,139,26,3,CHI,2329,798,MOT
1,5,16,117,0.777230298,122,5,one,"('MOT', 'CHI')",Providence,eth37.xml,139,17,1,CHI,2329,798,MOT
6,7,34,92,0.743919506,99,7,a,"('MOT', 'CHI')",Providence,eth37.xml,139,40,6,CHI,2329,798,MOT
7,8,35,89,0.693147181,97,8,the,"('MOT', 'CHI')",Providence,eth37.xml,139,42,7,CHI,2329,798,MOT
7,54,5,129,0.653406852,183,54,you,"('CHI', 'MOT')",Providence,eth37.xml,195,12,7,MOT,1099,2488,CHI
9,46,11,129,0.53754477,175,46,the,"('CHI', 'MOT')",Providence,eth37.xml,195,20,9,MOT,1099,2488,CHI
0,4,13,122,0.53454215,126,4,yeah,"('MOT', 'CHI')",Providence,eth37.xml,139,13,0,CHI,2329,798,MOT
1,15,7,116,0.508322494,131,15,no,"('MOT', 'CHI')",Providence,eth37.xml,139,8,1,CHI,2329,798,MOT
4,6,37,92,0.507497834,98,6,you,"('MOT', 'CHI')",Providence,eth37.xml,139,41,4,CHI,2329,798,MOT
1,6,18,114,0.506735639,120,6,we,"('MOT', 'CHI')",Providence,eth37.xml,139,19,1,CHI,2329,798,MOT
0,5,13,121,0.352220594,126,5,there,"('MOT', 'CHI')",Providence,eth37.xml,139,13,0,CHI,2329,798,MOT
1,8,20,110,0.14792013,118,8,he,"('MOT', 'CHI')",Providence,eth37.xml,139,21,1,CHI,2329,798,MOT
1,1,5,343,3.766997233,344,1,not,"('MOT', 'CHI')",Providence,eth38.xml,350,6,1,CHI,5289,1921,MOT
2,1,11,336,3.523415014,337,1,my,"('MOT', 'CHI')",Providence,eth38.xml,350,13,2,CHI,5289,1921,MOT
0,1,6,343,3.073850053,344,1,big,"('MOT', 'CHI')",Providence,eth38.xml,350,6,0,CHI,5289,1921,MOT
1,0,29,320,3.001962823,320,0,do,"('MOT', 'CHI')",Providence,eth38.xml,350,30,1,CHI,5289,1921,MOT
1,1,14,334,2.986869586,335,1,some,"('MOT', 'CHI')",Providence,eth38.xml,350,15,1,CHI,5289,1921,MOT
3,4,9,334,2.966744737,338,4,make,"('MOT', 'CHI')",Providence,eth38.xml,350,12,3,CHI,5289,1921,MOT
1,1,19,329,2.714092516,330,1,see,"('MOT', 'CHI')",Providence,eth38.xml,350,20,1,CHI,5289,1921,MOT
0,1,11,338,2.573785939,339,1,did,"('MOT', 'CHI')",Providence,eth38.xml,350,11,0,CHI,5289,1921,MOT
1,2,15,332,2.521274294,334,2,with,"('MOT', 'CHI')",Providence,eth38.xml,350,16,1,CHI,5289,1921,MOT
0,3,6,341,2.380702872,344,3,look,"('MOT', 'CHI')",Providence,eth38.xml,350,6,0,CHI,5289,1921,MOT
3,3,25,319,2.379546134,322,3,can,"('MOT', 'CHI')",Providence,eth38.xml,350,28,3,CHI,5289,1921,MOT
0,2,9,339,2.341222886,341,2,but,"('MOT', 'CHI')",Providence,eth38.xml,350,9,0,CHI,5289,1921,MOT
1,3,14,332,2.293722406,335,3,get,"('MOT', 'CHI')",Providence,eth38.xml,350,15,1,CHI,5289,1921,MOT
0,1,15,334,2.293722406,335,1,for,"('MOT', 'CHI')",Providence,eth38.xml,350,15,0,CHI,5289,1921,MOT
2,3,22,323,2.247234998,326,3,up,"('MOT', 'CHI')",Providence,eth38.xml,350,24,2,CHI,5289,1921,MOT
1,3,15,331,2.233592222,334,3,put,"('MOT', 'CHI')",Providence,eth38.xml,350,16,1,CHI,5289,1921,MOT
0,2,11,337,2.168320831,339,2,at,"('MOT', 'CHI')",Providence,eth38.xml,350,11,0,CHI,5289,1921,MOT
0,1,19,330,2.070472872,331,1,of,"('MOT', 'CHI')",Providence,eth38.xml,350,19,0,CHI,5289,1921,MOT
0,4,7,339,2.036881927,343,4,where,"('MOT', 'CHI')",Providence,eth38.xml,350,7,0,CHI,5289,1921,MOT
1,2,27,320,1.974081026,322,2,one,"('MOT', 'CHI')",Providence,eth38.xml,350,28,1,CHI,5289,1921,MOT
0,2,14,334,1.951844885,336,2,like,"('MOT', 'CHI')",Providence,eth38.xml,350,14,0,CHI,5289,1921,MOT
1,2,28,319,1.938200011,321,2,are,"('MOT', 'CHI')",Providence,eth38.xml,350,29,1,CHI,5289,1921,MOT
3,5,26,316,1.938200011,321,5,in,"('MOT', 'CHI')",Providence,eth38.xml,350,29,3,CHI,5289,1921,MOT
0,2,15,333,1.888257298,335,2,all,"('MOT', 'CHI')",Providence,eth38.xml,350,15,0,CHI,5289,1921,MOT
2,3,34,311,1.830473981,314,3,we,"('MOT', 'CHI')",Providence,eth38.xml,350,36,2,CHI,5289,1921,MOT
4,5,37,304,1.79627124,309,5,what,"('MOT', 'CHI')",Providence,eth38.xml,350,41,4,CHI,5289,1921,MOT
0,1,26,323,1.761545691,324,1,wanna,"('MOT', 'CHI')",Providence,eth38.xml,350,26,0,CHI,5289,1921,MOT
0,2,18,330,1.716796431,332,2,they,"('MOT', 'CHI')",Providence,eth38.xml,350,18,0,CHI,5289,1921,MOT
0,2,19,329,1.665007764,331,2,want,"('MOT', 'CHI')",Providence,eth38.xml,350,19,0,CHI,5289,1921,MOT
6,8,43,293,1.530592745,301,8,it,"('MOT', 'CHI')",Providence,eth38.xml,350,49,6,CHI,5289,1921,MOT
1,8,14,327,1.48279219,335,8,no,"('MOT', 'CHI')",Providence,eth38.xml,350,15,1,CHI,5289,1921,MOT
0,2,23,325,1.478569637,327,2,yeah,"('MOT', 'CHI')",Providence,eth38.xml,350,23,0,CHI,5289,1921,MOT
3,4,53,290,1.406772892,294,4,to,"('MOT', 'CHI')",Providence,eth38.xml,350,56,3,CHI,5289,1921,MOT
0,2,25,323,1.395511016,325,2,have,"('MOT', 'CHI')",Providence,eth38.xml,350,25,0,CHI,5289,1921,MOT
1,6,21,322,1.368275856,328,6,oh,"('MOT', 'CHI')",Providence,eth38.xml,350,22,1,CHI,5289,1921,MOT
0,3,21,326,1.280329798,329,3,gonna,"('MOT', 'CHI')",Providence,eth38.xml,350,21,0,CHI,5289,1921,MOT
1,5,28,316,1.24505283,321,5,that,"('MOT', 'CHI')",Providence,eth38.xml,350,29,1,CHI,5289,1921,MOT
0,5,16,329,1.134979933,334,5,was,"('MOT', 'CHI')",Providence,eth38.xml,350,16,0,CHI,5289,1921,MOT
1,6,27,316,1.126783166,322,6,on,"('MOT', 'CHI')",Providence,eth38.xml,350,28,1,CHI,5289,1921,MOT
1,6,30,313,1.022170593,319,6,go,"('MOT', 'CHI')",Providence,eth38.xml,350,31,1,CHI,5289,1921,MOT
4,15,30,301,1.015381635,316,15,he,"('MOT', 'CHI')",Providence,eth38.xml,350,34,4,CHI,5289,1921,MOT
4,13,35,298,1.003011707,311,13,is,"('MOT', 'CHI')",Providence,eth38.xml,350,39,4,CHI,5289,1921,MOT
3,14,29,304,0.920204631,318,14,and,"('MOT', 'CHI')",Providence,eth38.xml,350,32,3,CHI,5289,1921,MOT
24,22,82,222,0.906581918,244,22,the,"('MOT', 'CHI')",Providence,eth38.xml,350,106,24,CHI,5289,1921,MOT
1,10,24,315,0.789375213,325,10,this,"('MOT', 'CHI')",Providence,eth38.xml,350,25,1,CHI,5289,1921,MOT
9,14,72,255,0.777813105,269,14,a,"('MOT', 'CHI')",Providence,eth38.xml,350,81,9,CHI,5289,1921,MOT
0,6,33,311,0.263932892,317,6,there,"('MOT', 'CHI')",Providence,eth38.xml,350,33,0,CHI,5289,1921,MOT
4,9,97,240,0.19757677,249,9,you,"('MOT', 'CHI')",Providence,eth38.xml,350,101,4,CHI,5289,1921,MOT
2,0,17,220,3.456767233,220,0,see,"('MOT', 'CHI')",Providence,eth39.xml,239,19,2,CHI,5654,1235,MOT
1,1,7,230,3.148453361,231,1,she,"('MOT', 'CHI')",Providence,eth39.xml,239,8,1,CHI,5654,1235,MOT
1,0,17,221,3.104586678,221,0,up,"('MOT', 'CHI')",Providence,eth39.xml,239,18,1,CHI,5654,1235,MOT
0,1,9,229,2.355694918,230,1,where,"('MOT', 'CHI')",Providence,eth39.xml,239,9,0,CHI,5654,1235,MOT
1,2,12,224,2.31583032,226,2,no,"('MOT', 'CHI')",Providence,eth39.xml,239,13,1,CHI,5654,1235,MOT
2,2,18,217,2.307120248,219,2,one,"('MOT', 'CHI')",Providence,eth39.xml,239,20,2,CHI,5654,1235,MOT
0,1,11,227,2.179982771,228,1,go,"('MOT', 'CHI')",Providence,eth39.xml,239,11,0,CHI,5654,1235,MOT
0,1,13,225,2.028148247,226,1,they,"('MOT', 'CHI')",Providence,eth39.xml,239,13,0,CHI,5654,1235,MOT
0,1,13,225,2.028148247,226,1,all,"('MOT', 'CHI')",Providence,eth39.xml,239,13,0,CHI,5654,1235,MOT
0,1,15,223,1.894174475,224,1,some,"('MOT', 'CHI')",Providence,eth39.xml,239,15,0,CHI,5654,1235,MOT
0,2,10,227,1.858898772,229,2,not,"('MOT', 'CHI')",Providence,eth39.xml,239,10,0,CHI,5654,1235,MOT
3,4,24,208,1.775536634,212,4,this,"('MOT', 'CHI')",Providence,eth39.xml,239,27,3,CHI,5654,1235,MOT
1,1,34,203,1.716958256,204,1,do,"('MOT', 'CHI')",Providence,eth39.xml,239,35,1,CHI,5654,1235,MOT
0,2,12,225,1.696052385,227,2,have,"('MOT', 'CHI')",Providence,eth39.xml,239,12,0,CHI,5654,1235,MOT
0,1,19,219,1.665007764,220,1,on,"('MOT', 'CHI')",Providence,eth39.xml,239,19,0,CHI,5654,1235,MOT
12,9,34,184,1.664162812,193,9,he,"('MOT', 'CHI')",Providence,eth39.xml,239,46,12,CHI,5654,1235,MOT
1,5,12,221,1.622683139,226,5,make,"('MOT', 'CHI')",Providence,eth39.xml,239,13,1,CHI,5654,1235,MOT
1,5,14,219,1.488709367,224,5,want,"('MOT', 'CHI')",Providence,eth39.xml,239,15,1,CHI,5654,1235,MOT
0,1,23,215,1.472472057,216,1,wanna,"('MOT', 'CHI')",Providence,eth39.xml,239,23,0,CHI,5654,1235,MOT
3,5,28,203,1.445134861,208,5,in,"('MOT', 'CHI')",Providence,eth39.xml,239,31,3,CHI,5654,1235,MOT
1,3,23,212,1.428653635,215,3,for,"('MOT', 'CHI')",Providence,eth39.xml,239,24,1,CHI,5654,1235,MOT
0,1,26,212,1.345286337,213,1,we,"('MOT', 'CHI')",Providence,eth39.xml,239,26,0,CHI,5654,1235,MOT
0,3,13,223,1.335001067,226,3,with,"('MOT', 'CHI')",Providence,eth39.xml,239,13,0,CHI,5654,1235,MOT
0,3,14,222,1.266066934,225,3,are,"('MOT', 'CHI')",Providence,eth39.xml,239,14,0,CHI,5654,1235,MOT
0,2,19,218,1.259542655,220,2,yeah,"('MOT', 'CHI')",Providence,eth39.xml,239,19,0,CHI,5654,1235,MOT
7,4,69,159,1.219240276,163,4,you,"('MOT', 'CHI')",Providence,eth39.xml,239,76,7,CHI,5654,1235,MOT
0,2,20,217,1.208507959,219,2,oh,"('MOT', 'CHI')",Providence,eth39.xml,239,20,0,CHI,5654,1235,MOT
0,6,8,225,1.202543212,231,6,but,"('MOT', 'CHI')",Providence,eth39.xml,239,8,0,CHI,5654,1235,MOT
0,3,17,219,1.080912712,222,3,there,"('MOT', 'CHI')",Providence,eth39.xml,239,17,0,CHI,5654,1235,MOT
5,10,33,191,1.018190721,201,10,and,"('MOT', 'CHI')",Providence,eth39.xml,239,38,5,CHI,5654,1235,MOT
1,4,28,206,1.006308338,210,4,can,"('MOT', 'CHI')",Providence,eth39.xml,239,29,1,CHI,5654,1235,MOT
4,7,42,186,0.931794918,193,7,to,"('MOT', 'CHI')",Providence,eth39.xml,239,46,4,CHI,5654,1235,MOT
1,7,22,209,0.779324877,216,7,was,"('MOT', 'CHI')",Providence,eth39.xml,239,23,1,CHI,5654,1235,MOT
0,3,25,211,0.693147181,214,3,of,"('MOT', 'CHI')",Providence,eth39.xml,239,25,0,CHI,5654,1235,MOT
6,11,53,169,0.554136322,180,11,a,"('MOT', 'CHI')",Providence,eth39.xml,239,59,6,CHI,5654,1235,MOT
9,14,58,158,0.519483687,172,14,the,"('MOT', 'CHI')",Providence,eth39.xml,239,67,9,CHI,5654,1235,MOT
1,6,38,194,0.341932662,200,6,is,"('MOT', 'CHI')",Providence,eth39.xml,239,39,1,CHI,5654,1235,MOT
1,11,27,200,0.168335315,211,11,that,"('MOT', 'CHI')",Providence,eth39.xml,239,28,1,CHI,5654,1235,MOT
2,8,58,171,-0.027249642,179,8,it,"('MOT', 'CHI')",Providence,eth39.xml,239,60,2,CHI,5654,1235,MOT
0,6,30,203,-0.059787918,209,6,what,"('MOT', 'CHI')",Providence,eth39.xml,239,30,0,CHI,5654,1235,MOT
1,2,2,380,3.935739532,382,2,at,"('MOT', 'CHI')",Providence,eth40.xml,385,3,1,CHI,4031,2102,MOT
0,1,3,381,3.64805746,382,1,she,"('MOT', 'CHI')",Providence,eth40.xml,385,3,0,CHI,4031,2102,MOT
2,3,4,376,3.575675761,379,3,big,"('MOT', 'CHI')",Providence,eth40.xml,385,6,2,CHI,4031,2102,MOT
0,2,2,381,3.468336684,383,2,look,"('MOT', 'CHI')",Providence,eth40.xml,385,2,0,CHI,4031,2102,MOT
0,1,5,379,3.306363279,380,1,my,"('MOT', 'CHI')",Providence,eth40.xml,385,5,0,CHI,4031,2102,MOT
0,1,6,378,3.170210653,379,1,but,"('MOT', 'CHI')",Providence,eth40.xml,385,6,0,CHI,4031,2102,MOT
2,1,22,360,3.041771404,361,1,yeah,"('MOT', 'CHI')",Providence,eth40.xml,385,24,2,CHI,4031,2102,MOT
2,1,24,358,2.962138556,359,1,of,"('MOT', 'CHI')",Providence,eth40.xml,385,26,2,CHI,4031,2102,MOT
0,1,8,376,2.941803932,377,1,not,"('MOT', 'CHI')",Providence,eth40.xml,385,8,0,CHI,4031,2102,MOT
2,5,6,372,2.941803932,377,5,all,"('MOT', 'CHI')",Providence,eth40.xml,385,8,2,CHI,4031,2102,MOT
1,2,11,371,2.882403588,373,2,they,"('MOT', 'CHI')",Providence,eth40.xml,385,12,1,CHI,4031,2102,MOT
0,1,11,373,2.671492605,374,1,see,"('MOT', 'CHI')",Providence,eth40.xml,385,11,0,CHI,4031,2102,MOT
0,1,13,371,2.523058416,372,1,get,"('MOT', 'CHI')",Providence,eth40.xml,385,13,0,CHI,4031,2102,MOT
1,7,5,372,2.477063472,379,7,put,"('MOT', 'CHI')",Providence,eth40.xml,385,6,1,CHI,4031,2102,MOT
3,5,16,361,2.458095392,366,5,up,"('MOT', 'CHI')",Providence,eth40.xml,385,19,3,CHI,4031,2102,MOT
1,1,28,355,2.446545782,356,1,that,"('MOT', 'CHI')",Providence,eth40.xml,385,29,1,CHI,4031,2102,MOT
1,2,19,363,2.408854287,365,2,one,"('MOT', 'CHI')",Providence,eth40.xml,385,20,1,CHI,4031,2102,MOT
0,1,15,369,2.39253333,370,1,did,"('MOT', 'CHI')",Providence,eth40.xml,385,15,0,CHI,4031,2102,MOT
0,1,15,369,2.39253333,370,1,he,"('MOT', 'CHI')",Providence,eth40.xml,385,15,0,CHI,4031,2102,MOT
0,4,5,376,2.390072547,380,4,for,"('MOT', 'CHI')",Providence,eth40.xml,385,5,0,CHI,4031,2102,MOT
1,6,7,371,2.382188144,377,6,no,"('MOT', 'CHI')",Providence,eth40.xml,385,8,1,CHI,4031,2102,MOT
1,1,30,353,2.378423169,354,1,we,"('MOT', 'CHI')",Providence,eth40.xml,385,31,1,CHI,4031,2102,MOT
2,4,17,362,2.352734877,366,4,like,"('MOT', 'CHI')",Providence,eth40.xml,385,19,2,CHI,4031,2102,MOT
0,1,17,367,2.275916846,368,1,oh,"('MOT', 'CHI')",Providence,eth40.xml,385,17,0,CHI,4031,2102,MOT
1,3,16,365,2.275916846,368,3,there,"('MOT', 'CHI')",Providence,eth40.xml,385,17,1,CHI,4031,2102,MOT
3,3,32,347,2.252713263,350,3,is,"('MOT', 'CHI')",Providence,eth40.xml,385,35,3,CHI,4031,2102,MOT
0,3,8,374,2.248656751,377,3,was,"('MOT', 'CHI')",Providence,eth40.xml,385,8,0,CHI,4031,2102,MOT
0,1,18,366,2.22191719,367,1,are,"('MOT', 'CHI')",Providence,eth40.xml,385,18,0,CHI,4031,2102,MOT
1,6,9,369,2.194575569,375,6,on,"('MOT', 'CHI')",Providence,eth40.xml,385,10,1,CHI,4031,2102,MOT
1,3,18,363,2.17041332,366,3,go,"('MOT', 'CHI')",Providence,eth40.xml,385,19,1,CHI,4031,2102,MOT
1,2,26,356,2.113343093,358,2,this,"('MOT', 'CHI')",Providence,eth40.xml,385,27,1,CHI,4031,2102,MOT
14,14,31,326,1.984663135,340,14,and,"('MOT', 'CHI')",Providence,eth40.xml,385,45,14,CHI,4031,2102,MOT
0,2,19,364,1.764948212,366,2,do,"('MOT', 'CHI')",Providence,eth40.xml,385,19,0,CHI,4031,2102,MOT
3,6,30,346,1.754333064,352,6,in,"('MOT', 'CHI')",Providence,eth40.xml,385,33,3,CHI,4031,2102,MOT
0,2,20,363,1.715707106,365,2,what,"('MOT', 'CHI')",Providence,eth40.xml,385,20,0,CHI,4031,2102,MOT
4,9,27,345,1.685275989,354,9,make,"('MOT', 'CHI')",Providence,eth40.xml,385,31,4,CHI,4031,2102,MOT
0,3,20,362,1.428025034,365,3,can,"('MOT', 'CHI')",Providence,eth40.xml,385,20,0,CHI,4031,2102,MOT
12,15,53,305,1.362219561,320,15,a,"('MOT', 'CHI')",Providence,eth40.xml,385,65,12,CHI,4031,2102,MOT
20,20,71,274,1.157759961,294,20,the,"('MOT', 'CHI')",Providence,eth40.xml,385,91,20,CHI,4031,2102,MOT
16,25,60,284,0.958200892,309,25,it,"('MOT', 'CHI')",Providence,eth40.xml,385,76,16,CHI,4031,2102,MOT
0,1,1,12,0.916290732,13,1,to,"('CHI', 'MOT')",Providence,eth40.xml,14,1,0,MOT,55,78,CHI
0,4,32,349,0.736319352,353,4,to,"('MOT', 'CHI')",Providence,eth40.xml,385,32,0,CHI,4031,2102,MOT
6,9,100,270,0.599548498,279,9,you,"('MOT', 'CHI')",Providence,eth40.xml,385,106,6,CHI,4031,2102,MOT
1,5,0,8,0.510825624,13,5,the,"('CHI', 'MOT')",Providence,eth40.xml,14,1,1,MOT,55,78,CHI
1,0,7,260,3.958906591,260,0,they,"('MOT', 'CHI')",Providence,eth41.xml,268,8,1,CHI,4490,1412,MOT
2,1,15,250,2.994415618,251,1,see,"('MOT', 'CHI')",Providence,eth41.xml,268,17,2,CHI,4490,1412,MOT
1,2,6,259,2.969464347,261,2,big,"('MOT', 'CHI')",Providence,eth41.xml,268,7,1,CHI,4490,1412,MOT
0,1,6,261,2.803360381,262,1,think,"('MOT', 'CHI')",Providence,eth41.xml,268,6,0,CHI,4490,1412,MOT
3,4,9,252,2.690758704,256,4,make,"('MOT', 'CHI')",Providence,eth41.xml,268,12,3,CHI,4490,1412,MOT
0,1,7,260,2.681782274,261,1,not,"('MOT', 'CHI')",Providence,eth41.xml,268,7,0,CHI,4490,1412,MOT
2,2,14,250,2.646962509,252,2,what,"('MOT', 'CHI')",Providence,eth41.xml,268,16,2,CHI,4490,1412,MOT
0,1,8,259,2.57261223,260,1,did,"('MOT', 'CHI')",Providence,eth41.xml,268,8,0,CHI,4490,1412,MOT
0,1,9,258,2.473477954,259,1,for,"('MOT', 'CHI')",Providence,eth41.xml,268,9,0,CHI,4490,1412,MOT
1,3,9,255,2.382627801,258,3,all,"('MOT', 'CHI')",Providence,eth41.xml,268,10,1,CHI,4490,1412,MOT
0,1,12,255,2.220755075,256,1,look,"('MOT', 'CHI')",Providence,eth41.xml,268,12,0,CHI,4490,1412,MOT
2,2,23,241,2.205421345,243,2,was,"('MOT', 'CHI')",Providence,eth41.xml,268,25,2,CHI,4490,1412,MOT
1,2,16,249,2.183485401,251,2,can,"('MOT', 'CHI')",Providence,eth41.xml,268,17,1,CHI,4490,1412,MOT
0,2,8,258,2.167147122,260,2,no,"('MOT', 'CHI')",Providence,eth41.xml,268,8,0,CHI,4490,1412,MOT
1,4,9,254,2.159484249,258,4,at,"('MOT', 'CHI')",Providence,eth41.xml,268,10,1,CHI,4490,1412,MOT
0,1,15,252,2.014903021,253,1,are,"('MOT', 'CHI')",Providence,eth41.xml,268,15,0,CHI,4490,1412,MOT
0,2,10,256,1.977162693,258,2,get,"('MOT', 'CHI')",Providence,eth41.xml,268,10,0,CHI,4490,1412,MOT
0,2,10,256,1.977162693,258,2,my,"('MOT', 'CHI')",Providence,eth41.xml,268,10,0,CHI,4490,1412,MOT
0,2,11,255,1.893266416,257,2,little,"('MOT', 'CHI')",Providence,eth41.xml,268,11,0,CHI,4490,1412,MOT
1,4,13,250,1.85629799,254,4,one,"('MOT', 'CHI')",Providence,eth41.xml,268,14,1,CHI,4490,1412,MOT
0,4,7,257,1.765491542,261,4,want,"('MOT', 'CHI')",Providence,eth41.xml,268,7,0,CHI,4490,1412,MOT
0,2,13,253,1.742413595,255,2,where,"('MOT', 'CHI')",Providence,eth41.xml,268,13,0,CHI,4490,1412,MOT
0,3,10,255,1.68948062,258,3,with,"('MOT', 'CHI')",Providence,eth41.xml,268,10,0,CHI,4490,1412,MOT
0,1,21,246,1.6888115,247,1,we,"('MOT', 'CHI')",Providence,eth41.xml,268,21,0,CHI,4490,1412,MOT
0,1,22,245,1.642227735,246,1,there,"('MOT', 'CHI')",Providence,eth41.xml,268,22,0,CHI,4490,1412,MOT
1,3,22,242,1.597365331,245,3,have,"('MOT', 'CHI')",Providence,eth41.xml,268,23,1,CHI,4490,1412,MOT
2,4,27,235,1.539984105,239,4,of,"('MOT', 'CHI')",Providence,eth41.xml,268,29,2,CHI,4490,1412,MOT
3,8,19,238,1.5244447,246,8,like,"('MOT', 'CHI')",Providence,eth41.xml,268,22,3,CHI,4490,1412,MOT
1,4,21,242,1.419084184,246,4,that,"('MOT', 'CHI')",Providence,eth41.xml,268,22,1,CHI,4490,1412,MOT
3,5,37,223,1.294944583,228,5,to,"('MOT', 'CHI')",Providence,eth41.xml,268,40,3,CHI,4490,1412,MOT
0,2,21,245,1.283346392,247,2,gonna,"('MOT', 'CHI')",Providence,eth41.xml,268,21,0,CHI,4490,1412,MOT
1,3,33,231,1.187165686,234,3,he,"('MOT', 'CHI')",Providence,eth41.xml,268,34,1,CHI,4490,1412,MOT
1,6,19,242,1.177655496,248,6,up,"('MOT', 'CHI')",Providence,eth41.xml,268,20,1,CHI,4490,1412,MOT
0,5,14,249,0.980829253,254,5,put,"('MOT', 'CHI')",Providence,eth41.xml,268,14,0,CHI,4490,1412,MOT
2,10,23,233,0.90613836,243,10,is,"('MOT', 'CHI')",Providence,eth41.xml,268,25,2,CHI,4490,1412,MOT
0,4,19,245,0.871492589,249,4,go,"('MOT', 'CHI')",Providence,eth41.xml,268,19,0,CHI,4490,1412,MOT
1,15,11,241,0.834460714,256,15,this,"('MOT', 'CHI')",Providence,eth41.xml,268,12,1,CHI,4490,1412,MOT
2,10,32,224,0.581029882,234,10,in,"('MOT', 'CHI')",Providence,eth41.xml,268,34,2,CHI,4490,1412,MOT
6,15,47,200,0.545885595,215,15,it,"('MOT', 'CHI')",Providence,eth41.xml,268,53,6,CHI,4490,1412,MOT
7,14,61,186,0.431163796,200,14,a,"('MOT', 'CHI')",Providence,eth41.xml,268,68,7,CHI,4490,1412,MOT
7,16,55,190,0.424883194,206,16,and,"('MOT', 'CHI')",Providence,eth41.xml,268,62,7,CHI,4490,1412,MOT
8,14,78,168,0.226773319,182,14,you,"('MOT', 'CHI')",Providence,eth41.xml,268,86,8,CHI,4490,1412,MOT
0,7,25,236,0.125979803,243,7,on,"('MOT', 'CHI')",Providence,eth41.xml,268,25,0,CHI,4490,1412,MOT
14,23,86,145,0.040821995,168,23,the,"('MOT', 'CHI')",Providence,eth41.xml,268,100,14,CHI,4490,1412,MOT
1,0,13,327,3.716616209,327,0,all,"('MOT', 'CHI')",Providence,eth42.xml,341,14,1,CHI,4799,1819,MOT
0,1,5,335,3.183988566,336,1,not,"('MOT', 'CHI')",Providence,eth42.xml,341,5,0,CHI,4799,1819,MOT
1,1,16,323,2.842458402,324,1,gonna,"('MOT', 'CHI')",Providence,eth42.xml,341,17,1,CHI,4799,1819,MOT
1,1,18,321,2.736221078,322,1,up,"('MOT', 'CHI')",Providence,eth42.xml,341,19,1,CHI,4799,1819,MOT
0,1,9,331,2.72009854,332,1,get,"('MOT', 'CHI')",Providence,eth42.xml,341,9,0,CHI,4799,1819,MOT
0,2,6,333,2.6420291,335,2,they,"('MOT', 'CHI')",Providence,eth42.xml,341,6,0,CHI,4799,1819,MOT
2,5,9,325,2.547038431,330,5,was,"('MOT', 'CHI')",Providence,eth42.xml,341,11,2,CHI,4799,1819,MOT
2,4,13,322,2.448974641,326,4,have,"('MOT', 'CHI')",Providence,eth42.xml,341,15,2,CHI,4799,1819,MOT
0,2,8,331,2.41293315,333,2,with,"('MOT', 'CHI')",Providence,eth42.xml,341,8,0,CHI,4799,1819,MOT
1,4,11,325,2.246770314,329,4,he,"('MOT', 'CHI')",Providence,eth42.xml,341,12,1,CHI,4799,1819,MOT
0,2,12,327,2.064448757,329,2,go,"('MOT', 'CHI')",Providence,eth42.xml,341,12,0,CHI,4799,1819,MOT
0,3,10,328,1.936941479,331,3,where,"('MOT', 'CHI')",Providence,eth42.xml,341,10,0,CHI,4799,1819,MOT
2,5,21,313,1.85629799,318,5,there,"('MOT', 'CHI')",Providence,eth42.xml,341,23,2,CHI,4799,1819,MOT
0,4,9,328,1.803807808,332,4,want,"('MOT', 'CHI')",Providence,eth42.xml,341,9,0,CHI,4799,1819,MOT
0,2,18,321,1.68948062,323,2,for,"('MOT', 'CHI')",Providence,eth42.xml,341,18,0,CHI,4799,1819,MOT
0,2,20,319,1.587997581,321,2,can,"('MOT', 'CHI')",Providence,eth42.xml,341,20,0,CHI,4799,1819,MOT
0,4,13,324,1.481604541,328,4,put,"('MOT', 'CHI')",Providence,eth42.xml,341,13,0,CHI,4799,1819,MOT
0,6,9,326,1.467335571,332,6,oh,"('MOT', 'CHI')",Providence,eth42.xml,341,9,0,CHI,4799,1819,MOT
1,2,44,294,1.441480777,296,2,we,"('MOT', 'CHI')",Providence,eth42.xml,341,45,1,CHI,4799,1819,MOT
3,9,25,304,1.435084525,313,9,in,"('MOT', 'CHI')",Providence,eth42.xml,341,28,3,CHI,4799,1819,MOT
0,3,18,320,1.401798548,323,3,yeah,"('MOT', 'CHI')",Providence,eth42.xml,341,18,0,CHI,4799,1819,MOT
2,9,20,310,1.389414488,319,9,that,"('MOT', 'CHI')",Providence,eth42.xml,341,22,2,CHI,4799,1819,MOT
0,6,11,324,1.294275462,330,6,are,"('MOT', 'CHI')",Providence,eth42.xml,341,11,0,CHI,4799,1819,MOT
0,11,6,324,1.255734739,335,11,but,"('MOT', 'CHI')",Providence,eth42.xml,341,6,0,CHI,4799,1819,MOT
4,8,43,286,1.210752491,294,8,make,"('MOT', 'CHI')",Providence,eth42.xml,341,47,4,CHI,4799,1819,MOT
3,14,21,303,1.185338725,317,14,one,"('MOT', 'CHI')",Providence,eth42.xml,341,24,3,CHI,4799,1819,MOT
1,7,22,311,1.16315081,318,7,this,"('MOT', 'CHI')",Providence,eth42.xml,341,23,1,CHI,4799,1819,MOT
6,13,43,279,1.058606954,292,13,and,"('MOT', 'CHI')",Providence,eth42.xml,341,49,6,CHI,4799,1819,MOT
9,14,59,259,0.962810748,273,14,it,"('MOT', 'CHI')",Providence,eth42.xml,341,68,9,CHI,4799,1819,MOT
0,5,20,316,0.894850401,321,5,like,"('MOT', 'CHI')",Providence,eth42.xml,341,20,0,CHI,4799,1819,MOT
9,14,76,242,0.681586358,256,14,a,"('MOT', 'CHI')",Providence,eth42.xml,341,85,9,CHI,4799,1819,MOT
0,7,19,315,0.656779536,322,7,what,"('MOT', 'CHI')",Providence,eth42.xml,341,19,0,CHI,4799,1819,MOT
0,4,31,306,0.637057714,310,4,on,"('MOT', 'CHI')",Providence,eth42.xml,341,31,0,CHI,4799,1819,MOT
5,18,43,275,0.622272841,293,18,to,"('MOT', 'CHI')",Providence,eth42.xml,341,48,5,CHI,4799,1819,MOT
0,3,39,299,0.617161274,302,3,do,"('MOT', 'CHI')",Providence,eth42.xml,341,39,0,CHI,4799,1819,MOT
16,28,86,211,0.306323548,239,28,the,"('MOT', 'CHI')",Providence,eth42.xml,341,102,16,CHI,4799,1819,MOT
3,8,84,246,0.245610859,254,8,you,"('MOT', 'CHI')",Providence,eth42.xml,341,87,3,CHI,4799,1819,MOT
3,21,40,277,0.192371893,298,21,is,"('MOT', 'CHI')",Providence,eth42.xml,341,43,3,CHI,4799,1819,MOT
0,9,31,301,-0.056089467,310,9,of,"('MOT', 'CHI')",Providence,eth42.xml,341,31,0,CHI,4799,1819,MOT
1,0,12,336,3.808142875,336,0,was,"('MOT', 'CHI')",Providence,eth43.xml,349,13,1,CHI,4884,1864,MOT
2,2,6,339,3.535145354,341,2,my,"('MOT', 'CHI')",Providence,eth43.xml,349,8,2,CHI,4884,1864,MOT
1,2,4,342,3.495063518,344,2,where,"('MOT', 'CHI')",Providence,eth43.xml,349,5,1,CHI,4884,1864,MOT
1,1,8,339,3.436915464,340,1,at,"('MOT', 'CHI')",Providence,eth43.xml,349,9,1,CHI,4884,1864,MOT
2,3,7,337,3.149233392,340,3,look,"('MOT', 'CHI')",Providence,eth43.xml,349,9,2,CHI,4884,1864,MOT
0,1,6,342,3.070955695,343,1,all,"('MOT', 'CHI')",Providence,eth43.xml,349,6,0,CHI,4884,1864,MOT
1,1,13,334,3.047494208,335,1,like,"('MOT', 'CHI')",Providence,eth43.xml,349,14,1,CHI,4884,1864,MOT
0,2,4,343,2.958953022,345,2,get,"('MOT', 'CHI')",Providence,eth43.xml,349,4,0,CHI,4884,1864,MOT
0,1,9,339,2.743768284,340,1,with,"('MOT', 'CHI')",Providence,eth43.xml,349,9,0,CHI,4884,1864,MOT
0,2,6,341,2.665490587,343,2,they,"('MOT', 'CHI')",Providence,eth43.xml,349,6,0,CHI,4884,1864,MOT
4,5,15,325,2.578290974,330,5,he,"('MOT', 'CHI')",Providence,eth43.xml,349,19,4,CHI,4884,1864,MOT
0,3,5,341,2.514234265,344,3,some,"('MOT', 'CHI')",Providence,eth43.xml,349,5,0,CHI,4884,1864,MOT
0,1,12,336,2.493795597,337,1,gonna,"('MOT', 'CHI')",Providence,eth43.xml,349,12,0,CHI,4884,1864,MOT
1,1,24,323,2.491060515,324,1,yeah,"('MOT', 'CHI')",Providence,eth43.xml,349,25,1,CHI,4884,1864,MOT
0,2,8,339,2.436533066,341,2,think,"('MOT', 'CHI')",Providence,eth43.xml,349,8,0,CHI,4884,1864,MOT
1,1,32,315,2.206703321,316,1,do,"('MOT', 'CHI')",Providence,eth43.xml,349,33,1,CHI,4884,1864,MOT
0,1,18,330,2.119263036,331,1,want,"('MOT', 'CHI')",Providence,eth43.xml,349,18,0,CHI,4884,1864,MOT
0,1,20,328,2.017928741,329,1,see,"('MOT', 'CHI')",Providence,eth43.xml,349,20,0,CHI,4884,1864,MOT
3,6,20,320,2.014521996,326,6,on,"('MOT', 'CHI')",Providence,eth43.xml,349,23,3,CHI,4884,1864,MOT
1,4,15,329,2.007468042,333,4,are,"('MOT', 'CHI')",Providence,eth43.xml,349,16,1,CHI,4884,1864,MOT
0,1,21,327,1.970451258,328,1,wanna,"('MOT', 'CHI')",Providence,eth43.xml,349,21,0,CHI,4884,1864,MOT
2,6,16,325,1.965112356,331,6,oh,"('MOT', 'CHI')",Providence,eth43.xml,349,18,2,CHI,4884,1864,MOT
0,2,14,333,1.948881919,335,2,did,"('MOT', 'CHI')",Providence,eth43.xml,349,14,0,CHI,4884,1864,MOT
0,3,11,335,1.877701899,338,3,have,"('MOT', 'CHI')",Providence,eth43.xml,349,11,0,CHI,4884,1864,MOT
5,9,24,311,1.829738717,320,9,is,"('MOT', 'CHI')",Providence,eth43.xml,349,29,5,CHI,4884,1864,MOT
1,5,18,325,1.662000243,330,5,one,"('MOT', 'CHI')",Providence,eth43.xml,349,19,1,CHI,4884,1864,MOT
0,5,11,333,1.472236791,338,5,but,"('MOT', 'CHI')",Providence,eth43.xml,349,11,0,CHI,4884,1864,MOT
0,4,14,331,1.438056296,335,4,for,"('MOT', 'CHI')",Providence,eth43.xml,349,14,0,CHI,4884,1864,MOT
0,3,18,328,1.426115855,331,3,not,"('MOT', 'CHI')",Providence,eth43.xml,349,18,0,CHI,4884,1864,MOT
0,5,13,331,1.323236225,336,5,big,"('MOT', 'CHI')",Providence,eth43.xml,349,13,0,CHI,4884,1864,MOT
2,13,19,315,1.123153398,328,13,this,"('MOT', 'CHI')",Providence,eth43.xml,349,21,2,CHI,4884,1864,MOT
4,12,34,299,1.101812291,311,12,that,"('MOT', 'CHI')",Providence,eth43.xml,349,38,4,CHI,4884,1864,MOT
0,3,26,320,1.065326311,323,3,there,"('MOT', 'CHI')",Providence,eth43.xml,349,26,0,CHI,4884,1864,MOT
2,11,24,312,1.065326311,323,11,up,"('MOT', 'CHI')",Providence,eth43.xml,349,26,2,CHI,4884,1864,MOT
0,9,10,330,1.044390735,339,9,no,"('MOT', 'CHI')",Providence,eth43.xml,349,10,0,CHI,4884,1864,MOT
0,4,23,322,0.964699871,326,4,go,"('MOT', 'CHI')",Providence,eth43.xml,349,23,0,CHI,4884,1864,MOT
0,4,23,322,0.964699871,326,4,of,"('MOT', 'CHI')",Providence,eth43.xml,349,23,0,CHI,4884,1864,MOT
2,11,28,308,0.919410859,319,11,in,"('MOT', 'CHI')",Providence,eth43.xml,349,30,2,CHI,4884,1864,MOT
0,8,13,328,0.917771117,336,8,make,"('MOT', 'CHI')",Providence,eth43.xml,349,13,0,CHI,4884,1864,MOT
0,12,9,328,0.871966107,340,12,put,"('MOT', 'CHI')",Providence,eth43.xml,349,9,0,CHI,4884,1864,MOT
0,4,28,317,0.767017029,321,4,we,"('MOT', 'CHI')",Providence,eth43.xml,349,28,0,CHI,4884,1864,MOT
0,3,35,311,0.75852994,314,3,what,"('MOT', 'CHI')",Providence,eth43.xml,349,35,0,CHI,4884,1864,MOT
3,15,35,296,0.671029375,311,15,to,"('MOT', 'CHI')",Providence,eth43.xml,349,38,3,CHI,4884,1864,MOT
8,13,84,244,0.571700527,257,13,you,"('MOT', 'CHI')",Providence,eth43.xml,349,92,8,CHI,4884,1864,MOT
1,9,38,301,0.419993209,310,9,and,"('MOT', 'CHI')",Providence,eth43.xml,349,39,1,CHI,4884,1864,MOT
4,16,61,268,0.22752376,284,16,a,"('MOT', 'CHI')",Providence,eth43.xml,349,65,4,CHI,4884,1864,MOT
16,35,84,214,0.150174531,249,35,the,"('MOT', 'CHI')",Providence,eth43.xml,349,100,16,CHI,4884,1864,MOT
0,9,26,314,0.149035579,323,9,can,"('MOT', 'CHI')",Providence,eth43.xml,349,26,0,CHI,4884,1864,MOT
8,32,64,245,0.027863704,277,32,it,"('MOT', 'CHI')",Providence,eth43.xml,349,72,8,CHI,4884,1864,MOT
3,0,7,431,4.972125439,431,0,they,"('MOT', 'CHI')",Providence,eth44.xml,441,10,3,CHI,4712,2047,MOT
0,1,3,437,3.784189634,438,1,she,"('MOT', 'CHI')",Providence,eth44.xml,441,3,0,CHI,4712,2047,MOT
0,1,3,437,3.784189634,438,1,big,"('MOT', 'CHI')",Providence,eth44.xml,441,3,0,CHI,4712,2047,MOT
0,3,1,437,3.606403232,440,3,where,"('MOT', 'CHI')",Providence,eth44.xml,441,1,0,CHI,4712,2047,MOT
1,1,9,430,3.585831078,431,1,all,"('MOT', 'CHI')",Providence,eth44.xml,441,10,1,CHI,4712,2047,MOT
0,1,6,434,3.307344473,435,1,get,"('MOT', 'CHI')",Providence,eth44.xml,441,6,0,CHI,4712,2047,MOT
2,6,5,428,3.033119806,434,6,my,"('MOT', 'CHI')",Providence,eth44.xml,441,7,2,CHI,4712,2047,MOT
0,1,9,431,2.982002081,432,1,gonna,"('MOT', 'CHI')",Providence,eth44.xml,441,9,0,CHI,4712,2047,MOT
0,2,7,432,2.781805377,434,2,but,"('MOT', 'CHI')",Providence,eth44.xml,441,7,0,CHI,4712,2047,MOT
2,5,12,422,2.595721016,427,5,go,"('MOT', 'CHI')",Providence,eth44.xml,441,14,2,CHI,4712,2047,MOT
0,3,8,430,2.386466577,433,3,he,"('MOT', 'CHI')",Providence,eth44.xml,441,8,0,CHI,4712,2047,MOT
0,1,19,421,2.312063837,422,1,for,"('MOT', 'CHI')",Providence,eth44.xml,441,19,0,CHI,4712,2047,MOT
1,3,19,418,2.263182545,421,3,do,"('MOT', 'CHI')",Providence,eth44.xml,441,20,1,CHI,4712,2047,MOT
1,3,20,417,2.216363918,420,3,of,"('MOT', 'CHI')",Providence,eth44.xml,441,21,1,CHI,4712,2047,MOT
1,2,28,410,2.186413661,412,2,to,"('MOT', 'CHI')",Providence,eth44.xml,441,29,1,CHI,4712,2047,MOT
1,3,21,416,2.171431823,419,3,can,"('MOT', 'CHI')",Providence,eth44.xml,441,22,1,CHI,4712,2047,MOT
0,2,15,424,2.127297563,426,2,oh,"('MOT', 'CHI')",Providence,eth44.xml,441,15,0,CHI,4712,2047,MOT
0,2,15,424,2.127297563,426,2,with,"('MOT', 'CHI')",Providence,eth44.xml,441,15,0,CHI,4712,2047,MOT
0,3,11,427,2.11718187,430,3,some,"('MOT', 'CHI')",Providence,eth44.xml,441,11,0,CHI,4712,2047,MOT
2,9,12,418,2.084895392,427,9,no,"('MOT', 'CHI')",Providence,eth44.xml,441,14,2,CHI,4712,2047,MOT
1,5,15,420,2.067799967,425,5,in,"('MOT', 'CHI')",Providence,eth44.xml,441,16,1,CHI,4712,2047,MOT
0,3,12,426,2.040756399,429,3,up,"('MOT', 'CHI')",Providence,eth44.xml,441,12,0,CHI,4712,2047,MOT
0,4,10,427,1.976393166,431,4,look,"('MOT', 'CHI')",Providence,eth44.xml,441,10,0,CHI,4712,2047,MOT
2,5,25,409,1.97024225,414,5,on,"('MOT', 'CHI')",Providence,eth44.xml,441,27,2,CHI,4712,2047,MOT
0,3,13,425,1.969440646,428,3,little,"('MOT', 'CHI')",Providence,eth44.xml,441,13,0,CHI,4712,2047,MOT
0,3,14,424,1.902573836,427,3,there,"('MOT', 'CHI')",Providence,eth44.xml,441,14,0,CHI,4712,2047,MOT
0,5,9,427,1.883389792,432,5,was,"('MOT', 'CHI')",Providence,eth44.xml,441,9,0,CHI,4712,2047,MOT
3,12,15,411,1.877701899,423,12,one,"('MOT', 'CHI')",Providence,eth44.xml,441,18,3,CHI,4712,2047,MOT
17,12,62,350,1.828127113,362,12,a,"('MOT', 'CHI')",Providence,eth44.xml,441,79,17,CHI,4712,2047,MOT
1,3,35,402,1.678079845,405,3,we,"('MOT', 'CHI')",Providence,eth44.xml,441,36,1,CHI,4712,2047,MOT
4,11,28,398,1.616763953,409,11,like,"('MOT', 'CHI')",Providence,eth44.xml,441,32,4,CHI,4712,2047,MOT
0,4,16,421,1.556974343,425,4,not,"('MOT', 'CHI')",Providence,eth44.xml,441,16,0,CHI,4712,2047,MOT
2,5,41,393,1.491654877,398,5,and,"('MOT', 'CHI')",Providence,eth44.xml,441,43,2,CHI,4712,2047,MOT
2,15,17,407,1.331234584,422,15,this,"('MOT', 'CHI')",Providence,eth44.xml,441,19,2,CHI,4712,2047,MOT
0,4,21,416,1.300073186,420,4,yeah,"('MOT', 'CHI')",Providence,eth44.xml,441,21,0,CHI,4712,2047,MOT
10,16,58,357,1.243112713,373,16,it,"('MOT', 'CHI')",Providence,eth44.xml,441,68,10,CHI,4712,2047,MOT
0,4,23,414,1.211940974,418,4,have,"('MOT', 'CHI')",Providence,eth44.xml,441,23,0,CHI,4712,2047,MOT
7,22,34,378,1.179199299,400,22,that,"('MOT', 'CHI')",Providence,eth44.xml,441,41,7,CHI,4712,2047,MOT
0,4,25,412,1.130206654,416,4,make,"('MOT', 'CHI')",Providence,eth44.xml,441,25,0,CHI,4712,2047,MOT
1,11,27,402,0.835321669,413,11,is,"('MOT', 'CHI')",Providence,eth44.xml,441,28,1,CHI,4712,2047,MOT
0,6,26,409,0.754971563,415,6,wanna,"('MOT', 'CHI')",Providence,eth44.xml,441,26,0,CHI,4712,2047,MOT
2,4,97,338,0.714695517,342,4,you,"('MOT', 'CHI')",Providence,eth44.xml,441,99,2,CHI,4712,2047,MOT
6,20,64,351,0.546300012,371,20,the,"('MOT', 'CHI')",Providence,eth44.xml,441,70,6,CHI,4712,2047,MOT
2,11,54,374,0.511687321,385,11,what,"('MOT', 'CHI')",Providence,eth44.xml,441,56,2,CHI,4712,2047,MOT
1,1,2,466,4.541164856,467,1,she,"('MOT', 'CHI')",Providence,eth45.xml,470,3,1,CHI,5390,2887,MOT
1,0,7,462,4.53044664,462,0,my,"('MOT', 'CHI')",Providence,eth45.xml,470,8,1,CHI,5390,2887,MOT
1,1,7,461,3.837299459,462,1,make,"('MOT', 'CHI')",Providence,eth45.xml,470,8,1,CHI,5390,2887,MOT
3,1,15,451,3.815512105,452,1,little,"('MOT', 'CHI')",Providence,eth45.xml,470,18,3,CHI,5390,2887,MOT
0,2,2,466,3.667826045,468,2,big,"('MOT', 'CHI')",Providence,eth45.xml,470,2,0,CHI,5390,2887,MOT
0,1,7,462,3.251665648,463,1,want,"('MOT', 'CHI')",Providence,eth45.xml,470,7,0,CHI,5390,2887,MOT
0,5,2,463,2.974678864,468,5,was,"('MOT', 'CHI')",Providence,eth45.xml,470,2,0,CHI,5390,2887,MOT
0,1,11,458,2.875301505,459,1,gonna,"('MOT', 'CHI')",Providence,eth45.xml,470,11,0,CHI,5390,2887,MOT
0,2,7,461,2.84620054,463,2,oh,"('MOT', 'CHI')",Providence,eth45.xml,470,7,0,CHI,5390,2887,MOT
1,5,6,458,2.84620054,463,5,put,"('MOT', 'CHI')",Providence,eth45.xml,470,7,1,CHI,5390,2887,MOT
2,4,12,452,2.843454838,456,4,get,"('MOT', 'CHI')",Providence,eth45.xml,470,14,2,CHI,5390,2887,MOT
0,1,13,456,2.727852828,457,1,look,"('MOT', 'CHI')",Providence,eth45.xml,470,13,0,CHI,5390,2887,MOT
1,3,12,454,2.727852828,457,3,no,"('MOT', 'CHI')",Providence,eth45.xml,470,13,1,CHI,5390,2887,MOT
1,4,11,454,2.575878428,458,4,did,"('MOT', 'CHI')",Providence,eth45.xml,470,12,1,CHI,5390,2887,MOT
2,4,18,446,2.511814103,450,4,see,"('MOT', 'CHI')",Providence,eth45.xml,470,20,2,CHI,5390,2887,MOT
0,2,12,456,2.393556871,458,2,for,"('MOT', 'CHI')",Providence,eth45.xml,470,12,0,CHI,5390,2887,MOT
0,2,13,455,2.32238772,457,2,not,"('MOT', 'CHI')",Providence,eth45.xml,470,13,0,CHI,5390,2887,MOT
9,12,26,423,2.206651018,435,12,up,"('MOT', 'CHI')",Providence,eth45.xml,470,35,9,CHI,5390,2887,MOT
2,6,18,444,2.175341866,450,6,they,"('MOT', 'CHI')",Providence,eth45.xml,470,20,2,CHI,5390,2887,MOT
0,3,12,455,2.105874799,458,3,wanna,"('MOT', 'CHI')",Providence,eth45.xml,470,12,0,CHI,5390,2887,MOT
2,6,22,440,1.999398834,446,6,are,"('MOT', 'CHI')",Providence,eth45.xml,470,24,2,CHI,5390,2887,MOT
0,3,14,453,1.967986101,456,3,with,"('MOT', 'CHI')",Providence,eth45.xml,470,14,0,CHI,5390,2887,MOT
5,14,26,425,1.676246582,439,14,go,"('MOT', 'CHI')",Providence,eth45.xml,470,31,5,CHI,5390,2887,MOT
1,5,25,439,1.669502153,444,5,on,"('MOT', 'CHI')",Providence,eth45.xml,470,26,1,CHI,5390,2887,MOT
1,6,22,441,1.635384094,447,6,have,"('MOT', 'CHI')",Providence,eth45.xml,470,23,1,CHI,5390,2887,MOT
0,6,11,453,1.622538536,459,6,at,"('MOT', 'CHI')",Providence,eth45.xml,470,11,0,CHI,5390,2887,MOT
1,8,17,444,1.618287528,452,8,all,"('MOT', 'CHI')",Providence,eth45.xml,470,18,1,CHI,5390,2887,MOT
2,7,29,432,1.611708061,439,7,do,"('MOT', 'CHI')",Providence,eth45.xml,470,31,2,CHI,5390,2887,MOT
8,24,22,416,1.603922732,440,24,he,"('MOT', 'CHI')",Providence,eth45.xml,470,30,8,CHI,5390,2887,MOT
1,10,14,445,1.586721955,455,10,like,"('MOT', 'CHI')",Providence,eth45.xml,470,15,1,CHI,5390,2887,MOT
0,12,6,452,1.499794735,464,12,where,"('MOT', 'CHI')",Providence,eth45.xml,470,6,0,CHI,5390,2887,MOT
4,14,33,419,1.313172096,433,14,in,"('MOT', 'CHI')",Providence,eth45.xml,470,37,4,CHI,5390,2887,MOT
6,7,84,373,1.290100639,380,7,you,"('MOT', 'CHI')",Providence,eth45.xml,470,90,6,CHI,5390,2887,MOT
5,26,21,418,1.264037045,444,26,one,"('MOT', 'CHI')",Providence,eth45.xml,470,26,5,CHI,5390,2887,MOT
2,19,16,433,1.22524494,452,19,this,"('MOT', 'CHI')",Providence,eth45.xml,470,18,2,CHI,5390,2887,MOT
3,12,39,416,1.100940578,428,12,of,"('MOT', 'CHI')",Providence,eth45.xml,470,42,3,CHI,5390,2887,MOT
4,17,36,413,1.049822124,430,17,can,"('MOT', 'CHI')",Providence,eth45.xml,470,40,4,CHI,5390,2887,MOT
4,29,21,416,1.014962259,445,29,what,"('MOT', 'CHI')",Providence,eth45.xml,470,25,4,CHI,5390,2887,MOT
4,18,36,412,0.995754903,430,18,there,"('MOT', 'CHI')",Providence,eth45.xml,470,40,4,CHI,5390,2887,MOT
26,47,62,335,0.875468737,382,47,it,"('MOT', 'CHI')",Providence,eth45.xml,470,88,26,CHI,5390,2887,MOT
2,11,46,411,0.751416089,422,11,to,"('MOT', 'CHI')",Providence,eth45.xml,470,48,2,CHI,5390,2887,MOT
0,3,54,413,0.623835381,416,3,yeah,"('MOT', 'CHI')",Providence,eth45.xml,470,54,0,CHI,5390,2887,MOT
0,14,15,441,0.583419846,455,14,but,"('MOT', 'CHI')",Providence,eth45.xml,470,15,0,CHI,5390,2887,MOT
16,39,81,334,0.476140066,373,39,a,"('MOT', 'CHI')",Providence,eth45.xml,470,97,16,CHI,5390,2887,MOT
9,51,43,367,0.402612039,418,51,is,"('MOT', 'CHI')",Providence,eth45.xml,470,52,9,CHI,5390,2887,MOT
0,7,37,426,0.332342843,433,7,we,"('MOT', 'CHI')",Providence,eth45.xml,470,37,0,CHI,5390,2887,MOT
4,34,41,391,0.260726262,425,34,that,"('MOT', 'CHI')",Providence,eth45.xml,470,45,4,CHI,5390,2887,MOT
27,55,118,270,0.106380404,325,55,the,"('MOT', 'CHI')",Providence,eth45.xml,470,145,27,CHI,5390,2887,MOT
1,32,45,392,-0.620122046,424,32,and,"('MOT', 'CHI')",Providence,eth45.xml,470,46,1,CHI,5390,2887,MOT
0,1,1,418,4.250873364,419,1,where,"('CHI', 'MOT')",Providence,eth46.xml,420,1,0,MOT,2440,4729,CHI
1,3,1,415,3.96081317,418,3,with,"('CHI', 'MOT')",Providence,eth46.xml,420,2,1,MOT,2440,4729,CHI
1,4,1,414,3.737669618,418,4,big,"('CHI', 'MOT')",Providence,eth46.xml,420,2,1,MOT,2440,4729,CHI
1,5,1,413,3.555348061,418,5,at,"('CHI', 'MOT')",Providence,eth46.xml,420,2,1,MOT,2440,4729,CHI
1,5,1,413,3.555348061,418,5,not,"('CHI', 'MOT')",Providence,eth46.xml,420,2,1,MOT,2440,4729,CHI
1,6,1,412,3.401197382,418,6,they,"('CHI', 'MOT')",Providence,eth46.xml,420,2,1,MOT,2440,4729,CHI
4,10,1,405,3.298718712,415,10,are,"('CHI', 'MOT')",Providence,eth46.xml,420,5,4,MOT,2440,4729,CHI
0,10,1,409,2.546125272,419,10,did,"('CHI', 'MOT')",Providence,eth46.xml,420,1,0,MOT,2440,4729,CHI
0,10,1,409,2.546125272,419,10,little,"('CHI', 'MOT')",Providence,eth46.xml,420,1,0,MOT,2440,4729,CHI
0,12,1,407,2.379071188,419,12,oh,"('CHI', 'MOT')",Providence,eth46.xml,420,1,0,MOT,2440,4729,CHI
0,12,1,407,2.379071188,419,12,for,"('CHI', 'MOT')",Providence,eth46.xml,420,1,0,MOT,2440,4729,CHI
0,10,2,408,2.256065077,418,10,but,"('CHI', 'MOT')",Providence,eth46.xml,420,2,0,MOT,2440,4729,CHI
7,13,16,384,2.210469804,397,13,one,"('CHI', 'MOT')",Providence,eth46.xml,420,23,7,MOT,2440,4729,CHI
3,20,4,393,2.172825866,413,20,make,"('CHI', 'MOT')",Providence,eth46.xml,420,7,3,MOT,2440,4729,CHI
0,16,1,403,2.110807201,419,16,some,"('CHI', 'MOT')",Providence,eth46.xml,420,1,0,MOT,2440,4729,CHI
3,22,5,390,1.974081026,412,22,up,"('CHI', 'MOT')",Providence,eth46.xml,420,8,3,MOT,2440,4729,CHI
0,11,3,406,1.943526358,417,11,look,"('CHI', 'MOT')",Providence,eth46.xml,420,3,0,MOT,2440,4729,CHI
2,14,8,396,1.926678787,410,14,can,"('CHI', 'MOT')",Providence,eth46.xml,420,10,2,MOT,2440,4729,CHI
0,12,3,405,1.86348365,417,12,was,"('CHI', 'MOT')",Providence,eth46.xml,420,3,0,MOT,2440,4729,CHI
3,44,1,372,1.823353835,416,44,we,"('CHI', 'MOT')",Providence,eth46.xml,420,4,3,MOT,2440,4729,CHI
1,16,5,398,1.811177555,414,16,have,"('CHI', 'MOT')",Providence,eth46.xml,420,6,1,MOT,2440,4729,CHI
0,22,1,397,1.808526329,419,22,do,"('CHI', 'MOT')",Providence,eth46.xml,420,1,0,MOT,2440,4729,CHI
0,11,4,405,1.758815314,416,11,want,"('CHI', 'MOT')",Providence,eth46.xml,420,4,0,MOT,2440,4729,CHI
0,15,3,402,1.655844285,417,15,wanna,"('CHI', 'MOT')",Providence,eth46.xml,420,3,0,MOT,2440,4729,CHI
11,33,18,358,1.498368533,391,33,he,"('CHI', 'MOT')",Providence,eth46.xml,420,29,11,MOT,2440,4729,CHI
0,11,6,403,1.466337069,414,11,this,"('CHI', 'MOT')",Providence,eth46.xml,420,6,0,MOT,2440,4729,CHI
0,33,1,386,1.41766002,419,33,of,"('CHI', 'MOT')",Providence,eth46.xml,420,1,0,MOT,2440,4729,CHI
2,15,16,387,1.331706171,402,15,put,"('CHI', 'MOT')",Providence,eth46.xml,420,18,2,MOT,2440,4729,CHI
1,33,4,382,1.253962729,415,33,and,"('CHI', 'MOT')",Providence,eth46.xml,420,5,1,MOT,2440,4729,CHI
2,20,14,384,1.170071253,404,20,in,"('CHI', 'MOT')",Providence,eth46.xml,420,16,2,MOT,2440,4729,CHI
1,34,5,380,1.089042838,414,34,what,"('CHI', 'MOT')",Providence,eth46.xml,420,6,1,MOT,2440,4729,CHI
5,32,18,365,1.0653375,397,32,that,"('CHI', 'MOT')",Providence,eth46.xml,420,23,5,MOT,2440,4729,CHI
2,32,9,377,1.055748584,409,32,go,"('CHI', 'MOT')",Providence,eth46.xml,420,11,2,MOT,2440,4729,CHI
1,26,8,385,1.022862635,411,26,there,"('CHI', 'MOT')",Providence,eth46.xml,420,9,1,MOT,2440,4729,CHI
3,39,10,368,1.003079862,407,39,like,"('CHI', 'MOT')",Providence,eth46.xml,420,13,3,MOT,2440,4729,CHI
3,91,2,324,0.951681857,415,91,you,"('CHI', 'MOT')",Providence,eth46.xml,420,5,3,MOT,2440,4729,CHI
4,31,20,365,0.872057477,396,31,on,"('CHI', 'MOT')",Providence,eth46.xml,420,24,4,MOT,2440,4729,CHI
23,76,30,291,0.737711867,367,76,a,"('CHI', 'MOT')",Providence,eth46.xml,420,53,23,MOT,2440,4729,CHI
14,66,32,308,0.561745714,374,66,it,"('CHI', 'MOT')",Providence,eth46.xml,420,46,14,MOT,2440,4729,CHI
12,92,20,296,0.472136079,388,92,the,"('CHI', 'MOT')",Providence,eth46.xml,420,32,12,MOT,2440,4729,CHI
1,30,15,374,0.375141378,404,30,is,"('CHI', 'MOT')",Providence,eth46.xml,420,16,1,MOT,2440,4729,CHI
0,35,6,379,0.36772478,414,35,to,"('CHI', 'MOT')",Providence,eth46.xml,420,6,0,MOT,2440,4729,CHI
0,1,1,0,-0.693147181,1,1,it,"('MOT', 'CHI')",Providence,eth46.xml,2,1,0,CHI,12,10,MOT
2,2,2,387,4.176948091,389,2,big,"('CHI', 'MOT')",Providence,eth47.xml,393,4,2,MOT,2138,4516,CHI
2,6,0,385,3.74021739,391,6,where,"('CHI', 'MOT')",Providence,eth47.xml,393,2,2,MOT,2138,4516,CHI
1,5,1,386,3.488902962,391,5,at,"('CHI', 'MOT')",Providence,eth47.xml,393,2,1,MOT,2138,4516,CHI
1,0,0,43,3.401197382,43,0,have,"('MOT', 'CHI')",Providence,eth47.xml,44,1,1,CHI,523,262,MOT
3,8,2,380,3.209306374,388,8,some,"('CHI', 'MOT')",Providence,eth47.xml,393,5,3,MOT,2138,4516,CHI
1,0,1,42,3.091042453,42,0,at,"('MOT', 'CHI')",Providence,eth47.xml,44,2,1,CHI,523,262,MOT
1,0,2,41,2.844909384,41,0,this,"('MOT', 'CHI')",Providence,eth47.xml,44,3,1,CHI,523,262,MOT
0,9,1,383,2.575153528,392,9,for,"('CHI', 'MOT')",Providence,eth47.xml,393,1,0,MOT,2138,4516,CHI
3,13,4,373,2.511017794,386,13,make,"('CHI', 'MOT')",Providence,eth47.xml,393,7,3,MOT,2138,4516,CHI
0,10,1,382,2.479843348,392,10,with,"('CHI', 'MOT')",Providence,eth47.xml,393,1,0,MOT,2138,4516,CHI
2,20,1,370,2.415913778,390,20,do,"('CHI', 'MOT')",Providence,eth47.xml,393,3,2,MOT,2138,4516,CHI
0,8,2,383,2.390290673,391,8,get,"('CHI', 'MOT')",Providence,eth47.xml,393,2,0,MOT,2138,4516,CHI
1,17,1,374,2.390290673,391,17,little,"('CHI', 'MOT')",Providence,eth47.xml,393,2,1,MOT,2138,4516,CHI
1,11,3,378,2.385188622,389,11,all,"('CHI', 'MOT')",Providence,eth47.xml,393,4,1,MOT,2138,4516,CHI
1,0,5,38,2.302585093,38,0,do,"('MOT', 'CHI')",Providence,eth47.xml,44,6,1,CHI,523,262,MOT
1,0,6,37,2.159484249,37,0,to,"('MOT', 'CHI')",Providence,eth47.xml,44,7,1,CHI,523,262,MOT
1,10,6,376,2.05903267,386,10,like,"('CHI', 'MOT')",Providence,eth47.xml,393,7,1,MOT,2138,4516,CHI
2,18,4,369,2.038311111,387,18,they,"('CHI', 'MOT')",Providence,eth47.xml,393,6,2,MOT,2138,4516,CHI
2,1,4,37,2.014903021,38,1,it,"('MOT', 'CHI')",Providence,eth47.xml,44,6,2,CHI,523,262,MOT
0,1,1,42,2.014903021,43,1,wanna,"('MOT', 'CHI')",Providence,eth47.xml,44,1,0,CHI,523,262,MOT
2,23,3,365,1.940795048,388,23,of,"('CHI', 'MOT')",Providence,eth47.xml,393,5,2,MOT,2138,4516,CHI
0,14,2,377,1.87946505,391,14,gonna,"('CHI', 'MOT')",Providence,eth47.xml,393,2,0,MOT,2138,4516,CHI
0,5,8,380,1.864080131,385,5,look,"('CHI', 'MOT')",Providence,eth47.xml,393,8,0,MOT,2138,4516,CHI
1,20,3,369,1.825572834,389,20,have,"('CHI', 'MOT')",Providence,eth47.xml,393,4,1,MOT,2138,4516,CHI
1,13,6,373,1.817870613,386,13,put,"('CHI', 'MOT')",Providence,eth47.xml,393,7,1,MOT,2138,4516,CHI
6,23,10,354,1.815020766,377,23,he,"('CHI', 'MOT')",Providence,eth47.xml,393,16,6,MOT,2138,4516,CHI
0,12,3,378,1.79687457,390,12,was,"('CHI', 'MOT')",Providence,eth47.xml,393,3,0,MOT,2138,4516,CHI
2,15,9,367,1.711716762,382,15,up,"('CHI', 'MOT')",Providence,eth47.xml,393,11,2,MOT,2138,4516,CHI
0,1,2,41,1.704748092,42,1,go,"('MOT', 'CHI')",Providence,eth47.xml,44,2,0,CHI,523,262,MOT
0,1,2,41,1.704748092,42,1,yeah,"('MOT', 'CHI')",Providence,eth47.xml,44,2,0,CHI,523,262,MOT
1,25,3,364,1.611998733,389,25,this,"('CHI', 'MOT')",Providence,eth47.xml,393,4,1,MOT,2138,4516,CHI
2,49,1,341,1.548413211,390,49,to,"('CHI', 'MOT')",Providence,eth47.xml,393,3,2,MOT,2138,4516,CHI
0,17,3,373,1.471452169,390,17,are,"('CHI', 'MOT')",Providence,eth47.xml,393,3,0,MOT,2138,4516,CHI
0,1,3,40,1.458615023,41,1,they,"('MOT', 'CHI')",Providence,eth47.xml,44,3,0,CHI,523,262,MOT
0,1,3,40,1.458615023,41,1,what,"('MOT', 'CHI')",Providence,eth47.xml,44,3,0,CHI,523,262,MOT
0,1,3,40,1.458615023,41,1,no,"('MOT', 'CHI')",Providence,eth47.xml,44,3,0,CHI,523,262,MOT
0,1,3,40,1.458615023,41,1,are,"('MOT', 'CHI')",Providence,eth47.xml,44,3,0,CHI,523,262,MOT
2,41,3,347,1.38117926,388,41,we,"('CHI', 'MOT')",Providence,eth47.xml,393,5,2,MOT,2138,4516,CHI
0,24,2,367,1.368639426,391,24,go,"('CHI', 'MOT')",Providence,eth47.xml,393,2,0,MOT,2138,4516,CHI
1,22,6,364,1.321433727,386,22,what,"('CHI', 'MOT')",Providence,eth47.xml,393,7,1,MOT,2138,4516,CHI
6,39,10,338,1.304195142,377,39,is,"('CHI', 'MOT')",Providence,eth47.xml,393,16,6,MOT,2138,4516,CHI
0,1,4,39,1.252762968,40,1,we,"('MOT', 'CHI')",Providence,eth47.xml,44,4,0,CHI,523,262,MOT
0,1,4,39,1.252762968,40,1,there,"('MOT', 'CHI')",Providence,eth47.xml,44,4,0,CHI,523,262,MOT
0,1,4,39,1.252762968,40,1,put,"('MOT', 'CHI')",Providence,eth47.xml,44,4,0,CHI,523,262,MOT
1,15,11,366,1.229536118,381,15,one,"('CHI', 'MOT')",Providence,eth47.xml,393,12,1,MOT,2138,4516,CHI
1,28,5,359,1.209989153,387,28,and,"('CHI', 'MOT')",Providence,eth47.xml,393,6,1,MOT,2138,4516,CHI
1,2,5,36,1.203972804,38,2,in,"('MOT', 'CHI')",Providence,eth47.xml,44,6,1,CHI,523,262,MOT
0,40,1,352,1.164166554,392,40,yeah,"('CHI', 'MOT')",Providence,eth47.xml,393,1,0,MOT,2138,4516,CHI
5,3,9,27,1.098612289,30,3,the,"('MOT', 'CHI')",Providence,eth47.xml,44,14,5,CHI,523,262,MOT
0,3,2,39,1.011600912,42,3,one,"('MOT', 'CHI')",Providence,eth47.xml,44,2,0,CHI,523,262,MOT
3,32,12,346,0.996744708,378,32,on,"('CHI', 'MOT')",Providence,eth47.xml,393,15,3,MOT,2138,4516,CHI
3,29,15,346,0.921609893,375,29,in,"('CHI', 'MOT')",Providence,eth47.xml,393,18,3,MOT,2138,4516,CHI
0,1,6,37,0.916290732,38,1,on,"('MOT', 'CHI')",Providence,eth47.xml,44,6,0,CHI,523,262,MOT
1,3,5,35,0.916290732,38,3,a,"('MOT', 'CHI')",Providence,eth47.xml,44,6,1,CHI,523,262,MOT
1,4,4,35,0.851371186,39,4,did,"('MOT', 'CHI')",Providence,eth47.xml,44,5,1,CHI,523,262,MOT
2,4,6,32,0.824175443,36,4,he,"('MOT', 'CHI')",Providence,eth47.xml,44,8,2,CHI,523,262,MOT
17,71,21,284,0.802561967,355,71,a,"('CHI', 'MOT')",Providence,eth47.xml,393,38,17,MOT,2138,4516,CHI
12,64,19,298,0.791208394,362,64,it,"('CHI', 'MOT')",Providence,eth47.xml,393,31,12,MOT,2138,4516,CHI
0,1,7,36,0.773189888,37,1,is,"('MOT', 'CHI')",Providence,eth47.xml,44,7,0,CHI,523,262,MOT
0,1,7,36,0.773189888,37,1,can,"('MOT', 'CHI')",Providence,eth47.xml,44,7,0,CHI,523,262,MOT
4,30,23,336,0.716237816,366,30,that,"('CHI', 'MOT')",Providence,eth47.xml,393,27,4,MOT,2138,4516,CHI
0,34,4,355,0.621600029,389,34,can,"('CHI', 'MOT')",Providence,eth47.xml,393,4,0,MOT,2138,4516,CHI
7,82,11,293,0.597113848,375,82,you,"('CHI', 'MOT')",Providence,eth47.xml,393,18,7,MOT,2138,4516,CHI
0,3,4,37,0.559615788,40,3,and,"('MOT', 'CHI')",Providence,eth47.xml,44,4,0,CHI,523,262,MOT
21,97,23,252,0.538219802,349,97,the,"('CHI', 'MOT')",Providence,eth47.xml,393,44,21,MOT,2138,4516,CHI
0,26,12,355,0.013140794,381,26,there,"('CHI', 'MOT')",Providence,eth47.xml,393,12,0,MOT,2138,4516,CHI
1,1,6,527,4.075652429,528,1,at,"('MOT', 'CHI')",Providence,eth48.xml,535,7,1,CHI,4405,3140,MOT
2,1,10,522,4.029806041,523,1,with,"('MOT', 'CHI')",Providence,eth48.xml,535,12,2,CHI,4405,3140,MOT
1,0,16,518,4.002537013,518,0,see,"('MOT', 'CHI')",Providence,eth48.xml,535,17,1,CHI,4405,3140,MOT
0,1,5,529,3.63758616,530,1,they,"('MOT', 'CHI')",Providence,eth48.xml,535,5,0,CHI,4405,3140,MOT
1,1,11,522,3.624340933,523,1,are,"('MOT', 'CHI')",Providence,eth48.xml,535,12,1,CHI,4405,3140,MOT
2,1,18,514,3.562465529,515,1,all,"('MOT', 'CHI')",Providence,eth48.xml,535,20,2,CHI,4405,3140,MOT
0,3,2,530,3.509678025,533,3,where,"('MOT', 'CHI')",Providence,eth48.xml,535,2,0,CHI,4405,3140,MOT
0,1,6,528,3.502173299,529,1,but,"('MOT', 'CHI')",Providence,eth48.xml,535,6,0,CHI,4405,3140,MOT
0,2,4,529,3.388149666,531,2,not,"('MOT', 'CHI')",Providence,eth48.xml,535,4,0,CHI,4405,3140,MOT
0,1,8,526,3.275256158,527,1,was,"('MOT', 'CHI')",Providence,eth48.xml,535,8,0,CHI,4405,3140,MOT
1,1,17,516,3.25617161,517,1,in,"('MOT', 'CHI')",Providence,eth48.xml,535,18,1,CHI,4405,3140,MOT
0,1,10,524,3.089146718,525,1,did,"('MOT', 'CHI')",Providence,eth48.xml,535,10,0,CHI,4405,3140,MOT
0,1,10,524,3.089146718,525,1,he,"('MOT', 'CHI')",Providence,eth48.xml,535,10,0,CHI,4405,3140,MOT
0,1,13,521,2.860294303,522,1,oh,"('MOT', 'CHI')",Providence,eth48.xml,535,13,0,CHI,4405,3140,MOT
0,4,6,525,2.585882567,529,4,my,"('MOT', 'CHI')",Providence,eth48.xml,535,6,0,CHI,4405,3140,MOT
0,1,19,515,2.512305624,516,1,wanna,"('MOT', 'CHI')",Providence,eth48.xml,535,19,0,CHI,4405,3140,MOT
1,3,20,511,2.417465369,514,3,go,"('MOT', 'CHI')",Providence,eth48.xml,535,21,1,CHI,4405,3140,MOT
0,1,21,513,2.417465369,514,1,do,"('MOT', 'CHI')",Providence,eth48.xml,535,21,0,CHI,4405,3140,MOT
1,5,13,516,2.388380453,521,5,for,"('MOT', 'CHI')",Providence,eth48.xml,535,14,1,CHI,4405,3140,MOT
0,5,7,523,2.28389296,528,5,put,"('MOT', 'CHI')",Providence,eth48.xml,535,7,0,CHI,4405,3140,MOT
0,7,5,523,2.251291799,530,7,big,"('MOT', 'CHI')",Providence,eth48.xml,535,5,0,CHI,4405,3140,MOT
1,6,13,515,2.234229773,521,6,gonna,"('MOT', 'CHI')",Providence,eth48.xml,535,14,1,CHI,4405,3140,MOT
0,2,17,516,2.210777544,518,2,think,"('MOT', 'CHI')",Providence,eth48.xml,535,17,0,CHI,4405,3140,MOT
1,4,21,509,2.149822338,513,4,little,"('MOT', 'CHI')",Providence,eth48.xml,535,22,1,CHI,4405,3140,MOT
7,13,25,490,2.138582117,503,13,one,"('MOT', 'CHI')",Providence,eth48.xml,535,32,7,CHI,4405,3140,MOT
1,6,15,513,2.112615315,519,6,can,"('MOT', 'CHI')",Providence,eth48.xml,535,16,1,CHI,4405,3140,MOT
4,7,35,489,2.027024381,496,7,and,"('MOT', 'CHI')",Providence,eth48.xml,535,39,4,CHI,4405,3140,MOT
1,4,24,506,2.026197027,510,4,have,"('MOT', 'CHI')",Providence,eth48.xml,535,25,1,CHI,4405,3140,MOT
0,3,16,516,1.979083923,519,3,some,"('MOT', 'CHI')",Providence,eth48.xml,535,16,0,CHI,4405,3140,MOT
2,7,23,503,1.961658506,510,7,of,"('MOT', 'CHI')",Providence,eth48.xml,535,25,2,CHI,4405,3140,MOT
0,3,19,513,1.819158443,516,3,this,"('MOT', 'CHI')",Providence,eth48.xml,535,19,0,CHI,4405,3140,MOT
0,3,21,511,1.724318188,514,3,like,"('MOT', 'CHI')",Providence,eth48.xml,535,21,0,CHI,4405,3140,MOT
0,2,30,503,1.664162812,505,2,yeah,"('MOT', 'CHI')",Providence,eth48.xml,535,30,0,CHI,4405,3140,MOT
0,7,11,517,1.620910314,524,7,up,"('MOT', 'CHI')",Providence,eth48.xml,535,11,0,CHI,4405,3140,MOT
0,3,24,508,1.595884946,511,3,there,"('MOT', 'CHI')",Providence,eth48.xml,535,24,0,CHI,4405,3140,MOT
6,39,16,474,1.323143765,513,39,make,"('MOT', 'CHI')",Providence,eth48.xml,535,22,6,CHI,4405,3140,MOT
1,6,36,492,1.298283484,498,6,that,"('MOT', 'CHI')",Providence,eth48.xml,535,37,1,CHI,4405,3140,MOT
0,2,44,489,1.273255489,491,2,we,"('MOT', 'CHI')",Providence,eth48.xml,535,44,0,CHI,4405,3140,MOT
13,26,55,441,1.24532799,467,26,it,"('MOT', 'CHI')",Providence,eth48.xml,535,68,13,CHI,4405,3140,MOT
1,10,24,500,1.237739667,510,10,what,"('MOT', 'CHI')",Providence,eth48.xml,535,25,1,CHI,4405,3140,MOT
0,8,17,510,1.112165255,518,8,on,"('MOT', 'CHI')",Providence,eth48.xml,535,17,0,CHI,4405,3140,MOT
3,19,34,479,0.94160854,498,19,is,"('MOT', 'CHI')",Providence,eth48.xml,535,37,3,CHI,4405,3140,MOT
0,5,31,499,0.938269639,504,5,to,"('MOT', 'CHI')",Providence,eth48.xml,535,31,0,CHI,4405,3140,MOT
18,48,75,394,0.594566352,442,48,the,"('MOT', 'CHI')",Providence,eth48.xml,535,93,18,CHI,4405,3140,MOT
0,29,8,498,0.567205957,527,29,look,"('MOT', 'CHI')",Providence,eth48.xml,535,8,0,CHI,4405,3140,MOT
30,64,90,351,0.488665112,415,64,a,"('MOT', 'CHI')",Providence,eth48.xml,535,120,30,CHI,4405,3140,MOT
6,25,96,408,0.118768743,433,25,you,"('MOT', 'CHI')",Providence,eth48.xml,535,102,6,CHI,4405,3140,MOT
1,0,5,434,4.691347882,434,0,my,"('MOT', 'CHI')",Providence,eth49.xml,440,6,1,CHI,4602,2480,MOT
0,1,4,435,3.597312261,436,1,not,"('MOT', 'CHI')",Providence,eth49.xml,440,4,0,CHI,4602,2480,MOT
4,4,6,426,3.583518938,430,4,big,"('MOT', 'CHI')",Providence,eth49.xml,440,10,4,CHI,4602,2480,MOT
0,1,5,434,3.440875865,435,1,where,"('MOT', 'CHI')",Providence,eth49.xml,440,5,0,CHI,4602,2480,MOT
0,1,6,433,3.305053521,434,1,was,"('MOT', 'CHI')",Providence,eth49.xml,440,6,0,CHI,4602,2480,MOT
1,1,13,425,3.286534473,426,1,want,"('MOT', 'CHI')",Providence,eth49.xml,440,14,1,CHI,4602,2480,MOT
0,2,4,434,3.191847152,436,2,they,"('MOT', 'CHI')",Providence,eth49.xml,440,4,0,CHI,4602,2480,MOT
1,1,15,423,3.164067588,424,1,do,"('MOT', 'CHI')",Providence,eth49.xml,440,16,1,CHI,4602,2480,MOT
2,3,11,424,3.065724645,427,3,gonna,"('MOT', 'CHI')",Providence,eth49.xml,440,13,2,CHI,4602,2480,MOT
2,3,11,424,3.065724645,427,3,put,"('MOT', 'CHI')",Providence,eth49.xml,440,13,2,CHI,4602,2480,MOT
0,2,6,432,2.899588413,434,2,get,"('MOT', 'CHI')",Providence,eth49.xml,440,6,0,CHI,4602,2480,MOT
3,3,20,414,2.818995095,417,3,with,"('MOT', 'CHI')",Providence,eth49.xml,440,23,3,CHI,4602,2480,MOT
0,1,11,428,2.808011552,429,1,for,"('MOT', 'CHI')",Providence,eth49.xml,440,11,0,CHI,4602,2480,MOT
1,2,17,420,2.648536074,422,2,up,"('MOT', 'CHI')",Providence,eth49.xml,440,18,1,CHI,4602,2480,MOT
1,2,18,419,2.597384633,421,2,have,"('MOT', 'CHI')",Providence,eth49.xml,440,19,1,CHI,4602,2480,MOT
0,2,9,429,2.574230167,431,2,but,"('MOT', 'CHI')",Providence,eth49.xml,440,9,0,CHI,4602,2480,MOT
1,2,20,417,2.50167351,419,2,in,"('MOT', 'CHI')",Providence,eth49.xml,440,21,1,CHI,4602,2480,MOT
0,2,11,427,2.402546444,429,2,little,"('MOT', 'CHI')",Providence,eth49.xml,440,11,0,CHI,4602,2480,MOT
1,2,23,414,2.371919786,416,2,some,"('MOT', 'CHI')",Providence,eth49.xml,440,24,1,CHI,4602,2480,MOT
1,4,16,419,2.191359458,423,4,all,"('MOT', 'CHI')",Providence,eth49.xml,440,17,1,CHI,4602,2480,MOT
0,2,17,421,2.009037901,423,2,wanna,"('MOT', 'CHI')",Providence,eth49.xml,440,17,0,CHI,4602,2480,MOT
0,3,13,424,1.967112357,427,3,are,"('MOT', 'CHI')",Providence,eth49.xml,440,13,0,CHI,4602,2480,MOT
1,5,17,417,1.955388893,422,5,go,"('MOT', 'CHI')",Providence,eth49.xml,440,18,1,CHI,4602,2480,MOT
0,8,5,427,1.936798469,435,8,look,"('MOT', 'CHI')",Providence,eth49.xml,440,5,0,CHI,4602,2480,MOT
8,8,46,378,1.935653649,386,8,and,"('MOT', 'CHI')",Providence,eth49.xml,440,54,8,CHI,4602,2480,MOT
3,2,68,367,1.913424694,369,2,you,"('MOT', 'CHI')",Providence,eth49.xml,440,71,3,CHI,4602,2480,MOT
0,5,9,426,1.881082986,431,5,at,"('MOT', 'CHI')",Providence,eth49.xml,440,9,0,CHI,4602,2480,MOT
2,7,25,406,1.680153437,413,7,on,"('MOT', 'CHI')",Providence,eth49.xml,440,27,2,CHI,4602,2480,MOT
4,13,22,401,1.668861333,414,13,can,"('MOT', 'CHI')",Providence,eth49.xml,440,26,4,CHI,4602,2480,MOT
0,2,28,410,1.526056303,412,2,yeah,"('MOT', 'CHI')",Providence,eth49.xml,440,28,0,CHI,4602,2480,MOT
3,15,19,403,1.47590652,418,15,one,"('MOT', 'CHI')",Providence,eth49.xml,440,22,3,CHI,4602,2480,MOT
4,16,24,396,1.400893161,412,16,this,"('MOT', 'CHI')",Providence,eth49.xml,440,28,4,CHI,4602,2480,MOT
2,4,55,379,1.364880267,383,4,we,"('MOT', 'CHI')",Providence,eth49.xml,440,57,2,CHI,4602,2480,MOT
0,4,20,416,1.344524948,420,4,like,"('MOT', 'CHI')",Providence,eth49.xml,440,20,0,CHI,4602,2480,MOT
2,8,33,397,1.299282984,405,8,of,"('MOT', 'CHI')",Providence,eth49.xml,440,35,2,CHI,4602,2480,MOT
5,14,38,383,1.266008195,397,14,he,"('MOT', 'CHI')",Providence,eth49.xml,440,43,5,CHI,4602,2480,MOT
4,10,45,381,1.253526619,391,10,to,"('MOT', 'CHI')",Providence,eth49.xml,440,49,4,CHI,4602,2480,MOT
13,18,76,333,1.050226901,351,18,the,"('MOT', 'CHI')",Providence,eth49.xml,440,89,13,CHI,4602,2480,MOT
4,18,32,386,1.033765933,404,18,is,"('MOT', 'CHI')",Providence,eth49.xml,440,36,4,CHI,4602,2480,MOT
0,7,19,414,0.9234082,421,7,what,"('MOT', 'CHI')",Providence,eth49.xml,440,19,0,CHI,4602,2480,MOT
30,33,87,290,0.912328369,323,33,a,"('MOT', 'CHI')",Providence,eth49.xml,440,117,30,CHI,4602,2480,MOT
1,14,21,404,0.84729786,418,14,make,"('MOT', 'CHI')",Providence,eth49.xml,440,22,1,CHI,4602,2480,MOT
1,9,36,394,0.730887509,403,9,there,"('MOT', 'CHI')",Providence,eth49.xml,440,37,1,CHI,4602,2480,MOT
1,19,25,395,0.395895657,414,19,that,"('MOT', 'CHI')",Providence,eth49.xml,440,26,1,CHI,4602,2480,MOT
2,23,67,348,-0.420542999,371,23,it,"('MOT', 'CHI')",Providence,eth49.xml,440,69,2,CHI,4602,2480,MOT
1,0,4,439,4.836281907,439,0,big,"('MOT', 'CHI')",Providence,eth50.xml,444,5,1,CHI,5128,2187,MOT
1,0,12,431,4.055834707,431,0,some,"('MOT', 'CHI')",Providence,eth50.xml,444,13,1,CHI,5128,2187,MOT
2,0,20,422,3.970291914,422,0,wanna,"('MOT', 'CHI')",Providence,eth50.xml,444,22,2,CHI,5128,2187,MOT
1,0,17,426,3.756538103,426,0,are,"('MOT', 'CHI')",Providence,eth50.xml,444,18,1,CHI,5128,2187,MOT
0,1,6,437,3.314186005,438,1,did,"('MOT', 'CHI')",Providence,eth50.xml,444,6,0,CHI,5128,2187,MOT
0,1,6,437,3.314186005,438,1,at,"('MOT', 'CHI')",Providence,eth50.xml,444,6,0,CHI,5128,2187,MOT
0,1,8,435,3.086486637,436,1,was,"('MOT', 'CHI')",Providence,eth50.xml,444,8,0,CHI,5128,2187,MOT
1,1,19,423,2.963396893,424,1,put,"('MOT', 'CHI')",Providence,eth50.xml,444,20,1,CHI,5128,2187,MOT
2,2,19,421,2.916594953,423,2,go,"('MOT', 'CHI')",Providence,eth50.xml,444,21,2,CHI,5128,2187,MOT
1,2,15,426,2.767948343,428,2,see,"('MOT', 'CHI')",Providence,eth50.xml,444,16,1,CHI,5128,2187,MOT
0,2,8,434,2.681021529,436,2,look,"('MOT', 'CHI')",Providence,eth50.xml,444,8,0,CHI,5128,2187,MOT
1,2,17,424,2.657925814,426,2,for,"('MOT', 'CHI')",Providence,eth50.xml,444,18,1,CHI,5128,2187,MOT
0,2,11,431,2.411784385,433,2,but,"('MOT', 'CHI')",Providence,eth50.xml,444,11,0,CHI,5128,2187,MOT
4,3,41,396,2.366957377,399,3,on,"('MOT', 'CHI')",Providence,eth50.xml,444,45,4,CHI,5128,2187,MOT
4,4,33,403,2.35015351,407,4,there,"('MOT', 'CHI')",Providence,eth50.xml,444,37,4,CHI,5128,2187,MOT
3,4,27,410,2.341805806,414,4,can,"('MOT', 'CHI')",Providence,eth50.xml,444,30,3,CHI,5128,2187,MOT
0,1,19,424,2.319114395,425,1,all,"('MOT', 'CHI')",Providence,eth50.xml,444,19,0,CHI,5128,2187,MOT
1,4,14,425,2.316604014,429,4,not,"('MOT', 'CHI')",Providence,eth50.xml,444,15,1,CHI,5128,2187,MOT
1,5,12,426,2.264075238,431,5,they,"('MOT', 'CHI')",Providence,eth50.xml,444,13,1,CHI,5128,2187,MOT
0,3,10,431,2.206441232,434,3,little,"('MOT', 'CHI')",Providence,eth50.xml,444,10,0,CHI,5128,2187,MOT
0,2,14,428,2.197224577,430,2,want,"('MOT', 'CHI')",Providence,eth50.xml,444,14,0,CHI,5128,2187,MOT
0,1,22,421,2.178532444,422,1,no,"('MOT', 'CHI')",Providence,eth50.xml,444,22,0,CHI,5128,2187,MOT
2,4,27,411,2.088273394,415,4,have,"('MOT', 'CHI')",Providence,eth50.xml,444,29,2,CHI,5128,2187,MOT
2,6,19,417,2.069297093,423,6,one,"('MOT', 'CHI')",Providence,eth50.xml,444,21,2,CHI,5128,2187,MOT
1,1,50,392,2.008593851,393,1,we,"('MOT', 'CHI')",Providence,eth50.xml,444,51,1,CHI,5128,2187,MOT
0,4,10,430,1.983297681,434,4,make,"('MOT', 'CHI')",Providence,eth50.xml,444,10,0,CHI,5128,2187,MOT
1,6,15,422,1.920650482,428,6,with,"('MOT', 'CHI')",Providence,eth50.xml,444,16,1,CHI,5128,2187,MOT
0,3,17,424,1.730723579,427,3,think,"('MOT', 'CHI')",Providence,eth50.xml,444,17,0,CHI,5128,2187,MOT
0,1,35,408,1.714528121,409,1,in,"('MOT', 'CHI')",Providence,eth50.xml,444,35,0,CHI,5128,2187,MOT
1,4,32,407,1.5518088,411,4,of,"('MOT', 'CHI')",Providence,eth50.xml,444,33,1,CHI,5128,2187,MOT
2,11,22,409,1.400614415,420,11,this,"('MOT', 'CHI')",Providence,eth50.xml,444,24,2,CHI,5128,2187,MOT
0,3,26,415,1.32175584,418,3,yeah,"('MOT', 'CHI')",Providence,eth50.xml,444,26,0,CHI,5128,2187,MOT
2,10,27,405,1.299816033,415,10,he,"('MOT', 'CHI')",Providence,eth50.xml,444,29,2,CHI,5128,2187,MOT
1,11,18,414,1.220502106,425,11,like,"('MOT', 'CHI')",Providence,eth50.xml,444,19,1,CHI,5128,2187,MOT
0,3,31,410,1.145476598,413,3,to,"('MOT', 'CHI')",Providence,eth50.xml,444,31,0,CHI,5128,2187,MOT
2,10,32,400,1.138221427,410,10,what,"('MOT', 'CHI')",Providence,eth50.xml,444,34,2,CHI,5128,2187,MOT
0,3,32,409,1.113211088,412,3,do,"('MOT', 'CHI')",Providence,eth50.xml,444,32,0,CHI,5128,2187,MOT
2,14,27,401,0.989661105,415,14,that,"('MOT', 'CHI')",Providence,eth50.xml,444,29,2,CHI,5128,2187,MOT
4,16,54,370,0.642885346,386,16,is,"('MOT', 'CHI')",Providence,eth50.xml,444,58,4,CHI,5128,2187,MOT
12,26,85,321,0.529064564,347,26,the,"('MOT', 'CHI')",Providence,eth50.xml,444,97,12,CHI,5128,2187,MOT
0,10,24,410,0.389013503,420,10,up,"('MOT', 'CHI')",Providence,eth50.xml,444,24,0,CHI,5128,2187,MOT
13,29,95,307,0.360425478,336,29,a,"('MOT', 'CHI')",Providence,eth50.xml,444,108,13,CHI,5128,2187,MOT
5,13,104,322,0.263254869,335,13,you,"('MOT', 'CHI')",Providence,eth50.xml,444,109,5,CHI,5128,2187,MOT
1,11,50,382,0.216834382,393,11,and,"('MOT', 'CHI')",Providence,eth50.xml,444,51,1,CHI,5128,2187,MOT
4,15,85,340,0.203725465,355,15,it,"('MOT', 'CHI')",Providence,eth50.xml,444,89,4,CHI,5128,2187,MOT
1,0,32,109,1.84732932,109,0,yeah,"('MOT', 'CHI')",Providence,lil01.xml,142,33,1,CHI,5049,313,MOT
1,0,0,4,1.386294361,4,0,for,"('TOY', 'MOT')",Providence,lil02.xml,5,1,1,MOT,60,67,TOY
0,1,21,134,1.091339529,135,1,yeah,"('MOT', 'CHI')",Providence,lil02.xml,156,21,0,CHI,3252,368,MOT
1,1,0,3,0.693147181,4,1,for,"('MOT', 'TOY')",Providence,lil02.xml,5,1,1,TOY,233,32,MOT
1,0,2,2,0.470003629,2,0,the,"('MOT', 'TOY')",Providence,lil02.xml,5,3,1,TOY,233,32,MOT
1,2,0,2,0.287682072,4,2,is,"('MOT', 'TOY')",Providence,lil02.xml,5,1,1,TOY,233,32,MOT
0,1,1,3,0,4,1,go,"('MOT', 'TOY')",Providence,lil02.xml,5,1,0,TOY,233,32,MOT
0,1,1,3,0,4,1,the,"('TOY', 'MOT')",Providence,lil02.xml,5,1,0,MOT,60,67,TOY
0,2,2,1,-0.875468737,3,2,you,"('TOY', 'MOT')",Providence,lil02.xml,5,2,0,MOT,60,67,TOY
0,1,1,12,0.916290732,13,1,want,"('MOT', 'TOY')",Providence,lil03.xml,14,1,0,TOY,116,120,MOT
0,1,2,11,0.559615788,12,1,a,"('MOT', 'TOY')",Providence,lil03.xml,14,2,0,TOY,116,120,MOT
1,2,2,9,0.550046337,11,2,to,"('MOT', 'TOY')",Providence,lil03.xml,14,3,1,TOY,116,120,MOT
0,2,1,11,0.510825624,13,2,is,"('MOT', 'TOY')",Providence,lil03.xml,14,1,0,TOY,116,120,MOT
1,4,1,8,0.336472237,12,4,the,"('MOT', 'TOY')",Providence,lil03.xml,14,2,1,TOY,116,120,MOT
0,2,4,8,-0.405465108,10,2,you,"('MOT', 'TOY')",Providence,lil03.xml,14,4,0,TOY,116,120,MOT
1,1,0,14,1.734601055,15,1,can,"('TOY', 'MOT')",Providence,lil04.xml,16,1,1,MOT,143,282,TOY
1,1,2,12,1.098612289,13,1,little,"('TOY', 'MOT')",Providence,lil04.xml,16,3,1,MOT,143,282,TOY
1,3,0,12,1.041453875,15,3,you,"('TOY', 'MOT')",Providence,lil04.xml,16,1,1,MOT,143,282,TOY
0,2,1,13,0.635988767,15,2,are,"('TOY', 'MOT')",Providence,lil04.xml,16,1,0,MOT,143,282,TOY
2,4,2,8,0.336472237,12,4,the,"('TOY', 'MOT')",Providence,lil04.xml,16,4,2,MOT,143,282,TOY
0,2,3,11,0,13,2,and,"('TOY', 'MOT')",Providence,lil04.xml,16,3,0,MOT,143,282,TOY
1,5,6,4,-0.897941593,9,5,a,"('TOY', 'MOT')",Providence,lil04.xml,16,7,1,MOT,143,282,TOY
1,0,0,9,1.992430165,9,0,we,"('TOY', 'MOT')",Providence,lil05.xml,10,1,1,MOT,70,98,TOY
1,0,0,9,1.992430165,9,0,look,"('TOY', 'MOT')",Providence,lil05.xml,10,1,1,MOT,70,98,TOY
1,0,0,9,1.992430165,9,0,all,"('TOY', 'MOT')",Providence,lil05.xml,10,1,1,MOT,70,98,TOY
1,1,0,18,1.945910149,19,1,can,"('OPE', 'MOT')",Providence,lil05.xml,20,1,1,MOT,107,238,OPE
0,1,11,162,1.847848936,163,1,what,"('MOT', 'CHI')",Providence,lil05.xml,174,11,0,CHI,2624,505,MOT
1,1,1,20,1.749199855,21,1,it,"('MOT', 'OPE')",Providence,lil05.xml,23,2,1,OPE,325,110,MOT
1,1,1,16,1.558144618,17,1,little,"('MOT', 'TOY')",Providence,lil05.xml,19,2,1,TOY,161,114,MOT
1,1,2,19,1.481604541,20,1,see,"('MOT', 'OPE')",Providence,lil05.xml,23,3,1,OPE,325,110,MOT
1,1,2,19,1.481604541,20,1,is,"('MOT', 'OPE')",Providence,lil05.xml,23,3,1,OPE,325,110,MOT
2,0,7,14,1.473305738,14,0,you,"('MOT', 'OPE')",Providence,lil05.xml,23,9,2,OPE,325,110,MOT
0,1,1,21,1.386294361,22,1,there,"('MOT', 'OPE')",Providence,lil05.xml,23,1,0,OPE,325,110,MOT
0,1,1,21,1.386294361,22,1,where,"('MOT', 'OPE')",Providence,lil05.xml,23,1,0,OPE,325,110,MOT
1,2,1,19,1.343734747,21,2,oh,"('MOT', 'OPE')",Providence,lil05.xml,23,2,1,OPE,325,110,MOT
1,0,2,7,1.280933845,7,0,a,"('TOY', 'MOT')",Providence,lil05.xml,10,3,1,MOT,70,98,TOY
0,1,1,18,1.252762968,19,1,one,"('OPE', 'MOT')",Providence,lil05.xml,20,1,0,MOT,107,238,OPE
1,2,1,16,1.203972804,18,2,the,"('OPE', 'MOT')",Providence,lil05.xml,20,2,1,MOT,107,238,OPE
0,1,2,20,1.056052674,21,1,little,"('MOT', 'OPE')",Providence,lil05.xml,23,2,0,OPE,325,110,MOT
0,1,2,20,1.056052674,21,1,she,"('MOT', 'OPE')",Providence,lil05.xml,23,2,0,OPE,325,110,MOT
0,2,1,20,0.980829253,22,2,can,"('MOT', 'OPE')",Providence,lil05.xml,23,1,0,OPE,325,110,MOT
0,1,2,17,0.916290732,18,1,is,"('OPE', 'MOT')",Providence,lil05.xml,20,2,0,MOT,107,238,OPE
0,2,1,17,0.84729786,19,2,oh,"('OPE', 'MOT')",Providence,lil05.xml,20,1,0,MOT,107,238,OPE
0,2,1,17,0.84729786,19,2,in,"('OPE', 'MOT')",Providence,lil05.xml,20,1,0,MOT,107,238,OPE
0,2,1,17,0.84729786,19,2,see,"('OPE', 'MOT')",Providence,lil05.xml,20,1,0,MOT,107,238,OPE
0,1,33,140,0.714349388,141,1,is,"('MOT', 'CHI')",Providence,lil05.xml,174,33,0,CHI,2624,505,MOT
1,0,4,5,0.693147181,5,0,one,"('TOY', 'MOT')",Providence,lil05.xml,10,5,1,MOT,70,98,TOY
0,2,2,19,0.650587566,21,2,in,"('MOT', 'OPE')",Providence,lil05.xml,23,2,0,OPE,325,110,MOT
0,1,1,8,0.606135804,9,1,you,"('TOY', 'MOT')",Providence,lil05.xml,10,1,0,MOT,70,98,TOY
0,1,1,8,0.606135804,9,1,can,"('TOY', 'MOT')",Providence,lil05.xml,10,1,0,MOT,70,98,TOY
1,3,2,13,0.587786665,16,3,the,"('MOT', 'TOY')",Providence,lil05.xml,19,3,1,TOY,161,114,MOT
0,3,1,16,0.559615788,19,3,a,"('OPE', 'MOT')",Providence,lil05.xml,20,1,0,MOT,107,238,OPE
2,6,1,11,0.487703206,17,6,you,"('OPE', 'MOT')",Providence,lil05.xml,20,3,2,MOT,107,238,OPE
7,6,1,5,0.395895657,11,6,a,"('MOT', 'TOY')",Providence,lil05.xml,19,8,7,TOY,161,114,MOT
0,4,1,15,0.336472237,19,4,do,"('OPE', 'MOT')",Providence,lil05.xml,20,1,0,MOT,107,238,OPE
0,2,4,17,0.15415068,19,2,that,"('MOT', 'OPE')",Providence,lil05.xml,23,4,0,OPE,325,110,MOT
0,4,2,14,0,18,4,what,"('OPE', 'MOT')",Providence,lil05.xml,20,2,0,MOT,107,238,OPE
1,1,0,0,0,1,1,one,"('OPE', 'TOY')",Providence,lil05.xml,2,1,1,TOY,13,8,OPE
0,2,5,16,-0.048790164,18,2,what,"('MOT', 'OPE')",Providence,lil05.xml,23,5,0,OPE,325,110,MOT
3,4,6,7,-0.056089467,11,4,that,"('OPE', 'MOT')",Providence,lil05.xml,20,9,3,MOT,107,238,OPE
0,3,1,6,-0.087011377,9,3,the,"('TOY', 'MOT')",Providence,lil05.xml,10,1,0,MOT,70,98,TOY
0,3,4,16,-0.133531393,19,3,a,"('MOT', 'OPE')",Providence,lil05.xml,23,4,0,OPE,325,110,MOT
0,2,6,15,-0.233614851,17,2,the,"('MOT', 'OPE')",Providence,lil05.xml,23,6,0,OPE,325,110,MOT
1,1,0,22,2.120263536,23,1,like,"('OPE', 'MOT')",Providence,lil06.xml,24,1,1,MOT,116,220,OPE
1,0,1,14,2.079441542,14,0,do,"('MOT', 'OPE')",Providence,lil06.xml,16,2,1,OPE,369,80,MOT
1,1,1,21,1.791759469,22,1,oh,"('OPE', 'MOT')",Providence,lil06.xml,24,2,1,MOT,116,220,OPE
1,2,0,21,1.714798428,23,2,at,"('OPE', 'MOT')",Providence,lil06.xml,24,1,1,MOT,116,220,OPE
1,0,3,12,1.540445041,12,0,like,"('MOT', 'OPE')",Providence,lil06.xml,16,4,1,OPE,369,80,MOT
0,1,1,22,1.427116356,23,1,in,"('OPE', 'MOT')",Providence,lil06.xml,24,1,0,MOT,116,220,OPE
0,1,1,22,1.427116356,23,1,with,"('OPE', 'MOT')",Providence,lil06.xml,24,1,0,MOT,116,220,OPE
0,1,1,22,1.427116356,23,1,one,"('OPE', 'MOT')",Providence,lil06.xml,24,1,0,MOT,116,220,OPE
0,1,1,22,1.427116356,23,1,where,"('OPE', 'MOT')",Providence,lil06.xml,24,1,0,MOT,116,220,OPE
1,4,0,19,1.203972804,23,4,a,"('OPE', 'MOT')",Providence,lil06.xml,24,1,1,MOT,116,220,OPE
1,1,2,12,1.098612289,13,1,it,"('MOT', 'OPE')",Providence,lil06.xml,16,3,1,OPE,369,80,MOT
0,1,1,14,1.041453875,15,1,oh,"('MOT', 'OPE')",Providence,lil06.xml,16,1,0,OPE,369,80,MOT
0,1,1,14,1.041453875,15,1,yeah,"('MOT', 'OPE')",Providence,lil06.xml,16,1,0,OPE,369,80,MOT
0,2,1,21,1.021651248,23,2,it,"('OPE', 'MOT')",Providence,lil06.xml,24,1,0,MOT,116,220,OPE
0,2,1,21,1.021651248,23,2,was,"('OPE', 'MOT')",Providence,lil06.xml,24,1,0,MOT,116,220,OPE
0,2,1,21,1.021651248,23,2,what,"('OPE', 'MOT')",Providence,lil06.xml,24,1,0,MOT,116,220,OPE
0,2,1,21,1.021651248,23,2,is,"('OPE', 'MOT')",Providence,lil06.xml,24,1,0,MOT,116,220,OPE
0,2,2,20,0.693147181,22,2,to,"('OPE', 'MOT')",Providence,lil06.xml,24,2,0,MOT,116,220,OPE
0,2,1,13,0.635988767,15,2,for,"('MOT', 'OPE')",Providence,lil06.xml,16,1,0,OPE,369,80,MOT
0,2,1,13,0.635988767,15,2,are,"('MOT', 'OPE')",Providence,lil06.xml,16,1,0,OPE,369,80,MOT
0,2,3,19,0.427444015,21,2,that,"('OPE', 'MOT')",Providence,lil06.xml,24,3,0,MOT,116,220,OPE
1,1,1,3,0.405465108,4,1,a,"('TOY', 'MOT')",Providence,lil06.xml,6,2,1,MOT,36,61,TOY
0,3,2,19,0.405465108,22,3,the,"('OPE', 'MOT')",Providence,lil06.xml,24,2,0,MOT,116,220,OPE
1,2,4,9,0.2135741,11,2,you,"('MOT', 'OPE')",Providence,lil06.xml,16,5,1,OPE,369,80,MOT
1,7,3,13,-0.087011377,20,7,you,"('OPE', 'MOT')",Providence,lil06.xml,24,4,1,MOT,116,220,OPE
0,2,4,10,-0.251314428,12,2,a,"('MOT', 'OPE')",Providence,lil06.xml,16,4,0,OPE,369,80,MOT
0,2,1,3,-0.251314428,5,2,the,"('TOY', 'MOT')",Providence,lil06.xml,6,1,0,MOT,36,61,TOY
0,3,3,10,-0.287682072,13,3,that,"('MOT', 'OPE')",Providence,lil06.xml,16,3,0,OPE,369,80,MOT
0,1,17,357,2.248517872,358,1,no,"('MOT', 'CHI')",Providence,lil10.xml,375,17,0,CHI,5025,1168,MOT
0,1,94,280,0.387951526,281,1,you,"('MOT', 'CHI')",Providence,lil10.xml,375,94,0,CHI,5025,1168,MOT
0,1,110,292,0.275329304,293,1,a,"('MOT', 'CHI')",Providence,lil11.xml,403,110,0,CHI,5460,1218,MOT
1,5,0,458,3.944812828,463,5,no,"('CHI', 'MOT')",Providence,lil12.xml,464,1,1,MOT,1540,4862,CHI
1,45,0,418,1.907930901,463,45,oh,"('CHI', 'MOT')",Providence,lil12.xml,464,1,1,MOT,1540,4862,CHI
1,60,0,403,1.625698433,463,60,yeah,"('CHI', 'MOT')",Providence,lil12.xml,464,1,1,MOT,1540,4862,CHI
2,2,65,385,1.729472839,387,2,oh,"('MOT', 'CHI')",Providence,lil13.xml,454,67,2,CHI,6286,1439,MOT
0,1,116,337,0.365113813,338,1,that,"('MOT', 'CHI')",Providence,lil13.xml,454,116,0,CHI,6286,1439,MOT
0,3,102,349,-0.161388347,352,3,a,"('MOT', 'CHI')",Providence,lil13.xml,454,102,0,CHI,6286,1439,MOT
2,3,1,114,2.882003508,117,3,no,"('CHI', 'MOT')",Providence,lil14.xml,120,3,2,MOT,401,2037,CHI
1,0,0,7,1.791759469,7,0,yeah,"('OPE', 'MOT')",Providence,lil14.xml,8,1,1,MOT,50,368,OPE
1,0,0,7,1.791759469,7,0,did,"('OPE', 'MOT')",Providence,lil14.xml,8,1,1,MOT,50,368,OPE
1,5,12,254,1.757857918,259,5,no,"('MOT', 'CHI')",Providence,lil14.xml,272,13,1,CHI,4518,869,MOT
2,18,0,100,1.555370691,118,18,oh,"('CHI', 'MOT')",Providence,lil14.xml,120,2,2,MOT,401,2037,CHI
1,0,1,6,1.386294361,6,0,on,"('OPE', 'MOT')",Providence,lil14.xml,8,2,1,MOT,50,368,OPE
1,1,0,6,1.098612289,7,1,think,"('OPE', 'MOT')",Providence,lil14.xml,8,1,1,MOT,50,368,OPE
1,1,2,9,0.875468737,10,1,like,"('MOT', 'OPE')",Providence,lil14.xml,13,3,1,OPE,313,110,MOT
1,1,2,9,0.875468737,10,1,that,"('MOT', 'OPE')",Providence,lil14.xml,13,3,1,OPE,313,110,MOT
0,1,1,11,0.84729786,12,1,go,"('MOT', 'OPE')",Providence,lil14.xml,13,1,0,OPE,313,110,MOT
0,1,1,11,0.84729786,12,1,for,"('MOT', 'OPE')",Providence,lil14.xml,13,1,0,OPE,313,110,MOT
0,1,1,11,0.84729786,12,1,we,"('MOT', 'OPE')",Providence,lil14.xml,13,1,0,OPE,313,110,MOT
0,1,1,11,0.84729786,12,1,do,"('MOT', 'OPE')",Providence,lil14.xml,13,1,0,OPE,313,110,MOT
1,2,0,5,0.693147181,7,2,a,"('OPE', 'MOT')",Providence,lil14.xml,8,1,1,MOT,50,368,OPE
1,2,0,5,0.693147181,7,2,she,"('OPE', 'MOT')",Providence,lil14.xml,8,1,1,MOT,50,368,OPE
1,2,0,5,0.693147181,7,2,to,"('OPE', 'MOT')",Providence,lil14.xml,8,1,1,MOT,50,368,OPE
1,2,0,5,0.693147181,7,2,and,"('OPE', 'MOT')",Providence,lil14.xml,8,1,1,MOT,50,368,OPE
2,2,0,4,0.693147181,6,2,that,"('OPE', 'MOT')",Providence,lil14.xml,8,2,2,MOT,50,368,OPE
1,1,3,8,0.606135804,9,1,and,"('MOT', 'OPE')",Providence,lil14.xml,13,4,1,OPE,313,110,MOT
0,1,2,10,0.485507816,11,1,with,"('MOT', 'OPE')",Providence,lil14.xml,13,2,0,OPE,313,110,MOT
0,1,2,10,0.485507816,11,1,on,"('MOT', 'OPE')",Providence,lil14.xml,13,2,0,OPE,313,110,MOT
0,3,36,233,0.448390153,236,3,oh,"('MOT', 'CHI')",Providence,lil14.xml,272,36,0,CHI,4518,869,MOT
0,2,1,10,0.441832752,12,2,get,"('MOT', 'OPE')",Providence,lil14.xml,13,1,0,OPE,313,110,MOT
0,1,1,6,0.405465108,7,1,wanna,"('OPE', 'MOT')",Providence,lil14.xml,8,1,0,MOT,50,368,OPE
2,3,0,3,0.405465108,6,3,the,"('OPE', 'MOT')",Providence,lil14.xml,8,2,2,MOT,50,368,OPE
0,1,3,9,0.182321557,10,1,of,"('MOT', 'OPE')",Providence,lil14.xml,13,3,0,OPE,313,110,MOT
0,1,3,9,0.182321557,10,1,she,"('MOT', 'OPE')",Providence,lil14.xml,13,3,0,OPE,313,110,MOT
0,1,3,9,0.182321557,10,1,is,"('MOT', 'OPE')",Providence,lil14.xml,13,3,0,OPE,313,110,MOT
0,2,2,9,0.080042708,11,2,in,"('MOT', 'OPE')",Providence,lil14.xml,13,2,0,OPE,313,110,MOT
1,1,0,0,0,1,1,to,"('MOT', 'TOY')",Providence,lil14.xml,2,1,1,TOY,42,32,MOT
0,2,3,8,-0.223143551,10,2,to,"('MOT', 'OPE')",Providence,lil14.xml,13,3,0,OPE,313,110,MOT
0,2,2,4,-0.405465108,6,2,you,"('OPE', 'MOT')",Providence,lil14.xml,8,2,0,MOT,50,368,OPE
0,1,6,6,-0.575364145,7,1,the,"('MOT', 'OPE')",Providence,lil14.xml,13,6,0,OPE,313,110,MOT
1,0,0,59,3.705408756,59,0,big,"('CHI', 'MOT')",Providence,lil15.xml,60,1,1,MOT,149,547,CHI
1,0,60,456,2.676881638,456,0,is,"('MOT', 'CHI')",Providence,lil15.xml,517,61,1,CHI,5933,1465,MOT
1,5,13,498,2.353357418,503,5,no,"('MOT', 'CHI')",Providence,lil15.xml,517,14,1,CHI,5933,1465,MOT
1,0,1,12,1.945910149,12,0,it,"('OPE', 'MOT')",Providence,lil15.xml,14,2,1,MOT,60,210,OPE
1,0,2,8,1.386294361,8,0,of,"('MOT', 'OPE')",Providence,lil15.xml,11,3,1,OPE,272,74,MOT
0,2,44,471,1.236061119,473,2,oh,"('MOT', 'CHI')",Providence,lil15.xml,517,44,0,CHI,5933,1465,MOT
1,0,3,7,1.098612289,7,0,to,"('MOT', 'OPE')",Providence,lil15.xml,11,4,1,OPE,272,74,MOT
1,3,0,10,0.916290732,13,3,what,"('OPE', 'MOT')",Providence,lil15.xml,14,1,1,MOT,60,210,OPE
0,1,1,12,0.916290732,13,1,like,"('OPE', 'MOT')",Providence,lil15.xml,14,1,0,MOT,60,210,OPE
0,1,1,12,0.916290732,13,1,not,"('OPE', 'MOT')",Providence,lil15.xml,14,1,0,MOT,60,210,OPE
0,1,1,9,0.693147181,10,1,this,"('MOT', 'OPE')",Providence,lil15.xml,11,1,0,OPE,272,74,MOT
0,1,1,9,0.693147181,10,1,at,"('MOT', 'OPE')",Providence,lil15.xml,11,1,0,OPE,272,74,MOT
1,3,1,9,0.559615788,12,3,are,"('OPE', 'MOT')",Providence,lil15.xml,14,2,1,MOT,60,210,OPE
0,2,1,11,0.510825624,13,2,oh,"('OPE', 'MOT')",Providence,lil15.xml,14,1,0,MOT,60,210,OPE
0,10,25,482,0.508803378,492,10,big,"('MOT', 'CHI')",Providence,lil15.xml,517,25,0,CHI,5933,1465,MOT
1,1,3,6,0.405465108,7,1,she,"('MOT', 'OPE')",Providence,lil15.xml,11,4,1,OPE,272,74,MOT
0,1,2,8,0.318453731,9,1,but,"('MOT', 'OPE')",Providence,lil15.xml,11,2,0,OPE,272,74,MOT
0,1,140,376,0.288561967,377,1,a,"('MOT', 'CHI')",Providence,lil15.xml,517,140,0,CHI,5933,1465,MOT
0,2,1,8,0.287682072,10,2,oh,"('MOT', 'OPE')",Providence,lil15.xml,11,1,0,OPE,272,74,MOT
0,2,1,8,0.287682072,10,2,have,"('MOT', 'OPE')",Providence,lil15.xml,11,1,0,OPE,272,74,MOT
0,2,1,8,0.287682072,10,2,do,"('MOT', 'OPE')",Providence,lil15.xml,11,1,0,OPE,272,74,MOT
2,4,2,6,0.182321557,10,4,you,"('OPE', 'MOT')",Providence,lil15.xml,14,4,2,MOT,60,210,OPE
0,2,2,10,0.15415068,12,2,she,"('OPE', 'MOT')",Providence,lil15.xml,14,2,0,MOT,60,210,OPE
0,1,3,7,0,8,1,you,"('MOT', 'OPE')",Providence,lil15.xml,11,3,0,OPE,272,74,MOT
0,1,3,7,0,8,1,like,"('MOT', 'OPE')",Providence,lil15.xml,11,3,0,OPE,272,74,MOT
0,1,4,6,-0.287682072,7,1,a,"('MOT', 'OPE')",Providence,lil15.xml,11,4,0,OPE,272,74,MOT
0,1,4,6,-0.287682072,7,1,and,"('MOT', 'OPE')",Providence,lil15.xml,11,4,0,OPE,272,74,MOT
0,1,5,5,-0.559615788,6,1,it,"('MOT', 'OPE')",Providence,lil15.xml,11,5,0,OPE,272,74,MOT
0,1,5,5,-0.559615788,6,1,is,"('MOT', 'OPE')",Providence,lil15.xml,11,5,0,OPE,272,74,MOT
2,0,1,128,4.356708827,128,0,no,"('CHI', 'MOT')",Providence,lil16.xml,131,3,2,MOT,454,1114,CHI
0,1,2,260,3.49271249,261,1,up,"('MOT', 'CHI')",Providence,lil16.xml,263,2,0,CHI,2212,835,MOT
1,0,1,47,3.198673118,47,0,go,"('MOT', 'FAT')",Providence,lil16.xml,49,2,1,FAT,300,232,MOT
1,0,1,47,3.198673118,47,0,there,"('MOT', 'FAT')",Providence,lil16.xml,49,2,1,FAT,300,232,MOT
1,0,0,23,2.813410717,23,0,of,"('FAT', 'MOT')",Providence,lil16.xml,24,1,1,MOT,196,161,FAT
1,0,0,22,2.772588722,22,0,like,"('OPE', 'MOT')",Providence,lil16.xml,23,1,1,MOT,129,181,OPE
1,0,0,22,2.772588722,22,0,it,"('OPE', 'MOT')",Providence,lil16.xml,23,1,1,MOT,129,181,OPE
1,0,0,22,2.772588722,22,0,what,"('OPE', 'MOT')",Providence,lil16.xml,23,1,1,MOT,129,181,OPE
1,0,4,44,2.575878428,44,0,yeah,"('MOT', 'FAT')",Providence,lil16.xml,49,5,1,FAT,300,232,MOT
1,1,1,46,2.505525937,47,1,can,"('MOT', 'FAT')",Providence,lil16.xml,49,2,1,FAT,300,232,MOT
1,1,1,46,2.505525937,47,1,one,"('MOT', 'FAT')",Providence,lil16.xml,49,2,1,FAT,300,232,MOT
3,0,9,37,2.410798678,37,0,you,"('MOT', 'FAT')",Providence,lil16.xml,49,12,3,FAT,300,232,MOT
1,0,2,20,2.174751721,20,0,gonna,"('OPE', 'MOT')",Providence,lil16.xml,23,3,1,MOT,129,181,OPE
1,1,2,40,2.151762203,41,1,are,"('MOT', 'OPE')",Providence,lil16.xml,44,3,1,OPE,383,211,MOT
1,3,12,247,2.128231706,250,3,no,"('MOT', 'CHI')",Providence,lil16.xml,263,13,1,CHI,2212,835,MOT
1,1,0,22,2.120263536,23,1,have,"('FAT', 'MOT')",Providence,lil16.xml,24,1,1,MOT,196,161,FAT
0,1,1,47,2.120263536,48,1,in,"('MOT', 'FAT')",Providence,lil16.xml,49,1,0,FAT,300,232,MOT
0,1,1,47,2.120263536,48,1,she,"('MOT', 'FAT')",Providence,lil16.xml,49,1,0,FAT,300,232,MOT
1,10,0,120,2.079441542,130,10,she,"('CHI', 'MOT')",Providence,lil16.xml,131,1,1,MOT,454,1114,CHI
1,1,0,21,2.079441542,22,1,she,"('OPE', 'MOT')",Providence,lil16.xml,23,1,1,MOT,129,181,OPE
0,1,1,42,2.014903021,43,1,what,"('MOT', 'OPE')",Providence,lil16.xml,44,1,0,OPE,383,211,MOT
0,1,1,42,2.014903021,43,1,put,"('MOT', 'OPE')",Providence,lil16.xml,44,1,0,OPE,383,211,MOT
0,1,1,42,2.014903021,43,1,at,"('MOT', 'OPE')",Providence,lil16.xml,44,1,0,OPE,383,211,MOT
1,1,3,39,1.945910149,40,1,like,"('MOT', 'OPE')",Providence,lil16.xml,44,4,1,OPE,383,211,MOT
1,1,4,43,1.882731247,44,1,to,"('MOT', 'FAT')",Providence,lil16.xml,49,5,1,FAT,300,232,MOT
0,1,2,46,1.812378756,47,1,have,"('MOT', 'FAT')",Providence,lil16.xml,49,2,0,FAT,300,232,MOT
0,1,2,46,1.812378756,47,1,this,"('MOT', 'FAT')",Providence,lil16.xml,49,2,0,FAT,300,232,MOT
1,1,1,21,1.791759469,22,1,what,"('FAT', 'MOT')",Providence,lil16.xml,24,2,1,MOT,196,161,FAT
1,14,0,116,1.769286613,130,14,with,"('CHI', 'MOT')",Providence,lil16.xml,131,1,1,MOT,454,1114,CHI
0,2,1,46,1.714798428,48,2,see,"('MOT', 'FAT')",Providence,lil16.xml,49,1,0,FAT,300,232,MOT
0,1,2,41,1.704748092,42,1,for,"('MOT', 'OPE')",Providence,lil16.xml,44,2,0,OPE,383,211,MOT
0,1,2,41,1.704748092,42,1,there,"('MOT', 'OPE')",Providence,lil16.xml,44,2,0,OPE,383,211,MOT
0,1,2,41,1.704748092,42,1,this,"('MOT', 'OPE')",Providence,lil16.xml,44,2,0,OPE,383,211,MOT
0,1,2,41,1.704748092,42,1,my,"('MOT', 'OPE')",Providence,lil16.xml,44,2,0,OPE,383,211,MOT
0,1,21,241,1.668526829,242,1,oh,"('MOT', 'CHI')",Providence,lil16.xml,263,21,0,CHI,2212,835,MOT
1,12,1,117,1.617100785,129,12,oh,"('CHI', 'MOT')",Providence,lil16.xml,131,2,1,MOT,454,1114,CHI
2,15,1,113,1.584120104,128,15,and,"('CHI', 'MOT')",Providence,lil16.xml,131,3,2,MOT,454,1114,CHI
2,3,0,19,1.504077397,22,3,do,"('FAT', 'MOT')",Providence,lil16.xml,24,2,2,MOT,196,161,FAT
0,1,3,40,1.458615023,41,1,it,"('MOT', 'OPE')",Providence,lil16.xml,44,3,0,OPE,383,211,MOT
0,1,3,40,1.458615023,41,1,think,"('MOT', 'OPE')",Providence,lil16.xml,44,3,0,OPE,383,211,MOT
2,3,4,40,1.439538876,43,3,the,"('MOT', 'FAT')",Providence,lil16.xml,49,6,2,FAT,300,232,MOT
0,1,1,22,1.427116356,23,1,one,"('FAT', 'MOT')",Providence,lil16.xml,24,1,0,MOT,196,161,FAT
0,10,1,120,1.386294361,130,10,is,"('CHI', 'MOT')",Providence,lil16.xml,131,1,0,MOT,454,1114,CHI
0,1,1,21,1.386294361,22,1,in,"('OPE', 'MOT')",Providence,lil16.xml,23,1,0,MOT,129,181,OPE
0,1,1,21,1.386294361,22,1,yeah,"('OPE', 'MOT')",Providence,lil16.xml,23,1,0,MOT,129,181,OPE
0,1,1,21,1.386294361,22,1,get,"('OPE', 'MOT')",Providence,lil16.xml,23,1,0,MOT,129,181,OPE
0,1,1,21,1.386294361,22,1,to,"('OPE', 'MOT')",Providence,lil16.xml,23,1,0,MOT,129,181,OPE
2,5,2,40,1.365240952,45,5,that,"('MOT', 'FAT')",Providence,lil16.xml,49,4,2,FAT,300,232,MOT
1,2,1,19,1.343734747,21,2,the,"('OPE', 'MOT')",Providence,lil16.xml,23,2,1,MOT,129,181,OPE
0,2,2,40,1.299282984,42,2,she,"('MOT', 'OPE')",Providence,lil16.xml,44,2,0,OPE,383,211,MOT
1,2,5,36,1.203972804,38,2,yeah,"('MOT', 'OPE')",Providence,lil16.xml,44,6,1,OPE,383,211,MOT
1,2,2,19,1.120591195,21,2,a,"('FAT', 'MOT')",Providence,lil16.xml,24,3,1,MOT,196,161,FAT
0,2,3,39,1.053149915,41,2,of,"('MOT', 'OPE')",Providence,lil16.xml,44,3,0,OPE,383,211,MOT
2,6,3,38,1.035433387,44,6,are,"('MOT', 'FAT')",Providence,lil16.xml,49,5,2,FAT,300,232,MOT
1,4,3,36,1.029619417,40,4,oh,"('MOT', 'OPE')",Providence,lil16.xml,44,4,1,OPE,383,211,MOT
0,2,1,21,1.021651248,23,2,this,"('FAT', 'MOT')",Providence,lil16.xml,24,1,0,MOT,196,161,FAT
0,2,1,21,1.021651248,23,2,to,"('FAT', 'MOT')",Providence,lil16.xml,24,1,0,MOT,196,161,FAT
0,5,1,43,1.021651248,48,5,and,"('MOT', 'FAT')",Providence,lil16.xml,49,1,0,FAT,300,232,MOT
0,1,6,37,0.916290732,38,1,and,"('MOT', 'OPE')",Providence,lil16.xml,44,6,0,OPE,383,211,MOT
1,3,5,35,0.916290732,38,3,you,"('MOT', 'OPE')",Providence,lil16.xml,44,6,1,OPE,383,211,MOT
1,4,4,35,0.851371186,39,4,that,"('MOT', 'OPE')",Providence,lil16.xml,44,5,1,OPE,383,211,MOT
2,3,8,31,0.810930216,34,3,a,"('MOT', 'OPE')",Providence,lil16.xml,44,10,2,OPE,383,211,MOT
0,2,2,20,0.693147181,22,2,is,"('FAT', 'MOT')",Providence,lil16.xml,24,2,0,MOT,196,161,FAT
0,3,1,19,0.693147181,22,3,is,"('OPE', 'MOT')",Providence,lil16.xml,23,1,0,MOT,129,181,OPE
0,2,5,37,0.669049629,39,2,the,"('MOT', 'OPE')",Providence,lil16.xml,44,5,0,OPE,383,211,MOT
0,2,2,19,0.650587566,21,2,that,"('OPE', 'MOT')",Providence,lil16.xml,23,2,0,MOT,129,181,OPE
0,1,4,19,0.606135804,20,1,the,"('FAT', 'MOT')",Providence,lil16.xml,24,4,0,MOT,196,161,FAT
0,3,5,41,0.496436886,44,3,a,"('MOT', 'FAT')",Providence,lil16.xml,49,5,0,FAT,300,232,MOT
0,3,5,41,0.496436886,44,3,is,"('MOT', 'FAT')",Providence,lil16.xml,49,5,0,FAT,300,232,MOT
0,2,3,19,0.427444015,21,2,and,"('FAT', 'MOT')",Providence,lil16.xml,24,3,0,MOT,196,161,FAT
1,5,2,16,0.427444015,21,5,that,"('FAT', 'MOT')",Providence,lil16.xml,24,3,1,MOT,196,161,FAT
2,8,1,13,0.427444015,21,8,you,"('FAT', 'MOT')",Providence,lil16.xml,24,3,2,MOT,196,161,FAT
0,3,2,19,0.405465108,22,3,with,"('FAT', 'MOT')",Providence,lil16.xml,24,2,0,MOT,196,161,FAT
1,7,5,36,0.340926587,43,7,what,"('MOT', 'FAT')",Providence,lil16.xml,49,6,1,FAT,300,232,MOT
1,7,2,13,0.09531018,20,7,you,"('OPE', 'MOT')",Providence,lil16.xml,23,3,1,MOT,129,181,OPE
0,4,3,16,-0.127833372,20,4,oh,"('OPE', 'MOT')",Providence,lil16.xml,23,3,0,MOT,129,181,OPE
0,5,3,15,-0.310154928,20,5,a,"('OPE', 'MOT')",Providence,lil16.xml,23,3,0,MOT,129,181,OPE
1,6,0,394,3.645076831,400,6,no,"('CHI', 'MOT')",Providence,lil17.xml,401,1,1,MOT,1740,4509,CHI
1,0,0,29,3.028522096,29,0,he,"('OP1', 'MOT')",Providence,lil17.xml,30,1,1,MOT,196,354,OP1
2,21,1,377,2.38959647,398,21,oh,"('CHI', 'MOT')",Providence,lil17.xml,401,3,2,MOT,1740,4509,CHI
1,23,1,376,2.122760416,399,23,on,"('CHI', 'MOT')",Providence,lil17.xml,401,2,1,MOT,1740,4509,CHI
1,2,0,27,1.929909808,29,2,did,"('OP1', 'MOT')",Providence,lil17.xml,30,1,1,MOT,196,354,OP1
0,1,1,28,1.642227735,29,1,for,"('OP1', 'MOT')",Providence,lil17.xml,30,1,0,MOT,196,354,OP1
0,1,1,28,1.642227735,29,1,one,"('OP1', 'MOT')",Providence,lil17.xml,30,1,0,MOT,196,354,OP1
2,2,0,14,1.504077397,16,2,a,"('MOT', 'OP1')",Providence,lil17.xml,18,2,2,OP1,68,106,MOT
0,2,1,27,1.236762627,29,2,what,"('OP1', 'MOT')",Providence,lil17.xml,30,1,0,MOT,196,354,OP1
0,2,1,27,1.236762627,29,2,that,"('OP1', 'MOT')",Providence,lil17.xml,30,1,0,MOT,196,354,OP1
0,2,1,27,1.236762627,29,2,think,"('OP1', 'MOT')",Providence,lil17.xml,30,1,0,MOT,196,354,OP1
1,2,3,24,1.134979933,26,2,little,"('OP1', 'MOT')",Providence,lil17.xml,30,4,1,MOT,196,354,OP1
0,1,3,26,1.064710737,27,1,of,"('OP1', 'MOT')",Providence,lil17.xml,30,3,0,MOT,196,354,OP1
0,1,3,26,1.064710737,27,1,is,"('OP1', 'MOT')",Providence,lil17.xml,30,3,0,MOT,196,354,OP1
0,3,1,26,0.949080555,29,3,oh,"('OP1', 'MOT')",Providence,lil17.xml,30,1,0,MOT,196,354,OP1
0,53,1,347,0.908855753,400,53,is,"('CHI', 'MOT')",Providence,lil17.xml,401,1,0,MOT,1740,4509,CHI
1,4,2,23,0.841567186,27,4,can,"('OP1', 'MOT')",Providence,lil17.xml,30,3,1,MOT,196,354,OP1
0,1,1,10,0.773189888,11,1,a,"('OP1', 'CHI')",Providence,lil17.xml,12,1,0,CHI,70,33,OP1
0,4,1,25,0.725937003,29,4,it,"('OP1', 'MOT')",Providence,lil17.xml,30,1,0,MOT,196,354,OP1
0,3,2,25,0.628608659,28,3,my,"('OP1', 'MOT')",Providence,lil17.xml,30,2,0,MOT,196,354,OP1
1,144,0,256,0.614253238,400,144,a,"('CHI', 'MOT')",Providence,lil17.xml,401,1,1,MOT,1740,4509,CHI
0,5,1,24,0.543615447,29,5,we,"('OP1', 'MOT')",Providence,lil17.xml,30,1,0,MOT,196,354,OP1
0,5,1,24,0.543615447,29,5,to,"('OP1', 'MOT')",Providence,lil17.xml,30,1,0,MOT,196,354,OP1
0,4,2,24,0.405465108,28,4,yeah,"('OP1', 'MOT')",Providence,lil17.xml,30,2,0,MOT,196,354,OP1
2,4,6,18,0.364643114,22,4,a,"('OP1', 'MOT')",Providence,lil17.xml,30,8,2,MOT,196,354,OP1
0,4,1,13,0.236388778,17,4,can,"('MOT', 'OP1')",Providence,lil17.xml,18,1,0,OP1,68,106,MOT
0,5,2,23,0.223143551,28,5,and,"('OP1', 'MOT')",Providence,lil17.xml,30,2,0,MOT,196,354,OP1
4,7,6,13,0.136132174,20,7,you,"('OP1', 'MOT')",Providence,lil17.xml,30,10,4,MOT,196,354,OP1
0,2,6,22,0.080042708,24,2,the,"('OP1', 'MOT')",Providence,lil17.xml,30,6,0,MOT,196,354,OP1
0,6,1,11,-0.100083459,17,6,that,"('MOT', 'OP1')",Providence,lil17.xml,18,1,0,OP1,68,106,MOT
0,4,2,12,-0.105360516,16,4,you,"('MOT', 'OP1')",Providence,lil17.xml,18,2,0,OP1,68,106,MOT
1,0,19,375,3.534349915,375,0,see,"('MOT', 'CHI')",Providence,lil18.xml,395,20,1,CHI,4924,1257,MOT
1,3,6,385,3.075774981,388,3,big,"('MOT', 'CHI')",Providence,lil18.xml,395,7,1,CHI,4924,1257,MOT
1,2,9,383,3.068052935,385,2,up,"('MOT', 'CHI')",Providence,lil18.xml,395,10,1,CHI,4924,1257,MOT
0,1,8,386,2.96784707,387,1,little,"('MOT', 'CHI')",Providence,lil18.xml,395,8,0,CHI,4924,1257,MOT
1,3,7,384,2.96784707,387,3,no,"('MOT', 'CHI')",Providence,lil18.xml,395,8,1,CHI,4924,1257,MOT
1,0,0,26,2.926739402,26,0,no,"('OPE', 'MOT')",Providence,lil18.xml,27,1,1,MOT,250,284,OPE
1,2,0,46,2.407945609,48,2,is,"('CHI', 'MOT')",Providence,lil18.xml,49,1,1,MOT,144,444,CHI
1,1,1,26,1.981001469,27,1,she,"('MOT', 'OPE')",Providence,lil18.xml,29,2,1,OPE,258,194,MOT
1,1,1,24,1.909542505,25,1,can,"('OPE', 'MOT')",Providence,lil18.xml,27,2,1,MOT,250,284,OPE
1,5,0,43,1.714798428,48,5,in,"('CHI', 'MOT')",Providence,lil18.xml,49,1,1,MOT,144,444,CHI
18,8,98,271,1.614884447,279,8,a,"('MOT', 'CHI')",Providence,lil18.xml,395,116,18,CHI,4924,1257,MOT
0,1,1,27,1.609437912,28,1,like,"('MOT', 'OPE')",Providence,lil18.xml,29,1,0,OPE,258,194,MOT
0,1,1,27,1.609437912,28,1,look,"('MOT', 'OPE')",Providence,lil18.xml,29,1,0,OPE,258,194,MOT
0,1,1,27,1.609437912,28,1,on,"('MOT', 'OPE')",Providence,lil18.xml,29,1,0,OPE,258,194,MOT
0,1,1,25,1.540445041,26,1,it,"('OPE', 'MOT')",Providence,lil18.xml,27,1,0,MOT,250,284,OPE
0,1,1,25,1.540445041,26,1,was,"('OPE', 'MOT')",Providence,lil18.xml,27,1,0,MOT,250,284,OPE
0,1,1,25,1.540445041,26,1,see,"('OPE', 'MOT')",Providence,lil18.xml,27,1,0,MOT,250,284,OPE
0,1,1,25,1.540445041,26,1,my,"('OPE', 'MOT')",Providence,lil18.xml,27,1,0,MOT,250,284,OPE
0,1,1,25,1.540445041,26,1,one,"('OPE', 'MOT')",Providence,lil18.xml,27,1,0,MOT,250,284,OPE
3,2,2,20,1.519825754,22,2,a,"('OPE', 'MOT')",Providence,lil18.xml,27,5,3,MOT,250,284,OPE
1,1,3,22,1.427116356,23,1,she,"('OPE', 'MOT')",Providence,lil18.xml,27,4,1,MOT,250,284,OPE
1,2,2,24,1.31730149,26,2,oh,"('MOT', 'OPE')",Providence,lil18.xml,29,3,1,OPE,258,194,MOT
0,1,2,26,1.287854288,27,1,in,"('MOT', 'OPE')",Providence,lil18.xml,29,2,0,OPE,258,194,MOT
0,1,2,26,1.287854288,27,1,of,"('MOT', 'OPE')",Providence,lil18.xml,29,2,0,OPE,258,194,MOT
2,2,85,306,1.247935928,308,2,and,"('MOT', 'CHI')",Providence,lil18.xml,395,87,2,CHI,4924,1257,MOT
0,1,2,24,1.216395324,25,1,in,"('OPE', 'MOT')",Providence,lil18.xml,27,2,0,MOT,250,284,OPE
0,1,2,24,1.216395324,25,1,like,"('OPE', 'MOT')",Providence,lil18.xml,27,2,0,MOT,250,284,OPE
0,1,2,24,1.216395324,25,1,have,"('OPE', 'MOT')",Providence,lil18.xml,27,2,0,MOT,250,284,OPE
0,1,2,24,1.216395324,25,1,for,"('OPE', 'MOT')",Providence,lil18.xml,27,2,0,MOT,250,284,OPE
0,1,2,24,1.216395324,25,1,did,"('OPE', 'MOT')",Providence,lil18.xml,27,2,0,MOT,250,284,OPE
0,1,2,24,1.216395324,25,1,little,"('OPE', 'MOT')",Providence,lil18.xml,27,2,0,MOT,250,284,OPE
0,1,2,24,1.216395324,25,1,to,"('OPE', 'MOT')",Providence,lil18.xml,27,2,0,MOT,250,284,OPE
0,1,2,24,1.216395324,25,1,on,"('OPE', 'MOT')",Providence,lil18.xml,27,2,0,MOT,250,284,OPE
0,2,1,26,1.203972804,28,2,what,"('MOT', 'OPE')",Providence,lil18.xml,29,1,0,OPE,258,194,MOT
0,2,1,26,1.203972804,28,2,do,"('MOT', 'OPE')",Providence,lil18.xml,29,1,0,OPE,258,194,MOT
1,6,34,354,1.027963331,360,6,oh,"('MOT', 'CHI')",Providence,lil18.xml,395,35,1,CHI,4924,1257,MOT
1,11,0,37,1.021651248,48,11,the,"('CHI', 'MOT')",Providence,lil18.xml,49,1,1,MOT,144,444,CHI
1,1,7,20,0.832909123,21,1,the,"('MOT', 'OPE')",Providence,lil18.xml,29,8,1,OPE,258,194,MOT
0,1,4,24,0.810930216,25,1,and,"('MOT', 'OPE')",Providence,lil18.xml,29,4,0,OPE,258,194,MOT
2,7,1,19,0.741937345,26,7,you,"('MOT', 'OPE')",Providence,lil18.xml,29,3,2,OPE,258,194,MOT
0,4,1,24,0.693147181,28,4,is,"('MOT', 'OPE')",Providence,lil18.xml,29,1,0,OPE,258,194,MOT
0,4,1,22,0.624154309,26,4,this,"('OPE', 'MOT')",Providence,lil18.xml,27,1,0,MOT,250,284,OPE
0,2,3,22,0.550046337,24,2,and,"('OPE', 'MOT')",Providence,lil18.xml,27,3,0,MOT,250,284,OPE
1,10,0,16,0.528844129,26,10,oh,"('OPE', 'MOT')",Providence,lil18.xml,27,1,1,MOT,250,284,OPE
0,3,2,22,0.523248144,25,3,yeah,"('OPE', 'MOT')",Providence,lil18.xml,27,2,0,MOT,250,284,OPE
0,3,2,22,0.523248144,25,3,we,"('OPE', 'MOT')",Providence,lil18.xml,27,2,0,MOT,250,284,OPE
0,3,2,22,0.523248144,25,3,do,"('OPE', 'MOT')",Providence,lil18.xml,27,2,0,MOT,250,284,OPE
2,9,1,17,0.518793793,26,9,that,"('MOT', 'OPE')",Providence,lil18.xml,29,3,2,OPE,258,194,MOT
0,1,6,22,0.446287103,23,1,a,"('MOT', 'OPE')",Providence,lil18.xml,29,6,0,OPE,258,194,MOT
2,4,5,16,0.382992252,20,4,you,"('OPE', 'MOT')",Providence,lil18.xml,27,7,2,MOT,250,284,OPE
0,3,3,23,0.336472237,26,3,we,"('MOT', 'OPE')",Providence,lil18.xml,29,3,0,OPE,258,194,MOT
0,3,4,20,0.040821995,23,3,that,"('OPE', 'MOT')",Providence,lil18.xml,27,4,0,MOT,250,284,OPE
0,3,4,20,0.040821995,23,3,the,"('OPE', 'MOT')",Providence,lil18.xml,27,4,0,MOT,250,284,OPE
0,6,2,19,-0.036367644,25,6,what,"('OPE', 'MOT')",Providence,lil18.xml,27,2,0,MOT,250,284,OPE
0,4,4,21,-0.105360516,25,4,this,"('MOT', 'OPE')",Providence,lil18.xml,29,4,0,OPE,258,194,MOT
0,7,3,17,-0.430782916,24,7,is,"('OPE', 'MOT')",Providence,lil18.xml,27,3,0,MOT,250,284,OPE
2,0,1,176,4.670957927,176,0,no,"('CHI', 'MOT')",Providence,lil19.xml,179,3,2,MOT,470,1336,CHI
1,0,0,68,3.843030134,68,0,want,"('MOT', 'OPE')",Providence,lil19.xml,69,1,1,OPE,466,447,MOT
1,0,13,242,3.417726684,242,0,one,"('MOT', 'CHI')",Providence,lil19.xml,256,14,1,CHI,3198,862,MOT
1,0,2,58,3.17805383,58,0,no,"('OPE', 'MOT')",Providence,lil19.xml,61,3,1,MOT,400,406,OPE
1,0,3,65,3.106080331,65,0,oh,"('MOT', 'OPE')",Providence,lil19.xml,69,4,1,OPE,466,447,MOT
1,1,0,59,3.028522096,60,1,at,"('OPE', 'MOT')",Providence,lil19.xml,61,1,1,MOT,400,406,OPE
1,0,4,56,2.807680042,56,0,one,"('OPE', 'MOT')",Providence,lil19.xml,61,5,1,MOT,400,406,OPE
3,8,1,167,2.573460047,175,8,a,"('CHI', 'MOT')",Providence,lil19.xml,179,4,3,MOT,470,1336,CHI
4,1,36,215,2.563116176,216,1,and,"('MOT', 'CHI')",Providence,lil19.xml,256,40,4,CHI,3198,862,MOT
0,1,1,67,2.456735773,68,1,there,"('MOT', 'OPE')",Providence,lil19.xml,69,1,0,OPE,466,447,MOT
0,1,1,67,2.456735773,68,1,my,"('MOT', 'OPE')",Providence,lil19.xml,69,1,0,OPE,466,447,MOT
1,2,1,65,2.442347035,67,2,put,"('MOT', 'OPE')",Providence,lil19.xml,69,2,1,OPE,466,447,MOT
0,1,1,59,2.335374916,60,1,like,"('OPE', 'MOT')",Providence,lil19.xml,61,1,0,MOT,400,406,OPE
0,1,1,59,2.335374916,60,1,for,"('OPE', 'MOT')",Providence,lil19.xml,61,1,0,MOT,400,406,OPE
0,1,1,59,2.335374916,60,1,we,"('OPE', 'MOT')",Providence,lil19.xml,61,1,0,MOT,400,406,OPE
0,1,1,59,2.335374916,60,1,put,"('OPE', 'MOT')",Providence,lil19.xml,61,1,0,MOT,400,406,OPE
2,4,0,55,2.213753879,59,4,look,"('OPE', 'MOT')",Providence,lil19.xml,61,2,2,MOT,400,406,OPE
0,1,2,66,2.154664963,67,1,for,"('MOT', 'OPE')",Providence,lil19.xml,69,2,0,OPE,466,447,MOT
3,8,8,237,2.133508763,245,8,no,"('MOT', 'CHI')",Providence,lil19.xml,256,11,3,CHI,3198,862,MOT
1,1,0,22,2.120263536,23,1,what,"('FAT', 'MOT')",Providence,lil19.xml,24,1,1,MOT,106,198,FAT
1,0,48,207,2.1036558,207,0,is,"('MOT', 'CHI')",Providence,lil19.xml,256,49,1,CHI,3198,862,MOT
1,2,2,56,2.079441542,58,2,on,"('OPE', 'MOT')",Providence,lil19.xml,61,3,1,MOT,400,406,OPE
0,2,1,66,2.051270665,68,2,gonna,"('MOT', 'OPE')",Providence,lil19.xml,69,1,0,OPE,466,447,MOT
0,2,1,66,2.051270665,68,2,see,"('MOT', 'OPE')",Providence,lil19.xml,69,1,0,OPE,466,447,MOT
0,1,2,58,2.031432322,59,1,my,"('OPE', 'MOT')",Providence,lil19.xml,61,2,0,MOT,400,406,OPE
1,1,5,54,1.963609726,55,1,a,"('OPE', 'MOT')",Providence,lil19.xml,61,6,1,MOT,400,406,OPE
2,2,20,155,1.890850372,157,2,yeah,"('CHI', 'MOT')",Providence,lil19.xml,179,22,2,MOT,470,1336,CHI
2,2,6,59,1.840549633,61,2,to,"('MOT', 'OPE')",Providence,lil19.xml,69,8,2,OPE,466,447,MOT
1,0,0,7,1.791759469,7,0,what,"('MOT', 'FAT')",Providence,lil19.xml,8,1,1,FAT,90,27,MOT
0,1,3,57,1.791759469,58,1,have,"('OPE', 'MOT')",Providence,lil19.xml,61,3,0,MOT,400,406,OPE
0,3,1,65,1.763588592,68,3,little,"('MOT', 'OPE')",Providence,lil19.xml,69,1,0,OPE,466,447,MOT
0,2,2,65,1.749199855,67,2,wanna,"('MOT', 'OPE')",Providence,lil19.xml,69,2,0,OPE,466,447,MOT
0,2,2,65,1.749199855,67,2,are,"('MOT', 'OPE')",Providence,lil19.xml,69,2,0,OPE,466,447,MOT
0,3,1,57,1.642227735,60,3,there,"('OPE', 'MOT')",Providence,lil19.xml,61,1,0,MOT,400,406,OPE
0,3,1,57,1.642227735,60,3,are,"('OPE', 'MOT')",Providence,lil19.xml,61,1,0,MOT,400,406,OPE
0,3,1,57,1.642227735,60,3,to,"('OPE', 'MOT')",Providence,lil19.xml,61,1,0,MOT,400,406,OPE
0,2,2,57,1.625967214,59,2,what,"('OPE', 'MOT')",Providence,lil19.xml,61,2,0,MOT,400,406,OPE
0,2,3,64,1.511457504,66,2,she,"('MOT', 'OPE')",Providence,lil19.xml,69,3,0,OPE,466,447,MOT
0,3,2,64,1.461517782,67,3,look,"('MOT', 'OPE')",Providence,lil19.xml,69,2,0,OPE,466,447,MOT
0,3,2,64,1.461517782,67,3,do,"('MOT', 'OPE')",Providence,lil19.xml,69,2,0,OPE,466,447,MOT
0,1,1,22,1.427116356,23,1,they,"('FAT', 'MOT')",Providence,lil19.xml,24,1,0,MOT,106,198,FAT
0,1,1,22,1.427116356,23,1,all,"('FAT', 'MOT')",Providence,lil19.xml,24,1,0,MOT,106,198,FAT
1,3,4,53,1.421385681,56,3,that,"('OPE', 'MOT')",Providence,lil19.xml,61,5,1,MOT,400,406,OPE
0,14,1,164,1.386294361,178,14,and,"('CHI', 'MOT')",Providence,lil19.xml,179,1,0,MOT,470,1336,CHI
1,2,1,20,1.386294361,22,2,to,"('FAT', 'MOT')",Providence,lil19.xml,24,2,1,MOT,106,198,FAT
2,3,8,56,1.338285142,59,3,the,"('MOT', 'OPE')",Providence,lil19.xml,69,10,2,OPE,466,447,MOT
1,7,1,52,1.338285142,59,7,the,"('OPE', 'MOT')",Providence,lil19.xml,61,2,1,MOT,400,406,OPE
0,2,4,63,1.314320861,65,2,we,"('MOT', 'OPE')",Providence,lil19.xml,69,4,0,OPE,466,447,MOT
1,3,29,223,1.270462546,226,3,oh,"('MOT', 'CHI')",Providence,lil19.xml,256,30,1,CHI,3198,862,MOT
0,4,2,63,1.238374231,67,4,what,"('MOT', 'OPE')",Providence,lil19.xml,69,2,0,OPE,466,447,MOT
1,2,8,50,1.185623666,52,2,this,"('OPE', 'MOT')",Providence,lil19.xml,61,9,1,MOT,400,406,OPE
0,2,5,62,1.145132304,64,2,in,"('MOT', 'OPE')",Providence,lil19.xml,69,5,0,OPE,466,447,MOT
0,1,7,53,1.134979933,54,1,yeah,"('OPE', 'MOT')",Providence,lil19.xml,61,7,0,MOT,400,406,OPE
2,7,3,49,1.133703608,56,7,oh,"('OPE', 'MOT')",Providence,lil19.xml,61,5,2,MOT,400,406,OPE
1,3,1,19,1.098612289,22,3,you,"('FAT', 'MOT')",Providence,lil19.xml,24,2,1,MOT,106,198,FAT
0,1,2,20,1.056052674,21,1,a,"('OPE', 'CHI')",Providence,lil19.xml,23,2,0,CHI,132,65,OPE
0,2,1,21,1.021651248,23,2,is,"('FAT', 'MOT')",Providence,lil19.xml,24,1,0,MOT,106,198,FAT
3,4,54,195,1.002623913,199,4,a,"('MOT', 'CHI')",Providence,lil19.xml,256,57,3,CHI,3198,862,MOT
0,4,3,62,1.00063188,66,4,one,"('MOT', 'OPE')",Providence,lil19.xml,69,3,0,OPE,466,447,MOT
0,2,6,61,0.99633344,63,2,can,"('MOT', 'OPE')",Providence,lil19.xml,69,6,0,OPE,466,447,MOT
0,4,3,54,0.875468737,58,4,is,"('OPE', 'MOT')",Providence,lil19.xml,61,3,0,MOT,400,406,OPE
0,4,3,54,0.875468737,58,4,do,"('OPE', 'MOT')",Providence,lil19.xml,61,3,0,MOT,400,406,OPE
0,1,44,211,0.844187438,212,1,that,"('MOT', 'CHI')",Providence,lil19.xml,256,44,0,CHI,3198,862,MOT
0,4,4,61,0.803495238,65,4,on,"('MOT', 'OPE')",Providence,lil19.xml,69,4,0,OPE,466,447,MOT
0,3,1,20,0.733969175,23,3,in,"('FAT', 'MOT')",Providence,lil19.xml,24,1,0,MOT,106,198,FAT
0,3,1,20,0.733969175,23,3,are,"('FAT', 'MOT')",Providence,lil19.xml,24,1,0,MOT,106,198,FAT
1,2,4,17,0.693147181,19,2,yeah,"('FAT', 'MOT')",Providence,lil19.xml,24,5,1,MOT,106,198,FAT
1,5,1,17,0.693147181,22,5,that,"('FAT', 'MOT')",Providence,lil19.xml,24,2,1,MOT,106,198,FAT
0,15,6,235,0.677398824,250,15,yeah,"('MOT', 'CHI')",Providence,lil19.xml,256,6,0,CHI,3198,862,MOT
0,6,3,60,0.664159644,66,6,this,"('MOT', 'OPE')",Providence,lil19.xml,69,3,0,OPE,466,447,MOT
0,4,6,59,0.485507816,63,4,a,"('MOT', 'OPE')",Providence,lil19.xml,69,6,0,OPE,466,447,MOT
0,2,3,19,0.427444015,21,2,oh,"('FAT', 'MOT')",Providence,lil19.xml,24,3,0,MOT,106,198,FAT
0,1,1,6,0.405465108,7,1,is,"('MOT', 'FAT')",Providence,lil19.xml,8,1,0,FAT,90,27,MOT
1,11,5,52,0.303186259,63,11,that,"('MOT', 'OPE')",Providence,lil19.xml,69,6,1,OPE,466,447,MOT
3,11,9,38,0.194156014,49,11,you,"('OPE', 'MOT')",Providence,lil19.xml,61,12,3,MOT,400,406,OPE
0,1,2,5,0,6,1,you,"('MOT', 'FAT')",Providence,lil19.xml,8,2,0,FAT,90,27,MOT
1,8,11,49,-0.065597282,57,8,you,"('MOT', 'OPE')",Providence,lil19.xml,69,12,1,OPE,466,447,MOT
0,7,7,47,-0.251314428,54,7,can,"('OPE', 'MOT')",Providence,lil19.xml,61,7,0,MOT,400,406,OPE
0,4,4,16,-0.310154928,20,4,the,"('FAT', 'MOT')",Providence,lil19.xml,24,4,0,MOT,106,198,FAT
0,7,9,53,-0.350202429,60,7,is,"('MOT', 'OPE')",Providence,lil19.xml,69,9,0,OPE,466,447,MOT
4,0,3,171,4.56550493,171,0,not,"('MOT', 'CHI')",Providence,lil20.xml,178,7,4,CHI,1919,576,MOT
1,0,4,173,3.912023005,173,0,all,"('MOT', 'CHI')",Providence,lil20.xml,178,5,1,CHI,1919,576,MOT
1,0,7,170,3.538056564,170,0,see,"('MOT', 'CHI')",Providence,lil20.xml,178,8,1,CHI,1919,576,MOT
0,1,1,176,3.395626337,177,1,big,"('MOT', 'CHI')",Providence,lil20.xml,178,1,0,CHI,1919,576,MOT
7,5,10,296,3.056975899,301,5,no,"('CHI', 'MOT')",Providence,lil20.xml,318,17,7,MOT,1145,3806,CHI
1,0,13,164,3.032546247,164,0,go,"('MOT', 'CHI')",Providence,lil20.xml,178,14,1,CHI,1919,576,MOT
0,5,1,312,2.874819345,317,5,want,"('CHI', 'MOT')",Providence,lil20.xml,318,1,0,MOT,1145,3806,CHI
5,1,21,151,2.803360381,152,1,a,"('MOT', 'CHI')",Providence,lil20.xml,178,26,5,CHI,1919,576,MOT
1,3,3,171,2.685577345,174,3,no,"('MOT', 'CHI')",Providence,lil20.xml,178,4,1,CHI,1919,576,MOT
1,12,1,304,2.503954845,316,12,this,"('CHI', 'MOT')",Providence,lil20.xml,318,2,1,MOT,1145,3806,CHI
1,21,0,296,2.268683541,317,21,do,"('CHI', 'MOT')",Providence,lil20.xml,318,1,1,MOT,1145,3806,CHI
2,14,3,299,2.197224577,313,14,it,"('CHI', 'MOT')",Providence,lil20.xml,318,5,2,MOT,1145,3806,CHI
1,1,2,33,1.974081026,34,1,she,"('OPE', 'MOT')",Providence,lil20.xml,37,3,1,MOT,162,444,OPE
0,1,1,37,1.897119985,38,1,my,"('MOT', 'OPE')",Providence,lil20.xml,39,1,0,OPE,495,207,MOT
0,1,1,37,1.897119985,38,1,on,"('MOT', 'OPE')",Providence,lil20.xml,39,1,0,OPE,495,207,MOT
1,0,7,31,1.887069649,31,0,to,"('MOT', 'OPE')",Providence,lil20.xml,39,8,1,OPE,495,207,MOT
0,1,1,35,1.84582669,36,1,we,"('OPE', 'MOT')",Providence,lil20.xml,37,1,0,MOT,162,444,OPE
0,1,1,35,1.84582669,36,1,this,"('OPE', 'MOT')",Providence,lil20.xml,37,1,0,MOT,162,444,OPE
0,1,1,35,1.84582669,36,1,no,"('OPE', 'MOT')",Providence,lil20.xml,37,1,0,MOT,162,444,OPE
1,34,0,283,1.804377933,317,34,is,"('CHI', 'MOT')",Providence,lil20.xml,318,1,1,MOT,1145,3806,CHI
0,1,2,36,1.584120104,37,1,go,"('MOT', 'OPE')",Providence,lil20.xml,39,2,0,OPE,495,207,MOT
0,1,2,36,1.584120104,37,1,look,"('MOT', 'OPE')",Providence,lil20.xml,39,2,0,OPE,495,207,MOT
0,1,2,36,1.584120104,37,1,can,"('MOT', 'OPE')",Providence,lil20.xml,39,2,0,OPE,495,207,MOT
0,1,2,34,1.531476371,35,1,is,"('OPE', 'MOT')",Providence,lil20.xml,37,2,0,MOT,162,444,OPE
1,3,1,32,1.531476371,35,3,think,"('OPE', 'MOT')",Providence,lil20.xml,37,2,1,MOT,162,444,OPE
5,45,2,266,1.512096686,311,45,oh,"('CHI', 'MOT')",Providence,lil20.xml,318,7,5,MOT,1145,3806,CHI
0,2,1,36,1.491654877,38,2,yeah,"('MOT', 'OPE')",Providence,lil20.xml,39,1,0,OPE,495,207,MOT
5,42,3,268,1.470977448,310,42,and,"('CHI', 'MOT')",Providence,lil20.xml,318,8,5,MOT,1145,3806,CHI
0,2,1,34,1.440361582,36,2,little,"('OPE', 'MOT')",Providence,lil20.xml,37,1,0,MOT,162,444,OPE
0,2,1,34,1.440361582,36,2,put,"('OPE', 'MOT')",Providence,lil20.xml,37,1,0,MOT,162,444,OPE
1,3,2,33,1.335001067,36,3,it,"('MOT', 'OPE')",Providence,lil20.xml,39,3,1,OPE,495,207,MOT
1,1,6,31,1.329135947,32,1,oh,"('MOT', 'OPE')",Providence,lil20.xml,39,7,1,OPE,495,207,MOT
0,2,2,35,1.178654996,37,2,of,"('MOT', 'OPE')",Providence,lil20.xml,39,2,0,OPE,495,207,MOT
0,2,2,35,1.178654996,37,2,was,"('MOT', 'OPE')",Providence,lil20.xml,39,2,0,OPE,495,207,MOT
0,2,2,35,1.178654996,37,2,she,"('MOT', 'OPE')",Providence,lil20.xml,39,2,0,OPE,495,207,MOT
0,3,1,33,1.15267951,36,3,go,"('OPE', 'MOT')",Providence,lil20.xml,37,1,0,MOT,162,444,OPE
0,3,1,33,1.15267951,36,3,in,"('OPE', 'MOT')",Providence,lil20.xml,37,1,0,MOT,162,444,OPE
1,7,0,29,1.15267951,36,7,like,"('OPE', 'MOT')",Providence,lil20.xml,37,1,1,MOT,162,444,OPE
0,3,1,33,1.15267951,36,3,for,"('OPE', 'MOT')",Providence,lil20.xml,37,1,0,MOT,162,444,OPE
0,10,7,301,1.15108334,311,10,yeah,"('CHI', 'MOT')",Providence,lil20.xml,318,7,0,MOT,1145,3806,CHI
0,2,2,33,1.126011263,35,2,see,"('OPE', 'MOT')",Providence,lil20.xml,37,2,0,MOT,162,444,OPE
0,2,2,33,1.126011263,35,2,do,"('OPE', 'MOT')",Providence,lil20.xml,37,2,0,MOT,162,444,OPE
1,3,3,30,1.070441412,33,3,oh,"('OPE', 'MOT')",Providence,lil20.xml,37,4,1,MOT,162,444,OPE
1,4,2,30,1.057790294,34,4,that,"('OPE', 'MOT')",Providence,lil20.xml,37,3,1,MOT,162,444,OPE
2,66,1,249,1.043383531,315,66,you,"('CHI', 'MOT')",Providence,lil20.xml,318,3,2,MOT,1145,3806,CHI
4,8,26,140,0.957112726,148,8,and,"('MOT', 'CHI')",Providence,lil20.xml,178,30,4,CHI,1919,576,MOT
2,6,2,27,0.916290732,33,6,you,"('OPE', 'MOT')",Providence,lil20.xml,37,4,2,MOT,162,444,OPE
0,3,2,32,0.83832919,35,3,can,"('OPE', 'MOT')",Providence,lil20.xml,37,2,0,MOT,162,444,OPE
3,43,8,264,0.770496647,307,43,a,"('CHI', 'MOT')",Providence,lil20.xml,318,11,3,MOT,1145,3806,CHI
0,4,2,31,0.615185639,35,4,what,"('OPE', 'MOT')",Providence,lil20.xml,37,2,0,MOT,162,444,OPE
0,1,1,8,0.606135804,9,1,this,"('OPE', 'CHI')",Providence,lil20.xml,10,1,0,CHI,47,46,OPE
0,1,1,8,0.606135804,9,1,no,"('OPE', 'CHI')",Providence,lil20.xml,10,1,0,CHI,47,46,OPE
2,8,3,24,0.481838087,32,8,a,"('OPE', 'MOT')",Providence,lil20.xml,37,5,2,MOT,162,444,OPE
0,2,5,30,0.481838087,32,2,yeah,"('OPE', 'MOT')",Providence,lil20.xml,37,5,0,MOT,162,444,OPE
0,5,2,30,0.432864082,35,5,to,"('OPE', 'MOT')",Providence,lil20.xml,37,2,0,MOT,162,444,OPE
0,3,4,32,0.432864082,35,3,that,"('MOT', 'OPE')",Providence,lil20.xml,39,4,0,OPE,495,207,MOT
3,3,12,21,0.424883194,24,3,you,"('MOT', 'OPE')",Providence,lil20.xml,39,15,3,OPE,495,207,MOT
0,8,1,28,0.341749294,36,8,it,"('OPE', 'MOT')",Providence,lil20.xml,37,1,0,MOT,162,444,OPE
0,1,10,28,0.255933374,29,1,and,"('MOT', 'OPE')",Providence,lil20.xml,39,10,0,OPE,495,207,MOT
0,3,5,31,0.251314428,34,3,is,"('MOT', 'OPE')",Providence,lil20.xml,39,5,0,OPE,495,207,MOT
0,1,2,7,0.223143551,8,1,oh,"('OPE', 'CHI')",Providence,lil20.xml,10,2,0,CHI,47,46,OPE
0,4,4,31,0.209720531,35,4,like,"('MOT', 'OPE')",Providence,lil20.xml,39,4,0,OPE,495,207,MOT
0,13,8,157,0.205852054,170,13,yeah,"('MOT', 'CHI')",Providence,lil20.xml,178,8,0,CHI,1919,576,MOT
0,1,12,26,0.03509132,27,1,the,"('MOT', 'OPE')",Providence,lil20.xml,39,12,0,OPE,495,207,MOT
0,4,7,28,-0.280301965,32,4,a,"('MOT', 'OPE')",Providence,lil20.xml,39,7,0,OPE,495,207,MOT
2,1,2,313,4.369447852,314,1,big,"('MOT', 'CHI')",Providence,lil21.xml,318,4,2,CHI,2876,1042,MOT
3,1,6,308,4.03504482,309,1,one,"('MOT', 'CHI')",Providence,lil21.xml,318,9,3,CHI,2876,1042,MOT
1,1,3,313,3.963982744,314,1,all,"('MOT', 'CHI')",Providence,lil21.xml,318,4,1,CHI,2876,1042,MOT
0,1,2,315,3.682609841,316,1,up,"('MOT', 'CHI')",Providence,lil21.xml,318,2,0,CHI,2876,1042,MOT
1,3,0,195,3.506557897,198,3,up,"('CHI', 'MOT')",Providence,lil21.xml,199,1,1,MOT,698,2258,CHI
1,3,0,195,3.506557897,198,3,all,"('CHI', 'MOT')",Providence,lil21.xml,199,1,1,MOT,698,2258,CHI
7,3,4,185,3.375221895,188,3,no,"('CHI', 'MOT')",Providence,lil21.xml,199,11,7,MOT,698,2258,CHI
1,4,0,194,3.283414346,198,4,big,"('CHI', 'MOT')",Providence,lil21.xml,199,1,1,MOT,698,2258,CHI
2,0,0,21,2.847812143,21,0,on,"('CHI', 'OPE')",Providence,lil21.xml,23,2,2,OPE,98,135,CHI
0,1,8,309,2.747270914,310,1,this,"('MOT', 'CHI')",Providence,lil21.xml,318,8,0,CHI,2876,1042,MOT
3,3,16,296,2.662587827,299,3,on,"('MOT', 'CHI')",Providence,lil21.xml,318,19,3,CHI,2876,1042,MOT
4,11,0,184,2.615975522,195,11,on,"('CHI', 'MOT')",Providence,lil21.xml,199,4,4,MOT,698,2258,CHI
1,1,1,50,2.583997552,51,1,go,"('MOT', 'OPE')",Providence,lil21.xml,53,2,1,OPE,731,289,MOT
0,1,11,306,2.475244739,307,1,can,"('MOT', 'CHI')",Providence,lil21.xml,318,11,0,CHI,2876,1042,MOT
1,0,1,21,2.442347035,21,0,and,"('CHI', 'OPE')",Providence,lil21.xml,23,2,1,OPE,98,135,CHI
1,1,25,291,2.351375257,292,1,that,"('MOT', 'CHI')",Providence,lil21.xml,318,26,1,CHI,2876,1042,MOT
0,3,3,193,2.292534757,196,3,this,"('CHI', 'MOT')",Providence,lil21.xml,199,3,0,MOT,698,2258,CHI
7,15,1,176,2.266957915,191,15,oh,"('CHI', 'MOT')",Providence,lil21.xml,199,8,7,MOT,698,2258,CHI
0,1,1,51,2.197224577,52,1,at,"('MOT', 'OPE')",Providence,lil21.xml,53,1,0,OPE,731,289,MOT
0,1,1,51,2.197224577,52,1,not,"('MOT', 'OPE')",Providence,lil21.xml,53,1,0,OPE,731,289,MOT
2,3,22,291,2.144580844,294,3,in,"('MOT', 'CHI')",Providence,lil21.xml,318,24,2,CHI,2876,1042,MOT
0,5,2,192,2.115250994,197,5,get,"('CHI', 'MOT')",Providence,lil21.xml,199,2,0,MOT,698,2258,CHI
1,1,2,31,1.916922612,32,1,she,"('OPE', 'MOT')",Providence,lil21.xml,35,3,1,MOT,237,363,OPE
0,1,2,50,1.890850372,51,1,have,"('MOT', 'OPE')",Providence,lil21.xml,53,2,0,OPE,731,289,MOT
0,1,2,50,1.890850372,51,1,look,"('MOT', 'OPE')",Providence,lil21.xml,53,2,0,OPE,731,289,MOT
0,1,2,50,1.890850372,51,1,my,"('MOT', 'OPE')",Providence,lil21.xml,53,2,0,OPE,731,289,MOT
0,1,2,50,1.890850372,51,1,are,"('MOT', 'OPE')",Providence,lil21.xml,53,2,0,OPE,731,289,MOT
7,21,8,282,1.875497521,303,21,no,"('MOT', 'CHI')",Providence,lil21.xml,318,15,7,CHI,2876,1042,MOT
3,3,23,170,1.832581464,173,3,yeah,"('CHI', 'MOT')",Providence,lil21.xml,199,26,3,MOT,698,2258,CHI
4,22,1,172,1.806148207,194,22,it,"('CHI', 'MOT')",Providence,lil21.xml,199,5,4,MOT,698,2258,CHI
0,1,1,33,1.791759469,34,1,for,"('OPE', 'MOT')",Providence,lil21.xml,35,1,0,MOT,237,363,OPE
0,1,1,33,1.791759469,34,1,this,"('OPE', 'MOT')",Providence,lil21.xml,35,1,0,MOT,237,363,OPE
0,1,1,33,1.791759469,34,1,see,"('OPE', 'MOT')",Providence,lil21.xml,35,1,0,MOT,237,363,OPE
0,1,1,33,1.791759469,34,1,all,"('OPE', 'MOT')",Providence,lil21.xml,35,1,0,MOT,237,363,OPE
0,1,1,33,1.791759469,34,1,my,"('OPE', 'MOT')",Providence,lil21.xml,35,1,0,MOT,237,363,OPE
2,1,62,253,1.760987811,254,1,the,"('MOT', 'CHI')",Providence,lil21.xml,318,64,2,CHI,2876,1042,MOT
2,1,8,42,1.727220948,43,1,the,"('MOT', 'OPE')",Providence,lil21.xml,53,10,2,OPE,731,289,MOT
0,1,3,49,1.648658626,50,1,was,"('MOT', 'OPE')",Providence,lil21.xml,53,3,0,OPE,731,289,MOT
0,2,18,298,1.616082455,300,2,go,"('MOT', 'CHI')",Providence,lil21.xml,318,18,0,CHI,2876,1042,MOT
1,3,27,287,1.58240924,290,3,oh,"('MOT', 'CHI')",Providence,lil21.xml,318,28,1,CHI,2876,1042,MOT
0,1,1,25,1.540445041,26,1,and,"('OPE', 'CHI')",Providence,lil21.xml,27,1,0,CHI,106,90,OPE
0,10,2,187,1.509115191,197,10,in,"('CHI', 'MOT')",Providence,lil21.xml,199,2,0,MOT,698,2258,CHI
0,2,2,49,1.485385264,51,2,with,"('MOT', 'OPE')",Providence,lil21.xml,53,2,0,OPE,731,289,MOT
0,2,2,49,1.485385264,51,2,they,"('MOT', 'OPE')",Providence,lil21.xml,53,2,0,OPE,731,289,MOT
0,1,2,32,1.47590652,33,1,but,"('OPE', 'MOT')",Providence,lil21.xml,35,2,0,MOT,237,363,OPE
0,1,2,32,1.47590652,33,1,one,"('OPE', 'MOT')",Providence,lil21.xml,35,2,0,MOT,237,363,OPE
0,1,2,32,1.47590652,33,1,on,"('OPE', 'MOT')",Providence,lil21.xml,35,2,0,MOT,237,363,OPE
3,36,0,160,1.454205567,196,36,the,"('CHI', 'MOT')",Providence,lil21.xml,199,3,3,MOT,698,2258,CHI
18,19,39,242,1.443323294,261,19,a,"('MOT', 'CHI')",Providence,lil21.xml,318,57,18,CHI,2876,1042,MOT
0,3,16,299,1.440361582,302,3,it,"('MOT', 'CHI')",Providence,lil21.xml,318,16,0,CHI,2876,1042,MOT
2,23,2,172,1.412002718,195,23,is,"('CHI', 'MOT')",Providence,lil21.xml,199,4,2,MOT,698,2258,CHI
0,2,3,48,1.243193517,50,2,this,"('MOT', 'OPE')",Providence,lil21.xml,53,3,0,OPE,731,289,MOT
0,2,3,48,1.243193517,50,2,can,"('MOT', 'OPE')",Providence,lil21.xml,53,3,0,OPE,731,289,MOT
0,1,3,31,1.223775432,32,1,think,"('OPE', 'MOT')",Providence,lil21.xml,35,3,0,MOT,237,363,OPE
1,3,2,29,1.223775432,32,3,a,"('OPE', 'MOT')",Providence,lil21.xml,35,3,1,MOT,237,363,OPE
0,1,2,24,1.216395324,25,1,is,"('OPE', 'CHI')",Providence,lil21.xml,27,2,0,CHI,106,90,OPE
0,2,1,24,1.134979933,26,2,it,"('OPE', 'CHI')",Providence,lil21.xml,27,1,0,CHI,106,90,OPE
14,26,15,144,1.125720607,170,26,a,"('CHI', 'MOT')",Providence,lil21.xml,199,29,14,MOT,698,2258,CHI
3,3,9,38,1.122142786,41,3,a,"('MOT', 'OPE')",Providence,lil21.xml,53,12,3,OPE,731,289,MOT
0,3,1,31,1.098612289,34,3,with,"('OPE', 'MOT')",Providence,lil21.xml,35,1,0,MOT,237,363,OPE
0,3,1,31,1.098612289,34,3,to,"('OPE', 'MOT')",Providence,lil21.xml,35,1,0,MOT,237,363,OPE
1,6,2,44,1.089042838,50,6,yeah,"('MOT', 'OPE')",Providence,lil21.xml,53,3,1,OPE,731,289,MOT
0,2,2,31,1.070441412,33,2,like,"('OPE', 'MOT')",Providence,lil21.xml,35,2,0,MOT,237,363,OPE
0,2,2,31,1.070441412,33,2,was,"('OPE', 'MOT')",Providence,lil21.xml,35,2,0,MOT,237,363,OPE
0,2,4,47,1.041453875,49,2,do,"('MOT', 'OPE')",Providence,lil21.xml,53,4,0,OPE,731,289,MOT
0,2,4,47,1.041453875,49,2,big,"('MOT', 'OPE')",Providence,lil21.xml,53,4,0,OPE,731,289,MOT
0,2,4,47,1.041453875,49,2,on,"('MOT', 'OPE')",Providence,lil21.xml,53,4,0,OPE,731,289,MOT
7,18,33,260,1.032122547,278,18,and,"('MOT', 'CHI')",Providence,lil21.xml,318,40,7,CHI,2876,1042,MOT
0,1,7,45,0.980829253,46,1,and,"('MOT', 'OPE')",Providence,lil21.xml,53,7,0,OPE,731,289,MOT
2,4,7,40,0.9199205,44,4,is,"('MOT', 'OPE')",Providence,lil21.xml,53,9,2,OPE,731,289,MOT
5,30,8,156,0.886164026,186,30,and,"('CHI', 'MOT')",Providence,lil21.xml,199,13,5,MOT,698,2258,CHI
0,2,5,46,0.867500568,48,2,like,"('MOT', 'OPE')",Providence,lil21.xml,53,5,0,OPE,731,289,MOT
0,2,2,23,0.810930216,25,2,oh,"('OPE', 'CHI')",Providence,lil21.xml,27,2,0,CHI,106,90,OPE
0,15,7,296,0.776389891,311,15,yeah,"('MOT', 'CHI')",Providence,lil21.xml,318,7,0,CHI,2876,1042,MOT
1,2,11,39,0.716677678,41,2,she,"('MOT', 'OPE')",Providence,lil21.xml,53,12,1,OPE,731,289,MOT
0,2,6,45,0.713766468,47,2,little,"('MOT', 'OPE')",Providence,lil21.xml,53,6,0,OPE,731,289,MOT
2,14,26,276,0.666118508,290,14,is,"('MOT', 'CHI')",Providence,lil21.xml,318,28,2,CHI,2876,1042,MOT
0,2,2,19,0.650587566,21,2,is,"('CHI', 'OPE')",Providence,lil21.xml,23,2,0,OPE,98,135,CHI
1,4,7,41,0.631271777,45,4,that,"('MOT', 'OPE')",Providence,lil21.xml,53,8,1,OPE,731,289,MOT
1,3,9,40,0.628608659,43,3,oh,"('MOT', 'OPE')",Providence,lil21.xml,53,10,1,OPE,731,289,MOT
0,4,2,29,0.559615788,33,4,we,"('OPE', 'MOT')",Providence,lil21.xml,35,2,0,MOT,237,363,OPE
3,3,5,12,0.530628251,15,3,a,"('CHI', 'OPE')",Providence,lil21.xml,23,8,3,OPE,98,135,CHI
0,4,4,45,0.530628251,49,4,there,"('MOT', 'OPE')",Providence,lil21.xml,53,4,0,OPE,731,289,MOT
0,4,3,28,0.3074847,32,4,oh,"('OPE', 'MOT')",Providence,lil21.xml,35,3,0,MOT,237,363,OPE
0,4,3,28,0.3074847,32,4,that,"('OPE', 'MOT')",Providence,lil21.xml,35,3,0,MOT,237,363,OPE
0,3,3,21,0.262364264,24,3,yeah,"('OPE', 'CHI')",Providence,lil21.xml,27,3,0,CHI,106,90,OPE
0,6,2,27,0.223143551,33,6,you,"('OPE', 'MOT')",Providence,lil21.xml,35,2,0,MOT,237,363,OPE
0,2,4,17,0.15415068,19,2,yeah,"('CHI', 'OPE')",Providence,lil21.xml,23,4,0,OPE,98,135,CHI
0,4,4,27,0.09531018,31,4,yeah,"('OPE', 'MOT')",Providence,lil21.xml,35,4,0,MOT,237,363,OPE
0,7,3,25,-0.162518929,32,7,and,"('OPE', 'MOT')",Providence,lil21.xml,35,3,0,MOT,237,363,OPE
0,7,2,18,-0.169899037,25,7,a,"('OPE', 'CHI')",Providence,lil21.xml,27,2,0,CHI,106,90,OPE
1,5,14,33,-0.242946179,38,5,you,"('MOT', 'OPE')",Providence,lil21.xml,53,15,1,OPE,731,289,MOT
0,6,7,40,-0.271933715,46,6,it,"('MOT', 'OPE')",Providence,lil21.xml,53,7,0,OPE,731,289,MOT
0,7,4,24,-0.374693449,31,7,the,"('OPE', 'MOT')",Providence,lil21.xml,35,4,0,MOT,237,363,OPE
0,4,7,24,-0.405465108,28,4,it,"('OPE', 'MOT')",Providence,lil21.xml,35,7,0,MOT,237,363,OPE
1,0,0,175,4.770684624,175,0,not,"('MOT', 'CHI')",Providence,lil22.xml,176,1,1,CHI,1844,560,MOT
1,0,0,44,3.423176288,44,0,they,"('FAT', 'MOT')",Providence,lil22.xml,45,1,1,MOT,225,575,FAT
12,5,7,270,3.352684957,275,5,no,"('CHI', 'MOT')",Providence,lil22.xml,294,19,12,MOT,992,3117,CHI
1,6,0,287,3.335600099,293,6,my,"('CHI', 'MOT')",Providence,lil22.xml,294,1,1,MOT,992,3117,CHI
1,7,0,286,3.202068707,293,7,up,"('CHI', 'MOT')",Providence,lil22.xml,294,1,1,MOT,992,3117,CHI
1,7,0,286,3.202068707,293,7,big,"('CHI', 'MOT')",Providence,lil22.xml,294,1,1,MOT,992,3117,CHI
0,1,2,173,3.091042453,174,1,my,"('MOT', 'CHI')",Providence,lil22.xml,176,2,0,CHI,1844,560,MOT
0,1,2,173,3.091042453,174,1,big,"('MOT', 'CHI')",Providence,lil22.xml,176,2,0,CHI,1844,560,MOT
1,8,0,285,3.084285671,293,8,there,"('CHI', 'MOT')",Providence,lil22.xml,294,1,1,MOT,992,3117,CHI
1,0,14,161,2.953684037,161,0,that,"('MOT', 'CHI')",Providence,lil22.xml,176,15,1,CHI,1844,560,MOT
2,6,3,283,2.880115258,289,6,one,"('CHI', 'MOT')",Providence,lil22.xml,294,5,2,MOT,992,3117,CHI
0,5,1,288,2.796603598,293,5,get,"('CHI', 'MOT')",Providence,lil22.xml,294,1,0,MOT,992,3117,CHI
3,14,0,277,2.748978857,291,14,in,"('CHI', 'MOT')",Providence,lil22.xml,294,3,3,MOT,992,3117,CHI
3,0,5,37,2.747270914,37,0,oh,"('MOT', 'FAT')",Providence,lil22.xml,45,8,3,FAT,356,254,MOT
1,1,0,43,2.730029108,44,1,can,"('MOT', 'FAT')",Providence,lil22.xml,45,1,1,FAT,356,254,MOT
0,1,4,171,2.674148649,172,1,some,"('MOT', 'CHI')",Providence,lil22.xml,176,4,0,CHI,1844,560,MOT
1,0,1,25,2.602689685,25,0,no,"('CHI', 'FAT')",Providence,lil22.xml,27,2,1,FAT,93,121,CHI
1,0,0,18,2.590267165,18,0,but,"('OPE', 'MOT')",Providence,lil22.xml,19,1,1,MOT,97,170,OPE
1,0,1,21,2.442347035,21,0,in,"('MOT', 'OPE')",Providence,lil22.xml,23,2,1,OPE,156,98,MOT
1,13,1,279,2.351375257,292,13,look,"('CHI', 'MOT')",Providence,lil22.xml,294,2,1,MOT,992,3117,CHI
1,2,0,42,2.324564,44,2,big,"('FAT', 'MOT')",Providence,lil22.xml,45,1,1,MOT,225,575,FAT
3,19,1,271,2.275556421,290,19,on,"('CHI', 'MOT')",Providence,lil22.xml,294,4,3,MOT,992,3117,CHI
0,1,7,168,2.251291799,169,1,go,"('MOT', 'CHI')",Providence,lil22.xml,176,7,0,CHI,1844,560,MOT
1,1,2,41,2.174751721,42,1,want,"('MOT', 'FAT')",Providence,lil22.xml,45,3,1,FAT,356,254,MOT
4,20,2,268,2.155354856,288,20,it,"('CHI', 'MOT')",Providence,lil22.xml,294,6,4,MOT,992,3117,CHI
0,1,8,167,2.140066163,168,1,they,"('MOT', 'CHI')",Providence,lil22.xml,176,8,0,CHI,1844,560,MOT
0,11,1,282,2.103456418,293,11,go,"('CHI', 'MOT')",Providence,lil22.xml,294,1,0,MOT,992,3117,CHI
0,1,9,166,2.038856262,167,1,are,"('MOT', 'CHI')",Providence,lil22.xml,176,9,0,CHI,1844,560,MOT
0,1,1,43,2.036881927,44,1,go,"('FAT', 'MOT')",Providence,lil22.xml,45,1,0,MOT,225,575,FAT
0,1,1,43,2.036881927,44,1,put,"('FAT', 'MOT')",Providence,lil22.xml,45,1,0,MOT,225,575,FAT
0,1,1,43,2.036881927,44,1,go,"('MOT', 'FAT')",Providence,lil22.xml,45,1,0,FAT,356,254,MOT
0,1,1,43,2.036881927,44,1,was,"('MOT', 'FAT')",Providence,lil22.xml,45,1,0,FAT,356,254,MOT
0,1,1,43,2.036881927,44,1,all,"('MOT', 'FAT')",Providence,lil22.xml,45,1,0,FAT,356,254,MOT
1,2,1,41,2.014903021,43,2,is,"('FAT', 'MOT')",Providence,lil22.xml,45,2,1,MOT,225,575,FAT
1,2,1,41,2.014903021,43,2,do,"('FAT', 'MOT')",Providence,lil22.xml,45,2,1,MOT,225,575,FAT
1,2,1,41,2.014903021,43,2,on,"('MOT', 'FAT')",Providence,lil22.xml,45,2,1,FAT,356,254,MOT
1,0,3,19,1.945910149,19,0,and,"('MOT', 'OPE')",Providence,lil22.xml,23,4,1,OPE,156,98,MOT
1,1,20,154,1.920751589,155,1,in,"('MOT', 'CHI')",Providence,lil22.xml,176,21,1,CHI,1844,560,MOT
1,1,0,17,1.897119985,18,1,she,"('OPE', 'MOT')",Providence,lil22.xml,19,1,1,MOT,97,170,OPE
0,1,11,164,1.859897274,165,1,get,"('MOT', 'CHI')",Providence,lil22.xml,176,11,0,CHI,1844,560,MOT
0,1,11,164,1.859897274,165,1,on,"('MOT', 'CHI')",Providence,lil22.xml,176,11,0,CHI,1844,560,MOT
0,3,5,168,1.821087084,171,3,one,"('MOT', 'CHI')",Providence,lil22.xml,176,5,0,CHI,1844,560,MOT
1,0,0,7,1.791759469,7,0,this,"('FAT', 'OPE')",Providence,lil22.xml,8,1,1,OPE,28,65,FAT
1,0,0,7,1.791759469,7,0,and,"('FAT', 'OPE')",Providence,lil22.xml,8,1,1,OPE,28,65,FAT
1,0,0,7,1.791759469,7,0,no,"('OPE', 'FAT')",Providence,lil22.xml,8,1,1,FAT,41,32,OPE
1,1,4,39,1.791759469,40,1,yeah,"('MOT', 'FAT')",Providence,lil22.xml,45,5,1,FAT,356,254,MOT
1,1,4,39,1.791759469,40,1,to,"('MOT', 'FAT')",Providence,lil22.xml,45,5,1,FAT,356,254,MOT
1,3,11,161,1.779783278,164,3,see,"('MOT', 'CHI')",Providence,lil22.xml,176,12,1,CHI,1844,560,MOT
0,4,4,168,1.757857918,172,4,this,"('MOT', 'CHI')",Providence,lil22.xml,176,4,0,CHI,1844,560,MOT
0,1,2,42,1.727220948,43,1,little,"('FAT', 'MOT')",Providence,lil22.xml,45,2,0,MOT,225,575,FAT
0,1,2,42,1.727220948,43,1,my,"('FAT', 'MOT')",Providence,lil22.xml,45,2,0,MOT,225,575,FAT
0,1,2,42,1.727220948,43,1,he,"('MOT', 'FAT')",Providence,lil22.xml,45,2,0,FAT,356,254,MOT
1,0,1,9,1.704748092,9,0,oh,"('OPE', 'CHI')",Providence,lil22.xml,11,2,1,CHI,65,40,OPE
1,4,18,271,1.663204337,275,4,yeah,"('CHI', 'MOT')",Providence,lil22.xml,294,19,1,MOT,992,3117,CHI
4,1,53,118,1.634543834,119,1,you,"('MOT', 'CHI')",Providence,lil22.xml,176,57,4,CHI,1844,560,MOT
1,1,5,38,1.634130525,39,1,it,"('MOT', 'FAT')",Providence,lil22.xml,45,6,1,FAT,356,254,MOT
0,2,1,42,1.631416819,44,2,what,"('FAT', 'MOT')",Providence,lil22.xml,45,1,0,MOT,225,575,FAT
1,5,0,39,1.631416819,44,5,she,"('FAT', 'MOT')",Providence,lil22.xml,45,1,1,MOT,225,575,FAT
0,2,1,42,1.631416819,44,2,no,"('FAT', 'MOT')",Providence,lil22.xml,45,1,0,MOT,225,575,FAT
0,2,1,42,1.631416819,44,2,wanna,"('FAT', 'MOT')",Providence,lil22.xml,45,1,0,MOT,225,575,FAT
0,2,1,42,1.631416819,44,2,where,"('FAT', 'MOT')",Providence,lil22.xml,45,1,0,MOT,225,575,FAT
1,28,1,264,1.623136757,292,28,is,"('CHI', 'MOT')",Providence,lil22.xml,294,2,1,MOT,992,3117,CHI
1,0,48,127,1.621133952,127,0,the,"('MOT', 'CHI')",Providence,lil22.xml,176,49,1,CHI,1844,560,MOT
0,1,1,27,1.609437912,28,1,yeah,"('FAT', 'CHI')",Providence,lil22.xml,29,1,0,CHI,144,115,FAT
4,5,20,147,1.596534508,152,5,a,"('MOT', 'CHI')",Providence,lil22.xml,176,24,4,CHI,1844,560,MOT
1,0,5,17,1.558144618,17,0,you,"('MOT', 'OPE')",Providence,lil22.xml,23,6,1,OPE,156,98,MOT
12,32,9,241,1.549718678,273,32,a,"('CHI', 'MOT')",Providence,lil22.xml,294,21,12,MOT,992,3117,CHI
0,1,1,25,1.540445041,26,1,in,"('CHI', 'FAT')",Providence,lil22.xml,27,1,0,FAT,93,121,CHI
0,1,1,25,1.540445041,26,1,and,"('CHI', 'FAT')",Providence,lil22.xml,27,1,0,FAT,93,121,CHI
8,36,5,245,1.523703361,281,36,oh,"('CHI', 'MOT')",Providence,lil22.xml,294,13,8,MOT,992,3117,CHI
1,2,0,16,1.491654877,18,2,you,"('OPE', 'MOT')",Providence,lil22.xml,19,1,1,MOT,97,170,OPE
0,1,3,41,1.481604541,42,1,want,"('FAT', 'MOT')",Providence,lil22.xml,45,3,0,MOT,225,575,FAT
0,1,3,41,1.481604541,42,1,like,"('MOT', 'FAT')",Providence,lil22.xml,45,3,0,FAT,356,254,MOT
0,1,3,41,1.481604541,42,1,that,"('MOT', 'FAT')",Providence,lil22.xml,45,3,0,FAT,356,254,MOT
0,16,2,276,1.464072062,292,16,this,"('CHI', 'MOT')",Providence,lil22.xml,294,2,0,MOT,992,3117,CHI
19,38,11,226,1.449931033,264,38,and,"('CHI', 'MOT')",Providence,lil22.xml,294,30,19,MOT,992,3117,CHI
0,1,1,21,1.386294361,22,1,like,"('MOT', 'OPE')",Providence,lil22.xml,23,1,0,OPE,156,98,MOT
0,1,1,21,1.386294361,22,1,of,"('MOT', 'OPE')",Providence,lil22.xml,23,1,0,OPE,156,98,MOT
0,1,1,21,1.386294361,22,1,that,"('MOT', 'OPE')",Providence,lil22.xml,23,1,0,OPE,156,98,MOT
0,1,1,21,1.386294361,22,1,do,"('MOT', 'OPE')",Providence,lil22.xml,23,1,0,OPE,156,98,MOT
0,1,1,21,1.386294361,22,1,on,"('MOT', 'OPE')",Providence,lil22.xml,23,1,0,OPE,156,98,MOT
0,3,1,41,1.343734747,44,3,like,"('FAT', 'MOT')",Providence,lil22.xml,45,1,0,MOT,225,575,FAT
0,3,1,41,1.343734747,44,3,was,"('FAT', 'MOT')",Providence,lil22.xml,45,1,0,MOT,225,575,FAT
0,3,1,41,1.343734747,44,3,this,"('FAT', 'MOT')",Providence,lil22.xml,45,1,0,MOT,225,575,FAT
0,3,1,41,1.343734747,44,3,have,"('MOT', 'FAT')",Providence,lil22.xml,45,1,0,FAT,356,254,MOT
0,2,2,41,1.32175584,43,2,some,"('FAT', 'MOT')",Providence,lil22.xml,45,2,0,MOT,225,575,FAT
0,2,2,41,1.32175584,43,2,we,"('MOT', 'FAT')",Providence,lil22.xml,45,2,0,FAT,356,254,MOT
0,2,2,41,1.32175584,43,2,of,"('MOT', 'FAT')",Providence,lil22.xml,45,2,0,FAT,356,254,MOT
0,2,2,41,1.32175584,43,2,what,"('MOT', 'FAT')",Providence,lil22.xml,45,2,0,FAT,356,254,MOT
1,5,1,38,1.32175584,43,5,and,"('FAT', 'MOT')",Providence,lil22.xml,45,2,1,MOT,225,575,FAT
0,1,2,26,1.287854288,27,1,and,"('FAT', 'CHI')",Providence,lil22.xml,29,2,0,CHI,144,115,FAT
1,2,5,37,1.228665417,39,2,and,"('MOT', 'FAT')",Providence,lil22.xml,45,6,1,FAT,356,254,MOT
2,65,0,227,1.206242953,292,65,you,"('CHI', 'MOT')",Providence,lil22.xml,294,2,2,MOT,992,3117,CHI
0,1,1,17,1.203972804,18,1,in,"('OPE', 'MOT')",Providence,lil22.xml,19,1,0,MOT,97,170,OPE
0,1,1,17,1.203972804,18,1,it,"('OPE', 'MOT')",Providence,lil22.xml,19,1,0,MOT,97,170,OPE
0,1,1,17,1.203972804,18,1,to,"('OPE', 'MOT')",Providence,lil22.xml,19,1,0,MOT,97,170,OPE
2,7,1,35,1.193922468,42,7,the,"('FAT', 'MOT')",Providence,lil22.xml,45,3,2,MOT,225,575,FAT
0,4,1,40,1.120591195,44,4,we,"('FAT', 'MOT')",Providence,lil22.xml,45,1,0,MOT,225,575,FAT
1,66,0,227,1.076817629,293,66,the,"('CHI', 'MOT')",Providence,lil22.xml,294,1,1,MOT,992,3117,CHI
0,2,3,40,1.076139433,42,2,there,"('FAT', 'MOT')",Providence,lil22.xml,45,3,0,MOT,225,575,FAT
0,2,3,40,1.076139433,42,2,in,"('MOT', 'FAT')",Providence,lil22.xml,45,3,0,FAT,356,254,MOT
2,15,7,152,1.058027009,167,15,no,"('MOT', 'CHI')",Providence,lil22.xml,176,9,2,CHI,1844,560,MOT
0,1,2,20,1.056052674,21,1,yeah,"('MOT', 'OPE')",Providence,lil22.xml,23,2,0,OPE,156,98,MOT
0,3,2,40,1.034073768,43,3,get,"('FAT', 'MOT')",Providence,lil22.xml,45,2,0,MOT,225,575,FAT
0,1,3,25,1.029619417,26,1,on,"('FAT', 'CHI')",Providence,lil22.xml,29,3,0,CHI,144,115,FAT
0,2,1,20,0.980829253,22,2,a,"('MOT', 'OPE')",Providence,lil22.xml,23,1,0,OPE,156,98,MOT
0,37,1,256,0.950776908,293,37,that,"('CHI', 'MOT')",Providence,lil22.xml,294,1,0,MOT,992,3117,CHI
2,5,4,34,0.940983344,39,5,a,"('MOT', 'FAT')",Providence,lil22.xml,45,6,2,FAT,356,254,MOT
0,5,1,39,0.938269639,44,5,a,"('FAT', 'MOT')",Providence,lil22.xml,45,1,0,MOT,225,575,FAT
1,14,6,155,0.929535959,169,14,yeah,"('MOT', 'CHI')",Providence,lil22.xml,176,7,1,CHI,1844,560,MOT
0,2,4,39,0.870828358,41,2,no,"('MOT', 'FAT')",Providence,lil22.xml,45,4,0,FAT,356,254,MOT
0,2,4,39,0.870828358,41,2,do,"('MOT', 'FAT')",Providence,lil22.xml,45,4,0,FAT,356,254,MOT
2,2,4,15,0.864997437,17,2,oh,"('MOT', 'OPE')",Providence,lil22.xml,23,6,2,OPE,156,98,MOT
0,1,2,16,0.864997437,17,1,a,"('OPE', 'MOT')",Providence,lil22.xml,19,2,0,MOT,97,170,OPE
3,5,6,31,0.834225779,36,5,you,"('FAT', 'MOT')",Providence,lil22.xml,45,9,3,MOT,225,575,FAT
0,2,1,16,0.798507696,18,2,was,"('OPE', 'MOT')",Providence,lil22.xml,19,1,0,MOT,97,170,OPE
0,2,1,16,0.798507696,18,2,no,"('OPE', 'MOT')",Providence,lil22.xml,19,1,0,MOT,97,170,OPE
0,3,3,39,0.78845736,42,3,is,"('MOT', 'FAT')",Providence,lil22.xml,45,3,0,FAT,356,254,MOT
1,4,5,35,0.717839793,39,4,yeah,"('FAT', 'MOT')",Providence,lil22.xml,45,6,1,MOT,225,575,FAT
0,2,2,19,0.650587566,21,2,what,"('MOT', 'OPE')",Providence,lil22.xml,23,2,0,OPE,156,98,MOT
2,6,5,32,0.644357016,38,6,you,"('MOT', 'FAT')",Providence,lil22.xml,45,7,2,FAT,356,254,MOT
1,4,6,34,0.575364145,38,4,the,"('MOT', 'FAT')",Providence,lil22.xml,45,7,1,FAT,356,254,MOT
3,8,32,133,0.540996501,141,8,and,"('MOT', 'CHI')",Providence,lil22.xml,176,35,3,CHI,1844,560,MOT
0,3,1,15,0.510825624,18,3,and,"('OPE', 'MOT')",Providence,lil22.xml,19,1,0,MOT,97,170,OPE
0,2,2,15,0.459532329,17,2,is,"('OPE', 'MOT')",Providence,lil22.xml,19,2,0,MOT,97,170,OPE
0,1,1,6,0.405465108,7,1,you,"('OPE', 'FAT')",Providence,lil22.xml,8,1,0,FAT,41,32,OPE
0,1,1,6,0.405465108,7,1,the,"('OPE', 'FAT')",Providence,lil22.xml,8,1,0,FAT,41,32,OPE
1,5,6,33,0.393042588,38,5,oh,"('FAT', 'MOT')",Providence,lil22.xml,45,7,1,MOT,225,575,FAT
1,5,6,33,0.393042588,38,5,to,"('FAT', 'MOT')",Providence,lil22.xml,45,7,1,MOT,225,575,FAT
0,5,17,154,0.345205917,159,5,oh,"('MOT', 'CHI')",Providence,lil22.xml,176,17,0,CHI,1844,560,MOT
0,1,1,5,0.287682072,6,1,oh,"('CHI', 'OPE')",Providence,lil22.xml,7,1,0,OPE,21,39,CHI
0,4,1,14,0.287682072,18,4,the,"('OPE', 'MOT')",Providence,lil22.xml,19,1,0,MOT,97,170,OPE
0,8,2,35,0.223143551,43,8,in,"('FAT', 'MOT')",Providence,lil22.xml,45,2,0,MOT,225,575,FAT
1,9,4,31,0.182321557,40,9,that,"('FAT', 'MOT')",Providence,lil22.xml,45,5,1,MOT,225,575,FAT
0,3,2,14,0.171850257,17,3,that,"('OPE', 'MOT')",Providence,lil22.xml,19,2,0,MOT,97,170,OPE
0,6,1,16,0.133531393,22,6,she,"('MOT', 'OPE')",Providence,lil22.xml,23,1,0,OPE,156,98,MOT
0,5,1,13,0.105360516,18,5,yeah,"('OPE', 'MOT')",Providence,lil22.xml,19,1,0,MOT,97,170,OPE
0,2,1,5,0,7,2,a,"('FAT', 'OPE')",Providence,lil22.xml,8,1,0,OPE,28,65,FAT
0,4,3,12,-0.328504067,16,4,oh,"('OPE', 'MOT')",Providence,lil22.xml,19,3,0,MOT,97,170,OPE
1,0,9,247,3.725693427,247,0,think,"('MOT', 'CHI')",Providence,lil23.xml,257,10,1,CHI,3432,1022,MOT
2,2,2,104,2.890371758,106,2,one,"('CHI', 'MOT')",Providence,lil23.xml,110,4,2,MOT,373,2137,CHI
0,2,3,252,2.837127243,254,2,big,"('MOT', 'CHI')",Providence,lil23.xml,257,3,0,CHI,3432,1022,MOT
3,4,1,102,2.667228207,106,4,no,"('CHI', 'MOT')",Providence,lil23.xml,110,4,3,MOT,373,2137,CHI
0,1,7,249,2.63905733,250,1,he,"('MOT', 'CHI')",Providence,lil23.xml,257,7,0,CHI,3432,1022,MOT
1,3,1,105,2.621038824,108,3,big,"('CHI', 'MOT')",Providence,lil23.xml,110,2,1,MOT,373,2137,CHI
1,1,15,240,2.602689685,241,1,it,"('MOT', 'CHI')",Providence,lil23.xml,257,16,1,CHI,3432,1022,MOT
2,8,4,243,2.355335658,251,8,no,"('MOT', 'CHI')",Providence,lil23.xml,257,6,2,CHI,3432,1022,MOT
1,1,21,234,2.290006311,235,1,little,"('MOT', 'CHI')",Providence,lil23.xml,257,22,1,CHI,3432,1022,MOT
2,3,15,237,2.256816675,240,3,oh,"('MOT', 'CHI')",Providence,lil23.xml,257,17,2,CHI,3432,1022,MOT
1,1,22,233,2.24495598,234,1,what,"('MOT', 'CHI')",Providence,lil23.xml,257,23,1,CHI,3432,1022,MOT
1,1,0,24,2.197224577,25,1,what,"('OPE', 'MOT')",Providence,lil23.xml,26,1,1,MOT,122,560,OPE
0,4,4,249,2.140066163,253,4,one,"('MOT', 'CHI')",Providence,lil23.xml,257,4,0,CHI,3432,1022,MOT
0,2,8,247,2.124255557,249,2,up,"('MOT', 'CHI')",Providence,lil23.xml,257,8,0,CHI,3432,1022,MOT
3,8,1,98,2.079441542,106,8,on,"('CHI', 'MOT')",Providence,lil23.xml,110,4,3,MOT,373,2137,CHI
1,0,53,203,1.990805469,203,0,you,"('MOT', 'CHI')",Providence,lil23.xml,257,54,1,CHI,3432,1022,MOT
1,7,1,101,1.927891644,108,7,it,"('CHI', 'MOT')",Providence,lil23.xml,110,2,1,MOT,373,2137,CHI
2,9,1,98,1.877937165,107,9,oh,"('CHI', 'MOT')",Providence,lil23.xml,110,3,2,MOT,373,2137,CHI
1,1,1,23,1.871802177,24,1,is,"('OPE', 'MOT')",Providence,lil23.xml,26,2,1,MOT,122,560,OPE
0,3,9,245,1.737271284,248,3,can,"('MOT', 'CHI')",Providence,lil23.xml,257,9,0,CHI,3432,1022,MOT
4,6,7,93,1.713698923,99,6,yeah,"('CHI', 'MOT')",Providence,lil23.xml,110,11,4,MOT,373,2137,CHI
1,4,15,237,1.686398954,241,4,on,"('MOT', 'CHI')",Providence,lil23.xml,257,16,1,CHI,3432,1022,MOT
1,13,0,96,1.665007764,109,13,is,"('CHI', 'MOT')",Providence,lil23.xml,110,1,1,MOT,373,2137,CHI
2,15,0,93,1.640209571,108,15,in,"('CHI', 'MOT')",Providence,lil23.xml,110,2,2,MOT,373,2137,CHI
2,3,31,221,1.577504865,224,3,in,"('MOT', 'CHI')",Providence,lil23.xml,257,33,2,CHI,3432,1022,MOT
0,1,1,24,1.504077397,25,1,see,"('OPE', 'MOT')",Providence,lil23.xml,26,1,0,MOT,122,560,OPE
0,1,1,24,1.504077397,25,1,some,"('OPE', 'MOT')",Providence,lil23.xml,26,1,0,MOT,122,560,OPE
0,1,1,24,1.504077397,25,1,put,"('OPE', 'MOT')",Providence,lil23.xml,26,1,0,MOT,122,560,OPE
1,1,55,200,1.252762968,201,1,the,"('MOT', 'CHI')",Providence,lil23.xml,257,56,1,CHI,3432,1022,MOT
0,1,31,225,1.239690887,226,1,that,"('MOT', 'CHI')",Providence,lil23.xml,257,31,0,CHI,3432,1022,MOT
0,2,21,234,1.238164169,236,2,there,"('MOT', 'CHI')",Providence,lil23.xml,257,21,0,CHI,3432,1022,MOT
9,24,1,76,1.223775432,100,24,a,"('CHI', 'MOT')",Providence,lil23.xml,110,10,9,MOT,373,2137,CHI
0,1,2,23,1.178654996,24,1,for,"('OPE', 'MOT')",Providence,lil23.xml,26,2,0,MOT,122,560,OPE
0,2,1,23,1.098612289,25,2,with,"('OPE', 'MOT')",Providence,lil23.xml,26,1,0,MOT,122,560,OPE
0,2,1,23,1.098612289,25,2,he,"('OPE', 'MOT')",Providence,lil23.xml,26,1,0,MOT,122,560,OPE
0,2,1,23,1.098612289,25,2,that,"('OPE', 'MOT')",Providence,lil23.xml,26,1,0,MOT,122,560,OPE
1,0,1,4,1.098612289,4,0,a,"('CHI', 'OPE')",Providence,lil23.xml,6,2,1,OPE,45,27,CHI
48,25,56,128,1.013709783,153,25,a,"('MOT', 'CHI')",Providence,lil23.xml,257,104,48,CHI,3432,1022,MOT
1,2,3,20,0.980829253,22,2,oh,"('OPE', 'MOT')",Providence,lil23.xml,26,4,1,MOT,122,560,OPE
0,2,27,228,0.980829253,230,2,is,"('MOT', 'CHI')",Providence,lil23.xml,257,27,0,CHI,3432,1022,MOT
1,3,2,20,0.916290732,23,3,yeah,"('OPE', 'MOT')",Providence,lil23.xml,26,3,1,MOT,122,560,OPE
1,1,0,4,0.84729786,5,1,is,"('CHI', 'OPE')",Providence,lil23.xml,6,1,1,OPE,45,27,CHI
0,3,1,22,0.810930216,25,3,but,"('OPE', 'MOT')",Providence,lil23.xml,26,1,0,MOT,122,560,OPE
0,3,1,22,0.810930216,25,3,she,"('OPE', 'MOT')",Providence,lil23.xml,26,1,0,MOT,122,560,OPE
0,1,1,10,0.773189888,11,1,are,"('MOT', 'OPE')",Providence,lil23.xml,12,1,0,OPE,463,46,MOT
0,4,1,21,0.587786665,25,4,in,"('OPE', 'MOT')",Providence,lil23.xml,26,1,0,MOT,122,560,OPE
0,4,1,21,0.587786665,25,4,on,"('OPE', 'MOT')",Providence,lil23.xml,26,1,0,MOT,122,560,OPE
7,31,5,67,0.579818495,98,31,and,"('CHI', 'MOT')",Providence,lil23.xml,110,12,7,MOT,373,2137,CHI
2,31,2,75,0.523248144,106,31,the,"('CHI', 'MOT')",Providence,lil23.xml,110,4,2,MOT,373,2137,CHI
1,5,2,18,0.510825624,23,5,the,"('OPE', 'MOT')",Providence,lil23.xml,26,3,1,MOT,122,560,OPE
2,8,1,15,0.510825624,23,8,a,"('OPE', 'MOT')",Providence,lil23.xml,26,3,2,MOT,122,560,OPE
21,35,50,151,0.453506037,186,35,and,"('MOT', 'CHI')",Providence,lil23.xml,257,71,21,CHI,3432,1022,MOT
0,1,2,9,0.405465108,10,1,what,"('MOT', 'OPE')",Providence,lil23.xml,12,2,0,OPE,463,46,MOT
1,1,4,6,0.251314428,7,1,you,"('MOT', 'OPE')",Providence,lil23.xml,12,5,1,OPE,463,46,MOT
0,6,1,19,0.251314428,25,6,like,"('OPE', 'MOT')",Providence,lil23.xml,26,1,0,MOT,122,560,OPE
0,1,1,4,0.15415068,5,1,what,"('CHI', 'OPE')",Providence,lil23.xml,6,1,0,OPE,45,27,CHI
0,1,3,8,0.09531018,9,1,yeah,"('MOT', 'OPE')",Providence,lil23.xml,12,3,0,OPE,463,46,MOT
0,1,3,8,0.09531018,9,1,is,"('MOT', 'OPE')",Providence,lil23.xml,12,3,0,OPE,463,46,MOT
0,1,3,8,0.09531018,9,1,do,"('MOT', 'OPE')",Providence,lil23.xml,12,3,0,OPE,463,46,MOT
0,5,2,19,0.080042708,24,5,was,"('OPE', 'MOT')",Providence,lil23.xml,26,2,0,MOT,122,560,OPE
0,8,1,17,0,25,8,you,"('OPE', 'MOT')",Providence,lil23.xml,26,1,0,MOT,122,560,OPE
0,17,12,228,-0.020040751,245,17,yeah,"('MOT', 'CHI')",Providence,lil23.xml,257,12,0,CHI,3432,1022,MOT
0,9,1,16,-0.105360516,25,9,and,"('OPE', 'MOT')",Providence,lil23.xml,26,1,0,MOT,122,560,OPE
0,1,4,7,-0.182321557,8,1,that,"('MOT', 'OPE')",Providence,lil23.xml,12,4,0,OPE,463,46,MOT
1,0,3,142,3.871201011,142,0,there,"('MOT', 'CHI')",Providence,lil24.xml,146,4,1,CHI,1558,669,MOT
1,0,4,141,3.710081662,141,0,have,"('MOT', 'CHI')",Providence,lil24.xml,146,5,1,CHI,1558,669,MOT
2,6,0,320,3.559421387,326,6,there,"('CHI', 'MOT')",Providence,lil24.xml,328,2,2,MOT,1186,3899,CHI
1,1,2,142,3.36729583,143,1,are,"('MOT', 'CHI')",Providence,lil24.xml,146,3,1,CHI,1558,669,MOT
1,0,7,138,3.33220451,138,0,with,"('MOT', 'CHI')",Providence,lil24.xml,146,8,1,CHI,1558,669,MOT
1,7,0,320,3.311151101,327,7,at,"('CHI', 'MOT')",Providence,lil24.xml,328,1,1,MOT,1186,3899,CHI
0,3,1,324,3.311151101,327,3,not,"('CHI', 'MOT')",Providence,lil24.xml,328,1,0,MOT,1186,3899,CHI
1,0,0,32,3.120895417,32,0,think,"('OPE', 'MOT')",Providence,lil24.xml,33,1,1,MOT,136,344,OPE
2,11,0,315,3.020424886,326,11,big,"('CHI', 'MOT')",Providence,lil24.xml,328,2,2,MOT,1186,3899,CHI
1,0,0,26,2.926739402,26,0,have,"('MOT', 'OPE')",Providence,lil24.xml,27,1,1,OPE,215,136,MOT
1,0,0,26,2.926739402,26,0,he,"('MOT', 'OPE')",Providence,lil24.xml,27,1,1,OPE,215,136,MOT
0,1,2,143,2.90416508,144,1,all,"('MOT', 'CHI')",Providence,lil24.xml,146,2,0,CHI,1558,669,MOT
7,4,21,296,2.779233265,300,4,no,"('CHI', 'MOT')",Providence,lil24.xml,328,28,7,MOT,1186,3899,CHI
1,14,0,313,2.682542442,327,14,are,"('CHI', 'MOT')",Providence,lil24.xml,328,1,1,MOT,1186,3899,CHI
0,1,3,142,2.674148649,143,1,big,"('MOT', 'CHI')",Providence,lil24.xml,146,3,0,CHI,1558,669,MOT
0,7,1,320,2.61800392,327,7,up,"('CHI', 'MOT')",Providence,lil24.xml,328,1,0,MOT,1186,3899,CHI
1,1,8,136,2.53657866,137,1,is,"('MOT', 'CHI')",Providence,lil24.xml,146,9,1,CHI,1558,669,MOT
1,12,1,314,2.53491707,326,12,one,"('CHI', 'MOT')",Providence,lil24.xml,328,2,1,MOT,1186,3899,CHI
1,0,2,24,2.341805806,24,0,a,"('MOT', 'OPE')",Providence,lil24.xml,27,3,1,OPE,215,136,MOT
1,0,2,24,2.341805806,24,0,to,"('MOT', 'OPE')",Providence,lil24.xml,27,3,1,OPE,215,136,MOT
0,1,5,140,2.323787301,141,1,not,"('MOT', 'CHI')",Providence,lil24.xml,146,5,0,CHI,1558,669,MOT
0,11,1,316,2.212538812,327,11,see,"('CHI', 'MOT')",Providence,lil24.xml,328,1,0,MOT,1186,3899,CHI
3,10,8,307,2.188640834,317,10,my,"('CHI', 'MOT')",Providence,lil24.xml,328,11,3,MOT,1186,3899,CHI
0,1,6,139,2.183238335,140,1,this,"('MOT', 'CHI')",Providence,lil24.xml,146,6,0,CHI,1558,669,MOT
0,12,1,315,2.132496105,327,12,all,"('CHI', 'MOT')",Providence,lil24.xml,328,1,0,MOT,1186,3899,CHI
1,1,13,131,2.125251078,132,1,a,"('MOT', 'CHI')",Providence,lil24.xml,146,14,1,CHI,1558,669,MOT
2,25,1,300,2.021038009,325,25,on,"('CHI', 'MOT')",Providence,lil24.xml,328,3,2,MOT,1186,3899,CHI
2,18,3,305,1.992088343,323,18,this,"('CHI', 'MOT')",Providence,lil24.xml,328,5,2,MOT,1186,3899,CHI
0,15,1,312,1.92485674,327,15,want,"('CHI', 'MOT')",Providence,lil24.xml,328,1,0,MOT,1186,3899,CHI
1,1,1,24,1.909542505,25,1,the,"('MOT', 'OPE')",Providence,lil24.xml,27,2,1,OPE,215,136,MOT
3,2,21,120,1.8498671,122,2,in,"('MOT', 'CHI')",Providence,lil24.xml,146,24,3,CHI,1558,669,MOT
0,1,9,136,1.84343148,137,1,wanna,"('MOT', 'CHI')",Providence,lil24.xml,146,9,0,CHI,1558,669,MOT
2,38,0,288,1.84176989,326,38,what,"('CHI', 'MOT')",Providence,lil24.xml,328,2,2,MOT,1186,3899,CHI
0,2,6,138,1.777773227,140,2,get,"('MOT', 'CHI')",Providence,lil24.xml,146,6,0,CHI,1558,669,MOT
1,3,0,29,1.734601055,32,3,is,"('OPE', 'MOT')",Providence,lil24.xml,33,1,1,MOT,136,344,OPE
0,1,1,31,1.734601055,32,1,can,"('OPE', 'MOT')",Providence,lil24.xml,33,1,0,MOT,136,344,OPE
1,2,1,29,1.704748092,31,2,of,"('OPE', 'MOT')",Providence,lil24.xml,33,2,1,MOT,136,344,OPE
2,3,16,125,1.584120104,128,3,oh,"('MOT', 'CHI')",Providence,lil24.xml,146,18,2,CHI,1558,669,MOT
33,48,7,240,1.566751531,288,48,a,"('CHI', 'MOT')",Providence,lil24.xml,328,40,33,MOT,1186,3899,CHI
1,27,2,298,1.541464929,325,27,it,"('CHI', 'MOT')",Providence,lil24.xml,328,3,1,MOT,1186,3899,CHI
0,2,8,136,1.540445041,138,2,go,"('MOT', 'CHI')",Providence,lil24.xml,146,8,0,CHI,1558,669,MOT
0,1,1,25,1.540445041,26,1,gonna,"('MOT', 'OPE')",Providence,lil24.xml,27,1,0,OPE,215,136,MOT
0,1,1,25,1.540445041,26,1,go,"('MOT', 'OPE')",Providence,lil24.xml,27,1,0,OPE,215,136,MOT
0,1,1,25,1.540445041,26,1,in,"('MOT', 'OPE')",Providence,lil24.xml,27,1,0,OPE,215,136,MOT
0,1,1,25,1.540445041,26,1,get,"('MOT', 'OPE')",Providence,lil24.xml,27,1,0,OPE,215,136,MOT
0,1,1,25,1.540445041,26,1,it,"('MOT', 'OPE')",Providence,lil24.xml,27,1,0,OPE,215,136,MOT
0,1,1,25,1.540445041,26,1,see,"('MOT', 'OPE')",Providence,lil24.xml,27,1,0,OPE,215,136,MOT
0,1,1,25,1.540445041,26,1,can,"('MOT', 'OPE')",Providence,lil24.xml,27,1,0,OPE,215,136,MOT
1,24,3,300,1.469409268,324,24,in,"('CHI', 'MOT')",Providence,lil24.xml,328,4,1,MOT,1186,3899,CHI
1,1,26,118,1.428494716,119,1,to,"('MOT', 'CHI')",Providence,lil24.xml,146,27,1,CHI,1558,669,MOT
3,4,1,25,1.419084184,29,4,yeah,"('OPE', 'MOT')",Providence,lil24.xml,33,4,3,MOT,136,344,OPE
5,46,3,274,1.41357832,320,46,is,"('CHI', 'MOT')",Providence,lil24.xml,328,8,5,MOT,1186,3899,CHI
0,4,5,137,1.407496569,141,4,want,"('MOT', 'CHI')",Providence,lil24.xml,146,5,0,CHI,1558,669,MOT
1,9,4,132,1.407496569,141,9,no,"('MOT', 'CHI')",Providence,lil24.xml,146,5,1,CHI,1558,669,MOT
0,26,1,301,1.401608596,327,26,like,"('CHI', 'MOT')",Providence,lil24.xml,328,1,0,MOT,1186,3899,CHI
1,0,47,98,1.386294361,98,0,you,"('MOT', 'CHI')",Providence,lil24.xml,146,48,1,CHI,1558,669,MOT
8,5,31,102,1.383240924,107,5,the,"('MOT', 'CHI')",Providence,lil24.xml,146,39,8,CHI,1558,669,MOT
1,8,5,132,1.372308119,140,8,yeah,"('MOT', 'CHI')",Providence,lil24.xml,146,6,1,CHI,1558,669,MOT
0,2,1,30,1.329135947,32,2,in,"('OPE', 'MOT')",Providence,lil24.xml,33,1,0,MOT,136,344,OPE
0,2,1,30,1.329135947,32,2,big,"('OPE', 'MOT')",Providence,lil24.xml,33,1,0,MOT,136,344,OPE
7,57,3,261,1.302412877,318,57,and,"('CHI', 'MOT')",Providence,lil24.xml,328,10,7,MOT,1186,3899,CHI
0,1,2,24,1.216395324,25,1,what,"('MOT', 'OPE')",Providence,lil24.xml,27,2,0,OPE,215,136,MOT
0,1,2,24,1.216395324,25,1,is,"('MOT', 'OPE')",Providence,lil24.xml,27,2,0,OPE,215,136,MOT
0,1,18,127,1.178654996,128,1,do,"('MOT', 'CHI')",Providence,lil24.xml,146,18,0,CHI,1558,669,MOT
2,77,0,249,1.148622709,326,77,you,"('CHI', 'MOT')",Providence,lil24.xml,328,2,2,MOT,1186,3899,CHI
0,5,6,135,1.084626047,140,5,my,"('MOT', 'CHI')",Providence,lil24.xml,146,6,0,CHI,1558,669,MOT
0,3,1,29,1.041453875,32,3,one,"('OPE', 'MOT')",Providence,lil24.xml,33,1,0,MOT,136,344,OPE
12,74,6,236,0.994732158,310,74,the,"('CHI', 'MOT')",Providence,lil24.xml,328,18,12,MOT,1186,3899,CHI
0,1,1,13,0.980829253,14,1,it,"('OPE', 'CHI')",Providence,lil24.xml,15,1,0,CHI,55,74,OPE
0,4,9,133,0.927140748,137,4,it,"('MOT', 'CHI')",Providence,lil24.xml,146,9,0,CHI,1558,669,MOT
1,36,4,287,0.920144301,323,36,oh,"('CHI', 'MOT')",Providence,lil24.xml,328,5,1,MOT,1186,3899,CHI
1,16,13,298,0.843087328,314,16,yeah,"('CHI', 'MOT')",Providence,lil24.xml,328,14,1,MOT,1186,3899,CHI
0,4,1,28,0.818310324,32,4,that,"('OPE', 'MOT')",Providence,lil24.xml,33,1,0,MOT,136,344,OPE
1,4,3,25,0.725937003,29,4,a,"('OPE', 'MOT')",Providence,lil24.xml,33,4,1,MOT,136,344,OPE
1,7,1,24,0.723918839,31,7,you,"('OPE', 'MOT')",Providence,lil24.xml,33,2,1,MOT,136,344,OPE
1,4,22,119,0.693147181,123,4,and,"('MOT', 'CHI')",Providence,lil24.xml,146,23,1,CHI,1558,669,MOT
0,5,1,27,0.635988767,32,5,to,"('OPE', 'MOT')",Providence,lil24.xml,33,1,0,MOT,136,344,OPE
0,3,16,127,0.606135804,130,3,on,"('MOT', 'CHI')",Providence,lil24.xml,146,16,0,CHI,1558,669,MOT
0,2,4,27,0.543615447,29,2,she,"('OPE', 'MOT')",Providence,lil24.xml,33,4,0,MOT,136,344,OPE
1,3,0,5,0.510825624,8,3,the,"('CHI', 'OPE')",Providence,lil24.xml,9,1,1,OPE,30,45,CHI
0,2,4,21,0.328504067,23,2,that,"('MOT', 'OPE')",Providence,lil24.xml,27,4,0,OPE,215,136,MOT
0,2,2,11,0.223143551,13,2,a,"('OPE', 'CHI')",Providence,lil24.xml,15,2,0,CHI,55,74,OPE
0,4,3,20,0.039220713,24,4,yeah,"('MOT', 'OPE')",Providence,lil24.xml,27,3,0,OPE,215,136,MOT
0,6,3,24,-0.089612159,30,6,oh,"('OPE', 'MOT')",Providence,lil24.xml,33,3,0,MOT,136,344,OPE
0,6,3,18,-0.297251523,24,6,oh,"('MOT', 'OPE')",Providence,lil24.xml,27,3,0,OPE,215,136,MOT
0,3,8,16,-0.644357016,19,3,you,"('MOT', 'OPE')",Providence,lil24.xml,27,8,0,OPE,215,136,MOT
0,1,1,164,3.326234343,165,1,up,"('MOT', 'CHI')",Providence,lil25.xml,166,1,0,CHI,1977,592,MOT
0,1,2,163,3.032546247,164,1,she,"('MOT', 'CHI')",Providence,lil25.xml,166,2,0,CHI,1977,592,MOT
0,1,2,163,3.032546247,164,1,where,"('MOT', 'CHI')",Providence,lil25.xml,166,2,0,CHI,1977,592,MOT
2,2,8,215,2.90416508,217,2,no,"('CHI', 'MOT')",Providence,lil25.xml,227,10,2,MOT,740,4487,CHI
0,1,3,162,2.803360381,163,1,all,"('MOT', 'CHI')",Providence,lil25.xml,166,3,0,CHI,1977,592,MOT
0,1,3,162,2.803360381,163,1,one,"('MOT', 'CHI')",Providence,lil25.xml,166,3,0,CHI,1977,592,MOT
1,5,2,219,2.712484798,224,5,this,"('CHI', 'MOT')",Providence,lil25.xml,227,3,1,MOT,740,4487,CHI
1,0,1,22,2.48490665,22,0,of,"('MOT', 'OPE')",Providence,lil25.xml,24,2,1,OPE,492,137,MOT
1,0,1,22,2.48490665,22,0,do,"('MOT', 'OPE')",Providence,lil25.xml,24,2,1,OPE,492,137,MOT
2,14,0,211,2.429217744,225,14,are,"('CHI', 'MOT')",Providence,lil25.xml,227,2,2,MOT,740,4487,CHI
0,2,3,161,2.397895273,163,2,my,"('MOT', 'CHI')",Providence,lil25.xml,166,3,0,CHI,1977,592,MOT
1,0,27,138,2.233592222,138,0,to,"('MOT', 'CHI')",Providence,lil25.xml,166,28,1,CHI,1977,592,MOT
0,2,4,160,2.20949467,162,2,there,"('MOT', 'CHI')",Providence,lil25.xml,166,4,0,CHI,1977,592,MOT
1,9,2,215,2.201659174,224,9,go,"('CHI', 'MOT')",Providence,lil25.xml,227,3,1,MOT,740,4487,CHI
1,16,0,210,2.190667177,226,16,think,"('CHI', 'MOT')",Providence,lil25.xml,227,1,1,MOT,740,4487,CHI
2,10,3,212,2.166452919,222,10,one,"('CHI', 'MOT')",Providence,lil25.xml,227,5,2,MOT,740,4487,CHI
1,1,0,22,2.120263536,23,1,see,"('MOT', 'OPE')",Providence,lil25.xml,24,1,1,OPE,492,137,MOT
0,3,3,160,2.1102132,163,3,this,"('MOT', 'CHI')",Providence,lil25.xml,166,3,0,CHI,1977,592,MOT
1,2,10,153,2.08583134,155,2,see,"('MOT', 'CHI')",Providence,lil25.xml,166,11,1,CHI,1977,592,MOT
2,4,8,152,2.066862759,156,4,of,"('MOT', 'CHI')",Providence,lil25.xml,166,10,2,CHI,1977,592,MOT
3,5,14,205,2.006682187,210,5,yeah,"('CHI', 'MOT')",Providence,lil25.xml,227,17,3,MOT,740,4487,CHI
0,10,1,216,1.932838067,226,10,get,"('CHI', 'MOT')",Providence,lil25.xml,227,1,0,MOT,740,4487,CHI
0,10,1,216,1.932838067,226,10,did,"('CHI', 'MOT')",Providence,lil25.xml,227,1,0,MOT,740,4487,CHI
1,10,3,213,1.919592841,223,10,my,"('CHI', 'MOT')",Providence,lil25.xml,227,4,1,MOT,740,4487,CHI
0,1,10,155,1.884541203,156,1,want,"('MOT', 'CHI')",Providence,lil25.xml,166,10,0,CHI,1977,592,MOT
1,0,1,11,1.871802177,11,0,yeah,"('CHI', 'OPE')",Providence,lil25.xml,13,2,1,OPE,56,50,CHI
2,23,1,201,1.731655545,224,23,in,"('CHI', 'MOT')",Providence,lil25.xml,227,3,2,MOT,740,4487,CHI
0,2,8,156,1.673976434,158,2,go,"('MOT', 'CHI')",Providence,lil25.xml,166,8,0,CHI,1977,592,MOT
3,9,7,147,1.661397651,156,9,no,"('MOT', 'CHI')",Providence,lil25.xml,166,10,3,CHI,1977,592,MOT
1,0,5,18,1.609437912,18,0,like,"('MOT', 'OPE')",Providence,lil25.xml,24,6,1,OPE,492,137,MOT
2,37,0,188,1.499681785,225,37,on,"('CHI', 'MOT')",Providence,lil25.xml,227,2,2,MOT,740,4487,CHI
0,1,1,22,1.427116356,23,1,did,"('MOT', 'OPE')",Providence,lil25.xml,24,1,0,OPE,492,137,MOT
0,1,1,22,1.427116356,23,1,have,"('OPE', 'MOT')",Providence,lil25.xml,24,1,0,MOT,91,489,OPE
0,1,1,22,1.427116356,23,1,see,"('OPE', 'MOT')",Providence,lil25.xml,24,1,0,MOT,91,489,OPE
1,2,1,20,1.386294361,22,2,and,"('OPE', 'MOT')",Providence,lil25.xml,24,2,1,MOT,91,489,OPE
16,41,4,166,1.346835524,207,41,a,"('CHI', 'MOT')",Providence,lil25.xml,227,20,16,MOT,740,4487,CHI
2,24,3,198,1.345472367,222,24,oh,"('CHI', 'MOT')",Providence,lil25.xml,227,5,2,MOT,740,4487,CHI
2,1,4,17,1.32175584,18,1,a,"('MOT', 'OPE')",Providence,lil25.xml,24,6,2,OPE,492,137,MOT
0,10,4,213,1.22644566,223,10,want,"('CHI', 'MOT')",Providence,lil25.xml,227,4,0,MOT,740,4487,CHI
11,61,1,154,1.098612289,215,61,the,"('CHI', 'MOT')",Providence,lil25.xml,227,12,11,MOT,740,4487,CHI
0,1,2,21,1.098612289,22,1,it,"('MOT', 'OPE')",Providence,lil25.xml,24,2,0,OPE,492,137,MOT
0,1,2,21,1.098612289,22,1,she,"('OPE', 'MOT')",Providence,lil25.xml,24,2,0,MOT,91,489,OPE
0,2,1,21,1.021651248,23,2,oh,"('OPE', 'MOT')",Providence,lil25.xml,24,1,0,MOT,91,489,OPE
0,2,1,21,1.021651248,23,2,with,"('OPE', 'MOT')",Providence,lil25.xml,24,1,0,MOT,91,489,OPE
0,1,26,139,0.930475367,140,1,and,"('MOT', 'CHI')",Providence,lil25.xml,166,26,0,CHI,1977,592,MOT
0,3,14,149,0.878069519,152,3,on,"('MOT', 'CHI')",Providence,lil25.xml,166,14,0,CHI,1977,592,MOT
0,1,1,11,0.84729786,12,1,the,"('CHI', 'OPE')",Providence,lil25.xml,13,1,0,OPE,56,50,CHI
0,9,5,152,0.845254959,161,9,yeah,"('MOT', 'CHI')",Providence,lil25.xml,166,5,0,CHI,1977,592,MOT
0,2,20,144,0.807557532,146,2,it,"('MOT', 'CHI')",Providence,lil25.xml,166,20,0,CHI,1977,592,MOT
0,4,12,150,0.801360765,154,4,is,"('MOT', 'CHI')",Providence,lil25.xml,166,12,0,CHI,1977,592,MOT
1,1,6,16,0.747214402,17,1,oh,"('MOT', 'OPE')",Providence,lil25.xml,24,7,1,OPE,492,137,MOT
2,2,5,15,0.747214402,17,2,that,"('MOT', 'OPE')",Providence,lil25.xml,24,7,2,OPE,492,137,MOT
0,2,2,20,0.693147181,22,2,not,"('MOT', 'OPE')",Providence,lil25.xml,24,2,0,OPE,492,137,MOT
4,51,5,167,0.653926467,218,51,and,"('CHI', 'MOT')",Providence,lil25.xml,227,9,4,MOT,740,4487,CHI
0,30,2,195,0.604668452,225,30,it,"('CHI', 'MOT')",Providence,lil25.xml,227,2,0,MOT,740,4487,CHI
1,84,0,142,0.581229264,226,84,you,"('CHI', 'MOT')",Providence,lil25.xml,227,1,1,MOT,740,4487,CHI
0,4,1,19,0.510825624,23,4,like,"('OPE', 'MOT')",Providence,lil25.xml,24,1,0,MOT,91,489,OPE
0,4,1,19,0.510825624,23,4,was,"('OPE', 'MOT')",Providence,lil25.xml,24,1,0,MOT,91,489,OPE
0,3,2,19,0.405465108,22,3,a,"('OPE', 'MOT')",Providence,lil25.xml,24,2,0,MOT,91,489,OPE
0,3,2,19,0.405465108,22,3,that,"('OPE', 'MOT')",Providence,lil25.xml,24,2,0,MOT,91,489,OPE
0,1,5,18,0.405465108,19,1,you,"('MOT', 'OPE')",Providence,lil25.xml,24,5,0,OPE,492,137,MOT
0,1,5,18,0.405465108,19,1,there,"('MOT', 'OPE')",Providence,lil25.xml,24,5,0,OPE,492,137,MOT
4,11,31,120,0.403962478,131,11,the,"('MOT', 'CHI')",Providence,lil25.xml,166,35,4,CHI,1977,592,MOT
0,4,19,143,0.349985956,147,4,a,"('MOT', 'CHI')",Providence,lil25.xml,166,19,0,CHI,1977,592,MOT
0,2,4,18,0.200670695,20,2,in,"('MOT', 'OPE')",Providence,lil25.xml,24,4,0,OPE,492,137,MOT
1,3,6,14,0.054067221,17,3,she,"('MOT', 'OPE')",Providence,lil25.xml,24,7,1,OPE,492,137,MOT
0,1,61,104,-0.163453072,105,1,you,"('MOT', 'CHI')",Providence,lil25.xml,166,61,0,CHI,1977,592,MOT
0,1,9,14,-0.257829109,15,1,the,"('MOT', 'OPE')",Providence,lil25.xml,24,9,0,OPE,492,137,MOT
1,0,4,148,3.757872326,148,0,there,"('MOT', 'CHI')",Providence,lil26.xml,153,5,1,CHI,1690,691,MOT
5,2,10,323,3.649894007,325,2,no,"('CHI', 'MOT')",Providence,lil26.xml,340,15,5,MOT,1196,3852,CHI
1,0,8,144,3.278858529,144,0,of,"('MOT', 'CHI')",Providence,lil26.xml,153,9,1,CHI,1690,691,MOT
3,5,4,328,3.211440846,333,5,where,"('CHI', 'MOT')",Providence,lil26.xml,340,7,3,MOT,1196,3852,CHI
1,0,10,142,3.098011123,142,0,little,"('MOT', 'CHI')",Providence,lil26.xml,153,11,1,CHI,1690,691,MOT
1,10,0,329,3.028522096,339,10,little,"('CHI', 'MOT')",Providence,lil26.xml,340,1,1,MOT,1196,3852,CHI
2,1,8,142,2.897292201,143,1,see,"('MOT', 'CHI')",Providence,lil26.xml,153,10,2,CHI,1690,691,MOT
1,0,0,24,2.85263143,24,0,go,"('CHI', 'OPE')",Providence,lil26.xml,25,1,1,OPE,159,116,CHI
0,2,1,150,2.839728025,152,2,where,"('MOT', 'CHI')",Providence,lil26.xml,153,1,0,CHI,1690,691,MOT
3,8,4,325,2.805975738,333,8,want,"('CHI', 'MOT')",Providence,lil26.xml,340,7,3,MOT,1196,3852,CHI
1,0,1,29,2.740840024,29,0,they,"('OPE', 'MOT')",Providence,lil26.xml,31,2,1,MOT,114,370,OPE
1,3,2,147,2.721295428,150,3,want,"('MOT', 'CHI')",Providence,lil26.xml,153,3,1,CHI,1690,691,MOT
0,1,3,149,2.721295428,150,1,put,"('MOT', 'CHI')",Providence,lil26.xml,153,3,0,CHI,1690,691,MOT
1,2,4,146,2.659260037,148,2,go,"('MOT', 'CHI')",Providence,lil26.xml,153,5,1,CHI,1690,691,MOT
1,17,0,322,2.536045611,339,17,see,"('CHI', 'MOT')",Providence,lil26.xml,340,1,1,MOT,1196,3852,CHI
0,1,4,148,2.532373187,149,1,big,"('MOT', 'CHI')",Providence,lil26.xml,153,4,0,CHI,1690,691,MOT
1,0,1,23,2.525728644,23,0,no,"('CHI', 'OPE')",Providence,lil26.xml,25,2,1,OPE,159,116,CHI
1,13,1,325,2.496741107,338,13,he,"('CHI', 'MOT')",Providence,lil26.xml,340,2,1,MOT,1196,3852,CHI
1,13,1,325,2.496741107,338,13,on,"('CHI', 'MOT')",Providence,lil26.xml,340,2,1,MOT,1196,3852,CHI
1,1,9,142,2.491827093,143,1,in,"('MOT', 'CHI')",Providence,lil26.xml,153,10,1,CHI,1690,691,MOT
1,0,2,28,2.48490665,28,0,is,"('MOT', 'OPE')",Providence,lil26.xml,31,3,1,OPE,333,131,MOT
0,9,1,330,2.430685096,339,9,there,"('CHI', 'MOT')",Providence,lil26.xml,340,1,0,MOT,1196,3852,CHI
1,1,10,141,2.404863942,142,1,do,"('MOT', 'CHI')",Providence,lil26.xml,153,11,1,CHI,1690,691,MOT
3,2,13,135,2.331784248,137,2,to,"('MOT', 'CHI')",Providence,lil26.xml,153,16,3,CHI,1690,691,MOT
1,13,2,324,2.270652046,337,13,it,"('CHI', 'MOT')",Providence,lil26.xml,340,3,1,MOT,1196,3852,CHI
1,1,12,139,2.247776856,140,1,oh,"('MOT', 'CHI')",Providence,lil26.xml,153,13,1,CHI,1690,691,MOT
0,1,6,146,2.231357584,147,1,at,"('MOT', 'CHI')",Providence,lil26.xml,153,6,0,CHI,1690,691,MOT
4,22,2,312,2.211613315,334,22,in,"('CHI', 'MOT')",Providence,lil26.xml,340,6,4,MOT,1196,3852,CHI
1,1,0,23,2.159484249,24,1,is,"('CHI', 'OPE')",Providence,lil26.xml,25,1,1,OPE,159,116,CHI
0,13,1,326,2.094212859,339,13,have,"('CHI', 'MOT')",Providence,lil26.xml,340,1,0,MOT,1196,3852,CHI
0,5,5,330,2.082413312,335,5,my,"('CHI', 'MOT')",Providence,lil26.xml,340,5,0,MOT,1196,3852,CHI
0,2,5,146,1.966112856,148,2,he,"('MOT', 'CHI')",Providence,lil26.xml,153,5,0,CHI,1690,691,MOT
1,2,0,28,1.961658506,30,2,on,"('OPE', 'MOT')",Providence,lil26.xml,31,1,1,MOT,114,370,OPE
1,0,33,119,1.905418788,119,0,you,"('MOT', 'CHI')",Providence,lil26.xml,153,34,1,CHI,1690,691,MOT
0,16,1,323,1.900056845,339,16,one,"('CHI', 'MOT')",Providence,lil26.xml,340,1,0,MOT,1196,3852,CHI
0,4,3,146,1.805004696,150,4,no,"('MOT', 'CHI')",Providence,lil26.xml,153,3,0,CHI,1690,691,MOT
0,14,2,324,1.734601055,338,14,this,"('CHI', 'MOT')",Providence,lil26.xml,340,2,0,MOT,1196,3852,CHI
1,40,0,299,1.712845302,339,40,do,"('CHI', 'MOT')",Providence,lil26.xml,340,1,1,MOT,1196,3852,CHI
1,3,10,139,1.711716762,142,3,it,"('MOT', 'CHI')",Providence,lil26.xml,153,11,1,CHI,1690,691,MOT
0,1,11,141,1.711716762,142,1,did,"('MOT', 'CHI')",Providence,lil26.xml,153,11,0,CHI,1690,691,MOT
0,2,7,144,1.701375408,146,2,one,"('MOT', 'CHI')",Providence,lil26.xml,153,7,0,CHI,1690,691,MOT
0,1,1,29,1.673976434,30,1,can,"('MOT', 'OPE')",Providence,lil26.xml,31,1,0,OPE,333,131,MOT
0,1,1,29,1.673976434,30,1,are,"('MOT', 'OPE')",Providence,lil26.xml,31,1,0,OPE,333,131,MOT
1,3,0,27,1.673976434,30,3,she,"('OPE', 'MOT')",Providence,lil26.xml,31,1,1,MOT,114,370,OPE
1,2,0,18,1.586965057,20,2,and,"('OPE', 'CHI')",Providence,lil26.xml,21,1,1,CHI,105,94,OPE
2,52,0,286,1.570971632,338,52,to,"('CHI', 'MOT')",Providence,lil26.xml,340,2,2,MOT,1196,3852,CHI
2,4,0,25,1.53686722,29,4,to,"('OPE', 'MOT')",Providence,lil26.xml,31,2,2,MOT,114,370,OPE
26,41,15,258,1.504077397,299,41,a,"('CHI', 'MOT')",Providence,lil26.xml,340,41,26,MOT,1196,3852,CHI
0,1,1,23,1.466337069,24,1,a,"('CHI', 'OPE')",Providence,lil26.xml,25,1,0,OPE,159,116,CHI
4,31,6,299,1.463930329,330,31,is,"('CHI', 'MOT')",Providence,lil26.xml,340,10,4,MOT,1196,3852,CHI
1,31,2,306,1.443973473,337,31,oh,"('CHI', 'MOT')",Providence,lil26.xml,340,3,1,MOT,1196,3852,CHI
0,1,2,28,1.354545663,29,1,of,"('MOT', 'OPE')",Providence,lil26.xml,31,2,0,OPE,333,131,MOT
0,1,2,28,1.354545663,29,1,what,"('MOT', 'OPE')",Providence,lil26.xml,31,2,0,OPE,333,131,MOT
0,1,2,28,1.354545663,29,1,not,"('MOT', 'OPE')",Providence,lil26.xml,31,2,0,OPE,333,131,MOT
0,3,8,142,1.301553133,145,3,yeah,"('MOT', 'CHI')",Providence,lil26.xml,153,8,0,CHI,1690,691,MOT
0,1,1,19,1.299282984,20,1,see,"('OPE', 'CHI')",Providence,lil26.xml,21,1,0,CHI,105,94,OPE
0,1,1,19,1.299282984,20,1,is,"('OPE', 'CHI')",Providence,lil26.xml,21,1,0,CHI,105,94,OPE
0,2,1,28,1.268511325,30,2,but,"('MOT', 'OPE')",Providence,lil26.xml,31,1,0,OPE,333,131,MOT
0,2,1,28,1.268511325,30,2,did,"('MOT', 'OPE')",Providence,lil26.xml,31,1,0,OPE,333,131,MOT
0,2,1,28,1.268511325,30,2,that,"('MOT', 'OPE')",Providence,lil26.xml,31,1,0,OPE,333,131,MOT
0,2,1,28,1.268511325,30,2,that,"('OPE', 'MOT')",Providence,lil26.xml,31,1,0,MOT,114,370,OPE
1,1,5,24,1.216395324,25,1,it,"('MOT', 'OPE')",Providence,lil26.xml,31,6,1,OPE,333,131,MOT
18,73,6,243,1.144328731,316,73,the,"('CHI', 'MOT')",Providence,lil26.xml,340,24,18,MOT,1196,3852,CHI
0,1,2,22,1.139434283,23,1,and,"('CHI', 'OPE')",Providence,lil26.xml,25,2,0,OPE,159,116,CHI
0,13,6,321,1.098612289,334,13,yeah,"('CHI', 'MOT')",Providence,lil26.xml,340,6,0,MOT,1196,3852,CHI
2,4,2,23,1.064710737,27,4,oh,"('OPE', 'MOT')",Providence,lil26.xml,31,4,2,MOT,114,370,OPE
5,8,23,117,1.037524597,125,8,and,"('MOT', 'CHI')",Providence,lil26.xml,153,28,5,CHI,1690,691,MOT
0,3,1,27,0.980829253,30,3,in,"('OPE', 'MOT')",Providence,lil26.xml,31,1,0,MOT,114,370,OPE
0,3,1,27,0.980829253,30,3,it,"('OPE', 'MOT')",Providence,lil26.xml,31,1,0,MOT,114,370,OPE
0,3,1,27,0.980829253,30,3,is,"('OPE', 'MOT')",Providence,lil26.xml,31,1,0,MOT,114,370,OPE
0,2,2,27,0.949080555,29,2,she,"('MOT', 'OPE')",Providence,lil26.xml,31,2,0,OPE,333,131,MOT
0,2,2,27,0.949080555,29,2,yeah,"('OPE', 'MOT')",Providence,lil26.xml,31,2,0,MOT,114,370,OPE
2,2,6,21,0.916290732,23,2,you,"('MOT', 'OPE')",Providence,lil26.xml,31,8,2,OPE,333,131,MOT
0,2,1,18,0.893817876,20,2,oh,"('OPE', 'CHI')",Providence,lil26.xml,21,1,0,CHI,105,94,OPE
0,1,4,26,0.88238918,27,1,in,"('MOT', 'OPE')",Providence,lil26.xml,31,4,0,OPE,333,131,MOT
0,1,4,26,0.88238918,27,1,like,"('MOT', 'OPE')",Providence,lil26.xml,31,4,0,OPE,333,131,MOT
13,47,23,257,0.853855261,304,47,and,"('CHI', 'MOT')",Providence,lil26.xml,340,36,13,MOT,1196,3852,CHI
0,4,1,26,0.757685702,30,4,was,"('OPE', 'MOT')",Providence,lil26.xml,31,1,0,MOT,114,370,OPE
0,2,2,21,0.733969175,23,2,the,"('CHI', 'OPE')",Providence,lil26.xml,25,2,0,OPE,159,116,CHI
3,96,2,239,0.685756164,335,96,you,"('CHI', 'MOT')",Providence,lil26.xml,340,5,3,MOT,1196,3852,CHI
0,3,2,26,0.661398482,29,3,are,"('OPE', 'MOT')",Providence,lil26.xml,31,2,0,MOT,114,370,OPE
7,9,38,99,0.627189213,108,9,the,"('MOT', 'CHI')",Providence,lil26.xml,153,45,7,CHI,1690,691,MOT
0,3,1,17,0.606135804,20,3,you,"('OPE', 'CHI')",Providence,lil26.xml,21,1,0,CHI,105,94,OPE
3,9,24,117,0.568443702,126,9,a,"('MOT', 'CHI')",Providence,lil26.xml,153,27,3,CHI,1690,691,MOT
0,4,1,20,0.550046337,24,4,you,"('CHI', 'OPE')",Providence,lil26.xml,25,1,0,OPE,159,116,CHI
0,5,12,136,0.532027831,141,5,is,"('MOT', 'CHI')",Providence,lil26.xml,153,12,0,CHI,1690,691,MOT
0,4,2,25,0.438254931,29,4,a,"('OPE', 'MOT')",Providence,lil26.xml,31,2,0,MOT,114,370,OPE
0,6,1,24,0.421213465,30,6,you,"('OPE', 'MOT')",Providence,lil26.xml,31,1,0,MOT,114,370,OPE
0,4,2,15,0.048790164,19,4,a,"('OPE', 'CHI')",Providence,lil26.xml,21,2,0,CHI,105,94,OPE
0,4,4,23,-0.033901552,27,4,yeah,"('MOT', 'OPE')",Providence,lil26.xml,31,4,0,OPE,333,131,MOT
0,1,3,334,3.517497837,335,1,some,"('MOT', 'CHI')",Providence,lil27.xml,338,3,0,CHI,4005,1303,MOT
2,1,12,323,3.419773767,324,1,get,"('MOT', 'CHI')",Providence,lil27.xml,338,14,2,CHI,4005,1303,MOT
1,0,23,314,3.190792856,314,0,see,"('MOT', 'CHI')",Providence,lil27.xml,338,24,1,CHI,4005,1303,MOT
1,2,0,93,3.070633582,95,2,wanna,"('CHI', 'MOT')",Providence,lil27.xml,96,1,1,MOT,376,2021,CHI
0,1,6,331,3.038552271,332,1,put,"('MOT', 'CHI')",Providence,lil27.xml,338,6,0,CHI,4005,1303,MOT
0,4,2,332,2.827313622,336,4,no,"('MOT', 'CHI')",Providence,lil27.xml,338,2,0,CHI,4005,1303,MOT
2,2,2,90,2.751535313,92,2,go,"('CHI', 'MOT')",Providence,lil27.xml,96,4,2,MOT,376,2021,CHI
3,0,16,77,2.711219776,77,0,yeah,"('CHI', 'MOT')",Providence,lil27.xml,96,19,3,MOT,376,2021,CHI
2,4,10,322,2.643130655,326,4,one,"('MOT', 'CHI')",Providence,lil27.xml,338,12,2,CHI,4005,1303,MOT
0,1,11,326,2.537961213,327,1,there,"('MOT', 'CHI')",Providence,lil27.xml,338,11,0,CHI,4005,1303,MOT
0,1,11,326,2.537961213,327,1,he,"('MOT', 'CHI')",Providence,lil27.xml,338,11,0,CHI,4005,1303,MOT
0,2,7,329,2.512305624,331,2,big,"('MOT', 'CHI')",Providence,lil27.xml,338,7,0,CHI,4005,1303,MOT
0,1,2,93,2.48490665,94,1,no,"('CHI', 'MOT')",Providence,lil27.xml,96,2,0,MOT,376,2021,CHI
0,1,12,325,2.460809098,326,1,go,"('MOT', 'CHI')",Providence,lil27.xml,338,12,0,CHI,4005,1303,MOT
0,2,1,93,2.377486401,95,2,can,"('CHI', 'MOT')",Providence,lil27.xml,96,1,0,MOT,376,2021,CHI
1,0,1,18,2.302585093,18,0,this,"('MOT', 'OPE')",Providence,lil27.xml,20,2,1,OPE,389,119,MOT
0,1,15,322,2.257464658,323,1,are,"('MOT', 'CHI')",Providence,lil27.xml,338,15,0,CHI,4005,1303,MOT
1,0,2,17,2.028148247,17,0,you,"('MOT', 'OPE')",Providence,lil27.xml,20,3,1,OPE,389,119,MOT
1,0,2,17,2.028148247,17,0,can,"('MOT', 'OPE')",Providence,lil27.xml,20,3,1,OPE,389,119,MOT
1,9,0,86,1.866660777,95,9,oh,"('CHI', 'MOT')",Providence,lil27.xml,96,1,1,MOT,376,2021,CHI
1,9,0,86,1.866660777,95,9,it,"('CHI', 'MOT')",Providence,lil27.xml,96,1,1,MOT,376,2021,CHI
1,9,0,86,1.866660777,95,9,on,"('CHI', 'MOT')",Providence,lil27.xml,96,1,1,MOT,376,2021,CHI
0,4,1,91,1.866660777,95,4,little,"('CHI', 'MOT')",Providence,lil27.xml,96,1,0,MOT,376,2021,CHI
0,4,1,91,1.866660777,95,4,one,"('CHI', 'MOT')",Providence,lil27.xml,96,1,0,MOT,376,2021,CHI
0,2,15,321,1.85199955,323,2,with,"('MOT', 'CHI')",Providence,lil27.xml,338,15,0,CHI,4005,1303,MOT
0,3,2,91,1.791759469,94,3,this,"('CHI', 'MOT')",Providence,lil27.xml,96,2,0,MOT,376,2021,CHI
1,0,0,7,1.791759469,7,0,you,"('OPE', 'CHI')",Providence,lil27.xml,8,1,1,CHI,54,35,OPE
1,0,0,7,1.791759469,7,0,and,"('OPE', 'CHI')",Providence,lil27.xml,8,1,1,CHI,54,35,OPE
1,4,22,311,1.623735217,315,4,this,"('MOT', 'CHI')",Providence,lil27.xml,338,23,1,CHI,4005,1303,MOT
1,1,1,17,1.609437912,18,1,yeah,"('MOT', 'OPE')",Providence,lil27.xml,20,2,1,OPE,389,119,MOT
2,9,2,83,1.547562509,92,9,is,"('CHI', 'MOT')",Providence,lil27.xml,96,4,2,MOT,376,2021,CHI
0,6,1,89,1.530188541,95,6,see,"('CHI', 'MOT')",Providence,lil27.xml,96,1,0,MOT,376,2021,CHI
2,15,0,79,1.504077397,94,15,in,"('CHI', 'MOT')",Providence,lil27.xml,96,2,2,MOT,376,2021,CHI
0,2,23,313,1.44141366,315,2,in,"('MOT', 'CHI')",Providence,lil27.xml,338,23,0,CHI,4005,1303,MOT
0,1,35,302,1.416246683,303,1,like,"('MOT', 'CHI')",Providence,lil27.xml,338,35,0,CHI,4005,1303,MOT
0,7,1,88,1.396657148,95,7,there,"('CHI', 'MOT')",Providence,lil27.xml,96,1,0,MOT,376,2021,CHI
1,0,0,4,1.386294361,4,0,and,"('CHI', 'OPE')",Providence,lil27.xml,5,1,1,OPE,22,32,CHI
1,0,0,4,1.386294361,4,0,get,"('OPE', 'MOT')",Providence,lil27.xml,5,1,1,MOT,23,37,OPE
1,0,0,4,1.386294361,4,0,the,"('OPE', 'MOT')",Providence,lil27.xml,5,1,1,MOT,23,37,OPE
0,10,6,322,1.333804178,332,10,my,"('MOT', 'CHI')",Providence,lil27.xml,338,6,0,CHI,4005,1303,MOT
0,8,8,322,1.305325299,330,8,want,"('MOT', 'CHI')",Providence,lil27.xml,338,8,0,CHI,4005,1303,MOT
0,3,20,315,1.290984181,318,3,on,"('MOT', 'CHI')",Providence,lil27.xml,338,20,0,CHI,4005,1303,MOT
0,8,1,87,1.278874112,95,8,that,"('CHI', 'MOT')",Providence,lil27.xml,96,1,0,MOT,376,2021,CHI
0,1,1,18,1.252762968,19,1,in,"('MOT', 'OPE')",Providence,lil27.xml,20,1,0,OPE,389,119,MOT
0,4,4,88,1.142097401,92,4,where,"('CHI', 'MOT')",Providence,lil27.xml,96,4,0,MOT,376,2021,CHI
6,11,8,71,1.119231576,82,11,and,"('CHI', 'MOT')",Providence,lil27.xml,96,14,6,MOT,376,2021,CHI
2,1,4,13,1.098612289,14,1,the,"('MOT', 'OPE')",Providence,lil27.xml,20,6,2,OPE,389,119,MOT
1,0,7,12,1.029619417,12,0,it,"('MOT', 'OPE')",Providence,lil27.xml,20,8,1,OPE,389,119,MOT
1,6,30,301,0.984070747,307,6,it,"('MOT', 'CHI')",Providence,lil27.xml,338,31,1,CHI,4005,1303,MOT
0,1,2,17,0.916290732,18,1,there,"('MOT', 'OPE')",Providence,lil27.xml,20,2,0,OPE,389,119,MOT
12,23,5,56,0.836905703,79,23,a,"('CHI', 'MOT')",Providence,lil27.xml,96,17,12,MOT,376,2021,CHI
3,27,1,65,0.805625164,92,27,the,"('CHI', 'MOT')",Providence,lil27.xml,96,4,3,MOT,376,2021,CHI
0,10,2,84,0.780158558,94,10,for,"('CHI', 'MOT')",Providence,lil27.xml,96,2,0,MOT,376,2021,CHI
17,29,56,236,0.758934921,265,29,a,"('MOT', 'CHI')",Providence,lil27.xml,338,73,17,CHI,4005,1303,MOT
0,4,7,85,0.704197017,89,4,my,"('CHI', 'MOT')",Providence,lil27.xml,96,7,0,MOT,376,2021,CHI
1,1,0,3,0.693147181,4,1,in,"('CHI', 'OPE')",Providence,lil27.xml,5,1,1,OPE,22,32,CHI
1,1,0,3,0.693147181,4,1,you,"('OPE', 'MOT')",Providence,lil27.xml,5,1,1,MOT,23,37,OPE
0,2,52,284,0.575364145,286,2,what,"('MOT', 'CHI')",Providence,lil27.xml,338,52,0,CHI,4005,1303,MOT
0,3,41,294,0.552949097,297,3,that,"('MOT', 'CHI')",Providence,lil27.xml,338,41,0,CHI,4005,1303,MOT
6,11,79,242,0.536358926,253,11,the,"('MOT', 'CHI')",Providence,lil27.xml,338,85,6,CHI,4005,1303,MOT
1,3,3,13,0.405465108,16,3,a,"('MOT', 'OPE')",Providence,lil27.xml,20,4,1,OPE,389,119,MOT
11,29,64,234,0.319633672,263,29,and,"('MOT', 'CHI')",Providence,lil27.xml,338,75,11,CHI,4005,1303,MOT
0,2,3,15,0.236388778,17,2,to,"('MOT', 'OPE')",Providence,lil27.xml,20,3,0,OPE,389,119,MOT
0,1,5,14,0.194156014,15,1,have,"('MOT', 'OPE')",Providence,lil27.xml,20,5,0,OPE,389,119,MOT
1,43,10,284,0.14006594,327,43,yeah,"('MOT', 'CHI')",Providence,lil27.xml,338,11,1,CHI,4005,1303,MOT
0,1,2,5,0,6,1,the,"('OPE', 'CHI')",Providence,lil27.xml,8,2,0,CHI,54,35,OPE
0,5,50,283,-0.073122265,288,5,to,"('MOT', 'CHI')",Providence,lil27.xml,338,50,0,CHI,4005,1303,MOT
0,6,45,287,-0.109082394,293,6,is,"('MOT', 'CHI')",Providence,lil27.xml,338,45,0,CHI,4005,1303,MOT
0,2,5,13,-0.211309094,15,2,that,"('MOT', 'OPE')",Providence,lil27.xml,20,5,0,OPE,389,119,MOT
0,3,4,13,-0.287682072,16,3,for,"('MOT', 'OPE')",Providence,lil27.xml,20,4,0,OPE,389,119,MOT
1,2,1,196,3.506557897,198,2,did,"('CHI', 'MOT')",Providence,lil28.xml,200,2,1,MOT,901,2559,CHI
1,4,0,195,3.288401888,199,4,was,"('CHI', 'MOT')",Providence,lil28.xml,200,1,1,MOT,901,2559,CHI
0,1,1,128,3.083437854,129,1,see,"('MOT', 'CHI')",Providence,lil28.xml,130,1,0,CHI,2269,498,MOT
1,0,11,118,2.841581594,118,0,little,"('MOT', 'CHI')",Providence,lil28.xml,130,12,1,CHI,2269,498,MOT
0,1,2,127,2.788092909,128,1,where,"('MOT', 'CHI')",Providence,lil28.xml,130,2,0,CHI,2269,498,MOT
2,9,0,189,2.708050201,198,9,with,"('CHI', 'MOT')",Providence,lil28.xml,200,2,2,MOT,901,2559,CHI
1,6,1,192,2.659260037,198,6,all,"('CHI', 'MOT')",Providence,lil28.xml,200,2,1,MOT,901,2559,CHI
0,1,3,126,2.557227311,127,1,big,"('MOT', 'CHI')",Providence,lil28.xml,130,3,0,CHI,2269,498,MOT
3,4,7,186,2.549445171,190,4,no,"('CHI', 'MOT')",Providence,lil28.xml,200,10,3,MOT,901,2559,CHI
2,10,1,187,2.384583928,197,10,is,"('CHI', 'MOT')",Providence,lil28.xml,200,3,2,MOT,901,2559,CHI
0,2,2,126,2.382627801,128,2,my,"('MOT', 'CHI')",Providence,lil28.xml,130,2,0,CHI,2269,498,MOT
0,2,2,126,2.382627801,128,2,one,"('MOT', 'CHI')",Providence,lil28.xml,130,2,0,CHI,2269,498,MOT
1,12,0,187,2.332890442,199,12,for,"('CHI', 'MOT')",Providence,lil28.xml,200,1,1,MOT,901,2559,CHI
1,3,7,189,2.272125886,192,3,one,"('CHI', 'MOT')",Providence,lil28.xml,200,8,1,MOT,901,2559,CHI
1,13,0,186,2.25878247,199,13,are,"('CHI', 'MOT')",Providence,lil28.xml,200,1,1,MOT,901,2559,CHI
0,6,1,193,2.25878247,199,6,see,"('CHI', 'MOT')",Providence,lil28.xml,200,1,0,MOT,901,2559,CHI
0,6,1,193,2.25878247,199,6,little,"('CHI', 'MOT')",Providence,lil28.xml,200,1,0,MOT,901,2559,CHI
1,0,0,12,2.233592222,12,0,with,"('OPE', 'MOT')",Providence,lil28.xml,13,1,1,MOT,88,267,OPE
0,7,1,192,2.125251078,199,7,where,"('CHI', 'MOT')",Providence,lil28.xml,200,1,0,MOT,901,2559,CHI
0,4,3,193,2.074429,197,4,big,"('CHI', 'MOT')",Providence,lil28.xml,200,3,0,MOT,901,2559,CHI
0,1,6,123,2.063693185,124,1,wanna,"('MOT', 'CHI')",Providence,lil28.xml,130,6,0,CHI,2269,498,MOT
0,8,1,191,2.007468042,199,8,get,"('CHI', 'MOT')",Providence,lil28.xml,200,1,0,MOT,901,2559,CHI
3,17,1,179,1.992430165,196,17,go,"('CHI', 'MOT')",Providence,lil28.xml,200,4,3,MOT,901,2559,CHI
1,19,0,180,1.902107526,199,19,like,"('CHI', 'MOT')",Providence,lil28.xml,200,1,1,MOT,901,2559,CHI
1,14,1,184,1.897119985,198,14,we,"('CHI', 'MOT')",Providence,lil28.xml,200,2,1,MOT,901,2559,CHI
1,14,1,184,1.897119985,198,14,on,"('CHI', 'MOT')",Providence,lil28.xml,200,2,1,MOT,901,2559,CHI
1,4,9,186,1.85629799,190,4,want,"('CHI', 'MOT')",Providence,lil28.xml,200,10,1,MOT,901,2559,CHI
1,20,0,179,1.853317362,199,20,in,"('CHI', 'MOT')",Providence,lil28.xml,200,1,1,MOT,901,2559,CHI
0,10,1,189,1.806797347,199,10,have,"('CHI', 'MOT')",Providence,lil28.xml,200,1,0,MOT,901,2559,CHI
0,10,1,189,1.806797347,199,10,can,"('CHI', 'MOT')",Providence,lil28.xml,200,1,0,MOT,901,2559,CHI
2,13,4,181,1.658228077,194,13,that,"('CHI', 'MOT')",Providence,lil28.xml,200,6,2,MOT,901,2559,CHI
0,2,6,122,1.658228077,124,2,in,"('MOT', 'CHI')",Providence,lil28.xml,130,6,0,CHI,2269,498,MOT
0,2,6,122,1.658228077,124,2,did,"('MOT', 'CHI')",Providence,lil28.xml,130,6,0,CHI,2269,498,MOT
0,4,3,123,1.640936579,127,4,no,"('MOT', 'CHI')",Providence,lil28.xml,130,3,0,CHI,2269,498,MOT
2,1,0,10,1.584120104,11,1,she,"('OPE', 'MOT')",Providence,lil28.xml,13,2,2,MOT,88,267,OPE
0,5,5,190,1.54553411,195,5,this,"('CHI', 'MOT')",Providence,lil28.xml,200,5,0,MOT,901,2559,CHI
0,1,11,118,1.537694008,119,1,for,"('MOT', 'CHI')",Providence,lil28.xml,130,11,0,CHI,2269,498,MOT
0,2,7,121,1.532476871,123,2,we,"('MOT', 'CHI')",Providence,lil28.xml,130,7,0,CHI,2269,498,MOT
2,3,16,109,1.452784102,112,3,it,"('MOT', 'CHI')",Providence,lil28.xml,130,18,2,CHI,2269,498,MOT
3,16,6,175,1.417875933,191,16,it,"('CHI', 'MOT')",Providence,lil28.xml,200,9,3,MOT,901,2559,CHI
9,30,4,157,1.402294702,187,30,and,"('CHI', 'MOT')",Providence,lil28.xml,200,13,9,MOT,901,2559,CHI
0,1,13,116,1.377926111,117,1,with,"('MOT', 'CHI')",Providence,lil28.xml,130,13,0,CHI,2269,498,MOT
0,2,9,119,1.315676794,121,2,go,"('MOT', 'CHI')",Providence,lil28.xml,130,9,0,CHI,2269,498,MOT
1,1,0,8,1.299282984,9,1,are,"('MOT', 'OPE')",Providence,lil28.xml,10,1,1,OPE,208,64,MOT
0,1,15,114,1.23581341,115,1,on,"('MOT', 'CHI')",Providence,lil28.xml,130,15,0,CHI,2269,498,MOT
1,1,1,10,1.178654996,11,1,like,"('OPE', 'MOT')",Providence,lil28.xml,13,2,1,MOT,88,267,OPE
1,1,1,10,1.178654996,11,1,they,"('OPE', 'MOT')",Providence,lil28.xml,13,2,1,MOT,88,267,OPE
2,2,0,9,1.178654996,11,2,a,"('OPE', 'MOT')",Providence,lil28.xml,13,2,2,MOT,88,267,OPE
1,2,0,10,1.134979933,12,2,little,"('OPE', 'MOT')",Providence,lil28.xml,13,1,1,MOT,88,267,OPE
1,12,7,180,1.093470889,192,12,wanna,"('CHI', 'MOT')",Providence,lil28.xml,200,8,1,MOT,901,2559,CHI
7,47,2,144,1.073035447,191,47,the,"('CHI', 'MOT')",Providence,lil28.xml,200,9,7,MOT,901,2559,CHI
0,22,1,177,1.069198403,199,22,oh,"('CHI', 'MOT')",Providence,lil28.xml,200,1,0,MOT,901,2559,CHI
2,28,3,167,1.068610038,195,28,to,"('CHI', 'MOT')",Providence,lil28.xml,200,5,2,MOT,901,2559,CHI
0,23,1,176,1.026638789,199,23,do,"('CHI', 'MOT')",Providence,lil28.xml,200,1,0,MOT,901,2559,CHI
0,24,1,175,0.985816795,199,24,of,"('CHI', 'MOT')",Providence,lil28.xml,200,1,0,MOT,901,2559,CHI
6,30,8,156,0.975776185,186,30,a,"('CHI', 'MOT')",Providence,lil28.xml,200,14,6,MOT,901,2559,CHI
3,5,22,100,0.97152686,105,5,and,"('MOT', 'CHI')",Providence,lil28.xml,130,25,3,CHI,2269,498,MOT
3,9,13,105,0.946927701,114,9,yeah,"('MOT', 'CHI')",Providence,lil28.xml,130,16,3,CHI,2269,498,MOT
0,3,10,117,0.932820034,120,3,this,"('MOT', 'CHI')",Providence,lil28.xml,130,10,0,CHI,2269,498,MOT
3,3,34,90,0.890315245,93,3,the,"('MOT', 'CHI')",Providence,lil28.xml,130,37,3,CHI,2269,498,MOT
0,1,1,11,0.84729786,12,1,was,"('OPE', 'MOT')",Providence,lil28.xml,13,1,0,MOT,88,267,OPE
0,1,1,11,0.84729786,12,1,not,"('OPE', 'MOT')",Providence,lil28.xml,13,1,0,MOT,88,267,OPE
2,10,18,170,0.81368125,180,10,yeah,"('CHI', 'MOT')",Providence,lil28.xml,200,20,2,MOT,901,2559,CHI
0,7,6,117,0.677398824,124,7,want,"('MOT', 'CHI')",Providence,lil28.xml,130,6,0,CHI,2269,498,MOT
0,1,1,8,0.606135804,9,1,like,"('MOT', 'OPE')",Providence,lil28.xml,10,1,0,OPE,208,64,MOT
0,1,1,8,0.606135804,9,1,there,"('MOT', 'OPE')",Providence,lil28.xml,10,1,0,OPE,208,64,MOT
0,1,1,8,0.606135804,9,1,not,"('MOT', 'OPE')",Providence,lil28.xml,10,1,0,OPE,208,64,MOT
4,6,32,88,0.590289795,94,6,a,"('MOT', 'CHI')",Providence,lil28.xml,130,36,4,CHI,2269,498,MOT
2,3,1,7,0.587786665,10,3,the,"('OPE', 'MOT')",Providence,lil28.xml,13,3,2,MOT,88,267,OPE
0,2,19,109,0.584253092,111,2,is,"('MOT', 'CHI')",Providence,lil28.xml,130,19,0,CHI,2269,498,MOT
0,2,20,108,0.528844129,110,2,to,"('MOT', 'CHI')",Providence,lil28.xml,130,20,0,CHI,2269,498,MOT
0,2,1,10,0.441832752,12,2,there,"('OPE', 'MOT')",Providence,lil28.xml,13,1,0,MOT,88,267,OPE
0,2,1,10,0.441832752,12,2,that,"('OPE', 'MOT')",Providence,lil28.xml,13,1,0,MOT,88,267,OPE
0,2,1,10,0.441832752,12,2,on,"('OPE', 'MOT')",Providence,lil28.xml,13,1,0,MOT,88,267,OPE
1,5,0,7,0.441832752,12,5,you,"('OPE', 'MOT')",Providence,lil28.xml,13,1,1,MOT,88,267,OPE
1,5,0,7,0.441832752,12,5,to,"('OPE', 'MOT')",Providence,lil28.xml,13,1,1,MOT,88,267,OPE
0,1,2,7,0.223143551,8,1,a,"('MOT', 'OPE')",Providence,lil28.xml,10,2,0,OPE,208,64,MOT
0,1,2,7,0.223143551,8,1,she,"('MOT', 'OPE')",Providence,lil28.xml,10,2,0,OPE,208,64,MOT
0,1,2,7,0.223143551,8,1,to,"('MOT', 'OPE')",Providence,lil28.xml,10,2,0,OPE,208,64,MOT
0,3,1,9,0.15415068,12,3,is,"('OPE', 'MOT')",Providence,lil28.xml,13,1,0,MOT,88,267,OPE
0,1,2,6,0.117783036,7,1,you,"('CHI', 'OPE')",Providence,lil28.xml,9,2,0,OPE,54,63,CHI
0,1,3,6,-0.105360516,7,1,it,"('MOT', 'OPE')",Providence,lil28.xml,10,3,0,OPE,208,64,MOT
0,1,3,6,-0.105360516,7,1,one,"('MOT', 'OPE')",Providence,lil28.xml,10,3,0,OPE,208,64,MOT
1,2,3,4,-0.117783036,6,2,you,"('MOT', 'OPE')",Providence,lil28.xml,10,4,1,OPE,208,64,MOT
0,2,39,89,-0.279584862,91,2,you,"('MOT', 'CHI')",Providence,lil28.xml,130,39,0,CHI,2269,498,MOT
0,2,2,5,-0.287682072,7,2,the,"('CHI', 'OPE')",Providence,lil28.xml,9,2,0,OPE,54,63,CHI
0,3,2,5,-0.470003629,8,3,that,"('MOT', 'OPE')",Providence,lil28.xml,10,2,0,OPE,208,64,MOT
1,2,0,165,3.625821318,167,2,big,"('CHI', 'MOT')",Providence,lil29.xml,168,1,1,MOT,607,2236,CHI
1,0,10,184,3.353944497,184,0,are,"('MOT', 'CHI')",Providence,lil29.xml,195,11,1,CHI,2390,713,MOT
0,1,2,165,3.044522438,166,1,where,"('CHI', 'MOT')",Providence,lil29.xml,168,2,0,MOT,607,2236,CHI
3,4,3,158,2.797281335,162,4,want,"('CHI', 'MOT')",Providence,lil29.xml,168,6,3,MOT,607,2236,CHI
0,2,3,190,2.559807958,192,2,all,"('MOT', 'CHI')",Providence,lil29.xml,195,3,0,CHI,2390,713,MOT
2,9,0,157,2.533696814,166,9,he,"('CHI', 'MOT')",Providence,lil29.xml,168,2,2,MOT,607,2236,CHI
1,2,8,184,2.433081582,186,2,one,"('MOT', 'CHI')",Providence,lil29.xml,195,9,1,CHI,2390,713,MOT
1,9,0,158,2.421848514,167,9,in,"('CHI', 'MOT')",Providence,lil29.xml,168,1,1,MOT,607,2236,CHI
1,4,4,186,2.395294491,190,4,want,"('MOT', 'CHI')",Providence,lil29.xml,195,5,1,CHI,2390,713,MOT
0,1,7,187,2.356652314,188,1,on,"('MOT', 'CHI')",Providence,lil29.xml,195,7,0,CHI,2390,713,MOT
1,1,16,177,2.248517872,178,1,it,"('MOT', 'CHI')",Providence,lil29.xml,195,17,1,CHI,2390,713,MOT
0,1,8,186,2.246014742,187,1,not,"('MOT', 'CHI')",Providence,lil29.xml,195,8,0,CHI,2390,713,MOT
0,5,1,162,2.239526957,167,5,make,"('CHI', 'MOT')",Providence,lil29.xml,168,1,0,MOT,607,2236,CHI
3,5,9,178,2.175833387,183,5,no,"('MOT', 'CHI')",Providence,lil29.xml,195,12,3,CHI,2390,713,MOT
1,0,2,20,2.174751721,20,0,see,"('MOT', 'OPE')",Providence,lil29.xml,23,3,1,OPE,274,137,MOT
0,1,9,185,2.145399509,186,1,where,"('MOT', 'CHI')",Providence,lil29.xml,195,9,0,CHI,2390,713,MOT
5,15,1,147,2.039595633,162,15,on,"('CHI', 'MOT')",Providence,lil29.xml,168,6,5,MOT,607,2236,CHI
1,4,6,157,1.980234892,161,4,one,"('CHI', 'MOT')",Providence,lil29.xml,168,7,1,MOT,607,2236,CHI
2,4,10,152,1.91271208,156,4,no,"('CHI', 'MOT')",Providence,lil29.xml,168,12,2,MOT,607,2236,CHI
1,2,15,177,1.902660165,179,2,oh,"('MOT', 'CHI')",Providence,lil29.xml,195,16,1,CHI,2390,713,MOT
0,2,8,185,1.840549633,187,2,there,"('MOT', 'CHI')",Providence,lil29.xml,195,8,0,CHI,2390,713,MOT
1,2,17,175,1.786188424,177,2,to,"('MOT', 'CHI')",Providence,lil29.xml,195,18,1,CHI,2390,713,MOT
2,16,1,149,1.773954845,165,16,it,"('CHI', 'MOT')",Providence,lil29.xml,168,3,2,MOT,607,2236,CHI
1,0,4,18,1.742969305,18,0,like,"('MOT', 'OPE')",Providence,lil29.xml,23,5,1,OPE,274,137,MOT
0,2,9,184,1.739934401,186,2,at,"('MOT', 'CHI')",Providence,lil29.xml,195,9,0,CHI,2390,713,MOT
1,0,1,9,1.704748092,9,0,the,"('CHI', 'OPE')",Providence,lil29.xml,11,2,1,OPE,36,73,CHI
0,1,15,179,1.677646162,180,1,he,"('MOT', 'CHI')",Providence,lil29.xml,195,15,0,CHI,2390,713,MOT
2,15,2,149,1.646251886,164,15,that,"('CHI', 'MOT')",Providence,lil29.xml,168,4,2,MOT,607,2236,CHI
0,3,8,184,1.552867561,187,3,look,"('MOT', 'CHI')",Providence,lil29.xml,195,8,0,CHI,2390,713,MOT
0,8,3,184,1.461195669,192,8,yeah,"('MOT', 'CHI')",Providence,lil29.xml,195,3,0,CHI,2390,713,MOT
2,5,14,147,1.453433664,152,5,yeah,"('CHI', 'MOT')",Providence,lil29.xml,168,16,2,MOT,607,2236,CHI
0,2,13,180,1.408273268,182,2,of,"('MOT', 'CHI')",Providence,lil29.xml,195,13,0,CHI,2390,713,MOT
0,1,1,21,1.386294361,22,1,with,"('MOT', 'OPE')",Providence,lil29.xml,23,1,0,OPE,274,137,MOT
0,1,1,21,1.386294361,22,1,there,"('MOT', 'OPE')",Providence,lil29.xml,23,1,0,OPE,274,137,MOT
0,1,1,21,1.386294361,22,1,little,"('MOT', 'OPE')",Providence,lil29.xml,23,1,0,OPE,274,137,MOT
0,1,1,21,1.386294361,22,1,do,"('MOT', 'OPE')",Providence,lil29.xml,23,1,0,OPE,274,137,MOT
1,0,0,4,1.386294361,4,0,the,"('OPE', 'MOT')",Providence,lil29.xml,5,1,1,MOT,29,75,OPE
2,0,0,3,1.32175584,3,0,a,"('OPE', 'MOT')",Providence,lil29.xml,5,2,2,MOT,29,75,OPE
2,12,6,148,1.318674173,160,12,this,"('CHI', 'MOT')",Providence,lil29.xml,168,8,2,MOT,607,2236,CHI
0,11,2,155,1.252762968,166,11,oh,"('CHI', 'MOT')",Providence,lil29.xml,168,2,0,MOT,607,2236,CHI
0,4,9,182,1.229108778,186,4,in,"('MOT', 'CHI')",Providence,lil29.xml,195,9,0,CHI,2390,713,MOT
24,26,14,104,1.116961427,130,26,a,"('CHI', 'MOT')",Providence,lil29.xml,168,38,24,MOT,607,2236,CHI
0,1,2,20,1.056052674,21,1,have,"('MOT', 'OPE')",Providence,lil29.xml,23,2,0,OPE,274,137,MOT
0,1,2,20,1.056052674,21,1,but,"('MOT', 'OPE')",Providence,lil29.xml,23,2,0,OPE,274,137,MOT
0,1,2,20,1.056052674,21,1,did,"('MOT', 'OPE')",Providence,lil29.xml,23,2,0,OPE,274,137,MOT
0,1,2,20,1.056052674,21,1,to,"('MOT', 'OPE')",Providence,lil29.xml,23,2,0,OPE,274,137,MOT
0,4,11,180,1.051359404,184,4,this,"('MOT', 'CHI')",Providence,lil29.xml,195,11,0,CHI,2390,713,MOT
0,4,12,179,0.971860583,183,4,my,"('MOT', 'CHI')",Providence,lil29.xml,195,12,0,CHI,2390,713,MOT
5,12,26,152,0.842290339,164,12,and,"('MOT', 'CHI')",Providence,lil29.xml,195,31,5,CHI,2390,713,MOT
10,46,4,108,0.825014956,154,46,the,"('CHI', 'MOT')",Providence,lil29.xml,168,14,10,MOT,607,2236,CHI
3,9,28,155,0.699189495,164,9,a,"('MOT', 'CHI')",Providence,lil29.xml,195,31,3,CHI,2390,713,MOT
0,1,1,9,0.693147181,10,1,it,"('CHI', 'OPE')",Providence,lil29.xml,11,1,0,OPE,36,73,CHI
0,1,1,9,0.693147181,10,1,on,"('CHI', 'OPE')",Providence,lil29.xml,11,1,0,OPE,36,73,CHI
0,1,1,9,0.693147181,10,1,and,"('CHI', 'OPE')",Providence,lil29.xml,11,1,0,OPE,36,73,CHI
0,2,27,166,0.669890318,168,2,that,"('MOT', 'CHI')",Providence,lil29.xml,195,27,0,CHI,2390,713,MOT
0,2,2,19,0.650587566,21,2,no,"('MOT', 'OPE')",Providence,lil29.xml,23,2,0,OPE,274,137,MOT
0,1,4,18,0.559615788,19,1,is,"('MOT', 'OPE')",Providence,lil29.xml,23,4,0,OPE,274,137,MOT
0,1,4,18,0.559615788,19,1,and,"('MOT', 'OPE')",Providence,lil29.xml,23,4,0,OPE,274,137,MOT
1,20,6,141,0.545150366,161,20,is,"('CHI', 'MOT')",Providence,lil29.xml,168,7,1,MOT,607,2236,CHI
4,31,10,123,0.420969295,154,31,and,"('CHI', 'MOT')",Providence,lil29.xml,168,14,4,MOT,607,2236,CHI
0,2,3,18,0.382992252,20,2,a,"('MOT', 'OPE')",Providence,lil29.xml,23,3,0,OPE,274,137,MOT
0,1,5,17,0.356674944,18,1,yeah,"('MOT', 'OPE')",Providence,lil29.xml,23,5,0,OPE,274,137,MOT
0,2,1,8,0.287682072,10,2,and,"('OPE', 'CHI')",Providence,lil29.xml,11,1,0,CHI,94,49,OPE
1,2,7,13,0.125163143,15,2,you,"('MOT', 'OPE')",Providence,lil29.xml,23,8,1,OPE,274,137,MOT
1,4,1,5,0.09531018,9,4,a,"('OPE', 'CHI')",Providence,lil29.xml,11,2,1,CHI,94,49,OPE
0,1,1,3,0,4,1,and,"('OPE', 'MOT')",Providence,lil29.xml,5,1,0,MOT,29,75,OPE
1,7,37,150,-0.006269613,157,7,is,"('MOT', 'CHI')",Providence,lil29.xml,195,38,1,CHI,2390,713,MOT
0,2,5,16,-0.048790164,18,2,that,"('MOT', 'OPE')",Providence,lil29.xml,23,5,0,OPE,274,137,MOT
1,8,39,147,-0.18550121,155,8,the,"('MOT', 'CHI')",Providence,lil29.xml,195,40,1,CHI,2390,713,MOT
0,4,1,6,-0.223143551,10,4,is,"('CHI', 'OPE')",Providence,lil29.xml,11,1,0,OPE,36,73,CHI
0,2,6,15,-0.233614851,17,2,the,"('MOT', 'OPE')",Providence,lil29.xml,23,6,0,OPE,274,137,MOT
0,4,4,15,-0.356674944,19,4,oh,"('MOT', 'OPE')",Providence,lil29.xml,23,4,0,OPE,274,137,MOT
0,4,4,15,-0.356674944,19,4,it,"('MOT', 'OPE')",Providence,lil29.xml,23,4,0,OPE,274,137,MOT
0,1,5,5,-0.559615788,6,1,the,"('OPE', 'CHI')",Providence,lil29.xml,11,5,0,CHI,94,49,OPE
1,1,6,419,3.847780737,420,1,put,"('MOT', 'CHI')",Providence,lil30.xml,427,7,1,CHI,6069,1956,MOT
0,1,3,423,3.751854253,424,1,make,"('MOT', 'CHI')",Providence,lil30.xml,427,3,0,CHI,6069,1956,MOT
1,0,20,406,3.568920139,406,0,did,"('MOT', 'CHI')",Providence,lil30.xml,427,21,1,CHI,6069,1956,MOT
1,0,22,404,3.480624515,404,0,go,"('MOT', 'CHI')",Providence,lil30.xml,427,23,1,CHI,6069,1956,MOT
2,2,13,410,3.19265263,412,2,up,"('MOT', 'CHI')",Providence,lil30.xml,427,15,2,CHI,6069,1956,MOT
3,3,16,405,2.971634722,408,3,there,"('MOT', 'CHI')",Providence,lil30.xml,427,19,3,CHI,6069,1956,MOT
1,3,8,415,2.949212258,418,3,not,"('MOT', 'CHI')",Providence,lil30.xml,427,9,1,CHI,6069,1956,MOT
0,1,13,413,2.629487879,414,1,where,"('MOT', 'CHI')",Providence,lil30.xml,427,13,0,CHI,6069,1956,MOT
0,1,14,412,2.562542617,413,1,have,"('MOT', 'CHI')",Providence,lil30.xml,427,14,0,CHI,6069,1956,MOT
1,2,19,405,2.517207595,407,2,see,"('MOT', 'CHI')",Providence,lil30.xml,427,20,1,CHI,6069,1956,MOT
2,6,14,405,2.285777975,411,6,gonna,"('MOT', 'CHI')",Providence,lil30.xml,427,16,2,CHI,6069,1956,MOT
3,7,16,401,2.278487541,408,7,get,"('MOT', 'CHI')",Providence,lil30.xml,427,19,3,CHI,6069,1956,MOT
7,5,45,370,2.230943213,375,5,it,"('MOT', 'CHI')",Providence,lil30.xml,427,52,7,CHI,6069,1956,MOT
0,1,25,401,2.012430831,402,1,they,"('MOT', 'CHI')",Providence,lil30.xml,427,25,0,CHI,6069,1956,MOT
0,1,25,401,2.012430831,402,1,are,"('MOT', 'CHI')",Providence,lil30.xml,427,25,0,CHI,6069,1956,MOT
0,2,19,406,1.873022433,408,2,like,"('MOT', 'CHI')",Providence,lil30.xml,427,19,0,CHI,6069,1956,MOT
2,10,14,401,1.833792851,411,10,one,"('MOT', 'CHI')",Providence,lil30.xml,427,16,2,CHI,6069,1956,MOT
0,1,31,395,1.796797263,396,1,with,"('MOT', 'CHI')",Providence,lil30.xml,427,31,0,CHI,6069,1956,MOT
2,14,12,399,1.646251886,413,14,this,"('MOT', 'CHI')",Providence,lil30.xml,427,14,2,CHI,6069,1956,MOT
1,7,17,402,1.63656658,409,7,he,"('MOT', 'CHI')",Providence,lil30.xml,427,18,1,CHI,6069,1956,MOT
0,1,40,386,1.532762545,387,1,we,"('MOT', 'CHI')",Providence,lil30.xml,427,40,0,CHI,6069,1956,MOT
0,4,16,407,1.523637923,411,4,at,"('MOT', 'CHI')",Providence,lil30.xml,427,16,0,CHI,6069,1956,MOT
0,4,18,405,1.413423029,409,4,look,"('MOT', 'CHI')",Providence,lil30.xml,427,18,0,CHI,6069,1956,MOT
3,7,44,373,1.36045313,380,7,on,"('MOT', 'CHI')",Providence,lil30.xml,427,47,3,CHI,6069,1956,MOT
1,10,17,399,1.318112849,409,10,my,"('MOT', 'CHI')",Providence,lil30.xml,427,18,1,CHI,6069,1956,MOT
4,12,41,370,1.144983506,382,12,in,"('MOT', 'CHI')",Providence,lil30.xml,427,45,4,CHI,6069,1956,MOT
2,21,16,388,1.030430776,409,21,no,"('MOT', 'CHI')",Providence,lil30.xml,427,18,2,CHI,6069,1956,MOT
9,10,105,303,0.903672268,313,10,you,"('MOT', 'CHI')",Providence,lil30.xml,427,114,9,CHI,6069,1956,MOT
0,3,39,385,0.866280311,388,3,do,"('MOT', 'CHI')",Providence,lil30.xml,427,39,0,CHI,6069,1956,MOT
3,10,54,360,0.829755499,370,10,oh,"('MOT', 'CHI')",Providence,lil30.xml,427,57,3,CHI,6069,1956,MOT
2,10,48,367,0.687009502,377,10,is,"('MOT', 'CHI')",Providence,lil30.xml,427,50,2,CHI,6069,1956,MOT
0,15,12,400,0.62144017,415,15,want,"('MOT', 'CHI')",Providence,lil30.xml,427,12,0,CHI,6069,1956,MOT
9,13,110,295,0.604309515,308,13,the,"('MOT', 'CHI')",Providence,lil30.xml,427,119,9,CHI,6069,1956,MOT
14,32,75,306,0.529628751,338,32,a,"('MOT', 'CHI')",Providence,lil30.xml,427,89,14,CHI,6069,1956,MOT
1,84,7,335,-0.009456335,419,84,yeah,"('MOT', 'CHI')",Providence,lil30.xml,427,8,1,CHI,6069,1956,MOT
7,34,85,301,-0.199118372,335,34,and,"('MOT', 'CHI')",Providence,lil30.xml,427,92,7,CHI,6069,1956,MOT
0,7,58,362,-0.257584041,369,7,that,"('MOT', 'CHI')",Providence,lil30.xml,427,58,0,CHI,6069,1956,MOT
1,15,60,351,-0.31449333,366,15,to,"('MOT', 'CHI')",Providence,lil30.xml,427,61,1,CHI,6069,1956,MOT
1,3,0,128,3.098589659,131,3,up,"('CHI', 'MOT')",Providence,lil31.xml,132,1,1,MOT,553,1713,CHI
0,1,1,130,3.098589659,131,1,big,"('CHI', 'MOT')",Providence,lil31.xml,132,1,0,MOT,553,1713,CHI
0,1,3,206,3.039749159,207,1,up,"('MOT', 'CHI')",Providence,lil31.xml,210,3,0,CHI,2490,872,MOT
2,1,13,194,2.855455493,195,1,one,"('MOT', 'CHI')",Providence,lil31.xml,210,15,2,CHI,2490,872,MOT
0,2,1,129,2.693124551,131,2,at,"('CHI', 'MOT')",Providence,lil31.xml,132,1,0,MOT,553,1713,CHI
3,4,6,197,2.692167155,201,4,there,"('MOT', 'CHI')",Providence,lil31.xml,210,9,3,CHI,2490,872,MOT
0,1,3,128,2.57261223,129,1,my,"('CHI', 'MOT')",Providence,lil31.xml,132,3,0,MOT,553,1713,CHI
2,3,8,197,2.535678975,200,3,want,"('MOT', 'CHI')",Providence,lil31.xml,210,10,2,CHI,2490,872,MOT
0,2,4,204,2.447166322,206,2,big,"('MOT', 'CHI')",Providence,lil31.xml,210,4,0,CHI,2490,872,MOT
2,0,1,17,2.433613355,17,0,what,"('OPE', 'MOT')",Providence,lil31.xml,20,3,2,MOT,144,239,OPE
0,3,3,204,2.346601978,207,3,make,"('MOT', 'CHI')",Providence,lil31.xml,210,3,0,CHI,2490,872,MOT
1,0,1,18,2.302585093,18,0,one,"('OPE', 'MOT')",Providence,lil31.xml,20,2,1,MOT,144,239,OPE
0,2,5,203,2.288196356,205,2,look,"('MOT', 'CHI')",Providence,lil31.xml,210,5,0,CHI,2490,872,MOT
0,1,9,200,2.222163526,201,1,he,"('MOT', 'CHI')",Providence,lil31.xml,210,9,0,CHI,2490,872,MOT
0,1,5,126,2.220755075,127,1,no,"('CHI', 'MOT')",Providence,lil31.xml,132,5,0,MOT,553,1713,CHI
1,1,18,190,2.218167751,191,1,of,"('MOT', 'CHI')",Providence,lil31.xml,210,19,1,CHI,2490,872,MOT
0,4,1,127,2.182298927,131,4,get,"('CHI', 'MOT')",Providence,lil31.xml,132,1,0,MOT,553,1713,CHI
1,9,0,122,2.182298927,131,9,oh,"('CHI', 'MOT')",Providence,lil31.xml,132,1,1,MOT,553,1713,CHI
3,9,1,119,2.159484249,128,9,on,"('CHI', 'MOT')",Providence,lil31.xml,132,4,3,MOT,553,1713,CHI
0,5,1,126,1.99997737,131,5,one,"('CHI', 'MOT')",Providence,lil31.xml,132,1,0,MOT,553,1713,CHI
0,1,12,197,1.966112856,198,1,go,"('MOT', 'CHI')",Providence,lil31.xml,210,12,0,CHI,2490,872,MOT
1,1,0,18,1.945910149,19,1,my,"('OPE', 'MOT')",Providence,lil31.xml,20,1,1,MOT,144,239,OPE
1,1,0,18,1.945910149,19,1,and,"('OPE', 'MOT')",Providence,lil31.xml,20,1,1,MOT,144,239,OPE
3,8,8,191,1.927425334,199,8,no,"('MOT', 'CHI')",Providence,lil31.xml,210,11,3,CHI,2490,872,MOT
1,4,5,122,1.85629799,126,4,want,"('CHI', 'MOT')",Providence,lil31.xml,132,6,1,MOT,553,1713,CHI
0,6,1,125,1.84582669,131,6,go,"('CHI', 'MOT')",Providence,lil31.xml,132,1,0,MOT,553,1713,CHI
1,0,3,16,1.791759469,16,0,see,"('MOT', 'OPE')",Providence,lil31.xml,20,4,1,OPE,375,105,MOT
1,0,3,16,1.791759469,16,0,can,"('MOT', 'OPE')",Providence,lil31.xml,20,4,1,OPE,375,105,MOT
1,2,20,187,1.711314104,189,2,is,"('MOT', 'CHI')",Providence,lil31.xml,210,21,1,CHI,2490,872,MOT
0,2,12,196,1.560647748,198,2,with,"('MOT', 'CHI')",Providence,lil31.xml,210,12,0,CHI,2490,872,MOT
0,2,12,196,1.560647748,198,2,little,"('MOT', 'CHI')",Providence,lil31.xml,210,12,0,CHI,2490,872,MOT
0,2,13,195,1.486642335,197,2,in,"('MOT', 'CHI')",Providence,lil31.xml,210,13,0,CHI,2490,872,MOT
2,14,2,114,1.466337069,128,14,a,"('CHI', 'MOT')",Providence,lil31.xml,132,4,2,MOT,553,1713,CHI
0,1,21,188,1.423632032,189,1,oh,"('MOT', 'CHI')",Providence,lil31.xml,210,21,0,CHI,2490,872,MOT
0,4,8,198,1.406096988,202,4,my,"('MOT', 'CHI')",Providence,lil31.xml,210,8,0,CHI,2490,872,MOT
0,2,15,193,1.351378096,195,2,it,"('MOT', 'CHI')",Providence,lil31.xml,210,15,0,CHI,2490,872,MOT
1,21,2,186,1.335001067,207,21,yeah,"('MOT', 'CHI')",Providence,lil31.xml,210,3,1,CHI,2490,872,MOT
1,1,2,16,1.335001067,17,1,it,"('MOT', 'OPE')",Providence,lil31.xml,20,3,1,OPE,375,105,MOT
0,1,1,18,1.252762968,19,1,what,"('MOT', 'OPE')",Providence,lil31.xml,20,1,0,OPE,375,105,MOT
0,1,1,18,1.252762968,19,1,in,"('OPE', 'MOT')",Providence,lil31.xml,20,1,0,MOT,144,239,OPE
0,1,1,18,1.252762968,19,1,have,"('OPE', 'MOT')",Providence,lil31.xml,20,1,0,MOT,144,239,OPE
0,1,1,18,1.252762968,19,1,for,"('OPE', 'MOT')",Providence,lil31.xml,20,1,0,MOT,144,239,OPE
0,1,1,18,1.252762968,19,1,with,"('OPE', 'MOT')",Providence,lil31.xml,20,1,0,MOT,144,239,OPE
0,1,1,18,1.252762968,19,1,they,"('OPE', 'MOT')",Providence,lil31.xml,20,1,0,MOT,144,239,OPE
0,1,1,18,1.252762968,19,1,see,"('OPE', 'MOT')",Providence,lil31.xml,20,1,0,MOT,144,239,OPE
0,1,1,18,1.252762968,19,1,all,"('OPE', 'MOT')",Providence,lil31.xml,20,1,0,MOT,144,239,OPE
0,1,1,18,1.252762968,19,1,think,"('OPE', 'MOT')",Providence,lil31.xml,20,1,0,MOT,144,239,OPE
2,22,1,107,1.228877484,129,22,it,"('CHI', 'MOT')",Providence,lil31.xml,132,3,2,MOT,553,1713,CHI
1,2,32,175,1.226572636,177,2,to,"('MOT', 'CHI')",Providence,lil31.xml,210,33,1,CHI,2490,872,MOT
1,4,21,184,1.15267951,188,4,on,"('MOT', 'CHI')",Providence,lil31.xml,210,22,1,CHI,2490,872,MOT
5,7,34,164,1.152037455,171,7,a,"('MOT', 'CHI')",Providence,lil31.xml,210,39,5,CHI,2490,872,MOT
0,1,1,15,1.098612289,16,1,oh,"('OPE', 'CHI')",Providence,lil31.xml,17,1,0,CHI,114,64,OPE
0,1,1,15,1.098612289,16,1,make,"('OPE', 'CHI')",Providence,lil31.xml,17,1,0,CHI,114,64,OPE
2,3,1,14,1.047318994,17,3,a,"('OPE', 'MOT')",Providence,lil31.xml,20,3,2,MOT,144,239,OPE
1,2,2,15,0.929535959,17,2,they,"('MOT', 'OPE')",Providence,lil31.xml,20,3,1,OPE,375,105,MOT
2,1,5,12,0.916290732,13,1,you,"('MOT', 'OPE')",Providence,lil31.xml,20,7,2,OPE,375,105,MOT
0,1,2,17,0.916290732,18,1,have,"('MOT', 'OPE')",Providence,lil31.xml,20,2,0,OPE,375,105,MOT
0,1,2,17,0.916290732,18,1,of,"('MOT', 'OPE')",Providence,lil31.xml,20,2,0,OPE,375,105,MOT
3,4,1,12,0.875468737,16,4,you,"('OPE', 'MOT')",Providence,lil31.xml,20,4,3,MOT,144,239,OPE
0,10,3,119,0.867864138,129,10,this,"('CHI', 'MOT')",Providence,lil31.xml,132,3,0,MOT,553,1713,CHI
8,32,4,88,0.865680731,120,32,the,"('CHI', 'MOT')",Providence,lil31.xml,132,12,8,MOT,553,1713,CHI
0,2,1,17,0.84729786,19,2,are,"('MOT', 'OPE')",Providence,lil31.xml,20,1,0,OPE,375,105,MOT
0,2,1,17,0.84729786,19,2,wanna,"('OPE', 'MOT')",Providence,lil31.xml,20,1,0,MOT,144,239,OPE
0,2,1,17,0.84729786,19,2,are,"('OPE', 'MOT')",Providence,lil31.xml,20,1,0,MOT,144,239,OPE
0,4,16,190,0.778304989,194,4,this,"('MOT', 'CHI')",Providence,lil31.xml,210,16,0,CHI,2490,872,MOT
0,9,4,119,0.773189888,128,9,is,"('CHI', 'MOT')",Providence,lil31.xml,132,4,0,MOT,553,1713,CHI
0,1,2,14,0.753771802,15,1,of,"('OPE', 'CHI')",Providence,lil31.xml,17,2,0,CHI,114,64,OPE
2,20,5,105,0.70105236,125,20,and,"('CHI', 'MOT')",Providence,lil31.xml,132,7,2,MOT,553,1713,CHI
0,2,1,14,0.693147181,16,2,there,"('OPE', 'CHI')",Providence,lil31.xml,17,1,0,CHI,114,64,OPE
0,1,3,16,0.641853886,17,1,all,"('MOT', 'OPE')",Providence,lil31.xml,20,3,0,OPE,375,105,MOT
0,1,3,16,0.641853886,17,1,that,"('MOT', 'OPE')",Providence,lil31.xml,20,3,0,OPE,375,105,MOT
0,5,9,118,0.638658995,123,5,yeah,"('CHI', 'MOT')",Providence,lil31.xml,132,9,0,MOT,553,1713,CHI
0,2,2,16,0.510825624,18,2,yeah,"('OPE', 'MOT')",Providence,lil31.xml,20,2,0,MOT,144,239,OPE
0,2,2,16,0.510825624,18,2,there,"('OPE', 'MOT')",Providence,lil31.xml,20,2,0,MOT,144,239,OPE
0,19,2,111,0.500775288,130,19,to,"('CHI', 'MOT')",Providence,lil31.xml,132,2,0,MOT,553,1713,CHI
0,1,3,13,0.470003629,14,1,a,"('OPE', 'CHI')",Providence,lil31.xml,17,3,0,CHI,114,64,OPE
2,7,38,163,0.428995606,170,7,the,"('MOT', 'CHI')",Providence,lil31.xml,210,40,2,CHI,2490,872,MOT
0,4,1,15,0.336472237,19,4,oh,"('OPE', 'MOT')",Providence,lil31.xml,20,1,0,MOT,144,239,OPE
3,2,7,8,0.287682072,10,2,that,"('OPE', 'MOT')",Providence,lil31.xml,20,10,3,MOT,144,239,OPE
0,2,3,15,0.236388778,17,2,a,"('MOT', 'OPE')",Providence,lil31.xml,20,3,0,OPE,375,105,MOT
0,3,2,15,0.223143551,18,3,do,"('MOT', 'OPE')",Providence,lil31.xml,20,2,0,OPE,375,105,MOT
0,1,5,14,0.194156014,15,1,and,"('MOT', 'OPE')",Providence,lil31.xml,20,5,0,OPE,375,105,MOT
0,37,1,94,0.15415068,131,37,you,"('CHI', 'MOT')",Providence,lil31.xml,132,1,0,MOT,553,1713,CHI
0,5,1,14,0.15415068,19,5,of,"('OPE', 'MOT')",Providence,lil31.xml,20,1,0,MOT,144,239,OPE
0,1,64,145,0.114410351,146,1,you,"('MOT', 'CHI')",Providence,lil31.xml,210,64,0,CHI,2490,872,MOT
2,10,39,159,0.081180457,169,10,and,"('MOT', 'CHI')",Providence,lil31.xml,210,41,2,CHI,2490,872,MOT
0,4,2,14,0,18,4,do,"('OPE', 'MOT')",Providence,lil31.xml,20,2,0,MOT,144,239,OPE
1,0,23,436,3.517269553,436,0,are,"('MOT', 'CHI')",Providence,lil32.xml,460,24,1,CHI,8165,1674,MOT
2,0,35,423,3.487139811,423,0,with,"('MOT', 'CHI')",Providence,lil32.xml,460,37,2,CHI,8165,1674,MOT
1,0,39,420,3.000482876,420,0,put,"('MOT', 'CHI')",Providence,lil32.xml,460,40,1,CHI,8165,1674,MOT
2,4,10,444,2.959364629,448,4,my,"('MOT', 'CHI')",Providence,lil32.xml,460,12,2,CHI,8165,1674,MOT
1,0,46,413,2.829605403,413,0,look,"('MOT', 'CHI')",Providence,lil32.xml,460,47,1,CHI,8165,1674,MOT
2,3,19,436,2.665868587,439,3,go,"('MOT', 'CHI')",Providence,lil32.xml,460,21,2,CHI,8165,1674,MOT
0,3,6,451,2.656756907,454,3,not,"('MOT', 'CHI')",Providence,lil32.xml,460,6,0,CHI,8165,1674,MOT
0,1,14,445,2.63905733,446,1,get,"('MOT', 'CHI')",Providence,lil32.xml,460,14,0,CHI,8165,1674,MOT
3,4,25,428,2.448703601,432,4,he,"('MOT', 'CHI')",Providence,lil32.xml,460,28,3,CHI,8165,1674,MOT
0,1,18,441,2.406945108,442,1,was,"('MOT', 'CHI')",Providence,lil32.xml,460,18,0,CHI,8165,1674,MOT
0,1,20,439,2.307120248,440,1,all,"('MOT', 'CHI')",Providence,lil32.xml,460,20,0,CHI,8165,1674,MOT
0,1,20,439,2.307120248,440,1,some,"('MOT', 'CHI')",Providence,lil32.xml,460,20,0,CHI,8165,1674,MOT
3,3,52,402,1.965761918,405,3,in,"('MOT', 'CHI')",Providence,lil32.xml,460,55,3,CHI,8165,1674,MOT
3,4,42,411,1.959795069,415,4,on,"('MOT', 'CHI')",Providence,lil32.xml,460,45,3,CHI,8165,1674,MOT
0,2,25,433,1.68548404,435,2,for,"('MOT', 'CHI')",Providence,lil32.xml,460,25,0,CHI,8165,1674,MOT
0,2,31,427,1.47098824,429,2,there,"('MOT', 'CHI')",Providence,lil32.xml,460,31,0,CHI,8165,1674,MOT
3,10,33,414,1.405252275,424,10,one,"('MOT', 'CHI')",Providence,lil32.xml,460,36,3,CHI,8165,1674,MOT
0,3,30,427,1.216395324,430,3,at,"('MOT', 'CHI')",Providence,lil32.xml,460,30,0,CHI,8165,1674,MOT
3,27,14,416,1.207725154,443,27,no,"('MOT', 'CHI')",Providence,lil32.xml,460,17,3,CHI,8165,1674,MOT
6,12,61,381,1.125740052,393,12,oh,"('MOT', 'CHI')",Providence,lil32.xml,460,67,6,CHI,8165,1674,MOT
5,59,9,387,1.029619417,446,59,yeah,"('MOT', 'CHI')",Providence,lil32.xml,460,14,5,CHI,8165,1674,MOT
4,25,27,404,0.920941903,429,25,want,"('MOT', 'CHI')",Providence,lil32.xml,460,31,4,CHI,8165,1674,MOT
5,10,89,356,0.737598943,366,10,to,"('MOT', 'CHI')",Providence,lil32.xml,460,94,5,CHI,8165,1674,MOT
7,10,113,330,0.712335961,340,10,the,"('MOT', 'CHI')",Providence,lil32.xml,460,120,7,CHI,8165,1674,MOT
0,2,64,394,0.698184975,396,2,see,"('MOT', 'CHI')",Providence,lil32.xml,460,64,0,CHI,8165,1674,MOT
2,8,63,387,0.680631373,395,8,it,"('MOT', 'CHI')",Providence,lil32.xml,460,65,2,CHI,8165,1674,MOT
17,29,103,311,0.519964069,340,29,a,"('MOT', 'CHI')",Providence,lil32.xml,460,120,17,CHI,8165,1674,MOT
3,15,61,381,0.410502902,396,15,is,"('MOT', 'CHI')",Providence,lil32.xml,460,64,3,CHI,8165,1674,MOT
4,25,49,382,0.357723345,407,25,this,"('MOT', 'CHI')",Providence,lil32.xml,460,53,4,CHI,8165,1674,MOT
14,43,105,298,-0.034199531,341,43,and,"('MOT', 'CHI')",Providence,lil32.xml,460,119,14,CHI,8165,1674,MOT
0,2,147,311,-0.349985956,313,2,you,"('MOT', 'CHI')",Providence,lil32.xml,460,147,0,CHI,8165,1674,MOT
0,8,76,376,-0.598096035,384,8,that,"('MOT', 'CHI')",Providence,lil32.xml,460,76,0,CHI,8165,1674,MOT
0,1,1,0,-0.693147181,1,1,is,"('MOT', 'OPE')",Providence,lil32.xml,2,1,0,OPE,50,6,MOT
1,0,0,162,4.69440132,162,0,put,"('CHI', 'MOT')",Providence,lil33.xml,163,1,1,MOT,804,1884,CHI
1,4,0,158,3.084963407,162,4,all,"('CHI', 'MOT')",Providence,lil33.xml,163,1,1,MOT,804,1884,CHI
1,3,1,154,2.989462661,157,3,no,"('MOT', 'CHI')",Providence,lil33.xml,159,2,1,CHI,2349,710,MOT
1,5,0,157,2.90264185,162,5,there,"('CHI', 'MOT')",Providence,lil33.xml,163,1,1,MOT,804,1884,CHI
0,2,1,156,2.877949238,158,2,put,"('MOT', 'CHI')",Providence,lil33.xml,159,1,0,CHI,2349,710,MOT
2,2,5,154,2.865370456,156,2,no,"('CHI', 'MOT')",Providence,lil33.xml,163,7,2,MOT,804,1884,CHI
0,1,3,159,2.785011242,160,1,my,"('CHI', 'MOT')",Providence,lil33.xml,163,3,0,MOT,804,1884,CHI
5,2,12,144,2.745920475,146,2,yeah,"('CHI', 'MOT')",Providence,lil33.xml,163,17,5,MOT,804,1884,CHI
1,2,4,152,2.69848075,154,2,want,"('MOT', 'CHI')",Providence,lil33.xml,159,5,1,CHI,2349,710,MOT
0,3,1,159,2.614959778,162,3,think,"('CHI', 'MOT')",Providence,lil33.xml,163,1,0,MOT,804,1884,CHI
1,7,0,155,2.614959778,162,7,big,"('CHI', 'MOT')",Providence,lil33.xml,163,1,1,MOT,804,1884,CHI
0,1,4,154,2.571339156,155,1,up,"('MOT', 'CHI')",Providence,lil33.xml,159,4,0,CHI,2349,710,MOT
1,4,2,156,2.561867691,160,4,make,"('CHI', 'MOT')",Providence,lil33.xml,163,3,1,MOT,804,1884,CHI
2,1,14,142,2.491827093,143,1,to,"('MOT', 'CHI')",Providence,lil33.xml,159,16,2,CHI,2349,710,MOT
1,6,1,155,2.454692871,161,6,look,"('CHI', 'MOT')",Providence,lil33.xml,163,2,1,MOT,804,1884,CHI
1,1,10,147,2.445685937,148,1,go,"('MOT', 'CHI')",Providence,lil33.xml,159,11,1,CHI,2349,710,MOT
0,4,1,158,2.391816227,162,4,was,"('CHI', 'MOT')",Providence,lil33.xml,163,1,0,MOT,804,1884,CHI
0,4,1,158,2.391816227,162,4,up,"('CHI', 'MOT')",Providence,lil33.xml,163,1,0,MOT,804,1884,CHI
0,3,2,158,2.321161479,161,3,want,"('CHI', 'MOT')",Providence,lil33.xml,163,2,0,MOT,804,1884,CHI
0,3,2,154,2.29631548,157,3,make,"('MOT', 'CHI')",Providence,lil33.xml,159,2,0,CHI,2349,710,MOT
2,5,4,148,2.270836395,153,5,one,"('MOT', 'CHI')",Providence,lil33.xml,159,6,2,CHI,2349,710,MOT
1,1,13,144,2.217843865,145,1,see,"('MOT', 'CHI')",Providence,lil33.xml,159,14,1,CHI,2349,710,MOT
1,1,13,144,2.217843865,145,1,where,"('MOT', 'CHI')",Providence,lil33.xml,159,14,1,CHI,2349,710,MOT
1,8,1,153,2.203378443,161,8,are,"('CHI', 'MOT')",Providence,lil33.xml,163,2,1,MOT,804,1884,CHI
1,0,0,11,2.159484249,11,0,he,"('OPE', 'MOT')",Providence,lil33.xml,12,1,1,MOT,52,177,OPE
0,1,7,151,2.146580845,152,1,there,"('MOT', 'CHI')",Providence,lil33.xml,159,7,0,CHI,2349,710,MOT
0,6,1,156,2.05534399,162,6,little,"('CHI', 'MOT')",Providence,lil33.xml,163,1,0,MOT,804,1884,CHI
1,6,3,153,2.036881927,159,6,with,"('CHI', 'MOT')",Providence,lil33.xml,163,4,1,MOT,804,1884,CHI
2,9,3,149,1.925290862,158,9,like,"('CHI', 'MOT')",Providence,lil33.xml,163,5,2,MOT,804,1884,CHI
0,7,1,155,1.921812597,162,7,where,"('CHI', 'MOT')",Providence,lil33.xml,163,1,0,MOT,804,1884,CHI
1,1,19,138,1.857717437,139,1,that,"('MOT', 'CHI')",Providence,lil33.xml,159,20,1,CHI,2349,710,MOT
1,12,1,149,1.835653663,161,12,on,"('CHI', 'MOT')",Providence,lil33.xml,163,2,1,MOT,804,1884,CHI
1,2,13,143,1.812378756,145,2,are,"('MOT', 'CHI')",Providence,lil33.xml,159,14,1,CHI,2349,710,MOT
0,8,1,154,1.804029562,162,8,see,"('CHI', 'MOT')",Providence,lil33.xml,163,1,0,MOT,804,1884,CHI
1,0,1,10,1.791759469,10,0,to,"('MOT', 'OPE')",Providence,lil33.xml,12,2,1,OPE,145,85,MOT
0,3,6,150,1.577689214,153,3,like,"('MOT', 'CHI')",Providence,lil33.xml,159,6,0,CHI,2349,710,MOT
1,16,1,145,1.567389676,161,16,oh,"('CHI', 'MOT')",Providence,lil33.xml,163,2,1,MOT,804,1884,CHI
1,0,0,5,1.540445041,5,0,it,"('CHI', 'OPE')",Providence,lil33.xml,6,1,1,OPE,43,45,CHI
1,0,0,5,1.540445041,5,0,is,"('CHI', 'OPE')",Providence,lil33.xml,6,1,1,OPE,43,45,CHI
1,0,0,5,1.540445041,5,0,one,"('CHI', 'OPE')",Providence,lil33.xml,6,1,1,OPE,43,45,CHI
1,0,0,5,1.540445041,5,0,where,"('CHI', 'OPE')",Providence,lil33.xml,6,1,1,OPE,43,45,CHI
0,2,9,148,1.527372959,150,2,look,"('MOT', 'CHI')",Providence,lil33.xml,159,9,0,CHI,2349,710,MOT
1,0,2,9,1.481604541,9,0,is,"('MOT', 'OPE')",Providence,lil33.xml,12,3,1,OPE,145,85,MOT
4,17,4,138,1.472726867,155,17,it,"('CHI', 'MOT')",Providence,lil33.xml,163,8,4,MOT,804,1884,CHI
4,14,6,139,1.459906178,153,14,a,"('CHI', 'MOT')",Providence,lil33.xml,163,10,4,MOT,804,1884,CHI
3,12,8,136,1.26703094,148,12,this,"('MOT', 'CHI')",Providence,lil33.xml,159,11,3,CHI,2349,710,MOT
0,2,12,145,1.266276688,147,2,on,"('MOT', 'CHI')",Providence,lil33.xml,159,12,0,CHI,2349,710,MOT
3,4,25,127,1.266008195,131,4,is,"('MOT', 'CHI')",Providence,lil33.xml,159,28,3,CHI,2349,710,MOT
0,15,1,147,1.228665417,162,15,of,"('CHI', 'MOT')",Providence,lil33.xml,163,1,0,MOT,804,1884,CHI
0,5,6,148,1.172224106,153,5,my,"('MOT', 'CHI')",Providence,lil33.xml,159,6,0,CHI,2349,710,MOT
2,24,2,135,1.16938136,159,24,the,"('CHI', 'MOT')",Providence,lil33.xml,163,4,2,MOT,804,1884,CHI
2,4,22,131,1.151058764,135,4,in,"('MOT', 'CHI')",Providence,lil33.xml,159,24,2,CHI,2349,710,MOT
3,5,24,127,1.125078862,132,5,what,"('MOT', 'CHI')",Providence,lil33.xml,159,27,3,CHI,2349,710,MOT
2,2,0,8,1.098612289,10,2,oh,"('MOT', 'OPE')",Providence,lil33.xml,12,2,2,OPE,145,85,MOT
2,22,3,136,1.092381739,158,22,is,"('CHI', 'MOT')",Providence,lil33.xml,163,5,2,MOT,804,1884,CHI
8,18,13,124,1.087104682,142,18,and,"('CHI', 'MOT')",Providence,lil33.xml,163,21,8,MOT,804,1884,CHI
1,2,0,9,1.060871961,11,2,like,"('OPE', 'MOT')",Providence,lil33.xml,12,1,1,MOT,52,177,OPE
0,3,11,145,1.059391576,148,3,have,"('MOT', 'CHI')",Providence,lil33.xml,159,11,0,CHI,2349,710,MOT
0,2,15,142,1.051780989,144,2,of,"('MOT', 'CHI')",Providence,lil33.xml,159,15,0,CHI,2349,710,MOT
2,18,5,138,1.019543765,156,18,in,"('CHI', 'MOT')",Providence,lil33.xml,163,7,2,MOT,804,1884,CHI
0,19,1,143,1.005521866,162,19,to,"('CHI', 'MOT')",Providence,lil33.xml,163,1,0,MOT,804,1884,CHI
0,4,10,145,0.922935275,149,4,big,"('MOT', 'CHI')",Providence,lil33.xml,159,10,0,CHI,2349,710,MOT
5,9,27,118,0.822626256,127,9,a,"('MOT', 'CHI')",Providence,lil33.xml,159,32,5,CHI,2349,710,MOT
1,1,2,8,0.78845736,9,1,a,"('MOT', 'OPE')",Providence,lil33.xml,12,3,1,OPE,145,85,MOT
1,3,0,8,0.773189888,11,3,of,"('OPE', 'MOT')",Providence,lil33.xml,12,1,1,MOT,52,177,OPE
0,1,1,10,0.773189888,11,1,it,"('MOT', 'OPE')",Providence,lil33.xml,12,1,0,OPE,145,85,MOT
0,1,1,10,0.773189888,11,1,all,"('MOT', 'OPE')",Providence,lil33.xml,12,1,0,OPE,145,85,MOT
0,1,1,10,0.773189888,11,1,that,"('MOT', 'OPE')",Providence,lil33.xml,12,1,0,OPE,145,85,MOT
0,1,1,10,0.773189888,11,1,one,"('MOT', 'OPE')",Providence,lil33.xml,12,1,0,OPE,145,85,MOT
0,1,1,10,0.773189888,11,1,a,"('OPE', 'MOT')",Providence,lil33.xml,12,1,0,MOT,52,177,OPE
0,1,1,10,0.773189888,11,1,but,"('OPE', 'MOT')",Providence,lil33.xml,12,1,0,MOT,52,177,OPE
0,1,1,10,0.773189888,11,1,my,"('OPE', 'MOT')",Providence,lil33.xml,12,1,0,MOT,52,177,OPE
0,1,1,10,0.773189888,11,1,at,"('OPE', 'MOT')",Providence,lil33.xml,12,1,0,MOT,52,177,OPE
4,18,12,125,0.751360918,143,18,yeah,"('MOT', 'CHI')",Providence,lil33.xml,159,16,4,CHI,2349,710,MOT
2,15,14,132,0.439598114,147,15,this,"('CHI', 'MOT')",Providence,lil33.xml,163,16,2,MOT,804,1884,CHI
0,1,2,9,0.405465108,10,1,in,"('MOT', 'OPE')",Providence,lil33.xml,12,2,0,OPE,145,85,MOT
0,17,4,142,0.399273138,159,17,one,"('CHI', 'MOT')",Providence,lil33.xml,163,4,0,MOT,804,1884,CHI
4,53,4,102,0.374114578,155,53,you,"('CHI', 'MOT')",Providence,lil33.xml,163,8,4,MOT,804,1884,CHI
0,2,1,9,0.36772478,11,2,you,"('MOT', 'OPE')",Providence,lil33.xml,12,1,0,OPE,145,85,MOT
0,22,3,138,0.342664207,160,22,what,"('CHI', 'MOT')",Providence,lil33.xml,163,3,0,MOT,804,1884,CHI
5,3,78,73,0.319522678,76,3,you,"('MOT', 'CHI')",Providence,lil33.xml,159,83,5,CHI,2349,710,MOT
0,1,1,4,0.15415068,5,1,no,"('CHI', 'OPE')",Providence,lil33.xml,6,1,0,OPE,43,45,CHI
0,3,1,8,0.080042708,11,3,she,"('MOT', 'OPE')",Providence,lil33.xml,12,1,0,OPE,145,85,MOT
0,3,1,8,0.080042708,11,3,the,"('MOT', 'OPE')",Providence,lil33.xml,12,1,0,OPE,145,85,MOT
0,5,20,134,0.065957968,139,5,it,"('MOT', 'CHI')",Providence,lil33.xml,159,20,0,CHI,2349,710,MOT
1,6,36,116,-0.096043049,122,6,the,"('MOT', 'CHI')",Providence,lil33.xml,159,37,1,CHI,2349,710,MOT
0,29,4,130,-0.111552486,159,29,that,"('CHI', 'MOT')",Providence,lil33.xml,163,4,0,MOT,804,1884,CHI
5,27,27,100,-0.206993161,127,27,and,"('MOT', 'CHI')",Providence,lil33.xml,159,32,5,CHI,2349,710,MOT
1,3,0,317,3.982792076,320,3,big,"('CHI', 'MOT')",Providence,lil34.xml,321,1,1,MOT,1457,3835,CHI
1,2,2,316,3.753417975,318,2,make,"('CHI', 'MOT')",Providence,lil34.xml,321,3,1,MOT,1457,3835,CHI
1,6,0,314,3.423176288,320,6,up,"('CHI', 'MOT')",Providence,lil34.xml,321,1,1,MOT,1457,3835,CHI
1,4,2,314,3.242592351,318,4,all,"('CHI', 'MOT')",Providence,lil34.xml,321,3,1,MOT,1457,3835,CHI
2,9,0,310,3.181173958,319,9,have,"('CHI', 'MOT')",Providence,lil34.xml,321,2,2,MOT,1457,3835,CHI
1,8,0,312,3.17186186,320,8,get,"('CHI', 'MOT')",Providence,lil34.xml,321,1,1,MOT,1457,3835,CHI
2,10,0,309,3.085863778,319,10,put,"('CHI', 'MOT')",Providence,lil34.xml,321,2,2,MOT,1457,3835,CHI
5,5,11,300,2.83647599,305,5,yeah,"('CHI', 'MOT')",Providence,lil34.xml,321,16,5,MOT,1457,3835,CHI
2,9,2,308,2.769458829,317,9,there,"('CHI', 'MOT')",Providence,lil34.xml,321,4,2,MOT,1457,3835,CHI
0,6,1,314,2.730029108,320,6,look,"('CHI', 'MOT')",Providence,lil34.xml,321,1,0,MOT,1457,3835,CHI
0,6,1,314,2.730029108,320,6,not,"('CHI', 'MOT')",Providence,lil34.xml,321,1,0,MOT,1457,3835,CHI
1,14,0,306,2.661036236,320,14,with,"('CHI', 'MOT')",Providence,lil34.xml,321,1,1,MOT,1457,3835,CHI
2,4,11,304,2.517696473,308,4,no,"('CHI', 'MOT')",Providence,lil34.xml,321,13,2,MOT,1457,3835,CHI
2,9,4,306,2.475487428,315,9,where,"('CHI', 'MOT')",Providence,lil34.xml,321,6,2,MOT,1457,3835,CHI
0,9,1,311,2.373354164,320,9,for,"('CHI', 'MOT')",Providence,lil34.xml,321,1,0,MOT,1457,3835,CHI
1,1,2,47,2.302585093,48,1,like,"('MOT', 'CHI')",Providence,lil34.xml,51,3,1,CHI,532,255,MOT
1,12,2,306,2.287080906,318,12,go,"('CHI', 'MOT')",Providence,lil34.xml,321,3,1,MOT,1457,3835,CHI
0,10,1,310,2.278043984,320,10,they,"('CHI', 'MOT')",Providence,lil34.xml,321,1,0,MOT,1457,3835,CHI
5,20,3,293,2.197224577,313,20,like,"('CHI', 'MOT')",Providence,lil34.xml,321,8,5,MOT,1457,3835,CHI
0,11,1,309,2.191032607,320,11,was,"('CHI', 'MOT')",Providence,lil34.xml,321,1,0,MOT,1457,3835,CHI
0,11,1,309,2.191032607,320,11,he,"('CHI', 'MOT')",Providence,lil34.xml,321,1,0,MOT,1457,3835,CHI
0,1,1,49,2.159484249,50,1,yeah,"('MOT', 'CHI')",Providence,lil34.xml,51,1,0,CHI,532,255,MOT
0,1,1,49,2.159484249,50,1,wanna,"('MOT', 'CHI')",Providence,lil34.xml,51,1,0,CHI,532,255,MOT
0,8,3,310,1.961658506,318,8,did,"('CHI', 'MOT')",Providence,lil34.xml,321,3,0,MOT,1457,3835,CHI
2,14,5,300,1.949079724,314,14,she,"('CHI', 'MOT')",Providence,lil34.xml,321,7,2,MOT,1457,3835,CHI
6,26,4,285,1.911369824,311,26,it,"('CHI', 'MOT')",Providence,lil34.xml,321,10,6,MOT,1457,3835,CHI
1,32,0,288,1.872578876,320,32,do,"('CHI', 'MOT')",Providence,lil34.xml,321,1,1,MOT,1457,3835,CHI
0,1,2,48,1.852384091,49,1,get,"('MOT', 'CHI')",Providence,lil34.xml,51,2,0,CHI,532,255,MOT
0,1,2,48,1.852384091,49,1,of,"('MOT', 'CHI')",Providence,lil34.xml,51,2,0,CHI,532,255,MOT
4,20,6,291,1.826212015,311,20,one,"('CHI', 'MOT')",Providence,lil34.xml,321,10,4,MOT,1457,3835,CHI
2,21,3,295,1.823711069,316,21,on,"('CHI', 'MOT')",Providence,lil34.xml,321,5,2,MOT,1457,3835,CHI
0,13,2,306,1.746089432,319,13,little,"('CHI', 'MOT')",Providence,lil34.xml,321,2,0,MOT,1457,3835,CHI
0,18,1,302,1.731500278,320,18,of,"('CHI', 'MOT')",Providence,lil34.xml,321,1,0,MOT,1457,3835,CHI
0,1,3,47,1.609437912,48,1,go,"('MOT', 'CHI')",Providence,lil34.xml,51,3,0,CHI,532,255,MOT
1,42,0,278,1.607886322,320,42,to,"('CHI', 'MOT')",Providence,lil34.xml,321,1,1,MOT,1457,3835,CHI
1,14,6,300,1.543614616,314,14,are,"('CHI', 'MOT')",Providence,lil34.xml,321,7,1,MOT,1457,3835,CHI
1,0,0,5,1.540445041,5,0,of,"('MOT', 'OPE')",Providence,lil34.xml,6,1,1,OPE,47,40,MOT
0,2,2,47,1.446918983,49,2,put,"('MOT', 'CHI')",Providence,lil34.xml,51,2,0,CHI,532,255,MOT
0,2,2,47,1.446918983,49,2,one,"('MOT', 'CHI')",Providence,lil34.xml,51,2,0,CHI,532,255,MOT
0,2,2,47,1.446918983,49,2,big,"('MOT', 'CHI')",Providence,lil34.xml,51,2,0,CHI,532,255,MOT
1,3,3,44,1.406913648,47,3,no,"('MOT', 'CHI')",Providence,lil34.xml,51,4,1,CHI,532,255,MOT
14,51,7,249,1.331739284,300,51,the,"('CHI', 'MOT')",Providence,lil34.xml,321,21,14,MOT,1457,3835,CHI
8,34,11,268,1.31438178,302,34,a,"('CHI', 'MOT')",Providence,lil34.xml,321,19,8,MOT,1457,3835,CHI
0,14,4,303,1.265381432,317,14,want,"('CHI', 'MOT')",Providence,lil34.xml,321,4,0,MOT,1457,3835,CHI
0,4,1,46,1.243193517,50,4,want,"('MOT', 'CHI')",Providence,lil34.xml,51,1,0,CHI,532,255,MOT
0,2,3,46,1.203972804,48,2,a,"('MOT', 'CHI')",Providence,lil34.xml,51,3,0,CHI,532,255,MOT
1,1,0,7,1.203972804,8,1,it,"('OPE', 'MOT')",Providence,lil34.xml,9,1,1,MOT,54,149,OPE
0,3,2,46,1.15923691,49,3,in,"('MOT', 'CHI')",Providence,lil34.xml,51,2,0,CHI,532,255,MOT
2,23,9,287,1.098612289,310,23,is,"('CHI', 'MOT')",Providence,lil34.xml,321,11,2,MOT,1457,3835,CHI
1,0,1,4,1.098612289,4,0,a,"('MOT', 'OPE')",Providence,lil34.xml,6,2,1,OPE,47,40,MOT
0,1,6,44,1.077558879,45,1,that,"('MOT', 'CHI')",Providence,lil34.xml,51,6,0,CHI,532,255,MOT
0,2,4,45,1.00144854,47,2,see,"('MOT', 'CHI')",Providence,lil34.xml,51,4,0,CHI,532,255,MOT
1,0,0,2,0.980829253,2,0,in,"('CHI', 'OPE')",Providence,lil34.xml,3,1,1,OPE,39,18,CHI
1,0,0,2,0.980829253,2,0,a,"('CHI', 'OPE')",Providence,lil34.xml,3,1,1,OPE,39,18,CHI
1,0,0,2,0.980829253,2,0,little,"('CHI', 'OPE')",Providence,lil34.xml,3,1,1,OPE,39,18,CHI
1,0,0,2,0.980829253,2,0,put,"('CHI', 'OPE')",Providence,lil34.xml,3,1,1,OPE,39,18,CHI
1,0,0,2,0.980829253,2,0,one,"('CHI', 'OPE')",Providence,lil34.xml,3,1,1,OPE,39,18,CHI
1,29,5,286,0.971410031,315,29,oh,"('CHI', 'MOT')",Providence,lil34.xml,321,6,1,MOT,1457,3835,CHI
2,30,8,281,0.925921625,311,30,that,"('CHI', 'MOT')",Providence,lil34.xml,321,10,2,MOT,1457,3835,CHI
0,21,4,296,0.88238918,317,21,what,"('CHI', 'MOT')",Providence,lil34.xml,321,4,0,MOT,1457,3835,CHI
0,9,12,300,0.79815049,309,9,my,"('CHI', 'MOT')",Providence,lil34.xml,321,12,0,MOT,1457,3835,CHI
0,1,1,10,0.773189888,11,1,what,"('OPE', 'CHI')",Providence,lil34.xml,12,1,0,CHI,78,67,OPE
0,1,1,10,0.773189888,11,1,there,"('OPE', 'CHI')",Providence,lil34.xml,12,1,0,CHI,78,67,OPE
0,1,1,10,0.773189888,11,1,is,"('OPE', 'CHI')",Providence,lil34.xml,12,1,0,CHI,78,67,OPE
0,4,3,44,0.693147181,48,4,it,"('MOT', 'CHI')",Providence,lil34.xml,51,3,0,CHI,532,255,MOT
3,23,21,274,0.650587566,297,23,this,"('CHI', 'MOT')",Providence,lil34.xml,321,24,3,MOT,1457,3835,CHI
0,34,3,284,0.603535022,318,34,in,"('CHI', 'MOT')",Providence,lil34.xml,321,3,0,MOT,1457,3835,CHI
16,43,41,221,0.554982575,264,43,and,"('CHI', 'MOT')",Providence,lil34.xml,321,57,16,MOT,1457,3835,CHI
0,2,7,42,0.53280453,44,2,oh,"('MOT', 'CHI')",Providence,lil34.xml,51,7,0,CHI,532,255,MOT
0,1,1,7,0.510825624,8,1,do,"('OPE', 'MOT')",Providence,lil34.xml,9,1,0,MOT,54,149,OPE
0,1,1,7,0.510825624,8,1,on,"('OPE', 'MOT')",Providence,lil34.xml,9,1,0,MOT,54,149,OPE
1,4,8,38,0.470003629,42,4,the,"('MOT', 'CHI')",Providence,lil34.xml,51,9,1,CHI,532,255,MOT
0,1,1,4,0.15415068,5,1,you,"('MOT', 'OPE')",Providence,lil34.xml,6,1,0,OPE,47,40,MOT
0,1,1,4,0.15415068,5,1,that,"('MOT', 'OPE')",Providence,lil34.xml,6,1,0,OPE,47,40,MOT
1,7,7,36,0.117783036,43,7,and,"('MOT', 'CHI')",Providence,lil34.xml,51,8,1,CHI,532,255,MOT
0,1,2,6,0.117783036,7,1,have,"('OPE', 'MOT')",Providence,lil34.xml,9,2,0,MOT,54,149,OPE
0,2,1,6,0.105360516,8,2,you,"('OPE', 'MOT')",Providence,lil34.xml,9,1,0,MOT,54,149,OPE
0,2,1,6,0.105360516,8,2,she,"('OPE', 'MOT')",Providence,lil34.xml,9,1,0,MOT,54,149,OPE
0,2,1,6,0.105360516,8,2,think,"('OPE', 'MOT')",Providence,lil34.xml,9,1,0,MOT,54,149,OPE
3,88,8,222,0.075711822,310,88,you,"('CHI', 'MOT')",Providence,lil34.xml,321,11,3,MOT,1457,3835,CHI
0,3,1,5,-0.182321557,8,3,a,"('OPE', 'MOT')",Providence,lil34.xml,9,1,0,MOT,54,149,OPE
0,3,1,5,-0.182321557,8,3,that,"('OPE', 'MOT')",Providence,lil34.xml,9,1,0,MOT,54,149,OPE
0,2,2,5,-0.287682072,7,2,the,"('OPE', 'MOT')",Providence,lil34.xml,9,2,0,MOT,54,149,OPE
3,3,1,304,3.941581808,307,3,big,"('CHI', 'MOT')",Providence,lil35.xml,311,4,3,MOT,1588,4976,CHI
1,6,0,304,3.391627931,310,6,up,"('CHI', 'MOT')",Providence,lil35.xml,311,1,1,MOT,1588,4976,CHI
0,4,1,306,3.034952987,310,4,put,"('CHI', 'MOT')",Providence,lil35.xml,311,1,0,MOT,1588,4976,CHI
7,7,8,289,2.863880142,296,7,yeah,"('CHI', 'MOT')",Providence,lil35.xml,311,15,7,MOT,1588,4976,CHI
0,2,5,304,2.685577345,306,2,want,"('CHI', 'MOT')",Providence,lil35.xml,311,5,0,MOT,1588,4976,CHI
3,12,2,294,2.605534638,306,12,at,"('CHI', 'MOT')",Providence,lil35.xml,311,5,3,MOT,1588,4976,CHI
1,15,0,295,2.564949357,310,15,on,"('CHI', 'MOT')",Providence,lil35.xml,311,1,1,MOT,1588,4976,CHI
2,14,1,294,2.517696473,308,14,see,"('CHI', 'MOT')",Providence,lil35.xml,311,3,2,MOT,1588,4976,CHI
0,6,2,303,2.407588402,309,6,go,"('CHI', 'MOT')",Providence,lil35.xml,311,2,0,MOT,1588,4976,CHI
0,9,1,301,2.341805806,310,9,wanna,"('CHI', 'MOT')",Providence,lil35.xml,311,1,0,MOT,1588,4976,CHI
1,11,2,297,2.335374916,308,11,was,"('CHI', 'MOT')",Providence,lil35.xml,311,3,1,MOT,1588,4976,CHI
1,11,2,297,2.335374916,308,11,look,"('CHI', 'MOT')",Providence,lil35.xml,311,3,1,MOT,1588,4976,CHI
1,15,1,294,2.274057009,309,15,there,"('CHI', 'MOT')",Providence,lil35.xml,311,2,1,MOT,1588,4976,CHI
2,24,0,285,2.233235015,309,24,for,"('CHI', 'MOT')",Providence,lil35.xml,311,2,2,MOT,1588,4976,CHI
0,12,1,298,2.079441542,310,12,we,"('CHI', 'MOT')",Providence,lil35.xml,311,1,0,MOT,1588,4976,CHI
0,15,1,295,1.871802177,310,15,all,"('CHI', 'MOT')",Providence,lil35.xml,311,1,0,MOT,1588,4976,CHI
0,2,14,295,1.829242562,297,2,no,"('CHI', 'MOT')",Providence,lil35.xml,311,14,0,MOT,1588,4976,CHI
2,19,4,286,1.750286221,305,19,she,"('CHI', 'MOT')",Providence,lil35.xml,311,6,2,MOT,1588,4976,CHI
3,19,6,283,1.709694516,302,19,it,"('CHI', 'MOT')",Providence,lil35.xml,311,9,3,MOT,1588,4976,CHI
0,18,1,292,1.69995192,310,18,little,"('CHI', 'MOT')",Providence,lil35.xml,311,1,0,MOT,1588,4976,CHI
3,20,6,282,1.660904352,302,20,in,"('CHI', 'MOT')",Providence,lil35.xml,311,9,3,MOT,1588,4976,CHI
0,19,1,291,1.648658626,310,19,like,"('CHI', 'MOT')",Providence,lil35.xml,311,1,0,MOT,1588,4976,CHI
0,11,3,297,1.642227735,308,11,are,"('CHI', 'MOT')",Providence,lil35.xml,311,3,0,MOT,1588,4976,CHI
0,15,2,294,1.580909829,309,15,with,"('CHI', 'MOT')",Providence,lil35.xml,311,2,0,MOT,1588,4976,CHI
4,12,18,277,1.539757992,289,12,one,"('CHI', 'MOT')",Providence,lil35.xml,311,22,4,MOT,1588,4976,CHI
2,34,2,273,1.484846035,307,34,oh,"('CHI', 'MOT')",Providence,lil35.xml,311,4,2,MOT,1588,4976,CHI
3,16,11,281,1.480935868,297,16,he,"('CHI', 'MOT')",Providence,lil35.xml,311,14,3,MOT,1588,4976,CHI
0,18,2,291,1.409059572,309,18,do,"('CHI', 'MOT')",Providence,lil35.xml,311,2,0,MOT,1588,4976,CHI
10,39,8,254,1.400258901,293,39,that,"('CHI', 'MOT')",Providence,lil35.xml,311,18,10,MOT,1588,4976,CHI
0,14,4,293,1.233531607,307,14,where,"('CHI', 'MOT')",Providence,lil35.xml,311,4,0,MOT,1588,4976,CHI
29,52,17,213,1.146953116,265,52,a,"('CHI', 'MOT')",Providence,lil35.xml,311,46,29,MOT,1588,4976,CHI
0,13,5,293,1.145132304,306,13,have,"('CHI', 'MOT')",Providence,lil35.xml,311,5,0,MOT,1588,4976,CHI
0,29,2,280,0.952301169,309,29,of,"('CHI', 'MOT')",Providence,lil35.xml,311,2,0,MOT,1588,4976,CHI
1,39,3,268,0.945849534,307,39,to,"('CHI', 'MOT')",Providence,lil35.xml,311,4,1,MOT,1588,4976,CHI
17,61,13,220,0.942948368,281,61,the,"('CHI', 'MOT')",Providence,lil35.xml,311,30,17,MOT,1588,4976,CHI
4,65,4,238,0.837509854,303,65,you,"('CHI', 'MOT')",Providence,lil35.xml,311,8,4,MOT,1588,4976,CHI
16,46,39,210,0.492974059,256,46,and,"('CHI', 'MOT')",Providence,lil35.xml,311,55,16,MOT,1588,4976,CHI
0,18,10,283,0.284387177,301,18,this,"('CHI', 'MOT')",Providence,lil35.xml,311,10,0,MOT,1588,4976,CHI
2,60,8,241,0.21656458,301,60,is,"('CHI', 'MOT')",Providence,lil35.xml,311,10,2,MOT,1588,4976,CHI
2,32,23,254,-0.030771659,286,32,what,"('CHI', 'MOT')",Providence,lil35.xml,311,25,2,MOT,1588,4976,CHI
0,15,22,274,-0.277319285,289,15,my,"('CHI', 'MOT')",Providence,lil35.xml,311,22,0,MOT,1588,4976,CHI
1,0,4,109,3.456767233,109,0,for,"('MOT', 'CHI')",Providence,lil36.xml,114,5,1,CHI,1267,644,MOT
1,2,1,175,3.395626337,177,2,he,"('CHI', 'MOT')",Providence,lil36.xml,179,2,1,MOT,811,3069,CHI
2,0,7,105,3.37354585,105,0,she,"('MOT', 'CHI')",Providence,lil36.xml,114,9,2,CHI,1267,644,MOT
1,2,0,111,3.240854732,113,2,did,"('MOT', 'CHI')",Providence,lil36.xml,114,1,1,CHI,1267,644,MOT
3,1,6,104,2.968080742,105,1,are,"('MOT', 'CHI')",Providence,lil36.xml,114,9,3,CHI,1267,644,MOT
0,1,1,112,2.953172659,113,1,all,"('MOT', 'CHI')",Providence,lil36.xml,114,1,0,CHI,1267,644,MOT
0,1,1,112,2.953172659,113,1,he,"('MOT', 'CHI')",Providence,lil36.xml,114,1,0,CHI,1267,644,MOT
1,3,2,173,2.879198457,176,3,look,"('CHI', 'MOT')",Providence,lil36.xml,179,3,1,MOT,811,3069,CHI
1,7,0,171,2.708050201,178,7,one,"('CHI', 'MOT')",Providence,lil36.xml,179,1,1,MOT,811,3069,CHI
2,1,7,104,2.68039867,105,1,what,"('MOT', 'CHI')",Providence,lil36.xml,114,9,2,CHI,1267,644,MOT
1,1,6,106,2.494123305,107,1,have,"('MOT', 'CHI')",Providence,lil36.xml,114,7,1,CHI,1267,644,MOT
1,10,0,168,2.38959647,178,10,did,"('CHI', 'MOT')",Providence,lil36.xml,179,1,1,MOT,811,3069,CHI
0,5,1,173,2.302585093,178,5,where,"('CHI', 'MOT')",Providence,lil36.xml,179,1,0,MOT,811,3069,CHI
0,3,1,110,2.260025479,113,3,not,"('MOT', 'CHI')",Providence,lil36.xml,114,1,0,CHI,1267,644,MOT
0,1,4,109,2.233592222,110,1,get,"('MOT', 'CHI')",Providence,lil36.xml,114,4,0,CHI,1267,644,MOT
0,1,4,109,2.233592222,110,1,was,"('MOT', 'CHI')",Providence,lil36.xml,114,4,0,CHI,1267,644,MOT
0,1,4,109,2.233592222,110,1,at,"('MOT', 'CHI')",Providence,lil36.xml,114,4,0,CHI,1267,644,MOT
1,1,9,103,2.178532444,104,1,go,"('MOT', 'CHI')",Providence,lil36.xml,114,10,1,CHI,1267,644,MOT
1,1,9,103,2.178532444,104,1,they,"('MOT', 'CHI')",Providence,lil36.xml,114,10,1,CHI,1267,644,MOT
1,2,6,105,2.088658197,107,2,some,"('MOT', 'CHI')",Providence,lil36.xml,114,7,1,CHI,1267,644,MOT
1,0,0,10,2.079441542,10,0,of,"('MOT', 'OPE')",Providence,lil36.xml,11,1,1,OPE,251,90,MOT
1,0,0,10,2.079441542,10,0,no,"('MOT', 'OPE')",Providence,lil36.xml,11,1,1,OPE,251,90,MOT
2,13,1,163,2.031900597,176,13,oh,"('CHI', 'MOT')",Providence,lil36.xml,179,3,2,MOT,811,3069,CHI
0,5,2,172,2.009331975,177,5,put,"('CHI', 'MOT')",Providence,lil36.xml,179,2,0,MOT,811,3069,CHI
0,1,6,107,1.927891644,108,1,on,"('MOT', 'CHI')",Providence,lil36.xml,114,6,0,CHI,1267,644,MOT
0,2,4,108,1.828127113,110,2,wanna,"('MOT', 'CHI')",Providence,lil36.xml,114,4,0,CHI,1267,644,MOT
0,9,1,169,1.791759469,178,9,with,"('CHI', 'MOT')",Providence,lil36.xml,179,1,0,MOT,811,3069,CHI
0,9,1,169,1.791759469,178,9,are,"('CHI', 'MOT')",Providence,lil36.xml,179,1,0,MOT,811,3069,CHI
1,0,1,9,1.704748092,9,0,like,"('MOT', 'OPE')",Providence,lil36.xml,11,2,1,OPE,251,90,MOT
0,10,1,168,1.696449289,178,10,wanna,"('CHI', 'MOT')",Providence,lil36.xml,179,1,0,MOT,811,3069,CHI
1,2,10,101,1.683545885,103,2,that,"('MOT', 'CHI')",Providence,lil36.xml,114,11,1,CHI,1267,644,MOT
1,0,0,6,1.673976434,6,0,in,"('OPE', 'MOT')",Providence,lil36.xml,7,1,1,MOT,36,148,OPE
0,11,1,167,1.609437912,178,11,go,"('CHI', 'MOT')",Providence,lil36.xml,179,1,0,MOT,811,3069,CHI
5,10,11,153,1.609437912,163,10,yeah,"('CHI', 'MOT')",Providence,lil36.xml,179,16,5,MOT,811,3069,CHI
5,9,13,152,1.587192303,161,9,want,"('CHI', 'MOT')",Providence,lil36.xml,179,18,5,MOT,811,3069,CHI
0,3,4,107,1.540445041,110,3,my,"('MOT', 'CHI')",Providence,lil36.xml,114,4,0,CHI,1267,644,MOT
0,12,1,166,1.529395205,178,12,in,"('CHI', 'MOT')",Providence,lil36.xml,179,1,0,MOT,811,3069,CHI
1,12,3,163,1.512588086,175,12,what,"('CHI', 'MOT')",Providence,lil36.xml,179,4,1,MOT,811,3069,CHI
0,9,2,168,1.498506352,177,9,see,"('CHI', 'MOT')",Providence,lil36.xml,179,2,0,MOT,811,3069,CHI
0,1,11,102,1.395863812,103,1,to,"('MOT', 'CHI')",Providence,lil36.xml,114,11,0,CHI,1267,644,MOT
0,2,7,105,1.395511016,107,2,with,"('MOT', 'CHI')",Providence,lil36.xml,114,7,0,CHI,1267,644,MOT
0,2,7,105,1.395511016,107,2,look,"('MOT', 'CHI')",Providence,lil36.xml,114,7,0,CHI,1267,644,MOT
1,17,2,159,1.375121061,176,17,like,"('CHI', 'MOT')",Providence,lil36.xml,179,3,1,MOT,811,3069,CHI
1,17,2,159,1.375121061,176,17,is,"('CHI', 'MOT')",Providence,lil36.xml,179,3,1,MOT,811,3069,CHI
1,14,1,98,1.335001067,112,14,no,"('MOT', 'CHI')",Providence,lil36.xml,114,2,1,CHI,1267,644,MOT
0,2,8,104,1.280933845,106,2,little,"('MOT', 'CHI')",Providence,lil36.xml,114,8,0,CHI,1267,644,MOT
2,20,3,154,1.278663697,174,20,on,"('CHI', 'MOT')",Providence,lil36.xml,179,5,2,MOT,811,3069,CHI
0,2,9,103,1.176321273,105,2,of,"('MOT', 'CHI')",Providence,lil36.xml,114,9,0,CHI,1267,644,MOT
0,1,14,99,1.15923691,100,1,we,"('MOT', 'CHI')",Providence,lil36.xml,114,14,0,CHI,1267,644,MOT
1,9,4,100,1.15418214,109,9,want,"('MOT', 'CHI')",Providence,lil36.xml,114,5,1,CHI,1267,644,MOT
0,18,1,160,1.149905583,178,18,have,"('CHI', 'MOT')",Providence,lil36.xml,179,1,0,MOT,811,3069,CHI
2,7,9,96,1.10818174,103,7,is,"('MOT', 'CHI')",Providence,lil36.xml,114,11,2,CHI,1267,644,MOT
0,11,3,165,1.087438988,176,11,not,"('CHI', 'MOT')",Providence,lil36.xml,179,3,0,MOT,811,3069,CHI
0,9,4,166,1.08180517,175,9,get,"('CHI', 'MOT')",Providence,lil36.xml,179,4,0,MOT,811,3069,CHI
1,1,1,8,1.011600912,9,1,is,"('MOT', 'OPE')",Providence,lil36.xml,11,2,1,OPE,251,90,MOT
0,2,11,101,0.990398704,103,2,in,"('MOT', 'CHI')",Providence,lil36.xml,114,11,0,CHI,1267,644,MOT
5,24,8,142,0.988797423,166,24,and,"('CHI', 'MOT')",Providence,lil36.xml,179,13,5,MOT,811,3069,CHI
2,32,2,143,0.986494991,175,32,the,"('CHI', 'MOT')",Providence,lil36.xml,179,4,2,MOT,811,3069,CHI
0,6,4,104,0.980829253,110,6,yeah,"('MOT', 'CHI')",Providence,lil36.xml,114,4,0,CHI,1267,644,MOT
6,33,6,134,0.91039101,167,33,it,"('CHI', 'MOT')",Providence,lil36.xml,179,12,6,MOT,811,3069,CHI
6,40,4,129,0.889094989,169,40,to,"('CHI', 'MOT')",Providence,lil36.xml,179,10,6,MOT,811,3069,CHI
3,3,56,117,0.693147181,120,3,no,"('CHI', 'MOT')",Providence,lil36.xml,179,59,3,MOT,811,3069,CHI
1,0,0,1,0.693147181,1,0,the,"('OPE', 'CHI')",Providence,lil36.xml,2,1,1,CHI,6,16,OPE
0,1,1,9,0.693147181,10,1,go,"('MOT', 'OPE')",Providence,lil36.xml,11,1,0,OPE,251,90,MOT
0,1,1,9,0.693147181,10,1,for,"('MOT', 'OPE')",Providence,lil36.xml,11,1,0,OPE,251,90,MOT
3,9,15,87,0.672944473,96,9,and,"('MOT', 'CHI')",Providence,lil36.xml,114,18,3,CHI,1267,644,MOT
1,2,0,4,0.575364145,6,2,you,"('OPE', 'MOT')",Providence,lil36.xml,7,1,1,MOT,36,148,OPE
1,2,0,4,0.575364145,6,2,the,"('OPE', 'MOT')",Providence,lil36.xml,7,1,1,MOT,36,148,OPE
1,24,5,149,0.559615788,173,24,a,"('CHI', 'MOT')",Providence,lil36.xml,179,6,1,MOT,811,3069,CHI
1,1,1,4,0.559615788,5,1,wanna,"('OPE', 'MOT')",Providence,lil36.xml,7,2,1,MOT,36,148,OPE
1,4,19,90,0.557015006,94,4,it,"('MOT', 'CHI')",Providence,lil36.xml,114,20,1,CHI,1267,644,MOT
6,13,19,76,0.52187546,89,13,a,"('MOT', 'CHI')",Providence,lil36.xml,114,25,6,CHI,1267,644,MOT
1,5,20,88,0.319770387,93,5,the,"('MOT', 'CHI')",Providence,lil36.xml,114,21,1,CHI,1267,644,MOT
0,1,2,8,0.318453731,9,1,want,"('MOT', 'OPE')",Providence,lil36.xml,11,2,0,OPE,251,90,MOT
0,1,2,8,0.318453731,9,1,on,"('MOT', 'OPE')",Providence,lil36.xml,11,2,0,OPE,251,90,MOT
0,8,12,159,0.293616808,167,8,my,"('CHI', 'MOT')",Providence,lil36.xml,179,12,0,MOT,811,3069,CHI
0,2,1,8,0.287682072,10,2,it,"('MOT', 'OPE')",Providence,lil36.xml,11,1,0,OPE,251,90,MOT
0,1,1,5,0.287682072,6,1,oh,"('OPE', 'MOT')",Providence,lil36.xml,7,1,0,MOT,36,148,OPE
0,1,1,5,0.287682072,6,1,look,"('OPE', 'MOT')",Providence,lil36.xml,7,1,0,MOT,36,148,OPE
0,1,1,5,0.287682072,6,1,not,"('OPE', 'MOT')",Providence,lil36.xml,7,1,0,MOT,36,148,OPE
0,5,12,97,0.2135741,102,5,oh,"('MOT', 'CHI')",Providence,lil36.xml,114,12,0,CHI,1267,644,MOT
0,3,1,7,0,10,3,this,"('MOT', 'OPE')",Providence,lil36.xml,11,1,0,OPE,251,90,MOT
0,1,3,7,0,8,1,to,"('MOT', 'OPE')",Providence,lil36.xml,11,3,0,OPE,251,90,MOT
0,2,2,7,-0.087011377,9,2,oh,"('MOT', 'OPE')",Providence,lil36.xml,11,2,0,OPE,251,90,MOT
1,1,5,4,-0.133531393,5,1,you,"('MOT', 'OPE')",Providence,lil36.xml,11,6,1,OPE,251,90,MOT
0,1,1,2,-0.182321557,3,1,you,"('CHI', 'OPE')",Providence,lil36.xml,4,1,0,OPE,20,31,CHI
0,1,4,6,-0.287682072,7,1,she,"('MOT', 'OPE')",Providence,lil36.xml,11,4,0,OPE,251,90,MOT
0,82,1,96,-0.324496046,178,82,you,"('CHI', 'MOT')",Providence,lil36.xml,179,1,0,MOT,811,3069,CHI
0,3,2,6,-0.374693449,9,3,the,"('MOT', 'OPE')",Providence,lil36.xml,11,2,0,OPE,251,90,MOT
0,2,3,6,-0.405465108,8,2,a,"('MOT', 'OPE')",Providence,lil36.xml,11,3,0,OPE,251,90,MOT
1,2,0,220,3.907568655,222,2,all,"('CHI', 'MOT')",Providence,lil37.xml,223,1,1,MOT,1268,2553,CHI
1,0,3,134,3.814042597,134,0,big,"('MOT', 'CHI')",Providence,lil37.xml,138,4,1,CHI,1960,706,MOT
0,1,1,221,3.619886583,222,1,make,"('CHI', 'MOT')",Providence,lil37.xml,223,1,0,MOT,1268,2553,CHI
1,0,5,132,3.511545439,132,0,get,"('MOT', 'CHI')",Providence,lil37.xml,138,6,1,CHI,1960,706,MOT
1,0,5,132,3.511545439,132,0,did,"('MOT', 'CHI')",Providence,lil37.xml,138,6,1,CHI,1960,706,MOT
0,2,1,220,3.214421475,222,2,they,"('CHI', 'MOT')",Providence,lil37.xml,223,1,0,MOT,1268,2553,CHI
1,1,4,132,2.959364629,133,1,was,"('MOT', 'CHI')",Providence,lil37.xml,138,5,1,CHI,1960,706,MOT
0,3,1,219,2.926739402,222,3,of,"('CHI', 'MOT')",Providence,lil37.xml,223,1,0,MOT,1268,2553,CHI
1,5,1,216,2.922265122,221,5,big,"('CHI', 'MOT')",Providence,lil37.xml,223,2,1,MOT,1268,2553,CHI
1,1,6,130,2.693124551,131,1,he,"('MOT', 'CHI')",Providence,lil37.xml,138,7,1,CHI,1960,706,MOT
1,0,0,20,2.685577345,20,0,wanna,"('MOT', 'OPE')",Providence,lil37.xml,21,1,1,OPE,333,67,MOT
1,10,0,212,2.608285671,222,10,gonna,"('CHI', 'MOT')",Providence,lil37.xml,223,1,1,MOT,1268,2553,CHI
1,10,0,212,2.608285671,222,10,wanna,"('CHI', 'MOT')",Providence,lil37.xml,223,1,1,MOT,1268,2553,CHI
1,6,2,214,2.540476501,220,6,have,"('CHI', 'MOT')",Providence,lil37.xml,223,3,1,MOT,1268,2553,CHI
2,2,14,205,2.451962494,207,2,one,"('CHI', 'MOT')",Providence,lil37.xml,223,16,2,MOT,1268,2553,CHI
0,1,4,133,2.427748236,134,1,where,"('MOT', 'CHI')",Providence,lil37.xml,138,4,0,CHI,1960,706,MOT
1,9,1,212,2.411439498,221,9,at,"('CHI', 'MOT')",Providence,lil37.xml,223,2,1,MOT,1268,2553,CHI
1,1,9,127,2.382627801,128,1,on,"('MOT', 'CHI')",Providence,lil37.xml,138,10,1,CHI,1960,706,MOT
0,6,1,216,2.367123614,222,6,see,"('CHI', 'MOT')",Providence,lil37.xml,223,1,0,MOT,1268,2553,CHI
2,7,4,210,2.328800935,217,7,she,"('CHI', 'MOT')",Providence,lil37.xml,223,6,2,MOT,1268,2553,CHI
1,0,0,13,2.302585093,13,0,there,"('OPE', 'MOT')",Providence,lil37.xml,14,1,1,MOT,107,128,OPE
1,0,0,13,2.302585093,13,0,she,"('OPE', 'MOT')",Providence,lil37.xml,14,1,1,MOT,107,128,OPE
4,6,4,124,2.243744593,130,6,this,"('MOT', 'CHI')",Providence,lil37.xml,138,8,4,CHI,1960,706,MOT
0,7,1,215,2.233592222,222,7,there,"('CHI', 'MOT')",Providence,lil37.xml,223,1,0,MOT,1268,2553,CHI
0,5,2,216,2.229117941,221,5,look,"('CHI', 'MOT')",Providence,lil37.xml,223,2,0,MOT,1268,2553,CHI
4,3,22,194,2.184243866,197,3,no,"('CHI', 'MOT')",Providence,lil37.xml,223,26,4,MOT,1268,2553,CHI
1,0,0,11,2.159484249,11,0,of,"('CHI', 'OPE')",Providence,lil37.xml,12,1,1,OPE,65,56,CHI
0,1,6,131,2.125251078,132,1,see,"('MOT', 'CHI')",Providence,lil37.xml,138,6,0,CHI,1960,706,MOT
0,1,6,131,2.125251078,132,1,all,"('MOT', 'CHI')",Providence,lil37.xml,138,6,0,CHI,1960,706,MOT
1,0,2,18,2.079441542,18,0,with,"('MOT', 'OPE')",Providence,lil37.xml,21,3,1,OPE,333,67,MOT
1,18,0,204,2.061741965,222,18,oh,"('CHI', 'MOT')",Providence,lil37.xml,223,1,1,MOT,1268,2553,CHI
0,9,1,213,2.01044867,222,9,he,"('CHI', 'MOT')",Providence,lil37.xml,223,1,0,MOT,1268,2553,CHI
0,10,1,212,1.91513849,222,10,little,"('CHI', 'MOT')",Providence,lil37.xml,223,1,0,MOT,1268,2553,CHI
0,10,1,212,1.91513849,222,10,are,"('CHI', 'MOT')",Providence,lil37.xml,223,1,0,MOT,1268,2553,CHI
2,10,5,206,1.887987501,216,10,was,"('CHI', 'MOT')",Providence,lil37.xml,223,7,2,MOT,1268,2553,CHI
0,1,8,129,1.887069649,130,1,want,"('MOT', 'CHI')",Providence,lil37.xml,138,8,0,CHI,1960,706,MOT
6,4,17,111,1.879770347,115,4,it,"('MOT', 'CHI')",Providence,lil37.xml,138,23,6,CHI,1960,706,MOT
4,14,5,200,1.878770846,214,14,on,"('CHI', 'MOT')",Providence,lil37.xml,223,9,4,MOT,1268,2553,CHI
1,11,3,208,1.814643763,219,11,go,"('CHI', 'MOT')",Providence,lil37.xml,223,4,1,MOT,1268,2553,CHI
1,2,11,124,1.807507826,126,2,that,"('MOT', 'CHI')",Providence,lil37.xml,138,12,1,CHI,1960,706,MOT
1,24,0,198,1.787305119,222,24,do,"('CHI', 'MOT')",Providence,lil37.xml,223,1,1,MOT,1268,2553,CHI
0,1,9,128,1.78415487,129,1,but,"('MOT', 'CHI')",Providence,lil37.xml,138,9,0,CHI,1960,706,MOT
2,5,7,124,1.78415487,129,5,like,"('MOT', 'CHI')",Providence,lil37.xml,138,9,2,CHI,1960,706,MOT
2,18,2,201,1.760576542,219,18,in,"('CHI', 'MOT')",Providence,lil37.xml,223,4,2,MOT,1268,2553,CHI
1,10,4,208,1.742969305,218,10,like,"('CHI', 'MOT')",Providence,lil37.xml,223,5,1,MOT,1268,2553,CHI
0,3,4,131,1.734601055,134,3,put,"('MOT', 'CHI')",Providence,lil37.xml,138,4,0,CHI,1960,706,MOT
0,2,6,130,1.71978597,132,2,go,"('MOT', 'CHI')",Providence,lil37.xml,138,6,0,CHI,1960,706,MOT
0,2,6,130,1.71978597,132,2,up,"('MOT', 'CHI')",Providence,lil37.xml,138,6,0,CHI,1960,706,MOT
0,2,6,130,1.71978597,132,2,one,"('MOT', 'CHI')",Providence,lil37.xml,138,6,0,CHI,1960,706,MOT
0,2,6,130,1.71978597,132,2,are,"('MOT', 'CHI')",Providence,lil37.xml,138,6,0,CHI,1960,706,MOT
0,9,2,212,1.718292317,221,9,for,"('CHI', 'MOT')",Providence,lil37.xml,223,2,0,MOT,1268,2553,CHI
1,6,4,127,1.706601661,133,6,not,"('MOT', 'CHI')",Providence,lil37.xml,138,5,1,CHI,1960,706,MOT
2,5,8,123,1.68948062,128,5,in,"('MOT', 'CHI')",Providence,lil37.xml,138,10,2,CHI,1960,706,MOT
5,8,18,192,1.683926764,200,8,yeah,"('CHI', 'MOT')",Providence,lil37.xml,223,23,5,MOT,1268,2553,CHI
1,0,4,16,1.637608789,16,0,a,"('MOT', 'OPE')",Providence,lil37.xml,21,5,1,OPE,333,67,MOT
0,1,11,126,1.601715866,127,1,she,"('MOT', 'CHI')",Providence,lil37.xml,138,11,0,CHI,1960,706,MOT
0,8,3,212,1.596014892,220,8,put,"('CHI', 'MOT')",Providence,lil37.xml,223,3,0,MOT,1268,2553,CHI
0,3,5,130,1.573070268,133,3,for,"('MOT', 'CHI')",Providence,lil37.xml,138,5,0,CHI,1960,706,MOT
0,15,1,207,1.540445041,222,15,we,"('CHI', 'MOT')",Providence,lil37.xml,223,1,0,MOT,1268,2553,CHI
6,14,13,190,1.521213679,204,14,it,"('CHI', 'MOT')",Providence,lil37.xml,223,19,6,MOT,1268,2553,CHI
0,10,3,210,1.395344197,220,10,get,"('CHI', 'MOT')",Providence,lil37.xml,223,3,0,MOT,1268,2553,CHI
0,2,9,127,1.378689762,129,2,have,"('MOT', 'CHI')",Providence,lil37.xml,138,9,0,CHI,1960,706,MOT
0,7,5,211,1.368275856,218,7,want,"('CHI', 'MOT')",Providence,lil37.xml,223,5,0,MOT,1268,2553,CHI
4,28,4,187,1.319454343,215,28,to,"('CHI', 'MOT')",Providence,lil37.xml,223,8,4,MOT,1268,2553,CHI
0,9,4,210,1.303818139,219,9,that,"('CHI', 'MOT')",Providence,lil37.xml,223,4,0,MOT,1268,2553,CHI
0,1,1,19,1.299282984,20,1,that,"('MOT', 'OPE')",Providence,lil37.xml,21,1,0,OPE,333,67,MOT
1,1,1,11,1.252762968,12,1,is,"('OPE', 'MOT')",Providence,lil37.xml,14,2,1,MOT,107,128,OPE
0,6,7,210,1.241360336,216,6,not,"('CHI', 'MOT')",Providence,lil37.xml,223,7,0,MOT,1268,2553,CHI
4,4,26,104,1.234744463,108,4,the,"('MOT', 'CHI')",Providence,lil37.xml,138,30,4,CHI,1960,706,MOT
2,15,8,198,1.211754945,213,15,is,"('CHI', 'MOT')",Providence,lil37.xml,223,10,2,MOT,1268,2553,CHI
0,6,4,128,1.174985267,134,6,my,"('MOT', 'CHI')",Providence,lil37.xml,138,4,0,CHI,1960,706,MOT
2,13,11,197,1.108091033,210,13,with,"('CHI', 'MOT')",Providence,lil37.xml,223,13,2,MOT,1268,2553,CHI
10,30,13,170,1.053299941,200,30,a,"('CHI', 'MOT')",Providence,lil37.xml,223,23,10,MOT,1268,2553,CHI
0,3,10,125,0.99633344,128,3,with,"('MOT', 'CHI')",Providence,lil37.xml,138,10,0,CHI,1960,706,MOT
1,8,15,199,0.947885097,207,8,this,"('CHI', 'MOT')",Providence,lil37.xml,223,16,1,MOT,1268,2553,CHI
0,1,1,12,0.916290732,13,1,go,"('OPE', 'MOT')",Providence,lil37.xml,14,1,0,MOT,107,128,OPE
0,1,1,12,0.916290732,13,1,for,"('OPE', 'MOT')",Providence,lil37.xml,14,1,0,MOT,107,128,OPE
0,1,1,12,0.916290732,13,1,we,"('OPE', 'MOT')",Providence,lil37.xml,14,1,0,MOT,107,128,OPE
0,1,1,12,0.916290732,13,1,wanna,"('OPE', 'MOT')",Providence,lil37.xml,14,1,0,MOT,107,128,OPE
0,1,1,12,0.916290732,13,1,one,"('OPE', 'MOT')",Providence,lil37.xml,14,1,0,MOT,107,128,OPE
0,1,1,12,0.916290732,13,1,are,"('OPE', 'MOT')",Providence,lil37.xml,14,1,0,MOT,107,128,OPE
0,2,1,18,0.893817876,20,2,is,"('MOT', 'OPE')",Providence,lil37.xml,21,1,0,OPE,333,67,MOT
0,24,2,197,0.802001585,221,24,what,"('CHI', 'MOT')",Providence,lil37.xml,223,2,0,MOT,1268,2553,CHI
0,1,1,10,0.773189888,11,1,a,"('CHI', 'OPE')",Providence,lil37.xml,12,1,0,OPE,65,56,CHI
0,1,1,10,0.773189888,11,1,put,"('CHI', 'OPE')",Providence,lil37.xml,12,1,0,OPE,65,56,CHI
0,3,13,122,0.749842524,125,3,little,"('MOT', 'CHI')",Providence,lil37.xml,138,13,0,CHI,1960,706,MOT
9,48,10,156,0.694118526,204,48,the,"('CHI', 'MOT')",Providence,lil37.xml,223,19,9,MOT,1268,2553,CHI
0,6,8,124,0.634306681,130,6,yeah,"('MOT', 'CHI')",Providence,lil37.xml,138,8,0,CHI,1960,706,MOT
17,30,37,139,0.572696419,169,30,and,"('CHI', 'MOT')",Providence,lil37.xml,223,54,17,MOT,1268,2553,CHI
0,1,2,11,0.559615788,12,1,what,"('OPE', 'MOT')",Providence,lil37.xml,14,2,0,MOT,107,128,OPE
0,1,2,11,0.559615788,12,1,my,"('OPE', 'MOT')",Providence,lil37.xml,14,2,0,MOT,107,128,OPE
0,2,1,11,0.510825624,13,2,and,"('OPE', 'MOT')",Providence,lil37.xml,14,1,0,MOT,107,128,OPE
0,4,14,120,0.454255272,124,4,what,"('MOT', 'CHI')",Providence,lil37.xml,138,14,0,CHI,1960,706,MOT
0,1,2,9,0.405465108,10,1,my,"('CHI', 'OPE')",Providence,lil37.xml,12,2,0,OPE,65,56,CHI
3,5,39,91,0.395312737,96,5,you,"('MOT', 'CHI')",Providence,lil37.xml,138,42,3,CHI,1960,706,MOT
0,2,1,9,0.36772478,11,2,you,"('CHI', 'OPE')",Providence,lil37.xml,12,1,0,OPE,65,56,CHI
0,2,1,9,0.36772478,11,2,it,"('CHI', 'OPE')",Providence,lil37.xml,12,1,0,OPE,65,56,CHI
1,4,28,105,0.359252265,109,4,a,"('MOT', 'CHI')",Providence,lil37.xml,138,29,1,CHI,1960,706,MOT
0,8,16,199,0.254737917,207,8,my,"('CHI', 'MOT')",Providence,lil37.xml,223,16,0,MOT,1268,2553,CHI
2,31,6,99,0.213093215,130,31,no,"('MOT', 'CHI')",Providence,lil37.xml,138,8,2,CHI,1960,706,MOT
0,5,15,118,0.203340924,123,5,is,"('MOT', 'CHI')",Providence,lil37.xml,138,15,0,CHI,1960,706,MOT
0,4,18,116,0.198850859,120,4,to,"('MOT', 'CHI')",Providence,lil37.xml,138,18,0,CHI,1960,706,MOT
0,2,2,10,0.15415068,12,2,the,"('OPE', 'MOT')",Providence,lil37.xml,14,2,0,MOT,107,128,OPE
2,75,4,142,0.077509137,217,75,you,"('CHI', 'MOT')",Providence,lil37.xml,223,6,2,MOT,1268,2553,CHI
0,1,6,14,0.060624622,15,1,you,"('MOT', 'OPE')",Providence,lil37.xml,21,6,0,OPE,333,67,MOT
0,1,6,14,0.060624622,15,1,she,"('MOT', 'OPE')",Providence,lil37.xml,21,6,0,OPE,333,67,MOT
0,2,4,15,0.054067221,17,2,the,"('MOT', 'OPE')",Providence,lil37.xml,21,4,0,OPE,333,67,MOT
0,3,2,9,-0.133531393,12,3,you,"('OPE', 'MOT')",Providence,lil37.xml,14,2,0,MOT,107,128,OPE
1,13,18,106,-0.194642041,119,13,and,"('MOT', 'CHI')",Providence,lil37.xml,138,19,1,CHI,1960,706,MOT
0,3,3,8,-0.430782916,11,3,it,"('OPE', 'MOT')",Providence,lil37.xml,14,3,0,MOT,107,128,OPE
0,3,3,8,-0.430782916,11,3,a,"('OPE', 'MOT')",Providence,lil37.xml,14,3,0,MOT,107,128,OPE
1,0,9,354,4.083171262,354,0,look,"('MOT', 'CHI')",Providence,lil38.xml,364,10,1,CHI,5091,1643,MOT
1,0,13,350,3.784189634,350,0,but,"('MOT', 'CHI')",Providence,lil38.xml,364,14,1,CHI,5091,1643,MOT
2,2,7,353,3.479840509,355,2,get,"('MOT', 'CHI')",Providence,lil38.xml,364,9,2,CHI,5091,1643,MOT
0,1,4,359,3.406737562,360,1,make,"('MOT', 'CHI')",Providence,lil38.xml,364,4,0,CHI,5091,1643,MOT
1,1,11,351,3.230239584,352,1,at,"('MOT', 'CHI')",Providence,lil38.xml,364,12,1,CHI,5091,1643,MOT
0,1,6,357,3.113515309,358,1,my,"('MOT', 'CHI')",Providence,lil38.xml,364,6,0,CHI,5091,1643,MOT
0,1,6,357,3.113515309,358,1,can,"('MOT', 'CHI')",Providence,lil38.xml,364,6,0,CHI,5091,1643,MOT
2,3,9,350,3.01948636,353,3,like,"('MOT', 'CHI')",Providence,lil38.xml,364,11,2,CHI,5091,1643,MOT
1,1,15,347,2.967561397,348,1,have,"('MOT', 'CHI')",Providence,lil38.xml,364,16,1,CHI,5091,1643,MOT
0,1,9,354,2.786693328,355,1,up,"('MOT', 'CHI')",Providence,lil38.xml,364,9,0,CHI,5091,1643,MOT
0,1,9,354,2.786693328,355,1,he,"('MOT', 'CHI')",Providence,lil38.xml,364,9,0,CHI,5091,1643,MOT
0,2,7,355,2.587485522,357,2,put,"('MOT', 'CHI')",Providence,lil38.xml,364,7,0,CHI,5091,1643,MOT
3,5,15,341,2.451005098,346,5,are,"('MOT', 'CHI')",Providence,lil38.xml,364,18,3,CHI,5091,1643,MOT
1,3,13,347,2.397895273,350,3,on,"('MOT', 'CHI')",Providence,lil38.xml,364,14,1,CHI,5091,1643,MOT
1,2,19,342,2.349931214,344,2,go,"('MOT', 'CHI')",Providence,lil38.xml,364,20,1,CHI,5091,1643,MOT
2,4,16,342,2.345644582,346,4,there,"('MOT', 'CHI')",Providence,lil38.xml,364,18,2,CHI,5091,1643,MOT
0,2,10,352,2.291411792,354,2,big,"('MOT', 'CHI')",Providence,lil38.xml,364,10,0,CHI,5091,1643,MOT
1,11,4,348,2.15120834,359,11,not,"('MOT', 'CHI')",Providence,lil38.xml,364,5,1,CHI,5091,1643,MOT
0,3,9,352,2.093546148,355,3,want,"('MOT', 'CHI')",Providence,lil38.xml,364,9,0,CHI,5091,1643,MOT
0,1,21,342,2.014903021,343,1,where,"('MOT', 'CHI')",Providence,lil38.xml,364,21,0,CHI,5091,1643,MOT
15,10,44,295,1.990667333,305,10,in,"('MOT', 'CHI')",Providence,lil38.xml,364,59,15,CHI,5091,1643,MOT
0,3,13,348,1.772123495,351,3,all,"('MOT', 'CHI')",Providence,lil38.xml,364,13,0,CHI,5091,1643,MOT
0,4,11,349,1.69773052,353,4,wanna,"('MOT', 'CHI')",Providence,lil38.xml,364,11,0,CHI,5091,1643,MOT
1,3,31,329,1.591633288,332,3,to,"('MOT', 'CHI')",Providence,lil38.xml,364,32,1,CHI,5091,1643,MOT
1,4,28,331,1.469804994,335,4,we,"('MOT', 'CHI')",Providence,lil38.xml,364,29,1,CHI,5091,1643,MOT
1,4,28,331,1.469804994,335,4,of,"('MOT', 'CHI')",Providence,lil38.xml,364,29,1,CHI,5091,1643,MOT
1,22,5,336,1.364315454,358,22,no,"('MOT', 'CHI')",Providence,lil38.xml,364,6,1,CHI,5091,1643,MOT
0,11,8,345,1.093041244,356,11,yeah,"('MOT', 'CHI')",Providence,lil38.xml,364,8,0,CHI,5091,1643,MOT
0,6,15,343,1.08166273,349,6,with,"('MOT', 'CHI')",Providence,lil38.xml,364,15,0,CHI,5091,1643,MOT
1,3,52,308,1.045722825,311,3,oh,"('MOT', 'CHI')",Providence,lil38.xml,364,53,1,CHI,5091,1643,MOT
2,3,76,283,0.993251773,286,3,you,"('MOT', 'CHI')",Providence,lil38.xml,364,78,2,CHI,5091,1643,MOT
19,30,50,265,0.992797331,295,30,a,"('MOT', 'CHI')",Providence,lil38.xml,364,69,19,CHI,5091,1643,MOT
4,12,46,302,0.84898705,314,12,what,"('MOT', 'CHI')",Providence,lil38.xml,364,50,4,CHI,5091,1643,MOT
10,24,49,281,0.794993331,305,24,it,"('MOT', 'CHI')",Providence,lil38.xml,364,59,10,CHI,5091,1643,MOT
5,22,36,301,0.67889032,323,22,one,"('MOT', 'CHI')",Providence,lil38.xml,364,41,5,CHI,5091,1643,MOT
21,30,75,238,0.670509729,268,30,the,"('MOT', 'CHI')",Providence,lil38.xml,364,96,21,CHI,5091,1643,MOT
10,31,46,277,0.608288657,308,31,is,"('MOT', 'CHI')",Providence,lil38.xml,364,56,10,CHI,5091,1643,MOT
0,4,44,316,0.336472237,320,4,do,"('MOT', 'CHI')",Providence,lil38.xml,364,44,0,CHI,5091,1643,MOT
0,5,52,307,-0.03135053,312,5,that,"('MOT', 'CHI')",Providence,lil38.xml,364,52,0,CHI,5091,1643,MOT
3,20,59,282,-0.100083459,302,20,and,"('MOT', 'CHI')",Providence,lil38.xml,364,62,3,CHI,5091,1643,MOT
2,64,24,274,-0.579033874,338,64,this,"('MOT', 'CHI')",Providence,lil38.xml,364,26,2,CHI,5091,1643,MOT
0,1,2,213,3.295836866,214,1,where,"('MOT', 'CHI')",Providence,lil39.xml,216,2,0,CHI,3789,1064,MOT
1,3,1,176,3.11905549,179,3,where,"('CHI', 'MOT')",Providence,lil39.xml,181,2,1,MOT,886,2869,CHI
0,1,3,212,3.068052935,213,1,make,"('MOT', 'CHI')",Providence,lil39.xml,216,3,0,CHI,3789,1064,MOT
1,5,0,175,3.00678211,180,5,big,"('CHI', 'MOT')",Providence,lil39.xml,181,1,1,MOT,886,2869,CHI
3,4,3,171,2.87356464,175,4,yeah,"('CHI', 'MOT')",Providence,lil39.xml,181,6,3,MOT,886,2869,CHI
2,3,6,205,2.756840365,208,3,are,"('MOT', 'CHI')",Providence,lil39.xml,216,8,2,CHI,3789,1064,MOT
0,1,5,210,2.722234836,211,1,gonna,"('MOT', 'CHI')",Providence,lil39.xml,216,5,0,CHI,3789,1064,MOT
0,3,1,177,2.719100037,180,3,want,"('CHI', 'MOT')",Providence,lil39.xml,181,1,0,MOT,886,2869,CHI
1,7,0,173,2.719100037,180,7,for,"('CHI', 'MOT')",Providence,lil39.xml,181,1,1,MOT,886,2869,CHI
0,2,2,177,2.713590381,179,2,put,"('CHI', 'MOT')",Providence,lil39.xml,181,2,0,MOT,886,2869,CHI
1,4,2,174,2.667228207,178,4,wanna,"('CHI', 'MOT')",Providence,lil39.xml,181,3,1,MOT,886,2869,CHI
1,8,0,172,2.601317002,180,8,see,"('CHI', 'MOT')",Providence,lil39.xml,181,1,1,MOT,886,2869,CHI
0,1,6,209,2.583997552,210,1,big,"('MOT', 'CHI')",Providence,lil39.xml,216,6,0,CHI,3789,1064,MOT
1,0,27,188,2.538973871,188,0,do,"('MOT', 'CHI')",Providence,lil39.xml,216,28,1,CHI,3789,1064,MOT
2,4,5,170,2.462433794,174,4,no,"('CHI', 'MOT')",Providence,lil39.xml,181,7,2,MOT,886,2869,CHI
0,1,7,208,2.461486376,209,1,at,"('MOT', 'CHI')",Providence,lil39.xml,216,7,0,CHI,3789,1064,MOT
1,2,9,204,2.447166322,206,2,go,"('MOT', 'CHI')",Providence,lil39.xml,216,10,1,CHI,3789,1064,MOT
2,2,15,197,2.358865929,199,2,did,"('MOT', 'CHI')",Providence,lil39.xml,216,17,2,CHI,3789,1064,MOT
1,5,3,172,2.297014048,177,5,there,"('CHI', 'MOT')",Providence,lil39.xml,181,4,1,MOT,886,2869,CHI
2,0,2,17,2.251291799,17,0,that,"('OPE', 'MOT')",Providence,lil39.xml,21,4,2,MOT,92,229,OPE
1,4,6,205,2.238342824,209,4,want,"('MOT', 'CHI')",Providence,lil39.xml,216,7,1,CHI,3789,1064,MOT
1,12,0,168,2.233592222,180,12,she,"('CHI', 'MOT')",Providence,lil39.xml,181,1,1,MOT,886,2869,CHI
4,4,16,192,2.197224577,196,4,like,"('MOT', 'CHI')",Providence,lil39.xml,216,20,4,CHI,3789,1064,MOT
0,2,6,208,2.178532444,210,2,wanna,"('MOT', 'CHI')",Providence,lil39.xml,216,6,0,CHI,3789,1064,MOT
1,13,0,167,2.159484249,180,13,we,"('CHI', 'MOT')",Providence,lil39.xml,181,1,1,MOT,886,2869,CHI
3,13,1,164,2.142863368,177,13,are,"('CHI', 'MOT')",Providence,lil39.xml,181,4,3,MOT,886,2869,CHI
1,0,0,10,2.079441542,10,0,a,"('CHI', 'OPE')",Providence,lil39.xml,11,1,1,OPE,78,52,CHI
0,2,7,207,2.056021267,209,2,up,"('MOT', 'CHI')",Providence,lil39.xml,216,7,0,CHI,3789,1064,MOT
0,2,7,207,2.056021267,209,2,he,"('MOT', 'CHI')",Providence,lil39.xml,216,7,0,CHI,3789,1064,MOT
0,1,12,203,1.995671659,204,1,little,"('MOT', 'CHI')",Providence,lil39.xml,216,12,0,CHI,3789,1064,MOT
0,4,3,174,1.974081026,178,4,look,"('CHI', 'MOT')",Providence,lil39.xml,181,3,0,MOT,886,2869,CHI
1,12,1,167,1.940400493,179,12,with,"('CHI', 'MOT')",Providence,lil39.xml,181,2,1,MOT,886,2869,CHI
0,6,2,173,1.866292521,179,6,at,"('CHI', 'MOT')",Providence,lil39.xml,181,2,0,MOT,886,2869,CHI
0,9,1,171,1.802809305,180,9,up,"('CHI', 'MOT')",Providence,lil39.xml,181,1,0,MOT,886,2869,CHI
2,0,1,8,1.791759469,8,0,it,"('CHI', 'OPE')",Providence,lil39.xml,11,3,2,OPE,78,52,CHI
3,16,2,160,1.788954418,176,16,have,"('CHI', 'MOT')",Providence,lil39.xml,181,5,3,MOT,886,2869,CHI
0,3,7,206,1.768339195,209,3,not,"('MOT', 'CHI')",Providence,lil39.xml,216,7,0,CHI,3789,1064,MOT
1,20,0,160,1.754019141,180,20,of,"('CHI', 'MOT')",Providence,lil39.xml,181,1,1,MOT,886,2869,CHI
1,0,1,9,1.704748092,9,0,my,"('CHI', 'OPE')",Providence,lil39.xml,11,2,1,OPE,78,52,CHI
1,0,4,16,1.637608789,16,0,yeah,"('OPE', 'MOT')",Providence,lil39.xml,21,5,1,MOT,92,229,OPE
2,6,13,195,1.632694775,201,6,one,"('MOT', 'CHI')",Providence,lil39.xml,216,15,2,CHI,3789,1064,MOT
1,3,18,194,1.555635206,197,3,was,"('MOT', 'CHI')",Providence,lil39.xml,216,19,1,CHI,3789,1064,MOT
0,1,19,196,1.555635206,197,1,of,"('MOT', 'CHI')",Providence,lil39.xml,216,19,0,CHI,3789,1064,MOT
0,12,1,168,1.540445041,180,12,little,"('CHI', 'MOT')",Providence,lil39.xml,181,1,0,MOT,886,2869,CHI
0,2,14,200,1.446918983,202,2,see,"('MOT', 'CHI')",Providence,lil39.xml,216,14,0,CHI,3789,1064,MOT
3,23,2,153,1.444113932,176,23,that,"('CHI', 'MOT')",Providence,lil39.xml,181,5,3,MOT,886,2869,CHI
0,5,5,171,1.444113932,176,5,my,"('CHI', 'MOT')",Providence,lil39.xml,181,5,0,MOT,886,2869,CHI
9,17,11,144,1.414921083,161,17,it,"('CHI', 'MOT')",Providence,lil39.xml,181,20,9,MOT,886,2869,CHI
2,3,30,181,1.411704077,184,3,that,"('MOT', 'CHI')",Providence,lil39.xml,216,32,2,CHI,3789,1064,MOT
1,1,0,9,1.386294361,10,1,you,"('CHI', 'OPE')",Providence,lil39.xml,11,1,1,OPE,78,52,CHI
2,2,1,16,1.386294361,18,2,one,"('OPE', 'MOT')",Providence,lil39.xml,21,3,2,MOT,92,229,OPE
0,3,11,202,1.381475075,205,3,get,"('MOT', 'CHI')",Providence,lil39.xml,216,11,0,CHI,3789,1064,MOT
3,7,20,186,1.360976553,193,7,is,"('MOT', 'CHI')",Providence,lil39.xml,216,23,3,CHI,3789,1064,MOT
4,17,9,186,1.334025933,203,17,yeah,"('MOT', 'CHI')",Providence,lil39.xml,216,13,4,CHI,3789,1064,MOT
2,12,9,193,1.301432367,205,12,this,"('MOT', 'CHI')",Providence,lil39.xml,216,11,2,CHI,3789,1064,MOT
1,3,0,17,1.299282984,20,3,you,"('OPE', 'MOT')",Providence,lil39.xml,21,1,1,MOT,92,229,OPE
0,1,1,19,1.299282984,20,1,have,"('OPE', 'MOT')",Providence,lil39.xml,21,1,0,MOT,92,229,OPE
0,1,1,19,1.299282984,20,1,look,"('OPE', 'MOT')",Providence,lil39.xml,21,1,0,MOT,92,229,OPE
0,1,1,19,1.299282984,20,1,a,"('OPE', 'MOT')",Providence,lil39.xml,21,1,0,MOT,92,229,OPE
1,3,24,188,1.273706142,191,3,oh,"('MOT', 'CHI')",Providence,lil39.xml,216,25,1,CHI,3789,1064,MOT
2,14,6,159,1.252762968,173,14,like,"('CHI', 'MOT')",Providence,lil39.xml,181,8,2,MOT,886,2869,CHI
1,1,3,18,1.252762968,19,1,that,"('MOT', 'OPE')",Providence,lil39.xml,23,4,1,OPE,321,66,MOT
0,2,18,196,1.203972804,198,2,on,"('MOT', 'CHI')",Providence,lil39.xml,216,18,0,CHI,3789,1064,MOT
1,4,21,190,1.183770097,194,4,can,"('MOT', 'CHI')",Providence,lil39.xml,216,22,1,CHI,3789,1064,MOT
1,16,5,194,1.137078569,210,16,no,"('MOT', 'CHI')",Providence,lil39.xml,216,6,1,CHI,3789,1064,MOT
5,7,37,167,1.098612289,174,7,it,"('MOT', 'CHI')",Providence,lil39.xml,216,42,5,CHI,3789,1064,MOT
0,5,10,201,1.060871961,206,5,there,"('MOT', 'CHI')",Providence,lil39.xml,216,10,0,CHI,3789,1064,MOT
0,20,1,160,1.060871961,180,20,do,"('CHI', 'MOT')",Providence,lil39.xml,181,1,0,MOT,886,2869,CHI
0,1,2,20,1.056052674,21,1,she,"('MOT', 'OPE')",Providence,lil39.xml,23,2,0,OPE,321,66,MOT
0,1,2,20,1.056052674,21,1,is,"('MOT', 'OPE')",Providence,lil39.xml,23,2,0,OPE,321,66,MOT
1,17,4,159,1.038648824,176,17,on,"('CHI', 'MOT')",Providence,lil39.xml,181,5,1,MOT,886,2869,CHI
6,35,4,136,1.030776155,171,35,the,"('CHI', 'MOT')",Providence,lil39.xml,181,10,6,MOT,886,2869,CHI
3,16,10,152,0.980829253,168,16,is,"('CHI', 'MOT')",Providence,lil39.xml,181,13,3,MOT,886,2869,CHI
0,1,1,13,0.980829253,14,1,can,"('OPE', 'CHI')",Providence,lil39.xml,15,1,0,CHI,45,76,OPE
0,1,2,18,0.965080896,19,1,is,"('OPE', 'MOT')",Providence,lil39.xml,21,2,0,MOT,92,229,OPE
0,4,14,198,0.936093359,202,4,they,"('MOT', 'CHI')",Providence,lil39.xml,216,14,0,CHI,3789,1064,MOT
0,2,1,18,0.893817876,20,2,like,"('OPE', 'MOT')",Providence,lil39.xml,21,1,0,MOT,92,229,OPE
0,2,1,18,0.893817876,20,2,was,"('OPE', 'MOT')",Providence,lil39.xml,21,1,0,MOT,92,229,OPE
0,2,1,18,0.893817876,20,2,this,"('OPE', 'MOT')",Providence,lil39.xml,21,1,0,MOT,92,229,OPE
0,2,1,18,0.893817876,20,2,on,"('OPE', 'MOT')",Providence,lil39.xml,21,1,0,MOT,92,229,OPE
1,32,2,146,0.780158558,178,32,in,"('CHI', 'MOT')",Providence,lil39.xml,181,3,1,MOT,886,2869,CHI
0,5,14,197,0.753771802,202,5,with,"('MOT', 'CHI')",Providence,lil39.xml,216,14,0,CHI,3789,1064,MOT
1,2,3,15,0.747214402,17,2,oh,"('OPE', 'MOT')",Providence,lil39.xml,21,4,1,MOT,92,229,OPE
7,32,11,131,0.693147181,163,32,a,"('CHI', 'MOT')",Providence,lil39.xml,181,18,7,MOT,886,2869,CHI
0,12,5,164,0.670924044,176,12,oh,"('CHI', 'MOT')",Providence,lil39.xml,181,5,0,MOT,886,2869,CHI
0,2,2,19,0.650587566,21,2,yeah,"('MOT', 'OPE')",Providence,lil39.xml,23,2,0,OPE,321,66,MOT
0,7,12,197,0.609377297,204,7,my,"('MOT', 'CHI')",Providence,lil39.xml,216,12,0,CHI,3789,1064,MOT
11,12,63,130,0.559037252,142,12,the,"('MOT', 'CHI')",Providence,lil39.xml,216,74,11,CHI,3789,1064,MOT
3,11,32,170,0.499955952,181,11,a,"('MOT', 'CHI')",Providence,lil39.xml,216,35,3,CHI,3789,1064,MOT
4,52,5,120,0.400306025,172,52,you,"('CHI', 'MOT')",Providence,lil39.xml,181,9,4,MOT,886,2869,CHI
12,55,12,102,0.350405331,157,55,and,"('CHI', 'MOT')",Providence,lil39.xml,181,24,12,MOT,886,2869,CHI
3,10,42,161,0.291543081,171,10,to,"('MOT', 'CHI')",Providence,lil39.xml,216,45,3,CHI,3789,1064,MOT
0,3,1,11,0.287682072,14,3,a,"('OPE', 'CHI')",Providence,lil39.xml,15,1,0,CHI,45,76,OPE
9,18,54,135,0.227183961,153,18,and,"('MOT', 'CHI')",Providence,lil39.xml,216,63,9,CHI,3789,1064,MOT
0,5,1,15,0.200670695,20,5,are,"('OPE', 'MOT')",Providence,lil39.xml,21,1,0,MOT,92,229,OPE
0,5,1,15,0.200670695,20,5,the,"('OPE', 'MOT')",Providence,lil39.xml,21,1,0,MOT,92,229,OPE
1,23,9,148,0.183478295,171,23,what,"('CHI', 'MOT')",Providence,lil39.xml,181,10,1,MOT,886,2869,CHI
0,1,6,16,0.171850257,17,1,a,"('MOT', 'OPE')",Providence,lil39.xml,23,6,0,OPE,321,66,MOT
0,26,4,151,0.099789471,177,26,to,"('CHI', 'MOT')",Providence,lil39.xml,181,4,0,MOT,886,2869,CHI
3,6,70,137,0.099629841,143,6,you,"('MOT', 'CHI')",Providence,lil39.xml,216,73,3,CHI,3789,1064,MOT
0,3,3,17,0.09531018,20,3,oh,"('MOT', 'OPE')",Providence,lil39.xml,23,3,0,OPE,321,66,MOT
0,32,3,146,0.087011377,178,32,one,"('CHI', 'MOT')",Providence,lil39.xml,181,3,0,MOT,886,2869,CHI
0,5,34,177,-0.16034265,182,5,in,"('MOT', 'CHI')",Providence,lil39.xml,216,34,0,CHI,3789,1064,MOT
2,39,13,127,-0.29951653,166,39,this,"('CHI', 'MOT')",Providence,lil39.xml,181,15,2,MOT,886,2869,CHI
0,2,4,9,-0.3254224,11,2,yeah,"('OPE', 'CHI')",Providence,lil39.xml,15,4,0,CHI,45,76,OPE
1,0,5,218,4.007333185,218,0,for,"('MOT', 'CHI')",Providence,lil40.xml,224,6,1,CHI,3134,1125,MOT
3,0,13,208,3.843030134,208,0,he,"('MOT', 'CHI')",Providence,lil40.xml,224,16,3,CHI,3134,1125,MOT
1,0,1,59,3.417726684,59,0,was,"('CHI', 'MOT')",Providence,lil40.xml,61,2,1,MOT,347,582,CHI
0,1,2,221,3.33220451,222,1,have,"('MOT', 'CHI')",Providence,lil40.xml,224,2,0,CHI,3134,1125,MOT
1,0,2,58,3.17805383,58,0,one,"('CHI', 'MOT')",Providence,lil40.xml,61,3,1,MOT,347,582,CHI
1,2,4,217,3.046787444,219,2,want,"('MOT', 'CHI')",Providence,lil40.xml,224,5,1,CHI,3134,1125,MOT
1,1,10,212,2.805688671,213,1,see,"('MOT', 'CHI')",Providence,lil40.xml,224,11,1,CHI,3134,1125,MOT
0,1,5,218,2.759105372,219,1,all,"('MOT', 'CHI')",Providence,lil40.xml,224,5,0,CHI,3134,1125,MOT
0,1,5,218,2.759105372,219,1,wanna,"('MOT', 'CHI')",Providence,lil40.xml,224,5,0,CHI,3134,1125,MOT
1,2,7,214,2.676444862,216,2,they,"('MOT', 'CHI')",Providence,lil40.xml,224,8,1,CHI,3134,1125,MOT
1,0,5,55,2.656756907,55,0,no,"('CHI', 'MOT')",Providence,lil40.xml,61,6,1,MOT,347,582,CHI
1,2,0,58,2.623056988,60,2,with,"('CHI', 'MOT')",Providence,lil40.xml,61,1,1,MOT,347,582,CHI
1,2,0,58,2.623056988,60,2,wanna,"('CHI', 'MOT')",Providence,lil40.xml,61,1,1,MOT,347,582,CHI
3,4,11,206,2.360854001,210,4,was,"('MOT', 'CHI')",Providence,lil40.xml,224,14,3,CHI,3134,1125,MOT
0,2,5,217,2.353640264,219,2,get,"('MOT', 'CHI')",Providence,lil40.xml,224,5,0,CHI,3134,1125,MOT
1,2,11,210,2.321453577,212,2,at,"('MOT', 'CHI')",Providence,lil40.xml,224,12,1,CHI,3134,1125,MOT
2,4,9,209,2.294863047,213,4,look,"('MOT', 'CHI')",Providence,lil40.xml,224,11,2,CHI,3134,1125,MOT
1,1,3,56,2.285777975,57,1,my,"('CHI', 'MOT')",Providence,lil40.xml,61,4,1,MOT,347,582,CHI
1,5,5,213,2.215573716,218,5,this,"('MOT', 'CHI')",Providence,lil40.xml,224,6,1,CHI,3134,1125,MOT
1,2,13,208,2.178532444,210,2,do,"('MOT', 'CHI')",Providence,lil40.xml,224,14,1,CHI,3134,1125,MOT
1,0,1,15,2.140066163,15,0,this,"('CHI', 'OPE')",Providence,lil40.xml,17,2,1,OPE,80,193,CHI
0,1,11,212,2.11254149,213,1,go,"('MOT', 'CHI')",Providence,lil40.xml,224,11,0,CHI,3134,1125,MOT
0,1,2,58,2.031432322,59,1,where,"('CHI', 'MOT')",Providence,lil40.xml,61,2,0,MOT,347,582,CHI
0,1,2,58,2.031432322,59,1,not,"('CHI', 'MOT')",Providence,lil40.xml,61,2,0,MOT,347,582,CHI
1,5,7,211,1.983297681,216,5,she,"('MOT', 'CHI')",Providence,lil40.xml,224,8,1,CHI,3134,1125,MOT
1,5,7,211,1.983297681,216,5,one,"('MOT', 'CHI')",Providence,lil40.xml,224,8,1,CHI,3134,1125,MOT
0,2,8,214,1.983297681,216,2,not,"('MOT', 'CHI')",Providence,lil40.xml,224,8,0,CHI,3134,1125,MOT
0,2,1,58,1.929909808,60,2,some,"('CHI', 'MOT')",Providence,lil40.xml,61,1,0,MOT,347,582,CHI
1,4,11,208,1.810627954,212,4,up,"('MOT', 'CHI')",Providence,lil40.xml,224,12,1,CHI,3134,1125,MOT
1,7,8,208,1.59570772,215,7,where,"('MOT', 'CHI')",Providence,lil40.xml,224,9,1,CHI,3134,1125,MOT
1,3,3,54,1.592630794,57,3,up,"('CHI', 'MOT')",Providence,lil40.xml,61,4,1,MOT,347,582,CHI
1,4,15,204,1.540445041,208,4,on,"('MOT', 'CHI')",Providence,lil40.xml,224,16,1,CHI,3134,1125,MOT
0,4,1,56,1.419084184,60,4,in,"('CHI', 'MOT')",Providence,lil40.xml,61,1,0,MOT,347,582,CHI
2,14,7,201,1.372564168,215,14,no,"('MOT', 'CHI')",Providence,lil40.xml,224,9,2,CHI,3134,1125,MOT
0,3,2,56,1.338285142,59,3,get,"('CHI', 'MOT')",Providence,lil40.xml,61,2,0,MOT,347,582,CHI
0,3,2,56,1.338285142,59,3,look,"('CHI', 'MOT')",Providence,lil40.xml,61,2,0,MOT,347,582,CHI
0,5,8,211,1.290150501,216,5,like,"('MOT', 'CHI')",Providence,lil40.xml,224,8,0,CHI,3134,1125,MOT
4,10,20,190,1.261713799,200,10,are,"('MOT', 'CHI')",Providence,lil40.xml,224,24,4,CHI,3134,1125,MOT
2,7,18,197,1.256004462,204,7,what,"('MOT', 'CHI')",Providence,lil40.xml,224,20,2,CHI,3134,1125,MOT
4,8,3,46,1.240340448,54,8,it,"('CHI', 'MOT')",Providence,lil40.xml,61,7,4,MOT,347,582,CHI
0,2,4,55,1.187165686,57,2,yeah,"('CHI', 'MOT')",Providence,lil40.xml,61,4,0,MOT,347,582,CHI
1,1,2,13,1.16315081,14,1,is,"('CHI', 'OPE')",Providence,lil40.xml,17,3,1,OPE,80,193,CHI
2,7,3,49,1.133703608,56,7,the,"('CHI', 'MOT')",Providence,lil40.xml,61,5,2,MOT,347,582,CHI
0,4,2,55,1.115141591,59,4,what,"('CHI', 'MOT')",Providence,lil40.xml,61,2,0,MOT,347,582,CHI
0,3,3,55,1.098612289,58,3,have,"('CHI', 'MOT')",Providence,lil40.xml,61,3,0,MOT,347,582,CHI
1,3,0,13,1.098612289,16,3,it,"('CHI', 'OPE')",Providence,lil40.xml,17,1,1,OPE,80,193,CHI
0,1,1,15,1.098612289,16,1,some,"('CHI', 'OPE')",Providence,lil40.xml,17,1,0,OPE,80,193,CHI
0,1,1,15,1.098612289,16,1,can,"('CHI', 'OPE')",Providence,lil40.xml,17,1,0,OPE,80,193,CHI
19,16,44,145,1.08188186,161,16,the,"('MOT', 'CHI')",Providence,lil40.xml,224,63,19,CHI,3134,1125,MOT
4,7,6,44,1.015381635,51,7,a,"('CHI', 'MOT')",Providence,lil40.xml,61,10,4,MOT,347,582,CHI
1,6,19,198,0.984070747,204,6,that,"('MOT', 'CHI')",Providence,lil40.xml,224,20,1,CHI,3134,1125,MOT
1,0,0,2,0.980829253,2,0,look,"('CHI', 'VIS')",Providence,lil40.xml,3,1,1,VIS,18,31,CHI
6,15,25,178,0.949813424,193,15,to,"('MOT', 'CHI')",Providence,lil40.xml,224,31,6,CHI,3134,1125,MOT
0,6,10,208,0.944461609,214,6,my,"('MOT', 'CHI')",Providence,lil40.xml,224,10,0,CHI,3134,1125,MOT
6,12,36,170,0.811706915,182,12,a,"('MOT', 'CHI')",Providence,lil40.xml,224,42,6,CHI,3134,1125,MOT
1,4,7,49,0.78845736,53,4,and,"('CHI', 'MOT')",Providence,lil40.xml,61,8,1,MOT,347,582,CHI
0,4,17,203,0.78845736,207,4,there,"('MOT', 'CHI')",Providence,lil40.xml,224,17,0,CHI,3134,1125,MOT
0,1,1,10,0.773189888,11,1,was,"('MOT', 'OPE')",Providence,lil40.xml,12,1,0,OPE,127,45,MOT
0,1,1,10,0.773189888,11,1,they,"('MOT', 'OPE')",Providence,lil40.xml,12,1,0,OPE,127,45,MOT
0,1,1,10,0.773189888,11,1,that,"('MOT', 'OPE')",Providence,lil40.xml,12,1,0,OPE,127,45,MOT
0,2,7,52,0.729514825,54,2,can,"('CHI', 'MOT')",Providence,lil40.xml,61,7,0,MOT,347,582,CHI
1,6,5,49,0.710846758,55,6,is,"('CHI', 'MOT')",Providence,lil40.xml,61,6,1,MOT,347,582,CHI
1,0,0,1,0.693147181,1,0,the,"('VIS', 'CHI')",Providence,lil40.xml,2,1,1,CHI,25,46,VIS
7,22,26,169,0.651289453,191,22,it,"('MOT', 'CHI')",Providence,lil40.xml,224,33,7,CHI,3134,1125,MOT
1,4,1,11,0.530628251,15,4,the,"('CHI', 'OPE')",Providence,lil40.xml,17,2,1,OPE,80,193,CHI
3,13,28,180,0.523729029,193,13,is,"('MOT', 'CHI')",Providence,lil40.xml,224,31,3,CHI,3134,1125,MOT
3,19,2,37,0.505094949,56,19,you,"('CHI', 'MOT')",Providence,lil40.xml,61,5,3,MOT,347,582,CHI
2,23,13,186,0.439203248,209,23,can,"('MOT', 'CHI')",Providence,lil40.xml,224,15,2,CHI,3134,1125,MOT
0,3,1,13,0.405465108,16,3,oh,"('CHI', 'OPE')",Providence,lil40.xml,17,1,0,OPE,80,193,CHI
0,1,2,9,0.405465108,10,1,yeah,"('MOT', 'OPE')",Providence,lil40.xml,12,2,0,OPE,127,45,MOT
0,1,2,9,0.405465108,10,1,see,"('MOT', 'OPE')",Providence,lil40.xml,12,2,0,OPE,127,45,MOT
5,24,26,169,0.349375641,193,24,and,"('MOT', 'CHI')",Providence,lil40.xml,224,31,5,CHI,3134,1125,MOT
2,22,16,184,0.304923879,206,22,yeah,"('MOT', 'CHI')",Providence,lil40.xml,224,18,2,CHI,3134,1125,MOT
0,8,3,50,0.287682072,58,8,to,"('CHI', 'MOT')",Providence,lil40.xml,61,3,0,MOT,347,582,CHI
0,3,35,186,0.255061154,189,3,oh,"('MOT', 'CHI')",Providence,lil40.xml,224,35,0,CHI,3134,1125,MOT
0,6,21,197,0.241605614,203,6,in,"('MOT', 'CHI')",Providence,lil40.xml,224,21,0,CHI,3134,1125,MOT
0,1,3,8,0.09531018,9,1,it,"('MOT', 'OPE')",Providence,lil40.xml,12,3,0,OPE,127,45,MOT
0,1,3,8,0.09531018,9,1,the,"('MOT', 'OPE')",Providence,lil40.xml,12,3,0,OPE,127,45,MOT
0,3,2,12,0.060624622,15,3,yeah,"('CHI', 'OPE')",Providence,lil40.xml,17,2,0,OPE,80,193,CHI
0,3,2,12,0.060624622,15,3,a,"('CHI', 'OPE')",Providence,lil40.xml,17,2,0,OPE,80,193,CHI
4,15,52,153,-0.087795383,168,15,you,"('MOT', 'CHI')",Providence,lil40.xml,224,56,4,CHI,3134,1125,MOT
0,1,4,7,-0.182321557,8,1,oh,"('MOT', 'OPE')",Providence,lil40.xml,12,4,0,OPE,127,45,MOT
1,0,8,406,4.306519082,406,0,make,"('MOT', 'CHI')",Providence,lil42.xml,415,9,1,CHI,4068,2032,MOT
2,1,5,407,4.22439769,408,1,she,"('MOT', 'CHI')",Providence,lil42.xml,415,7,2,CHI,4068,2032,MOT
2,1,7,405,4.01883701,406,1,look,"('MOT', 'CHI')",Providence,lil42.xml,415,9,2,CHI,4068,2032,MOT
1,0,12,402,3.986511857,402,0,all,"('MOT', 'CHI')",Providence,lil42.xml,415,13,1,CHI,4068,2032,MOT
0,1,2,412,3.948836979,413,1,put,"('MOT', 'CHI')",Providence,lil42.xml,415,2,0,CHI,4068,2032,MOT
0,1,5,409,3.38196602,410,1,wanna,"('MOT', 'CHI')",Providence,lil42.xml,415,5,0,CHI,4068,2032,MOT
4,1,30,380,3.280806783,381,1,we,"('MOT', 'CHI')",Providence,lil42.xml,415,34,4,CHI,4068,2032,MOT
1,1,13,400,3.22634784,401,1,with,"('MOT', 'CHI')",Providence,lil42.xml,415,14,1,CHI,4068,2032,MOT
2,2,12,399,3.22634784,401,2,there,"('MOT', 'CHI')",Providence,lil42.xml,415,14,2,CHI,4068,2032,MOT
2,4,9,400,2.930578178,404,4,some,"('MOT', 'CHI')",Providence,lil42.xml,415,11,2,CHI,4068,2032,MOT
0,1,10,404,2.830759355,405,1,not,"('MOT', 'CHI')",Providence,lil42.xml,415,10,0,CHI,4068,2032,MOT
2,3,14,396,2.815907597,399,3,at,"('MOT', 'CHI')",Providence,lil42.xml,415,16,2,CHI,4068,2032,MOT
3,6,9,397,2.80521395,403,6,one,"('MOT', 'CHI')",Providence,lil42.xml,415,12,3,CHI,4068,2032,MOT
1,2,14,398,2.757773636,400,2,they,"('MOT', 'CHI')",Providence,lil42.xml,415,15,1,CHI,4068,2032,MOT
0,2,7,406,2.720320294,408,2,but,"('MOT', 'CHI')",Providence,lil42.xml,415,7,0,CHI,4068,2032,MOT
1,3,11,400,2.671682557,403,3,up,"('MOT', 'CHI')",Providence,lil42.xml,415,12,1,CHI,4068,2032,MOT
2,6,9,398,2.594105942,404,6,get,"('MOT', 'CHI')",Providence,lil42.xml,415,11,2,CHI,4068,2032,MOT
1,4,10,400,2.52511307,404,4,for,"('MOT', 'CHI')",Providence,lil42.xml,415,11,1,CHI,4068,2032,MOT
0,4,5,406,2.465675288,410,4,where,"('MOT', 'CHI')",Providence,lil42.xml,415,5,0,CHI,4068,2032,MOT
1,7,6,401,2.432638221,408,7,gonna,"('MOT', 'CHI')",Providence,lil42.xml,415,7,1,CHI,4068,2032,MOT
4,5,25,381,2.344696578,386,5,that,"('MOT', 'CHI')",Providence,lil42.xml,415,29,4,CHI,4068,2032,MOT
0,4,6,405,2.32971376,409,4,big,"('MOT', 'CHI')",Providence,lil42.xml,415,6,0,CHI,4068,2032,MOT
1,2,23,389,2.310247966,391,2,want,"('MOT', 'CHI')",Providence,lil42.xml,415,24,1,CHI,4068,2032,MOT
1,5,11,398,2.266217449,403,5,go,"('MOT', 'CHI')",Providence,lil42.xml,415,12,1,CHI,4068,2032,MOT
1,3,19,392,2.199746647,395,3,see,"('MOT', 'CHI')",Providence,lil42.xml,415,20,1,CHI,4068,2032,MOT
2,2,38,373,2.194575569,375,2,oh,"('MOT', 'CHI')",Providence,lil42.xml,415,40,2,CHI,4068,2032,MOT
1,2,26,386,2.193385801,388,2,are,"('MOT', 'CHI')",Providence,lil42.xml,415,27,1,CHI,4068,2032,MOT
0,2,15,398,2.064626456,400,2,like,"('MOT', 'CHI')",Providence,lil42.xml,415,15,0,CHI,4068,2032,MOT
1,6,15,393,1.850826701,399,6,on,"('MOT', 'CHI')",Providence,lil42.xml,415,16,1,CHI,4068,2032,MOT
0,1,29,385,1.833870955,386,1,do,"('MOT', 'CHI')",Providence,lil42.xml,415,29,0,CHI,4068,2032,MOT
1,5,22,387,1.658862796,392,5,of,"('MOT', 'CHI')",Providence,lil42.xml,415,23,1,CHI,4068,2032,MOT
1,5,30,379,1.360717519,384,5,in,"('MOT', 'CHI')",Providence,lil42.xml,415,31,1,CHI,4068,2032,MOT
0,6,13,396,1.347454528,402,6,was,"('MOT', 'CHI')",Providence,lil42.xml,415,13,0,CHI,4068,2032,MOT
0,8,10,397,1.326681958,405,8,this,"('MOT', 'CHI')",Providence,lil42.xml,415,10,0,CHI,4068,2032,MOT
0,4,20,391,1.283455915,395,4,little,"('MOT', 'CHI')",Providence,lil42.xml,415,20,0,CHI,4068,2032,MOT
0,6,17,392,1.101115419,398,6,he,"('MOT', 'CHI')",Providence,lil42.xml,415,17,0,CHI,4068,2032,MOT
0,8,13,394,1.0961401,402,8,have,"('MOT', 'CHI')",Providence,lil42.xml,415,13,0,CHI,4068,2032,MOT
0,11,11,393,0.956497152,404,11,can,"('MOT', 'CHI')",Providence,lil42.xml,415,11,0,CHI,4068,2032,MOT
5,44,14,352,0.927026547,396,44,no,"('MOT', 'CHI')",Providence,lil42.xml,415,19,5,CHI,4068,2032,MOT
9,20,58,328,0.881889305,348,20,a,"('MOT', 'CHI')",Providence,lil42.xml,415,67,9,CHI,4068,2032,MOT
6,32,27,350,0.844697079,382,32,it,"('MOT', 'CHI')",Providence,lil42.xml,415,33,6,CHI,4068,2032,MOT
7,9,103,296,0.785205325,305,9,you,"('MOT', 'CHI')",Providence,lil42.xml,415,110,7,CHI,4068,2032,MOT
13,59,40,303,0.43453345,362,59,and,"('MOT', 'CHI')",Providence,lil42.xml,415,53,13,CHI,4068,2032,MOT
2,13,50,350,0.370468266,363,13,to,"('MOT', 'CHI')",Providence,lil42.xml,415,52,2,CHI,4068,2032,MOT
0,3,60,352,0.364307036,355,3,what,"('MOT', 'CHI')",Providence,lil42.xml,415,60,0,CHI,4068,2032,MOT
6,20,72,317,0.345361184,337,20,the,"('MOT', 'CHI')",Providence,lil42.xml,415,78,6,CHI,4068,2032,MOT
0,17,14,384,0.335976082,401,17,my,"('MOT', 'CHI')",Providence,lil42.xml,415,14,0,CHI,4068,2032,MOT
1,24,33,357,-0.161212594,381,24,is,"('MOT', 'CHI')",Providence,lil42.xml,415,34,1,CHI,4068,2032,MOT
1,61,17,336,-0.440758061,397,61,yeah,"('MOT', 'CHI')",Providence,lil42.xml,415,18,1,CHI,4068,2032,MOT
1,0,1,43,3.113515309,43,0,little,"('FAT', 'CHI')",Providence,lil43.xml,45,2,1,CHI,362,244,FAT
0,1,1,126,3.068052935,127,1,not,"('CHI', 'MOT')",Providence,lil43.xml,128,1,0,MOT,647,1221,CHI
0,1,2,125,2.772588722,126,1,put,"('CHI', 'MOT')",Providence,lil43.xml,128,2,0,MOT,647,1221,CHI
2,2,4,120,2.740840024,122,2,go,"('CHI', 'MOT')",Providence,lil43.xml,128,6,2,MOT,647,1221,CHI
0,2,1,125,2.662587827,127,2,they,"('CHI', 'MOT')",Providence,lil43.xml,128,1,0,MOT,647,1221,CHI
1,5,0,122,2.662587827,127,5,what,"('CHI', 'MOT')",Providence,lil43.xml,128,1,1,MOT,647,1221,CHI
0,1,3,124,2.541601993,125,1,want,"('CHI', 'MOT')",Providence,lil43.xml,128,3,0,MOT,647,1221,CHI
1,3,0,71,2.538973871,74,3,do,"('CHI', 'FAT')",Providence,lil43.xml,75,1,1,FAT,402,548,CHI
0,1,1,73,2.538973871,74,1,they,"('CHI', 'FAT')",Providence,lil43.xml,75,1,0,FAT,402,548,CHI
0,1,1,71,2.512305624,72,1,for,"('MOT', 'CHI')",Providence,lil43.xml,73,1,0,CHI,850,344,MOT
1,2,4,121,2.47693848,123,2,he,"('CHI', 'MOT')",Providence,lil43.xml,128,5,1,MOT,647,1221,CHI
0,3,1,124,2.374905755,127,3,my,"('CHI', 'MOT')",Providence,lil43.xml,128,1,0,MOT,647,1221,CHI
0,3,1,124,2.374905755,127,3,do,"('CHI', 'MOT')",Providence,lil43.xml,128,1,0,MOT,647,1221,CHI
1,7,0,120,2.374905755,127,7,have,"('CHI', 'MOT')",Providence,lil43.xml,128,1,1,MOT,647,1221,CHI
0,2,2,124,2.367123614,126,2,get,"('CHI', 'MOT')",Providence,lil43.xml,128,2,0,MOT,647,1221,CHI
1,0,5,39,2.327277706,39,0,do,"('FAT', 'CHI')",Providence,lil43.xml,45,6,1,CHI,362,244,FAT
1,1,9,117,2.302585093,118,1,no,"('CHI', 'MOT')",Providence,lil43.xml,128,10,1,MOT,647,1221,CHI
0,1,2,72,2.238046572,73,1,look,"('CHI', 'FAT')",Providence,lil43.xml,75,2,0,FAT,402,548,CHI
0,1,2,72,2.238046572,73,1,no,"('CHI', 'FAT')",Providence,lil43.xml,75,2,0,FAT,402,548,CHI
0,1,2,72,2.238046572,73,1,put,"('CHI', 'FAT')",Providence,lil43.xml,75,2,0,FAT,402,548,CHI
0,1,2,70,2.211017899,71,1,gonna,"('MOT', 'CHI')",Providence,lil43.xml,73,2,0,CHI,850,344,MOT
0,1,2,70,2.211017899,71,1,was,"('MOT', 'CHI')",Providence,lil43.xml,73,2,0,CHI,850,344,MOT
0,1,2,70,2.211017899,71,1,see,"('MOT', 'CHI')",Providence,lil43.xml,73,2,0,CHI,850,344,MOT
0,1,2,70,2.211017899,71,1,one,"('MOT', 'CHI')",Providence,lil43.xml,73,2,0,CHI,850,344,MOT
2,3,2,68,2.211017899,71,3,there,"('CHI', 'FAT')",Providence,lil43.xml,75,4,2,FAT,402,548,CHI
0,4,1,123,2.151762203,127,4,like,"('CHI', 'MOT')",Providence,lil43.xml,128,1,0,MOT,647,1221,CHI
1,5,2,120,2.136136885,125,5,look,"('CHI', 'MOT')",Providence,lil43.xml,128,3,1,MOT,647,1221,CHI
0,2,1,72,2.133508763,74,2,gonna,"('CHI', 'FAT')",Providence,lil43.xml,75,1,0,FAT,402,548,CHI
0,2,1,72,2.133508763,74,2,go,"('CHI', 'FAT')",Providence,lil43.xml,75,1,0,FAT,402,548,CHI
1,5,0,69,2.133508763,74,5,see,"('CHI', 'FAT')",Providence,lil43.xml,75,1,1,FAT,402,548,CHI
2,0,9,34,2.11718187,34,0,you,"('FAT', 'CHI')",Providence,lil43.xml,45,11,2,CHI,362,244,FAT
1,7,1,119,2.079441542,126,7,with,"('CHI', 'MOT')",Providence,lil43.xml,128,2,1,MOT,647,1221,CHI
1,2,3,67,2.0654553,69,2,oh,"('MOT', 'CHI')",Providence,lil43.xml,73,4,1,CHI,850,344,MOT
1,1,6,67,2.051270665,68,1,for,"('CHI', 'FAT')",Providence,lil43.xml,75,7,1,FAT,402,548,CHI
2,1,4,38,2.039595633,39,1,that,"('FAT', 'CHI')",Providence,lil43.xml,45,6,2,CHI,362,244,FAT
0,1,1,43,2.036881927,44,1,with,"('FAT', 'CHI')",Providence,lil43.xml,45,1,0,CHI,362,244,FAT
0,1,1,43,2.036881927,44,1,of,"('FAT', 'CHI')",Providence,lil43.xml,45,1,0,CHI,362,244,FAT
0,1,1,43,2.036881927,44,1,not,"('FAT', 'CHI')",Providence,lil43.xml,45,1,0,CHI,362,244,FAT
1,1,6,65,2.022283128,66,1,go,"('MOT', 'CHI')",Providence,lil43.xml,73,7,1,CHI,850,344,MOT
2,2,5,64,2.022283128,66,2,that,"('MOT', 'CHI')",Providence,lil43.xml,73,7,2,CHI,850,344,MOT
1,2,1,41,2.014903021,43,2,want,"('FAT', 'CHI')",Providence,lil43.xml,45,2,1,CHI,362,244,FAT
0,1,3,71,2.00148,72,1,one,"('CHI', 'FAT')",Providence,lil43.xml,75,3,0,FAT,402,548,CHI
0,1,3,69,1.974081026,70,1,there,"('MOT', 'CHI')",Providence,lil43.xml,73,3,0,CHI,850,344,MOT
1,7,2,118,1.848454813,125,7,gonna,"('CHI', 'MOT')",Providence,lil43.xml,128,3,1,MOT,647,1221,CHI
0,3,1,71,1.84582669,74,3,where,"('CHI', 'FAT')",Providence,lil43.xml,75,1,0,FAT,402,548,CHI
0,3,1,71,1.84582669,74,3,not,"('CHI', 'FAT')",Providence,lil43.xml,75,1,0,FAT,402,548,CHI
1,13,0,114,1.815289967,127,13,there,"('CHI', 'MOT')",Providence,lil43.xml,128,1,1,MOT,647,1221,CHI
1,0,16,56,1.809151212,56,0,did,"('MOT', 'CHI')",Providence,lil43.xml,73,17,1,CHI,850,344,MOT
0,1,4,68,1.777773227,69,1,but,"('MOT', 'CHI')",Providence,lil43.xml,73,4,0,CHI,850,344,MOT
1,2,2,40,1.769286613,42,2,get,"('FAT', 'CHI')",Providence,lil43.xml,45,3,1,CHI,362,244,FAT
2,2,8,63,1.71978597,65,2,yeah,"('CHI', 'FAT')",Providence,lil43.xml,75,10,2,FAT,402,548,CHI
1,0,0,6,1.673976434,6,0,you,"('MOT', 'OPE')",Providence,lil43.xml,7,1,1,OPE,60,49,MOT
1,0,0,6,1.673976434,6,0,there,"('MOT', 'OPE')",Providence,lil43.xml,7,1,1,OPE,60,49,MOT
2,1,13,57,1.666596326,58,1,to,"('MOT', 'CHI')",Providence,lil43.xml,73,15,2,CHI,850,344,MOT
2,7,5,114,1.634130525,121,7,can,"('CHI', 'MOT')",Providence,lil43.xml,128,7,2,MOT,647,1221,CHI
2,14,1,111,1.625311262,125,14,that,"('CHI', 'MOT')",Providence,lil43.xml,128,3,2,MOT,647,1221,CHI
4,4,7,60,1.624705385,64,4,it,"('CHI', 'FAT')",Providence,lil43.xml,75,11,4,FAT,402,548,CHI
0,4,1,70,1.622683139,74,4,have,"('CHI', 'FAT')",Providence,lil43.xml,75,1,0,FAT,402,548,CHI
1,16,0,111,1.621133952,127,16,are,"('CHI', 'MOT')",Providence,lil43.xml,128,1,1,MOT,647,1221,CHI
0,1,5,67,1.609437912,68,1,in,"('MOT', 'CHI')",Providence,lil43.xml,73,5,0,CHI,850,344,MOT
0,1,5,67,1.609437912,68,1,put,"('MOT', 'CHI')",Providence,lil43.xml,73,5,0,CHI,850,344,MOT
0,6,2,120,1.519825754,126,6,we,"('CHI', 'MOT')",Providence,lil43.xml,128,2,0,MOT,647,1221,CHI
2,7,2,64,1.517870719,71,7,the,"('CHI', 'FAT')",Providence,lil43.xml,75,4,2,FAT,402,548,CHI
1,1,11,60,1.504077397,61,1,what,"('MOT', 'CHI')",Providence,lil43.xml,73,12,1,CHI,850,344,MOT
0,5,1,69,1.440361582,74,5,to,"('CHI', 'FAT')",Providence,lil43.xml,75,1,0,FAT,402,548,CHI
0,4,4,120,1.435084525,124,4,one,"('CHI', 'MOT')",Providence,lil43.xml,128,4,0,MOT,647,1221,CHI
0,2,4,69,1.400087683,71,2,can,"('CHI', 'FAT')",Providence,lil43.xml,75,4,0,FAT,402,548,CHI
1,2,4,38,1.386294361,40,2,is,"('FAT', 'CHI')",Providence,lil43.xml,45,5,1,CHI,362,244,FAT
1,0,1,6,1.386294361,6,0,gonna,"('ENV', 'FAT')",Providence,lil43.xml,8,2,1,FAT,143,74,ENV
0,1,13,114,1.360976553,115,1,yeah,"('CHI', 'MOT')",Providence,lil43.xml,128,13,0,MOT,647,1221,CHI
3,15,3,107,1.354545663,122,15,a,"('CHI', 'MOT')",Providence,lil43.xml,128,6,3,MOT,647,1221,CHI
0,1,7,65,1.329135947,66,1,want,"('MOT', 'CHI')",Providence,lil43.xml,73,7,0,CHI,850,344,MOT
0,6,1,68,1.286210903,74,6,we,"('CHI', 'FAT')",Providence,lil43.xml,75,1,0,FAT,402,548,CHI
0,3,3,67,1.280933845,70,3,can,"('MOT', 'CHI')",Providence,lil43.xml,73,3,0,CHI,850,344,MOT
0,8,2,118,1.268511325,126,8,see,"('CHI', 'MOT')",Providence,lil43.xml,128,2,0,MOT,647,1221,CHI
1,0,1,5,1.252762968,5,0,yeah,"('MOT', 'OPE')",Providence,lil43.xml,7,2,1,OPE,60,49,MOT
1,2,5,37,1.228665417,39,2,a,"('FAT', 'CHI')",Providence,lil43.xml,45,6,1,CHI,362,244,FAT
1,2,5,37,1.228665417,39,2,to,"('FAT', 'CHI')",Providence,lil43.xml,45,6,1,CHI,362,244,FAT
2,10,2,61,1.199416988,71,10,a,"('CHI', 'FAT')",Providence,lil43.xml,75,4,2,FAT,402,548,CHI
1,8,2,64,1.190549784,72,8,that,"('CHI', 'FAT')",Providence,lil43.xml,75,3,1,FAT,402,548,CHI
4,11,9,104,1.178654996,115,11,and,"('CHI', 'MOT')",Providence,lil43.xml,128,13,4,MOT,647,1221,CHI
0,9,2,117,1.16315081,126,9,on,"('CHI', 'MOT')",Providence,lil43.xml,128,2,0,MOT,647,1221,CHI
1,8,2,62,1.16315081,70,8,yeah,"('MOT', 'CHI')",Providence,lil43.xml,73,3,1,CHI,850,344,MOT
3,3,14,55,1.149905583,58,3,is,"('CHI', 'FAT')",Providence,lil43.xml,75,17,3,FAT,402,548,CHI
2,12,5,109,1.148622709,121,12,to,"('CHI', 'MOT')",Providence,lil43.xml,128,7,2,MOT,647,1221,CHI
0,5,2,68,1.139434283,73,5,are,"('CHI', 'FAT')",Providence,lil43.xml,75,2,0,FAT,402,548,CHI
2,1,0,5,1.098612289,6,1,the,"('ENV', 'FAT')",Providence,lil43.xml,8,2,2,FAT,143,74,ENV
1,3,8,61,1.098612289,64,3,is,"('MOT', 'CHI')",Providence,lil43.xml,73,9,1,CHI,850,344,MOT
0,2,3,40,1.076139433,42,2,the,"('FAT', 'CHI')",Providence,lil43.xml,45,3,0,CHI,362,244,FAT
0,4,3,66,1.057790294,70,4,this,"('MOT', 'CHI')",Providence,lil43.xml,73,3,0,CHI,850,344,MOT
0,8,3,117,1.037524597,125,8,for,"('CHI', 'MOT')",Providence,lil43.xml,128,3,0,MOT,647,1221,CHI
1,0,2,5,1.029619417,5,0,to,"('ENV', 'FAT')",Providence,lil43.xml,8,3,1,FAT,143,74,ENV
2,9,9,108,1.010201331,117,9,it,"('CHI', 'MOT')",Providence,lil43.xml,128,11,2,MOT,647,1221,CHI
2,1,0,4,0.965080896,5,1,was,"('MOT', 'OPE')",Providence,lil43.xml,7,2,2,OPE,60,49,MOT
3,13,3,56,0.930475367,69,13,you,"('CHI', 'FAT')",Providence,lil43.xml,75,6,3,FAT,402,548,CHI
0,16,1,111,0.927986772,127,16,in,"('CHI', 'MOT')",Providence,lil43.xml,128,1,0,MOT,647,1221,CHI
1,2,14,56,0.85566611,58,2,the,"('MOT', 'CHI')",Providence,lil43.xml,73,15,1,CHI,850,344,MOT
1,5,7,60,0.803495238,65,5,it,"('MOT', 'CHI')",Providence,lil43.xml,73,8,1,CHI,850,344,MOT
6,19,10,93,0.796004566,112,19,the,"('CHI', 'MOT')",Providence,lil43.xml,128,16,6,MOT,647,1221,CHI
0,3,6,64,0.768370602,67,3,we,"('MOT', 'CHI')",Providence,lil43.xml,73,6,0,CHI,850,344,MOT
0,5,8,115,0.709676483,120,5,this,"('CHI', 'MOT')",Providence,lil43.xml,128,8,0,MOT,647,1221,CHI
0,5,2,38,0.628608659,43,5,yeah,"('FAT', 'CHI')",Providence,lil43.xml,45,2,0,CHI,362,244,FAT
2,8,8,57,0.621173681,65,8,and,"('CHI', 'FAT')",Providence,lil43.xml,75,10,2,FAT,402,548,CHI
1,14,6,107,0.600056757,121,14,is,"('CHI', 'MOT')",Providence,lil43.xml,128,7,1,MOT,647,1221,CHI
0,2,10,61,0.590868331,63,2,a,"('MOT', 'CHI')",Providence,lil43.xml,73,10,0,CHI,850,344,MOT
2,11,2,30,0.583146285,41,11,and,"('FAT', 'CHI')",Providence,lil43.xml,45,4,2,CHI,362,244,FAT
0,23,1,104,0.583146285,127,23,oh,"('CHI', 'MOT')",Providence,lil43.xml,128,1,0,MOT,647,1221,CHI
0,4,7,64,0.441832752,68,4,this,"('CHI', 'FAT')",Providence,lil43.xml,75,7,0,FAT,402,548,CHI
0,7,4,64,0.41925843,71,7,on,"('CHI', 'FAT')",Providence,lil43.xml,75,4,0,FAT,402,548,CHI
0,1,1,6,0.405465108,7,1,put,"('CHI', 'ENV')",Providence,lil43.xml,8,1,0,ENV,40,154,CHI
0,1,1,6,0.405465108,7,1,in,"('ENV', 'FAT')",Providence,lil43.xml,8,1,0,FAT,143,74,ENV
0,1,1,6,0.405465108,7,1,have,"('ENV', 'FAT')",Providence,lil43.xml,8,1,0,FAT,143,74,ENV
0,1,1,6,0.405465108,7,1,we,"('ENV', 'FAT')",Providence,lil43.xml,8,1,0,FAT,143,74,ENV
0,1,1,6,0.405465108,7,1,and,"('FAT', 'ENV')",Providence,lil43.xml,8,1,0,ENV,37,76,FAT
0,3,5,37,0.405465108,40,3,this,"('FAT', 'CHI')",Providence,lil43.xml,45,5,0,CHI,362,244,FAT
0,4,4,37,0.360002734,41,4,it,"('FAT', 'CHI')",Providence,lil43.xml,45,4,0,CHI,362,244,FAT
2,8,11,52,0.320471895,60,8,and,"('MOT', 'CHI')",Providence,lil43.xml,73,13,2,CHI,850,344,MOT
1,2,1,4,0.287682072,6,2,you,"('ENV', 'FAT')",Providence,lil43.xml,8,2,1,FAT,143,74,ENV
0,2,1,5,0,7,2,it,"('CHI', 'ENV')",Providence,lil43.xml,8,1,0,ENV,40,154,CHI
0,2,1,5,0,7,2,on,"('ENV', 'FAT')",Providence,lil43.xml,8,1,0,FAT,143,74,ENV
0,2,1,5,0,7,2,you,"('FAT', 'ENV')",Providence,lil43.xml,8,1,0,ENV,37,76,FAT
0,3,1,4,-0.287682072,7,3,and,"('CHI', 'ENV')",Providence,lil43.xml,8,1,0,ENV,40,154,CHI
1,38,6,83,-0.355454688,121,38,you,"('CHI', 'MOT')",Providence,lil43.xml,128,7,1,MOT,647,1221,CHI
0,1,32,40,-0.458307589,41,1,you,"('MOT', 'CHI')",Providence,lil43.xml,73,32,0,CHI,850,344,MOT
0,16,6,53,-0.649975009,69,16,what,"('CHI', 'FAT')",Providence,lil43.xml,75,6,0,FAT,402,548,CHI
0,1,6,427,3.291196486,428,1,put,"('MOT', 'CHI')",Providence,lil44.xml,434,6,0,CHI,6879,2010,MOT
1,6,2,425,3.208536847,431,6,some,"('MOT', 'CHI')",Providence,lil44.xml,434,3,1,CHI,6879,2010,MOT
2,6,4,422,3.137045807,428,6,gonna,"('MOT', 'CHI')",Providence,lil44.xml,434,6,2,CHI,6879,2010,MOT
1,0,35,398,3.047025568,398,0,we,"('MOT', 'CHI')",Providence,lil44.xml,434,36,1,CHI,6879,2010,MOT
1,0,37,396,2.990719732,396,0,are,"('MOT', 'CHI')",Providence,lil44.xml,434,38,1,CHI,6879,2010,MOT
1,2,13,418,2.866951484,420,2,at,"('MOT', 'CHI')",Providence,lil44.xml,434,14,1,CHI,6879,2010,MOT
5,3,28,398,2.849053609,401,3,on,"('MOT', 'CHI')",Providence,lil44.xml,434,33,5,CHI,6879,2010,MOT
1,2,14,417,2.803954382,419,2,all,"('MOT', 'CHI')",Providence,lil44.xml,434,15,1,CHI,6879,2010,MOT
4,11,7,412,2.611671074,423,11,want,"('MOT', 'CHI')",Providence,lil44.xml,434,11,4,CHI,6879,2010,MOT
0,1,14,419,2.579269411,420,1,big,"('MOT', 'CHI')",Providence,lil44.xml,434,14,0,CHI,6879,2010,MOT
2,1,42,389,2.548085551,390,1,do,"('MOT', 'CHI')",Providence,lil44.xml,434,44,2,CHI,6879,2010,MOT
2,2,28,402,2.540617257,404,2,for,"('MOT', 'CHI')",Providence,lil44.xml,434,30,2,CHI,6879,2010,MOT
1,2,19,412,2.534177699,414,2,get,"('MOT', 'CHI')",Providence,lil44.xml,434,20,1,CHI,6879,2010,MOT
1,2,23,408,2.357461703,410,2,go,"('MOT', 'CHI')",Providence,lil44.xml,434,24,1,CHI,6879,2010,MOT
5,14,9,406,2.35612586,420,14,one,"('MOT', 'CHI')",Providence,lil44.xml,434,14,5,CHI,6879,2010,MOT
5,8,20,401,2.31729124,409,8,he,"('MOT', 'CHI')",Providence,lil44.xml,434,25,5,CHI,6879,2010,MOT
1,3,18,412,2.295416604,415,3,was,"('MOT', 'CHI')",Providence,lil44.xml,434,19,1,CHI,6879,2010,MOT
0,3,9,422,2.272594379,425,3,wanna,"('MOT', 'CHI')",Providence,lil44.xml,434,9,0,CHI,6879,2010,MOT
0,4,8,422,2.14710019,426,4,make,"('MOT', 'CHI')",Providence,lil44.xml,434,8,0,CHI,6879,2010,MOT
0,2,21,411,1.794172016,413,2,they,"('MOT', 'CHI')",Providence,lil44.xml,434,21,0,CHI,6879,2010,MOT
9,9,52,364,1.7837913,373,9,to,"('MOT', 'CHI')",Providence,lil44.xml,434,61,9,CHI,6879,2010,MOT
0,3,17,414,1.70713758,417,3,there,"('MOT', 'CHI')",Providence,lil44.xml,434,17,0,CHI,6879,2010,MOT
1,3,37,393,1.604425371,396,3,oh,"('MOT', 'CHI')",Providence,lil44.xml,434,38,1,CHI,6879,2010,MOT
7,10,47,370,1.601615187,380,10,what,"('MOT', 'CHI')",Providence,lil44.xml,434,54,7,CHI,6879,2010,MOT
3,9,29,393,1.558763621,402,9,in,"('MOT', 'CHI')",Providence,lil44.xml,434,32,3,CHI,6879,2010,MOT
0,3,21,410,1.506489943,413,3,see,"('MOT', 'CHI')",Providence,lil44.xml,434,21,0,CHI,6879,2010,MOT
2,9,24,399,1.479979845,408,9,my,"('MOT', 'CHI')",Providence,lil44.xml,434,26,2,CHI,6879,2010,MOT
0,3,22,409,1.461517782,412,3,like,"('MOT', 'CHI')",Providence,lil44.xml,434,22,0,CHI,6879,2010,MOT
2,8,28,396,1.442004968,404,8,she,"('MOT', 'CHI')",Providence,lil44.xml,434,30,2,CHI,6879,2010,MOT
1,8,19,406,1.43556541,414,8,of,"('MOT', 'CHI')",Providence,lil44.xml,434,20,1,CHI,6879,2010,MOT
0,4,20,410,1.330204894,414,4,look,"('MOT', 'CHI')",Providence,lil44.xml,434,20,0,CHI,6879,2010,MOT
0,4,22,408,1.238374231,412,4,with,"('MOT', 'CHI')",Providence,lil44.xml,434,22,0,CHI,6879,2010,MOT
0,6,17,411,1.147521792,417,6,have,"('MOT', 'CHI')",Providence,lil44.xml,434,17,0,CHI,6879,2010,MOT
8,21,55,350,0.853373274,371,21,is,"('MOT', 'CHI')",Providence,lil44.xml,434,63,8,CHI,6879,2010,MOT
13,24,78,319,0.731126429,343,24,the,"('MOT', 'CHI')",Providence,lil44.xml,434,91,13,CHI,6879,2010,MOT
7,32,37,358,0.725554424,390,32,it,"('MOT', 'CHI')",Providence,lil44.xml,434,44,7,CHI,6879,2010,MOT
5,44,20,365,0.707853328,409,44,yeah,"('MOT', 'CHI')",Providence,lil44.xml,434,25,5,CHI,6879,2010,MOT
2,41,13,378,0.57036216,419,41,no,"('MOT', 'CHI')",Providence,lil44.xml,434,15,2,CHI,6879,2010,MOT
1,12,35,386,0.48207621,398,12,that,"('MOT', 'CHI')",Providence,lil44.xml,434,36,1,CHI,6879,2010,MOT
6,21,70,337,0.3842629,358,21,a,"('MOT', 'CHI')",Providence,lil44.xml,434,76,6,CHI,6879,2010,MOT
6,13,109,306,0.316120008,319,13,you,"('MOT', 'CHI')",Providence,lil44.xml,434,115,6,CHI,6879,2010,MOT
0,15,18,401,0.267160437,416,15,this,"('MOT', 'CHI')",Providence,lil44.xml,434,18,0,CHI,6879,2010,MOT
7,42,58,327,0.029750869,369,42,and,"('MOT', 'CHI')",Providence,lil44.xml,434,65,7,CHI,6879,2010,MOT
0,17,21,396,0.002412546,413,17,can,"('MOT', 'CHI')",Providence,lil44.xml,434,21,0,CHI,6879,2010,MOT
1,0,5,261,4.185859671,261,0,little,"('MOT', 'CHI')",Providence,lil45.xml,267,6,1,CHI,3173,1195,MOT
2,2,0,161,3.719651113,163,2,up,"('CHI', 'MOT')",Providence,lil45.xml,165,2,2,MOT,718,1892,CHI
0,1,1,163,3.320228319,164,1,gonna,"('CHI', 'MOT')",Providence,lil45.xml,165,1,0,MOT,718,1892,CHI
2,3,1,159,3.202746443,162,3,did,"('CHI', 'MOT')",Providence,lil45.xml,165,3,2,MOT,718,1892,CHI
1,2,2,160,3.084963407,162,2,he,"('CHI', 'MOT')",Providence,lil45.xml,165,3,1,MOT,718,1892,CHI
2,2,4,157,3.001962823,159,2,where,"('CHI', 'MOT')",Providence,lil45.xml,165,6,2,MOT,718,1892,CHI
1,3,4,259,2.936891774,262,3,they,"('MOT', 'CHI')",Providence,lil45.xml,267,5,1,CHI,3173,1195,MOT
1,3,4,259,2.936891774,262,3,she,"('MOT', 'CHI')",Providence,lil45.xml,267,5,1,CHI,3173,1195,MOT
0,1,5,261,2.936891774,262,1,big,"('MOT', 'CHI')",Providence,lil45.xml,267,5,0,CHI,3173,1195,MOT
1,5,0,159,2.914763211,164,5,was,"('CHI', 'MOT')",Providence,lil45.xml,165,1,1,MOT,718,1892,CHI
1,2,7,257,2.856470206,259,2,my,"('MOT', 'CHI')",Providence,lil45.xml,267,8,1,CHI,3173,1195,MOT
2,3,3,157,2.854004114,160,3,go,"('CHI', 'MOT')",Providence,lil45.xml,165,5,2,MOT,718,1892,CHI
0,1,6,260,2.79956531,261,1,at,"('MOT', 'CHI')",Providence,lil45.xml,267,6,0,CHI,3173,1195,MOT
0,1,7,259,2.677972746,260,1,up,"('MOT', 'CHI')",Providence,lil45.xml,267,7,0,CHI,3173,1195,MOT
1,5,1,158,2.621038824,163,5,there,"('CHI', 'MOT')",Providence,lil45.xml,165,2,1,MOT,718,1892,CHI
0,1,8,258,2.568788134,259,1,not,"('MOT', 'CHI')",Providence,lil45.xml,267,8,0,CHI,3173,1195,MOT
1,3,7,256,2.568788134,259,3,but,"('MOT', 'CHI')",Providence,lil45.xml,267,8,1,CHI,3173,1195,MOT
5,4,9,147,2.440170756,151,4,one,"('CHI', 'MOT')",Providence,lil45.xml,165,14,5,MOT,718,1892,CHI
0,4,1,160,2.403937587,164,4,not,"('CHI', 'MOT')",Providence,lil45.xml,165,1,0,MOT,718,1892,CHI
0,3,4,260,2.401675996,263,3,gonna,"('MOT', 'CHI')",Providence,lil45.xml,267,4,0,CHI,3173,1195,MOT
0,2,6,259,2.394100202,261,2,there,"('MOT', 'CHI')",Providence,lil45.xml,267,6,0,CHI,3173,1195,MOT
0,1,10,256,2.378774231,257,1,with,"('MOT', 'CHI')",Providence,lil45.xml,267,10,0,CHI,3173,1195,MOT
0,1,10,256,2.378774231,257,1,did,"('MOT', 'CHI')",Providence,lil45.xml,267,10,0,CHI,3173,1195,MOT
1,0,0,14,2.367123614,14,0,on,"('CHI', 'OPE')",Providence,lil45.xml,15,1,1,OPE,59,105,CHI
0,5,1,159,2.22161603,164,5,can,"('CHI', 'MOT')",Providence,lil45.xml,165,1,0,MOT,718,1892,CHI
1,1,14,149,2.190667177,150,1,no,"('CHI', 'MOT')",Providence,lil45.xml,165,15,1,MOT,718,1892,CHI
0,5,3,259,2.182298927,264,5,where,"('MOT', 'CHI')",Providence,lil45.xml,267,3,0,CHI,3173,1195,MOT
0,3,6,258,2.106418129,261,3,make,"('MOT', 'CHI')",Providence,lil45.xml,267,6,0,CHI,3173,1195,MOT
1,7,2,155,2.104134154,162,7,see,"('CHI', 'MOT')",Providence,lil45.xml,165,3,1,MOT,718,1892,CHI
0,6,1,158,2.067465351,164,6,my,"('CHI', 'MOT')",Providence,lil45.xml,165,1,0,MOT,718,1892,CHI
0,6,1,158,2.067465351,164,6,some,"('CHI', 'MOT')",Providence,lil45.xml,165,1,0,MOT,718,1892,CHI
0,1,16,250,1.94987055,251,1,of,"('MOT', 'CHI')",Providence,lil45.xml,267,16,0,CHI,3173,1195,MOT
0,7,1,157,1.933933958,164,7,wanna,"('CHI', 'MOT')",Providence,lil45.xml,165,1,0,MOT,718,1892,CHI
1,12,1,151,1.847848936,163,12,think,"('CHI', 'MOT')",Providence,lil45.xml,165,2,1,MOT,718,1892,CHI
0,8,1,156,1.816150922,164,8,are,"('CHI', 'MOT')",Providence,lil45.xml,165,1,0,MOT,718,1892,CHI
0,6,2,157,1.773740964,163,6,put,"('CHI', 'MOT')",Providence,lil45.xml,165,2,0,MOT,718,1892,CHI
9,11,10,135,1.770368279,146,11,it,"('CHI', 'MOT')",Providence,lil45.xml,165,19,9,MOT,718,1892,CHI
3,3,36,225,1.724507242,228,3,in,"('MOT', 'CHI')",Providence,lil45.xml,267,39,3,CHI,3173,1195,MOT
0,5,6,256,1.700953021,261,5,have,"('MOT', 'CHI')",Providence,lil45.xml,267,6,0,CHI,3173,1195,MOT
0,3,10,254,1.685627051,257,3,put,"('MOT', 'CHI')",Providence,lil45.xml,267,10,0,CHI,3173,1195,MOT
0,4,8,255,1.652497402,259,4,look,"('MOT', 'CHI')",Providence,lil45.xml,267,8,0,CHI,3173,1195,MOT
1,7,5,152,1.615668462,159,7,want,"('CHI', 'MOT')",Providence,lil45.xml,165,6,1,MOT,718,1892,CHI
5,17,11,234,1.544405442,251,17,want,"('MOT', 'CHI')",Providence,lil45.xml,267,16,5,CHI,3173,1195,MOT
1,0,0,5,1.540445041,5,0,that,"('MOT', 'OPE')",Providence,lil45.xml,6,1,1,OPE,61,45,MOT
2,6,19,240,1.53063667,246,6,are,"('MOT', 'CHI')",Providence,lil45.xml,267,21,2,CHI,3173,1195,MOT
1,17,1,146,1.522426535,163,17,in,"('CHI', 'MOT')",Providence,lil45.xml,165,2,1,MOT,718,1892,CHI
2,15,3,145,1.467709753,160,15,to,"('CHI', 'MOT')",Providence,lil45.xml,165,5,2,MOT,718,1892,CHI
1,9,9,248,1.462483499,257,9,wanna,"('MOT', 'CHI')",Providence,lil45.xml,267,10,1,CHI,3173,1195,MOT
2,5,25,235,1.428494716,240,5,what,"('MOT', 'CHI')",Providence,lil45.xml,267,27,2,CHI,3173,1195,MOT
16,13,45,193,1.388559368,206,13,a,"('MOT', 'CHI')",Providence,lil45.xml,267,61,16,CHI,3173,1195,MOT
1,7,13,246,1.382380462,253,7,one,"('MOT', 'CHI')",Providence,lil45.xml,267,14,1,CHI,3173,1195,MOT
0,5,9,253,1.371026889,258,5,he,"('MOT', 'CHI')",Providence,lil45.xml,267,9,0,CHI,3173,1195,MOT
2,3,24,136,1.328873308,139,3,yeah,"('CHI', 'MOT')",Providence,lil45.xml,165,26,2,MOT,718,1892,CHI
1,21,1,142,1.32175584,163,21,we,"('CHI', 'MOT')",Providence,lil45.xml,165,2,1,MOT,718,1892,CHI
8,16,11,130,1.316701069,146,16,is,"('CHI', 'MOT')",Providence,lil45.xml,165,19,8,MOT,718,1892,CHI
2,12,12,241,1.302337754,253,12,this,"('MOT', 'CHI')",Providence,lil45.xml,267,14,2,CHI,3173,1195,MOT
0,8,3,154,1.293203938,162,8,on,"('CHI', 'MOT')",Providence,lil45.xml,165,3,0,MOT,718,1892,CHI
7,13,29,218,1.253836506,231,13,and,"('MOT', 'CHI')",Providence,lil45.xml,267,36,7,CHI,3173,1195,MOT
0,15,1,149,1.240786777,164,15,oh,"('CHI', 'MOT')",Providence,lil45.xml,165,1,0,MOT,718,1892,CHI
0,2,22,243,1.232722218,245,2,oh,"('MOT', 'CHI')",Providence,lil45.xml,267,22,0,CHI,3173,1195,MOT
12,25,9,119,1.154965225,144,25,a,"('CHI', 'MOT')",Providence,lil45.xml,165,21,12,MOT,718,1892,CHI
6,4,77,180,1.119567654,184,4,you,"('MOT', 'CHI')",Providence,lil45.xml,267,83,6,CHI,3173,1195,MOT
1,11,11,244,1.118259286,255,11,some,"('MOT', 'CHI')",Providence,lil45.xml,267,12,1,CHI,3173,1195,MOT
1,0,1,4,1.098612289,4,0,oh,"('MOT', 'OPE')",Providence,lil45.xml,6,2,1,OPE,61,45,MOT
7,22,9,127,1.070855405,149,22,and,"('CHI', 'MOT')",Providence,lil45.xml,165,16,7,MOT,718,1892,CHI
3,16,8,138,1.037987667,154,16,what,"('CHI', 'MOT')",Providence,lil45.xml,165,11,3,MOT,718,1892,CHI
3,1,3,8,1.011600912,9,1,yeah,"('CHI', 'OPE')",Providence,lil45.xml,15,6,3,OPE,59,105,CHI
4,42,5,216,1.011024155,258,42,no,"('MOT', 'CHI')",Providence,lil45.xml,267,9,4,CHI,3173,1195,MOT
1,0,0,2,0.980829253,2,0,have,"('OPE', 'MOT')",Providence,lil45.xml,3,1,1,MOT,20,38,OPE
1,0,0,2,0.980829253,2,0,he,"('OPE', 'MOT')",Providence,lil45.xml,3,1,1,MOT,20,38,OPE
5,6,59,197,0.979204557,203,6,the,"('MOT', 'CHI')",Providence,lil45.xml,267,64,5,CHI,3173,1195,MOT
0,9,8,250,0.959350221,259,9,go,"('MOT', 'CHI')",Providence,lil45.xml,267,8,0,CHI,3173,1195,MOT
2,10,12,141,0.958566215,151,10,this,"('CHI', 'MOT')",Providence,lil45.xml,165,14,2,MOT,718,1892,CHI
1,2,1,11,0.916290732,13,2,the,"('CHI', 'OPE')",Providence,lil45.xml,15,2,1,OPE,59,105,CHI
4,17,22,224,0.879923088,241,17,it,"('MOT', 'CHI')",Providence,lil45.xml,267,26,4,CHI,3173,1195,MOT
0,18,2,145,0.775212134,163,18,make,"('CHI', 'MOT')",Providence,lil45.xml,165,2,0,MOT,718,1892,CHI
1,3,0,7,0.693147181,10,3,yeah,"('OPE', 'CHI')",Providence,lil45.xml,11,1,1,CHI,67,45,OPE
0,1,1,9,0.693147181,10,1,a,"('OPE', 'CHI')",Providence,lil45.xml,11,1,0,CHI,67,45,OPE
2,8,35,222,0.684563437,230,8,is,"('MOT', 'CHI')",Providence,lil45.xml,267,37,2,CHI,3173,1195,MOT
2,24,6,133,0.646055573,157,24,the,"('CHI', 'MOT')",Providence,lil45.xml,165,8,2,MOT,718,1892,CHI
2,11,28,226,0.624433288,237,11,to,"('MOT', 'CHI')",Providence,lil45.xml,267,30,2,CHI,3173,1195,MOT
0,7,20,240,0.346968901,247,7,on,"('MOT', 'CHI')",Providence,lil45.xml,267,20,0,CHI,3173,1195,MOT
0,1,2,8,0.318453731,9,1,the,"('OPE', 'CHI')",Providence,lil45.xml,11,2,0,CHI,67,45,OPE
1,1,0,1,0.287682072,2,1,a,"('OPE', 'MOT')",Providence,lil45.xml,3,1,1,MOT,20,38,OPE
0,9,17,241,0.282405015,250,9,can,"('MOT', 'CHI')",Providence,lil45.xml,267,17,0,CHI,3173,1195,MOT
1,27,6,131,0.238891908,158,27,that,"('CHI', 'MOT')",Providence,lil45.xml,165,7,1,MOT,718,1892,CHI
0,1,1,4,0.15415068,5,1,to,"('MOT', 'OPE')",Providence,lil45.xml,6,1,0,OPE,61,45,MOT
0,6,33,228,-0.037426406,234,6,that,"('MOT', 'CHI')",Providence,lil45.xml,267,33,0,CHI,3173,1195,MOT
0,51,2,112,-0.231592606,163,51,you,"('CHI', 'MOT')",Providence,lil45.xml,165,2,0,MOT,718,1892,CHI
0,1,2,3,-0.287682072,4,1,the,"('MOT', 'OPE')",Providence,lil45.xml,6,2,0,OPE,61,45,MOT
1,49,11,206,-0.30885707,255,49,yeah,"('MOT', 'CHI')",Providence,lil45.xml,267,12,1,CHI,3173,1195,MOT
0,1,1,1,-0.405465108,2,1,what,"('OPE', 'MOT')",Providence,lil45.xml,3,1,0,MOT,20,38,OPE
1,1,1,220,4.02087741,221,1,put,"('MOT', 'CHI')",Providence,lil46.xml,223,2,1,CHI,4234,980,MOT
1,3,0,256,3.772760938,259,3,look,"('CHI', 'MOT')",Providence,lil46.xml,260,1,1,MOT,1238,2096,CHI
1,2,1,256,3.768922162,258,2,did,"('CHI', 'MOT')",Providence,lil46.xml,260,2,1,MOT,1238,2096,CHI
1,0,10,212,3.494173838,212,0,did,"('MOT', 'CHI')",Providence,lil46.xml,223,11,1,CHI,4234,980,MOT
1,3,1,255,3.481240089,258,3,where,"('CHI', 'MOT')",Providence,lil46.xml,260,2,1,MOT,1238,2096,CHI
2,4,1,253,3.436564525,257,4,there,"('CHI', 'MOT')",Providence,lil46.xml,260,3,2,MOT,1238,2096,CHI
2,0,17,204,3.38196602,204,0,we,"('MOT', 'CHI')",Providence,lil46.xml,223,19,2,CHI,4234,980,MOT
0,2,1,257,3.36729583,259,2,get,"('CHI', 'MOT')",Providence,lil46.xml,260,1,0,MOT,1238,2096,CHI
0,2,1,257,3.36729583,259,2,was,"('CHI', 'MOT')",Providence,lil46.xml,260,1,0,MOT,1238,2096,CHI
0,2,1,257,3.36729583,259,2,big,"('CHI', 'MOT')",Providence,lil46.xml,260,1,0,MOT,1238,2096,CHI
1,2,3,254,3.355735008,256,2,of,"('CHI', 'MOT')",Providence,lil46.xml,260,4,1,MOT,1238,2096,CHI
2,0,20,201,3.233764437,201,0,are,"('MOT', 'CHI')",Providence,lil46.xml,223,22,2,CHI,4234,980,MOT
1,2,3,217,3.200938124,219,2,want,"('MOT', 'CHI')",Providence,lil46.xml,223,4,1,CHI,4234,980,MOT
1,1,6,215,3.187270485,216,1,there,"('MOT', 'CHI')",Providence,lil46.xml,223,7,1,CHI,4234,980,MOT
1,0,17,205,3.0301337,205,0,he,"('MOT', 'CHI')",Providence,lil46.xml,223,18,1,CHI,4234,980,MOT
3,8,1,248,2.950269899,256,8,think,"('CHI', 'MOT')",Providence,lil46.xml,260,4,3,MOT,1238,2096,CHI
0,2,2,219,2.922265122,221,2,make,"('MOT', 'CHI')",Providence,lil46.xml,223,2,0,CHI,4234,980,MOT
1,5,2,252,2.848777861,257,5,can,"('CHI', 'MOT')",Providence,lil46.xml,260,3,1,MOT,1238,2096,CHI
1,2,6,214,2.781805377,216,2,gonna,"('MOT', 'CHI')",Providence,lil46.xml,223,7,1,CHI,4234,980,MOT
1,5,2,215,2.694627181,220,5,get,"('MOT', 'CHI')",Providence,lil46.xml,223,3,1,CHI,4234,980,MOT
2,13,0,245,2.633942229,258,13,are,"('CHI', 'MOT')",Providence,lil46.xml,260,2,2,MOT,1238,2096,CHI
0,1,6,216,2.616483008,217,1,one,"('MOT', 'CHI')",Providence,lil46.xml,223,6,0,CHI,4234,980,MOT
0,4,2,254,2.564949357,258,4,one,"('CHI', 'MOT')",Providence,lil46.xml,260,2,0,MOT,1238,2096,CHI
0,1,7,215,2.494123305,216,1,little,"('MOT', 'CHI')",Providence,lil46.xml,223,7,0,CHI,4234,980,MOT
4,6,9,241,2.472930459,247,6,on,"('CHI', 'MOT')",Providence,lil46.xml,260,13,4,MOT,1238,2096,CHI
1,4,6,249,2.427748236,253,4,gonna,"('CHI', 'MOT')",Providence,lil46.xml,260,7,1,MOT,1238,2096,CHI
0,5,2,253,2.382627801,258,5,with,"('CHI', 'MOT')",Providence,lil46.xml,260,2,0,MOT,1238,2096,CHI
4,20,0,236,2.32611559,256,20,oh,"('CHI', 'MOT')",Providence,lil46.xml,260,4,4,MOT,1238,2096,CHI
1,12,1,246,2.302585093,258,12,we,"('CHI', 'MOT')",Providence,lil46.xml,260,2,1,MOT,1238,2096,CHI
1,1,18,203,2.283353731,204,1,with,"('MOT', 'CHI')",Providence,lil46.xml,223,19,1,CHI,4234,980,MOT
0,3,4,216,2.220108871,219,3,not,"('MOT', 'CHI')",Providence,lil46.xml,223,4,0,CHI,4234,980,MOT
3,16,2,239,2.156246953,255,16,for,"('CHI', 'MOT')",Providence,lil46.xml,260,5,3,MOT,1238,2096,CHI
0,7,2,251,2.094945728,258,7,in,"('CHI', 'MOT')",Providence,lil46.xml,260,2,0,MOT,1238,2096,CHI
0,7,2,251,2.094945728,258,7,they,"('CHI', 'MOT')",Providence,lil46.xml,260,2,0,MOT,1238,2096,CHI
0,2,7,214,2.088658197,216,2,but,"('MOT', 'CHI')",Providence,lil46.xml,223,7,0,CHI,4234,980,MOT
1,12,2,245,2.075587972,257,12,some,"('CHI', 'MOT')",Providence,lil46.xml,260,3,1,MOT,1238,2096,CHI
10,18,6,226,2.068416072,244,18,is,"('CHI', 'MOT')",Providence,lil46.xml,260,16,10,MOT,1238,2096,CHI
1,0,0,9,1.992430165,9,0,you,"('MOT', 'OPE')",Providence,lil46.xml,10,1,1,OPE,202,28,MOT
0,8,2,250,1.977162693,258,8,but,"('CHI', 'MOT')",Providence,lil46.xml,260,2,0,MOT,1238,2096,CHI
4,3,28,188,1.959473216,191,3,what,"('MOT', 'CHI')",Providence,lil46.xml,223,32,4,CHI,4234,980,MOT
1,7,6,246,1.957744607,253,7,go,"('CHI', 'MOT')",Providence,lil46.xml,260,7,1,MOT,1238,2096,CHI
1,3,12,207,1.955388893,210,3,go,"('MOT', 'CHI')",Providence,lil46.xml,223,13,1,CHI,4234,980,MOT
1,2,21,236,1.897119985,238,2,yeah,"('CHI', 'MOT')",Providence,lil46.xml,260,22,1,MOT,1238,2096,CHI
2,3,19,199,1.894943705,202,3,they,"('MOT', 'CHI')",Providence,lil46.xml,223,21,2,CHI,4234,980,MOT
13,14,18,215,1.876917278,229,14,it,"('CHI', 'MOT')",Providence,lil46.xml,260,31,13,MOT,1238,2096,CHI
0,9,2,249,1.871802177,258,9,see,"('CHI', 'MOT')",Providence,lil46.xml,260,2,0,MOT,1238,2096,CHI
5,12,11,232,1.84176989,244,12,and,"('CHI', 'MOT')",Providence,lil46.xml,260,16,5,MOT,1238,2096,CHI
0,13,1,246,1.826850789,259,13,little,"('CHI', 'MOT')",Providence,lil46.xml,260,1,0,MOT,1238,2096,CHI
0,1,15,207,1.820747006,208,1,see,"('MOT', 'CHI')",Providence,lil46.xml,223,15,0,CHI,4234,980,MOT
3,4,26,227,1.793907698,231,4,no,"('CHI', 'MOT')",Providence,lil46.xml,260,29,3,MOT,1238,2096,CHI
0,2,10,211,1.78711909,213,2,up,"('MOT', 'CHI')",Providence,lil46.xml,223,10,0,CHI,4234,980,MOT
2,32,0,226,1.776491997,258,32,what,"('CHI', 'MOT')",Providence,lil46.xml,260,2,2,MOT,1238,2096,CHI
0,1,16,206,1.758815314,207,1,she,"('MOT', 'CHI')",Providence,lil46.xml,223,16,0,CHI,4234,980,MOT
0,3,9,248,1.749199855,251,3,my,"('CHI', 'MOT')",Providence,lil46.xml,260,9,0,MOT,1238,2096,CHI
4,22,4,230,1.708692871,252,22,do,"('CHI', 'MOT')",Providence,lil46.xml,260,8,4,MOT,1238,2096,CHI
0,1,17,205,1.69995192,206,1,of,"('MOT', 'CHI')",Providence,lil46.xml,223,17,0,CHI,4234,980,MOT
1,4,13,205,1.662978679,209,4,was,"('MOT', 'CHI')",Providence,lil46.xml,223,14,1,CHI,4234,980,MOT
1,8,7,207,1.573234864,215,8,this,"('MOT', 'CHI')",Providence,lil46.xml,223,8,1,CHI,4234,980,MOT
0,1,20,202,1.538820345,203,1,do,"('MOT', 'CHI')",Providence,lil46.xml,223,20,0,CHI,4234,980,MOT
0,4,9,247,1.526056303,251,4,want,"('CHI', 'MOT')",Providence,lil46.xml,260,9,0,MOT,1238,2096,CHI
0,2,14,207,1.480657123,209,2,for,"('MOT', 'CHI')",Providence,lil46.xml,223,14,0,CHI,4234,980,MOT
1,0,0,4,1.386294361,4,0,to,"('OPE', 'MOT')",Providence,lil46.xml,5,1,1,MOT,25,28,OPE
0,7,5,211,1.368275856,218,7,can,"('MOT', 'CHI')",Providence,lil46.xml,223,5,0,CHI,4234,980,MOT
0,3,15,242,1.289880631,245,3,this,"('CHI', 'MOT')",Providence,lil46.xml,260,15,0,MOT,1238,2096,CHI
1,4,20,198,1.266335046,202,4,is,"('MOT', 'CHI')",Providence,lil46.xml,223,21,1,CHI,4234,980,MOT
0,14,3,243,1.239339948,257,14,have,"('CHI', 'MOT')",Providence,lil46.xml,260,3,0,MOT,1238,2096,CHI
1,2,34,186,1.230641051,188,2,oh,"('MOT', 'CHI')",Providence,lil46.xml,223,35,1,CHI,4234,980,MOT
5,24,11,220,1.187843422,244,24,a,"('CHI', 'MOT')",Providence,lil46.xml,260,16,5,MOT,1238,2096,CHI
10,35,11,204,1.163679052,239,35,the,"('CHI', 'MOT')",Providence,lil46.xml,260,21,10,MOT,1238,2096,CHI
1,5,20,197,1.084013489,202,5,like,"('MOT', 'CHI')",Providence,lil46.xml,223,21,1,CHI,4234,980,MOT
6,16,22,179,0.994703152,195,16,it,"('MOT', 'CHI')",Providence,lil46.xml,223,28,6,CHI,4234,980,MOT
0,6,10,207,0.939821229,213,6,my,"('MOT', 'CHI')",Providence,lil46.xml,223,10,0,CHI,4234,980,MOT
0,3,19,201,0.89705937,204,3,in,"('MOT', 'CHI')",Providence,lil46.xml,223,19,0,CHI,4234,980,MOT
0,21,3,236,0.856347696,257,21,that,"('CHI', 'MOT')",Providence,lil46.xml,260,3,0,MOT,1238,2096,CHI
2,27,8,223,0.810930216,250,27,to,"('CHI', 'MOT')",Providence,lil46.xml,260,10,2,MOT,1238,2096,CHI
1,6,24,192,0.749717532,198,6,on,"('MOT', 'CHI')",Providence,lil46.xml,223,25,1,CHI,4234,980,MOT
3,10,29,181,0.724728753,191,10,to,"('MOT', 'CHI')",Providence,lil46.xml,223,32,3,CHI,4234,980,MOT
0,15,5,203,0.675128675,218,15,no,"('MOT', 'CHI')",Providence,lil46.xml,223,5,0,CHI,4234,980,MOT
0,1,1,8,0.606135804,9,1,oh,"('MOT', 'OPE')",Providence,lil46.xml,10,1,0,OPE,202,28,MOT
9,22,39,153,0.431217604,175,22,and,"('MOT', 'CHI')",Providence,lil46.xml,223,48,9,CHI,4234,980,MOT
4,9,51,159,0.399599989,168,9,the,"('MOT', 'CHI')",Providence,lil46.xml,223,55,4,CHI,4234,980,MOT
3,64,6,187,0.347401307,251,64,you,"('CHI', 'MOT')",Providence,lil46.xml,260,9,3,MOT,1238,2096,CHI
0,6,20,197,0.286057377,203,6,that,"('MOT', 'CHI')",Providence,lil46.xml,223,20,0,CHI,4234,980,MOT
0,1,2,7,0.223143551,8,1,is,"('MOT', 'OPE')",Providence,lil46.xml,10,2,0,OPE,202,28,MOT
0,1,2,7,0.223143551,8,1,that,"('MOT', 'OPE')",Providence,lil46.xml,10,2,0,OPE,202,28,MOT
2,9,41,171,0.193371393,180,9,a,"('MOT', 'CHI')",Providence,lil46.xml,223,43,2,CHI,4234,980,MOT
3,50,11,159,0.03373814,209,50,yeah,"('MOT', 'CHI')",Providence,lil46.xml,223,14,3,CHI,4234,980,MOT
0,1,1,3,0,4,1,what,"('OPE', 'MOT')",Providence,lil46.xml,5,1,0,MOT,25,28,OPE
2,5,77,139,-0.103989714,144,5,you,"('MOT', 'CHI')",Providence,lil46.xml,223,79,2,CHI,4234,980,MOT
0,1,3,2,-0.693147181,3,1,it,"('OPE', 'CHI')",Providence,lil46.xml,6,3,0,CHI,38,18,OPE
2,0,2,135,4.226833745,135,0,big,"('MOT', 'CHI')",Providence,lil47.xml,139,4,2,CHI,1519,596,MOT
1,1,3,245,3.721669277,246,1,make,"('CHI', 'MOT')",Providence,lil47.xml,250,4,1,MOT,1126,2384,CHI
1,0,4,134,3.659891917,134,0,gonna,"('MOT', 'CHI')",Providence,lil47.xml,139,5,1,CHI,1519,596,MOT
1,0,5,133,3.518980417,133,0,like,"('MOT', 'CHI')",Providence,lil47.xml,139,6,1,CHI,1519,596,MOT
1,3,1,245,3.442019376,248,3,big,"('CHI', 'MOT')",Providence,lil47.xml,250,2,1,MOT,1126,2384,CHI
3,3,3,241,3.425889994,244,3,gonna,"('CHI', 'MOT')",Providence,lil47.xml,250,6,3,MOT,1126,2384,CHI
1,0,6,132,3.393762403,132,0,did,"('MOT', 'CHI')",Providence,lil47.xml,139,7,1,CHI,1519,596,MOT
1,2,3,244,3.316204169,246,2,some,"('CHI', 'MOT')",Providence,lil47.xml,250,4,1,MOT,1126,2384,CHI
1,4,1,244,3.218875825,248,4,want,"('CHI', 'MOT')",Providence,lil47.xml,250,2,1,MOT,1126,2384,CHI
0,1,1,137,3.149882953,138,1,they,"('MOT', 'CHI')",Providence,lil47.xml,139,1,0,CHI,1519,596,MOT
0,1,1,137,3.149882953,138,1,up,"('MOT', 'CHI')",Providence,lil47.xml,139,1,0,CHI,1519,596,MOT
0,1,1,137,3.149882953,138,1,she,"('MOT', 'CHI')",Providence,lil47.xml,139,1,0,CHI,1519,596,MOT
2,1,5,131,3.106080331,132,1,was,"('MOT', 'CHI')",Providence,lil47.xml,139,7,2,CHI,1519,596,MOT
0,3,1,246,3.040546289,249,3,did,"('CHI', 'MOT')",Providence,lil47.xml,250,1,0,MOT,1126,2384,CHI
1,5,1,243,3.036554268,248,5,they,"('CHI', 'MOT')",Providence,lil47.xml,250,2,1,MOT,1126,2384,CHI
1,0,10,128,2.995732274,128,0,on,"('MOT', 'CHI')",Providence,lil47.xml,139,11,1,CHI,1519,596,MOT
1,4,2,243,2.991724252,247,4,all,"('CHI', 'MOT')",Providence,lil47.xml,250,3,1,MOT,1126,2384,CHI
1,1,4,133,2.966744737,134,1,some,"('MOT', 'CHI')",Providence,lil47.xml,139,5,1,CHI,1519,596,MOT
0,1,2,136,2.855032391,137,1,not,"('MOT', 'CHI')",Providence,lil47.xml,139,2,0,CHI,1519,596,MOT
3,10,1,236,2.710068365,246,10,get,"('CHI', 'MOT')",Providence,lil47.xml,250,4,3,MOT,1126,2384,CHI
2,9,1,238,2.70404218,247,9,with,"('CHI', 'MOT')",Providence,lil47.xml,250,3,2,MOT,1126,2384,CHI
0,5,1,244,2.635081181,249,5,at,"('CHI', 'MOT')",Providence,lil47.xml,250,1,0,MOT,1126,2384,CHI
0,1,3,135,2.624668592,136,1,go,"('MOT', 'CHI')",Providence,lil47.xml,139,3,0,CHI,1519,596,MOT
0,1,3,135,2.624668592,136,1,there,"('MOT', 'CHI')",Providence,lil47.xml,139,3,0,CHI,1519,596,MOT
2,8,2,238,2.623056988,246,8,have,"('CHI', 'MOT')",Providence,lil47.xml,250,4,2,MOT,1126,2384,CHI
1,9,1,239,2.525728644,248,9,we,"('CHI', 'MOT')",Providence,lil47.xml,250,2,1,MOT,1126,2384,CHI
1,7,2,240,2.521720623,247,7,are,"('CHI', 'MOT')",Providence,lil47.xml,250,3,1,MOT,1126,2384,CHI
4,4,5,126,2.48490665,130,4,one,"('MOT', 'CHI')",Providence,lil47.xml,139,9,4,CHI,1519,596,MOT
0,6,1,243,2.480930501,249,6,she,"('CHI', 'MOT')",Providence,lil47.xml,250,1,0,MOT,1126,2384,CHI
0,6,1,243,2.480930501,249,6,wanna,"('CHI', 'MOT')",Providence,lil47.xml,250,1,0,MOT,1126,2384,CHI
0,1,4,134,2.435074276,135,1,at,"('MOT', 'CHI')",Providence,lil47.xml,139,4,0,CHI,1519,596,MOT
2,13,1,234,2.367569943,247,13,on,"('CHI', 'MOT')",Providence,lil47.xml,250,3,2,MOT,1126,2384,CHI
3,18,0,229,2.349870366,247,18,to,"('CHI', 'MOT')",Providence,lil47.xml,250,3,3,MOT,1126,2384,CHI
0,1,5,133,2.273597556,134,1,of,"('MOT', 'CHI')",Providence,lil47.xml,139,5,0,CHI,1519,596,MOT
0,8,1,241,2.229616073,249,8,see,"('CHI', 'MOT')",Providence,lil47.xml,250,1,0,MOT,1126,2384,CHI
0,8,1,241,2.229616073,249,8,not,"('CHI', 'MOT')",Providence,lil47.xml,250,1,0,MOT,1126,2384,CHI
2,11,3,234,2.177183826,245,11,in,"('CHI', 'MOT')",Providence,lil47.xml,250,5,2,MOT,1126,2384,CHI
0,3,5,242,2.177183826,245,3,my,"('CHI', 'MOT')",Providence,lil47.xml,250,5,0,MOT,1126,2384,CHI
2,6,8,234,2.156733216,240,6,can,"('CHI', 'MOT')",Providence,lil47.xml,250,10,2,MOT,1126,2384,CHI
0,1,6,132,2.132686056,133,1,have,"('MOT', 'CHI')",Providence,lil47.xml,139,6,0,CHI,1519,596,MOT
0,7,2,241,2.055725015,248,7,little,"('CHI', 'MOT')",Providence,lil47.xml,250,2,0,MOT,1126,2384,CHI
0,2,4,133,2.029609168,135,2,with,"('MOT', 'CHI')",Providence,lil47.xml,139,4,0,CHI,1519,596,MOT
2,0,0,8,2.014903021,8,0,it,"('VIS', 'MOT')",Providence,lil47.xml,10,2,2,MOT,81,121,VIS
1,16,1,232,1.995100393,248,16,for,"('CHI', 'MOT')",Providence,lil47.xml,250,2,1,MOT,1126,2384,CHI
1,0,0,9,1.992430165,9,0,are,"('VIS', 'MOT')",Providence,lil47.xml,10,1,1,MOT,81,121,VIS
0,8,2,240,1.937941979,248,8,like,"('CHI', 'MOT')",Providence,lil47.xml,250,2,0,MOT,1126,2384,CHI
0,8,2,240,1.937941979,248,8,he,"('CHI', 'MOT')",Providence,lil47.xml,250,2,0,MOT,1126,2384,CHI
2,11,5,232,1.917739272,243,11,go,"('CHI', 'MOT')",Providence,lil47.xml,250,7,2,MOT,1126,2384,CHI
1,18,1,230,1.883874758,248,18,do,"('CHI', 'MOT')",Providence,lil47.xml,250,2,1,MOT,1126,2384,CHI
1,7,7,235,1.808288771,242,7,where,"('CHI', 'MOT')",Providence,lil47.xml,250,8,1,MOT,1126,2384,CHI
1,6,9,234,1.751268108,240,6,no,"('CHI', 'MOT')",Providence,lil47.xml,250,10,1,MOT,1126,2384,CHI
0,3,4,132,1.741927095,135,3,want,"('MOT', 'CHI')",Providence,lil47.xml,139,4,0,CHI,1519,596,MOT
0,3,4,132,1.741927095,135,3,can,"('MOT', 'CHI')",Providence,lil47.xml,139,4,0,CHI,1519,596,MOT
2,4,10,123,1.709929451,127,4,we,"('MOT', 'CHI')",Providence,lil47.xml,139,12,2,CHI,1519,596,MOT
1,3,9,126,1.697143493,129,3,to,"('MOT', 'CHI')",Providence,lil47.xml,139,10,1,CHI,1519,596,MOT
1,22,1,226,1.692819521,248,22,oh,"('CHI', 'MOT')",Providence,lil47.xml,250,2,1,MOT,1126,2384,CHI
1,11,5,233,1.634130525,244,11,one,"('CHI', 'MOT')",Providence,lil47.xml,250,6,1,MOT,1126,2384,CHI
1,0,1,8,1.609437912,8,0,of,"('VIS', 'MOT')",Providence,lil47.xml,10,2,1,MOT,81,121,VIS
0,9,3,238,1.605429891,247,9,was,"('CHI', 'MOT')",Providence,lil47.xml,250,3,0,MOT,1126,2384,CHI
0,3,5,131,1.580450376,134,3,little,"('MOT', 'CHI')",Providence,lil47.xml,139,5,0,CHI,1519,596,MOT
1,14,4,231,1.548575167,245,14,of,"('CHI', 'MOT')",Providence,lil47.xml,250,5,1,MOT,1126,2384,CHI
0,5,3,131,1.526056303,136,5,this,"('MOT', 'CHI')",Providence,lil47.xml,139,3,0,CHI,1519,596,MOT
0,2,8,129,1.489151747,131,2,are,"('MOT', 'CHI')",Providence,lil47.xml,139,8,0,CHI,1519,596,MOT
4,14,13,219,1.416534246,233,14,it,"('CHI', 'MOT')",Providence,lil47.xml,250,17,4,MOT,1126,2384,CHI
0,6,3,130,1.371905624,136,6,no,"('MOT', 'CHI')",Providence,lil47.xml,139,3,0,CHI,1519,596,MOT
9,28,10,203,1.341805279,231,28,is,"('CHI', 'MOT')",Providence,lil47.xml,250,19,9,MOT,1126,2384,CHI
1,1,0,8,1.299282984,9,1,to,"('VIS', 'MOT')",Providence,lil47.xml,10,1,1,MOT,81,121,VIS
3,9,10,117,1.227689331,126,9,what,"('MOT', 'CHI')",Providence,lil47.xml,139,13,3,CHI,1519,596,MOT
3,5,20,111,1.146343691,116,5,that,"('MOT', 'CHI')",Providence,lil47.xml,139,23,3,CHI,1519,596,MOT
2,4,19,114,1.141171903,118,4,in,"('MOT', 'CHI')",Providence,lil47.xml,139,21,2,CHI,1519,596,MOT
5,6,26,102,1.049822124,108,6,the,"('MOT', 'CHI')",Providence,lil47.xml,139,31,5,CHI,1519,596,MOT
0,2,13,124,1.045367774,126,2,see,"('MOT', 'CHI')",Providence,lil47.xml,139,13,0,CHI,1519,596,MOT
5,10,34,201,1.041584295,211,10,yeah,"('CHI', 'MOT')",Providence,lil47.xml,250,39,5,MOT,1126,2384,CHI
0,4,8,127,0.978326123,131,4,my,"('MOT', 'CHI')",Providence,lil47.xml,139,8,0,CHI,1519,596,MOT
4,11,14,110,0.940983344,121,11,is,"('MOT', 'CHI')",Providence,lil47.xml,139,18,4,CHI,1519,596,MOT
1,27,4,218,0.924420858,245,27,what,"('CHI', 'MOT')",Providence,lil47.xml,250,5,1,MOT,1126,2384,CHI
8,39,11,192,0.914861139,231,39,the,"('CHI', 'MOT')",Providence,lil47.xml,250,19,8,MOT,1126,2384,CHI
4,9,18,108,0.907922482,117,9,and,"('MOT', 'CHI')",Providence,lil47.xml,139,22,4,CHI,1519,596,MOT
1,2,0,7,0.893817876,9,2,you,"('VIS', 'MOT')",Providence,lil47.xml,10,1,1,MOT,81,121,VIS
1,2,0,7,0.893817876,9,2,the,"('VIS', 'MOT')",Providence,lil47.xml,10,1,1,MOT,81,121,VIS
0,20,3,227,0.863492546,247,20,think,"('CHI', 'MOT')",Providence,lil47.xml,250,3,0,MOT,1126,2384,CHI
5,9,22,103,0.858076995,112,9,a,"('MOT', 'CHI')",Providence,lil47.xml,139,27,5,CHI,1519,596,MOT
0,1,1,8,0.606135804,9,1,was,"('VIS', 'MOT')",Providence,lil47.xml,10,1,0,MOT,81,121,VIS
0,1,1,8,0.606135804,9,1,see,"('VIS', 'MOT')",Providence,lil47.xml,10,1,0,MOT,81,121,VIS
0,1,1,8,0.606135804,9,1,is,"('VIS', 'MOT')",Providence,lil47.xml,10,1,0,MOT,81,121,VIS
4,33,13,200,0.598223923,233,33,a,"('CHI', 'MOT')",Providence,lil47.xml,250,17,4,MOT,1126,2384,CHI
0,28,3,219,0.540719154,247,28,that,"('CHI', 'MOT')",Providence,lil47.xml,250,3,0,MOT,1126,2384,CHI
0,1,1,7,0.510825624,8,1,one,"('OPE', 'CHI')",Providence,lil47.xml,9,1,0,CHI,38,50,OPE
4,13,20,102,0.47445798,115,13,it,"('MOT', 'CHI')",Providence,lil47.xml,139,24,4,CHI,1519,596,MOT
4,51,9,186,0.426607545,237,51,you,"('CHI', 'MOT')",Providence,lil47.xml,250,13,4,MOT,1126,2384,CHI
2,29,12,207,0.397096858,236,29,and,"('CHI', 'MOT')",Providence,lil47.xml,250,14,2,MOT,1126,2384,CHI
2,4,39,94,0.333144447,98,4,you,"('MOT', 'CHI')",Providence,lil47.xml,139,41,2,CHI,1519,596,MOT
3,22,15,99,0.067252227,121,22,yeah,"('MOT', 'CHI')",Providence,lil47.xml,139,18,3,CHI,1519,596,MOT
0,13,15,222,-0.004210533,235,13,this,"('CHI', 'MOT')",Providence,lil47.xml,250,15,0,MOT,1126,2384,CHI
0,1,3,6,-0.105360516,7,1,yeah,"('VIS', 'MOT')",Providence,lil47.xml,10,3,0,MOT,81,121,VIS
0,1,3,6,-0.105360516,7,1,this,"('VIS', 'MOT')",Providence,lil47.xml,10,3,0,MOT,81,121,VIS
0,2,1,2,-0.405465108,4,2,you,"('OPE', 'MOT')",Providence,lil47.xml,5,1,0,MOT,24,48,OPE
0,1,1,1,-0.405465108,2,1,it,"('VIS', 'CHI')",Providence,lil47.xml,3,1,0,CHI,16,10,VIS
0,1,1,0,-0.693147181,1,1,what,"('MOT', 'VIS')",Providence,lil47.xml,2,1,0,VIS,12,18,MOT
0,1,1,0,-0.693147181,1,1,the,"('MOT', 'VIS')",Providence,lil47.xml,2,1,0,VIS,12,18,MOT
1,2,2,143,2.975529566,145,2,no,"('CHI', 'MOT')",Providence,lil48.xml,148,3,1,MOT,846,2209,CHI
0,2,1,145,2.806721729,147,2,want,"('CHI', 'MOT')",Providence,lil48.xml,148,1,0,MOT,846,2209,CHI
0,2,1,145,2.806721729,147,2,wanna,"('CHI', 'MOT')",Providence,lil48.xml,148,1,0,MOT,846,2209,CHI
1,5,0,142,2.806721729,147,5,go,"('CHI', 'MOT')",Providence,lil48.xml,148,1,1,MOT,846,2209,CHI
1,5,0,142,2.806721729,147,5,with,"('CHI', 'MOT')",Providence,lil48.xml,148,1,1,MOT,846,2209,CHI
0,3,1,144,2.519039656,147,3,they,"('CHI', 'MOT')",Providence,lil48.xml,148,1,0,MOT,846,2209,CHI
0,3,1,144,2.519039656,147,3,put,"('CHI', 'MOT')",Providence,lil48.xml,148,1,0,MOT,846,2209,CHI
1,8,0,139,2.401256621,147,8,was,"('CHI', 'MOT')",Providence,lil48.xml,148,1,1,MOT,846,2209,CHI
1,6,1,140,2.358154944,146,6,he,"('CHI', 'MOT')",Providence,lil48.xml,148,2,1,MOT,846,2209,CHI
0,4,1,143,2.295896105,147,4,some,"('CHI', 'MOT')",Providence,lil48.xml,148,1,0,MOT,846,2209,CHI
0,4,1,143,2.295896105,147,4,at,"('CHI', 'MOT')",Providence,lil48.xml,148,1,0,MOT,846,2209,CHI
0,3,2,143,2.224623552,146,3,this,"('CHI', 'MOT')",Providence,lil48.xml,148,2,0,MOT,846,2209,CHI
0,5,1,142,2.113574548,147,5,for,"('CHI', 'MOT')",Providence,lil48.xml,148,1,0,MOT,846,2209,CHI
0,5,1,142,2.113574548,147,5,look,"('CHI', 'MOT')",Providence,lil48.xml,148,1,0,MOT,846,2209,CHI
0,6,1,141,1.959423868,147,6,get,"('CHI', 'MOT')",Providence,lil48.xml,148,1,0,MOT,846,2209,CHI
0,6,1,141,1.959423868,147,6,of,"('CHI', 'MOT')",Providence,lil48.xml,148,1,0,MOT,846,2209,CHI
1,6,3,138,1.939084184,144,6,one,"('CHI', 'MOT')",Providence,lil48.xml,148,4,1,MOT,846,2209,CHI
0,7,1,140,1.825892476,147,7,but,"('CHI', 'MOT')",Providence,lil48.xml,148,1,0,MOT,846,2209,CHI
5,3,28,112,1.612290981,115,3,yeah,"('CHI', 'MOT')",Providence,lil48.xml,148,33,5,MOT,846,2209,CHI
0,4,4,140,1.58240924,144,4,gonna,"('CHI', 'MOT')",Providence,lil48.xml,148,4,0,MOT,846,2209,CHI
1,15,1,131,1.531476371,146,15,up,"('CHI', 'MOT')",Providence,lil48.xml,148,2,1,MOT,846,2209,CHI
0,10,1,137,1.507438744,147,10,we,"('CHI', 'MOT')",Providence,lil48.xml,148,1,0,MOT,846,2209,CHI
0,6,3,139,1.435084525,145,6,my,"('CHI', 'MOT')",Providence,lil48.xml,148,3,0,MOT,846,2209,CHI
0,11,1,136,1.420427367,147,11,in,"('CHI', 'MOT')",Providence,lil48.xml,148,1,0,MOT,846,2209,CHI
0,5,4,139,1.400087683,144,5,have,"('CHI', 'MOT')",Providence,lil48.xml,148,4,0,MOT,846,2209,CHI
3,6,15,124,1.327453861,130,6,can,"('CHI', 'MOT')",Providence,lil48.xml,148,18,3,MOT,846,2209,CHI
3,11,8,126,1.270912287,137,11,it,"('CHI', 'MOT')",Providence,lil48.xml,148,11,3,MOT,846,2209,CHI
2,20,2,124,1.245937003,144,20,that,"('CHI', 'MOT')",Providence,lil48.xml,148,4,2,MOT,846,2209,CHI
7,19,8,114,1.155770703,133,19,a,"('CHI', 'MOT')",Providence,lil48.xml,148,15,7,MOT,846,2209,CHI
0,11,2,135,1.126011263,146,11,do,"('CHI', 'MOT')",Providence,lil48.xml,148,2,0,MOT,846,2209,CHI
0,19,1,128,0.909601744,147,19,is,"('CHI', 'MOT')",Providence,lil48.xml,148,1,0,MOT,846,2209,CHI
2,19,5,122,0.868500068,141,19,and,"('CHI', 'MOT')",Providence,lil48.xml,148,7,2,MOT,846,2209,CHI
2,22,4,120,0.853489831,142,22,oh,"('CHI', 'MOT')",Providence,lil48.xml,148,6,2,MOT,846,2209,CHI
0,15,2,131,0.83832919,146,15,are,"('CHI', 'MOT')",Providence,lil48.xml,148,2,0,MOT,846,2209,CHI
0,23,1,124,0.727280187,147,23,the,"('CHI', 'MOT')",Providence,lil48.xml,148,1,0,MOT,846,2209,CHI
0,15,3,130,0.608405952,145,15,what,"('CHI', 'MOT')",Providence,lil48.xml,148,3,0,MOT,846,2209,CHI
8,41,8,91,0.467023001,132,41,you,"('CHI', 'MOT')",Providence,lil48.xml,148,16,8,MOT,846,2209,CHI
1,22,5,120,0.448024723,142,22,to,"('CHI', 'MOT')",Providence,lil48.xml,148,6,1,MOT,846,2209,CHI
0,10,9,129,0.152969345,139,10,she,"('CHI', 'MOT')",Providence,lil48.xml,148,9,0,MOT,846,2209,CHI
1,0,5,414,4.644390899,414,0,big,"('MOT', 'CHI')",Providence,lil49a.xml,420,6,1,CHI,7681,1745,MOT
1,0,29,390,3.198673118,390,0,oh,"('MOT', 'CHI')",Providence,lil49a.xml,420,30,1,CHI,7681,1745,MOT
6,5,12,397,3.159833284,402,5,they,"('MOT', 'CHI')",Providence,lil49a.xml,420,18,6,CHI,7681,1745,MOT
2,1,23,394,3.093564523,395,1,think,"('MOT', 'CHI')",Providence,lil49a.xml,420,25,2,CHI,7681,1745,MOT
0,1,9,410,2.93240514,411,1,go,"('MOT', 'CHI')",Providence,lil49a.xml,420,9,0,CHI,7681,1745,MOT
1,3,9,407,2.842969519,410,3,gonna,"('MOT', 'CHI')",Providence,lil49a.xml,420,10,1,CHI,7681,1745,MOT
0,1,11,408,2.760496676,409,1,get,"('MOT', 'CHI')",Providence,lil49a.xml,420,11,0,CHI,7681,1745,MOT
0,1,11,408,2.760496676,409,1,make,"('MOT', 'CHI')",Providence,lil49a.xml,420,11,0,CHI,7681,1745,MOT
0,1,14,405,2.545531272,406,1,was,"('MOT', 'CHI')",Providence,lil49a.xml,420,14,0,CHI,7681,1745,MOT
1,2,19,398,2.499944527,400,2,my,"('MOT', 'CHI')",Providence,lil49a.xml,420,20,1,CHI,7681,1745,MOT
2,3,25,390,2.323907862,393,3,there,"('MOT', 'CHI')",Providence,lil49a.xml,420,27,2,CHI,7681,1745,MOT
0,2,12,406,2.278487541,408,2,put,"('MOT', 'CHI')",Providence,lil49a.xml,420,12,0,CHI,7681,1745,MOT
0,1,19,400,2.261266944,401,1,look,"('MOT', 'CHI')",Providence,lil49a.xml,420,19,0,CHI,7681,1745,MOT
2,5,17,396,2.261266944,401,5,have,"('MOT', 'CHI')",Providence,lil49a.xml,420,19,2,CHI,7681,1745,MOT
0,1,20,399,2.212262455,400,1,at,"('MOT', 'CHI')",Providence,lil49a.xml,420,20,0,CHI,7681,1745,MOT
4,7,23,386,2.141586306,393,7,he,"('MOT', 'CHI')",Providence,lil49a.xml,420,27,4,CHI,7681,1745,MOT
3,3,41,373,2.106252799,376,3,of,"('MOT', 'CHI')",Providence,lil49a.xml,420,44,3,CHI,7681,1745,MOT
0,1,23,396,2.076938411,397,1,but,"('MOT', 'CHI')",Providence,lil49a.xml,420,23,0,CHI,7681,1745,MOT
2,12,8,398,2.069779631,410,12,where,"('MOT', 'CHI')",Providence,lil49a.xml,420,10,2,CHI,7681,1745,MOT
2,3,35,380,2.001999616,383,3,on,"('MOT', 'CHI')",Providence,lil49a.xml,420,37,2,CHI,7681,1745,MOT
0,3,12,405,1.990805469,408,3,some,"('MOT', 'CHI')",Providence,lil49a.xml,420,12,0,CHI,7681,1745,MOT
0,2,17,401,1.960835799,403,2,not,"('MOT', 'CHI')",Providence,lil49a.xml,420,17,0,CHI,7681,1745,MOT
0,4,10,406,1.926678787,410,4,wanna,"('MOT', 'CHI')",Providence,lil49a.xml,420,10,0,CHI,7681,1745,MOT
5,10,30,375,1.741370977,385,10,are,"('MOT', 'CHI')",Providence,lil49a.xml,420,35,5,CHI,7681,1745,MOT
0,1,33,386,1.715084102,387,1,do,"('MOT', 'CHI')",Providence,lil49a.xml,420,33,0,CHI,7681,1745,MOT
7,19,21,373,1.658862796,392,19,one,"('MOT', 'CHI')",Providence,lil49a.xml,420,28,7,CHI,7681,1745,MOT
0,2,25,393,1.589487126,395,2,she,"('MOT', 'CHI')",Providence,lil49a.xml,420,25,0,CHI,7681,1745,MOT
2,0,0,4,1.504077397,4,0,the,"('CHI', 'MOT')",Providence,lil49a.xml,6,2,2,MOT,35,61,CHI
1,5,27,387,1.476541239,392,5,like,"('MOT', 'CHI')",Providence,lil49a.xml,420,28,1,CHI,7681,1745,MOT
1,18,7,394,1.471989082,412,18,want,"('MOT', 'CHI')",Providence,lil49a.xml,420,8,1,CHI,7681,1745,MOT
0,3,24,393,1.342061106,396,3,for,"('MOT', 'CHI')",Providence,lil49a.xml,420,24,0,CHI,7681,1745,MOT
9,17,47,347,1.254403658,364,17,what,"('MOT', 'CHI')",Providence,lil49a.xml,420,56,9,CHI,7681,1745,MOT
7,8,77,328,1.250915564,336,8,that,"('MOT', 'CHI')",Providence,lil49a.xml,420,84,7,CHI,7681,1745,MOT
9,11,72,328,1.230720313,339,11,a,"('MOT', 'CHI')",Providence,lil49a.xml,420,81,9,CHI,7681,1745,MOT
2,8,39,371,1.082986971,379,8,in,"('MOT', 'CHI')",Providence,lil49a.xml,420,41,2,CHI,7681,1745,MOT
21,21,90,288,1.012405093,309,21,the,"('MOT', 'CHI')",Providence,lil49a.xml,420,111,21,CHI,7681,1745,MOT
28,22,106,264,0.982107208,286,22,is,"('MOT', 'CHI')",Providence,lil49a.xml,420,134,28,CHI,7681,1745,MOT
16,21,96,287,0.74254474,308,21,you,"('MOT', 'CHI')",Providence,lil49a.xml,420,112,16,CHI,7681,1745,MOT
5,33,26,356,0.737598943,389,33,can,"('MOT', 'CHI')",Providence,lil49a.xml,420,31,5,CHI,7681,1745,MOT
1,0,2,3,0.693147181,3,0,one,"('CHI', 'MOT')",Providence,lil49a.xml,6,3,1,MOT,35,61,CHI
3,12,55,350,0.624154309,362,12,to,"('MOT', 'CHI')",Providence,lil49a.xml,420,58,3,CHI,7681,1745,MOT
3,31,23,363,0.569768159,394,31,no,"('MOT', 'CHI')",Providence,lil49a.xml,420,26,3,CHI,7681,1745,MOT
1,36,10,373,0.535873125,409,36,yeah,"('MOT', 'CHI')",Providence,lil49a.xml,420,11,1,CHI,7681,1745,MOT
2,11,52,355,0.496436886,366,11,and,"('MOT', 'CHI')",Providence,lil49a.xml,420,54,2,CHI,7681,1745,MOT
1,2,0,3,0.441832752,5,2,is,"('CHI', 'MOT')",Providence,lil49a.xml,6,1,1,MOT,35,61,CHI
11,40,55,314,0.426757609,354,40,it,"('MOT', 'CHI')",Providence,lil49a.xml,420,66,11,CHI,7681,1745,MOT
0,1,1,4,0.15415068,5,1,a,"('CHI', 'MOT')",Providence,lil49a.xml,6,1,0,MOT,35,61,CHI
0,12,27,381,0.046640577,393,12,this,"('MOT', 'CHI')",Providence,lil49a.xml,420,27,0,CHI,7681,1745,MOT
0,1,2,3,-0.287682072,4,1,for,"('CHI', 'MOT')",Providence,lil49a.xml,6,2,0,MOT,35,61,CHI
1,1,2,223,3.811097087,224,1,big,"('MOT', 'CHI')",Providence,lil49b.xml,227,3,1,CHI,1894,1276,MOT
0,1,1,249,3.737669618,250,1,get,"('CHI', 'MOT')",Providence,lil49b.xml,251,1,0,MOT,2335,1814,CHI
0,1,1,225,3.63758616,226,1,think,"('MOT', 'CHI')",Providence,lil49b.xml,227,1,0,CHI,1894,1276,MOT
0,1,2,248,3.446011397,249,1,look,"('CHI', 'MOT')",Providence,lil49b.xml,251,2,0,MOT,2335,1814,CHI
1,1,5,244,3.429946795,245,1,she,"('CHI', 'MOT')",Providence,lil49b.xml,251,6,1,MOT,2335,1814,CHI
4,1,12,210,3.38721114,211,1,are,"('MOT', 'CHI')",Providence,lil49b.xml,227,16,4,CHI,1894,1276,MOT
1,3,2,245,3.218875825,248,3,at,"('CHI', 'MOT')",Providence,lil49b.xml,251,3,1,MOT,2335,1814,CHI
3,3,4,217,3.205452805,220,3,where,"('MOT', 'CHI')",Providence,lil49b.xml,227,7,3,CHI,1894,1276,MOT
0,3,1,247,3.044522438,250,3,want,"('CHI', 'MOT')",Providence,lil49b.xml,251,1,0,MOT,2335,1814,CHI
0,2,2,247,3.040546289,249,2,put,"('CHI', 'MOT')",Providence,lil49b.xml,251,2,0,MOT,2335,1814,CHI
0,2,2,247,3.040546289,249,2,on,"('CHI', 'MOT')",Providence,lil49b.xml,251,2,0,MOT,2335,1814,CHI
1,2,5,243,3.024481687,245,2,where,"('CHI', 'MOT')",Providence,lil49b.xml,251,6,1,MOT,2335,1814,CHI
2,2,8,239,3.008154794,241,2,some,"('CHI', 'MOT')",Providence,lil49b.xml,251,10,2,MOT,2335,1814,CHI
0,2,2,223,2.940043368,225,2,they,"('MOT', 'CHI')",Providence,lil49b.xml,227,2,0,CHI,1894,1276,MOT
0,1,4,222,2.931193752,223,1,did,"('MOT', 'CHI')",Providence,lil49b.xml,227,4,0,CHI,1894,1276,MOT
0,4,1,246,2.821378886,250,4,for,"('CHI', 'MOT')",Providence,lil49b.xml,251,1,0,MOT,2335,1814,CHI
0,4,1,246,2.821378886,250,4,make,"('CHI', 'MOT')",Providence,lil49b.xml,251,1,0,MOT,2335,1814,CHI
1,3,4,219,2.772588722,222,3,wanna,"('MOT', 'CHI')",Providence,lil49b.xml,227,5,1,CHI,1894,1276,MOT
0,1,5,221,2.772588722,222,1,put,"('MOT', 'CHI')",Providence,lil49b.xml,227,5,0,CHI,1894,1276,MOT
3,7,3,238,2.736799614,245,7,no,"('CHI', 'MOT')",Providence,lil49b.xml,251,6,3,MOT,2335,1814,CHI
2,6,3,240,2.720220737,246,6,have,"('CHI', 'MOT')",Providence,lil49b.xml,251,5,2,MOT,2335,1814,CHI
4,7,5,235,2.629269323,242,7,he,"('CHI', 'MOT')",Providence,lil49b.xml,251,9,4,MOT,2335,1814,CHI
0,3,3,245,2.525728644,248,3,gonna,"('CHI', 'MOT')",Providence,lil49b.xml,251,3,0,MOT,2335,1814,CHI
1,5,4,241,2.468906308,246,5,can,"('CHI', 'MOT')",Providence,lil49b.xml,251,5,1,MOT,2335,1814,CHI
3,5,10,233,2.367123614,238,5,they,"('CHI', 'MOT')",Providence,lil49b.xml,251,13,3,MOT,2335,1814,CHI
0,2,5,220,2.367123614,222,2,like,"('MOT', 'CHI')",Providence,lil49b.xml,227,5,0,CHI,1894,1276,MOT
0,5,2,244,2.347399109,249,5,think,"('CHI', 'MOT')",Providence,lil49b.xml,251,2,0,MOT,2335,1814,CHI
0,2,6,243,2.331334506,245,2,like,"('CHI', 'MOT')",Providence,lil49b.xml,251,6,0,MOT,2335,1814,CHI
0,2,6,243,2.331334506,245,2,not,"('CHI', 'MOT')",Providence,lil49b.xml,251,6,0,MOT,2335,1814,CHI
0,5,2,220,2.246896187,225,5,get,"('MOT', 'CHI')",Providence,lil49b.xml,227,2,0,CHI,1894,1276,MOT
0,3,4,220,2.238046572,223,3,not,"('MOT', 'CHI')",Providence,lil49b.xml,227,4,0,CHI,1894,1276,MOT
0,1,11,215,2.126398525,216,1,we,"('MOT', 'CHI')",Providence,lil49b.xml,227,11,0,CHI,1894,1276,MOT
0,5,3,243,2.120263536,248,5,see,"('CHI', 'MOT')",Providence,lil49b.xml,251,3,0,MOT,2335,1814,CHI
1,8,3,215,2.120263536,223,8,make,"('MOT', 'CHI')",Providence,lil49b.xml,227,4,1,CHI,1894,1276,MOT
1,5,6,215,2.106840516,220,5,little,"('MOT', 'CHI')",Providence,lil49b.xml,227,7,1,CHI,1894,1276,MOT
0,2,7,218,2.106840516,220,2,gonna,"('MOT', 'CHI')",Providence,lil49b.xml,227,7,0,CHI,1894,1276,MOT
0,2,7,218,2.106840516,220,2,see,"('MOT', 'CHI')",Providence,lil49b.xml,227,7,0,CHI,1894,1276,MOT
0,3,5,219,2.079441542,222,3,do,"('MOT', 'CHI')",Providence,lil49b.xml,227,5,0,CHI,1894,1276,MOT
0,5,3,219,2.019337618,224,5,this,"('MOT', 'CHI')",Providence,lil49b.xml,227,3,0,CHI,1894,1276,MOT
2,7,7,211,2.014903021,218,7,no,"('MOT', 'CHI')",Providence,lil49b.xml,227,9,2,CHI,1894,1276,MOT
0,3,6,218,1.941435869,221,3,want,"('MOT', 'CHI')",Providence,lil49b.xml,227,6,0,CHI,1894,1276,MOT
0,3,6,218,1.941435869,221,3,some,"('MOT', 'CHI')",Providence,lil49b.xml,227,6,0,CHI,1894,1276,MOT
7,7,21,192,1.902107526,199,7,it,"('MOT', 'CHI')",Providence,lil49b.xml,227,28,7,CHI,1894,1276,MOT
0,4,5,218,1.85629799,222,4,look,"('MOT', 'CHI')",Providence,lil49b.xml,227,5,0,CHI,1894,1276,MOT
0,4,5,218,1.85629799,222,4,but,"('MOT', 'CHI')",Providence,lil49b.xml,227,5,0,CHI,1894,1276,MOT
1,6,7,213,1.84281464,219,6,one,"('MOT', 'CHI')",Providence,lil49b.xml,227,8,1,CHI,1894,1276,MOT
4,10,12,225,1.789231023,235,10,to,"('CHI', 'MOT')",Providence,lil49b.xml,251,16,4,MOT,2335,1814,CHI
0,3,9,239,1.712978591,242,3,with,"('CHI', 'MOT')",Providence,lil49b.xml,251,9,0,MOT,2335,1814,CHI
1,8,6,212,1.701375408,220,8,yeah,"('MOT', 'CHI')",Providence,lil49b.xml,227,7,1,CHI,1894,1276,MOT
0,4,7,240,1.698669046,244,4,go,"('CHI', 'MOT')",Providence,lil49b.xml,251,7,0,MOT,2335,1814,CHI
1,12,4,234,1.69571642,246,12,are,"('CHI', 'MOT')",Providence,lil49b.xml,251,5,1,MOT,2335,1814,CHI
0,6,4,217,1.678430784,223,6,he,"('MOT', 'CHI')",Providence,lil49b.xml,227,4,0,CHI,1894,1276,MOT
0,1,20,230,1.66684882,231,1,one,"('CHI', 'MOT')",Providence,lil49b.xml,251,20,0,MOT,2335,1814,CHI
0,2,12,213,1.642227735,215,2,go,"('MOT', 'CHI')",Providence,lil49b.xml,227,12,0,CHI,1894,1276,MOT
1,5,11,210,1.642227735,215,5,in,"('MOT', 'CHI')",Providence,lil49b.xml,227,12,1,CHI,1894,1276,MOT
2,6,14,205,1.623622547,211,6,that,"('MOT', 'CHI')",Providence,lil49b.xml,227,16,2,CHI,1894,1276,MOT
0,4,7,216,1.596014892,220,4,have,"('MOT', 'CHI')",Providence,lil49b.xml,227,7,0,CHI,1894,1276,MOT
6,20,9,216,1.540445041,236,20,is,"('CHI', 'MOT')",Providence,lil49b.xml,251,15,6,MOT,2335,1814,CHI
0,5,7,239,1.516347489,244,5,we,"('CHI', 'MOT')",Providence,lil49b.xml,251,7,0,MOT,2335,1814,CHI
0,6,6,239,1.484036646,245,6,big,"('CHI', 'MOT')",Providence,lil49b.xml,251,6,0,MOT,2335,1814,CHI
0,11,3,237,1.427116356,248,11,do,"('CHI', 'MOT')",Providence,lil49b.xml,251,3,0,MOT,2335,1814,CHI
2,10,12,227,1.404591846,237,10,yeah,"('CHI', 'MOT')",Providence,lil49b.xml,251,14,2,MOT,2335,1814,CHI
0,4,10,237,1.398716881,241,4,all,"('CHI', 'MOT')",Providence,lil49b.xml,251,10,0,MOT,2335,1814,CHI
1,4,20,226,1.394952424,230,4,up,"('CHI', 'MOT')",Providence,lil49b.xml,251,21,1,MOT,2335,1814,CHI
1,6,14,230,1.386294361,236,6,little,"('CHI', 'MOT')",Providence,lil49b.xml,251,15,1,MOT,2335,1814,CHI
2,8,14,203,1.372308119,211,8,what,"('MOT', 'CHI')",Providence,lil49b.xml,227,16,2,CHI,1894,1276,MOT
2,16,7,226,1.364671897,242,16,there,"('CHI', 'MOT')",Providence,lil49b.xml,251,9,2,MOT,2335,1814,CHI
1,8,10,208,1.315468309,216,8,there,"('MOT', 'CHI')",Providence,lil49b.xml,227,11,1,CHI,1894,1276,MOT
1,10,8,208,1.290984181,218,10,can,"('MOT', 'CHI')",Providence,lil49b.xml,227,9,1,CHI,1894,1276,MOT
0,4,12,211,1.131402111,215,4,of,"('MOT', 'CHI')",Providence,lil49b.xml,227,12,0,CHI,1894,1276,MOT
0,4,15,232,1.029619417,236,4,this,"('CHI', 'MOT')",Providence,lil49b.xml,251,15,0,MOT,2335,1814,CHI
0,9,7,235,1.005521866,244,9,did,"('CHI', 'MOT')",Providence,lil49b.xml,251,7,0,MOT,2335,1814,CHI
0,13,4,210,0.985283603,223,13,my,"('MOT', 'CHI')",Providence,lil49b.xml,227,4,0,CHI,1894,1276,MOT
9,23,24,195,0.962810748,218,23,a,"('CHI', 'MOT')",Providence,lil49b.xml,251,33,9,MOT,2335,1814,CHI
0,6,10,211,0.958254931,217,6,with,"('MOT', 'CHI')",Providence,lil49b.xml,227,10,0,CHI,1894,1276,MOT
1,11,15,224,0.785928914,235,11,my,"('CHI', 'MOT')",Providence,lil49b.xml,251,16,1,MOT,2335,1814,CHI
3,21,15,212,0.759105148,233,21,what,"('CHI', 'MOT')",Providence,lil49b.xml,251,18,3,MOT,2335,1814,CHI
6,9,55,181,0.757685702,190,9,and,"('CHI', 'MOT')",Providence,lil49b.xml,251,61,6,MOT,2335,1814,CHI
8,18,37,188,0.740176076,206,18,the,"('CHI', 'MOT')",Providence,lil49b.xml,251,45,8,MOT,2335,1814,CHI
1,3,44,179,0.671640975,182,3,oh,"('MOT', 'CHI')",Providence,lil49b.xml,227,45,1,CHI,1894,1276,MOT
0,9,11,231,0.621403276,240,9,of,"('CHI', 'MOT')",Providence,lil49b.xml,251,11,0,MOT,2335,1814,CHI
5,36,15,195,0.540837557,231,36,you,"('CHI', 'MOT')",Providence,lil49b.xml,251,20,5,MOT,2335,1814,CHI
9,17,46,155,0.528217366,172,17,you,"('MOT', 'CHI')",Providence,lil49b.xml,227,55,9,CHI,1894,1276,MOT
3,23,18,207,0.519483687,230,23,that,"('CHI', 'MOT')",Providence,lil49b.xml,251,21,3,MOT,2335,1814,CHI
1,11,18,197,0.510825624,208,11,on,"('MOT', 'CHI')",Providence,lil49b.xml,227,19,1,CHI,1894,1276,MOT
1,51,4,195,0.309422059,246,51,oh,"('CHI', 'MOT')",Providence,lil49b.xml,251,5,1,MOT,2335,1814,CHI
1,11,25,214,0.300986038,225,11,it,"('CHI', 'MOT')",Providence,lil49b.xml,251,26,1,MOT,2335,1814,CHI
1,9,29,188,0.218131009,197,9,is,"('MOT', 'CHI')",Providence,lil49b.xml,227,30,1,CHI,1894,1276,MOT
1,12,25,189,0.109199292,201,12,the,"('MOT', 'CHI')",Providence,lil49b.xml,227,26,1,CHI,1894,1276,MOT
1,16,22,212,0.079137321,228,16,was,"('CHI', 'MOT')",Providence,lil49b.xml,251,23,1,MOT,2335,1814,CHI
0,1,1,3,0,4,1,oh,"('OPE', 'MOT')",Providence,lil49b.xml,5,1,0,MOT,21,32,OPE
0,1,1,3,0,4,1,is,"('OPE', 'MOT')",Providence,lil49b.xml,5,1,0,MOT,21,32,OPE
0,1,1,3,0,4,1,that,"('OPE', 'MOT')",Providence,lil49b.xml,5,1,0,MOT,21,32,OPE
0,1,1,3,0,4,1,do,"('OPE', 'MOT')",Providence,lil49b.xml,5,1,0,MOT,21,32,OPE
1,14,28,208,-0.037244173,222,14,in,"('CHI', 'MOT')",Providence,lil49b.xml,251,29,1,MOT,2335,1814,CHI
1,16,28,182,-0.275736001,198,16,a,"('MOT', 'CHI')",Providence,lil49b.xml,227,29,1,CHI,1894,1276,MOT
0,14,17,196,-0.295902906,210,14,to,"('MOT', 'CHI')",Providence,lil49b.xml,227,17,0,CHI,1894,1276,MOT
0,15,17,195,-0.360441427,210,15,and,"('MOT', 'CHI')",Providence,lil49b.xml,227,17,0,CHI,1894,1276,MOT
3,0,1,107,4.285882774,107,0,some,"('CHI', 'MOT')",Providence,lil50.xml,111,4,3,MOT,715,1948,CHI
2,1,1,107,3.496507561,108,1,with,"('CHI', 'MOT')",Providence,lil50.xml,111,3,2,MOT,715,1948,CHI
1,1,1,108,3.32323584,109,1,she,"('CHI', 'MOT')",Providence,lil50.xml,111,2,1,MOT,715,1948,CHI
2,1,5,147,3.218875825,148,1,she,"('MOT', 'CHI')",Providence,lil50.xml,155,7,2,CHI,3213,808,MOT
0,1,2,152,2.963983575,153,1,want,"('MOT', 'CHI')",Providence,lil50.xml,155,2,0,CHI,3213,808,MOT
0,1,1,109,2.926739402,110,1,where,"('CHI', 'MOT')",Providence,lil50.xml,111,1,0,MOT,715,1948,CHI
1,0,14,140,2.815760894,140,0,up,"('MOT', 'CHI')",Providence,lil50.xml,155,15,1,CHI,3213,808,MOT
1,1,4,105,2.736221078,106,1,wanna,"('CHI', 'MOT')",Providence,lil50.xml,111,5,1,MOT,715,1948,CHI
0,1,3,151,2.734367509,152,1,wanna,"('MOT', 'CHI')",Providence,lil50.xml,155,3,0,CHI,3213,808,MOT
1,3,1,106,2.63008866,109,3,get,"('CHI', 'MOT')",Providence,lil50.xml,111,2,1,MOT,715,1948,CHI
0,2,1,108,2.521274294,110,2,look,"('CHI', 'MOT')",Providence,lil50.xml,111,1,0,MOT,715,1948,CHI
0,2,1,108,2.521274294,110,2,think,"('CHI', 'MOT')",Providence,lil50.xml,111,1,0,MOT,715,1948,CHI
1,2,3,105,2.494123305,107,2,but,"('CHI', 'MOT')",Providence,lil50.xml,111,4,1,MOT,715,1948,CHI
5,1,18,87,2.379546134,88,1,yeah,"('CHI', 'MOT')",Providence,lil50.xml,111,23,5,MOT,715,1948,CHI
3,8,0,100,2.280112237,108,8,at,"('CHI', 'MOT')",Providence,lil50.xml,111,3,3,MOT,715,1948,CHI
0,3,1,107,2.233592222,110,3,little,"('CHI', 'MOT')",Providence,lil50.xml,111,1,0,MOT,715,1948,CHI
0,3,1,107,2.233592222,110,3,not,"('CHI', 'MOT')",Providence,lil50.xml,111,1,0,MOT,715,1948,CHI
0,2,2,107,2.224623552,109,2,this,"('CHI', 'MOT')",Providence,lil50.xml,111,2,0,MOT,715,1948,CHI
0,2,4,149,2.140066163,151,2,see,"('MOT', 'CHI')",Providence,lil50.xml,155,4,0,CHI,3213,808,MOT
1,1,14,139,2.122613714,140,1,do,"('MOT', 'CHI')",Providence,lil50.xml,155,15,1,CHI,3213,808,MOT
4,3,9,95,2.120263536,98,3,no,"('CHI', 'MOT')",Providence,lil50.xml,111,13,4,MOT,715,1948,CHI
1,3,6,145,2.120263536,148,3,no,"('MOT', 'CHI')",Providence,lil50.xml,155,7,1,CHI,3213,808,MOT
0,1,7,147,2.120263536,148,1,big,"('MOT', 'CHI')",Providence,lil50.xml,155,7,0,CHI,3213,808,MOT
3,6,3,99,2.033771505,105,6,want,"('CHI', 'MOT')",Providence,lil50.xml,111,6,3,MOT,715,1948,CHI
3,4,6,98,2.023352075,102,4,can,"('CHI', 'MOT')",Providence,lil50.xml,111,9,3,MOT,715,1948,CHI
1,0,1,13,2.014903021,13,0,is,"('MOT', 'OPE')",Providence,lil50.xml,15,2,1,OPE,190,63,MOT
0,4,1,106,2.01044867,110,4,on,"('CHI', 'MOT')",Providence,lil50.xml,111,1,0,MOT,715,1948,CHI
0,3,2,106,1.936941479,109,3,they,"('CHI', 'MOT')",Providence,lil50.xml,111,2,0,MOT,715,1948,CHI
0,3,2,106,1.936941479,109,3,see,"('CHI', 'MOT')",Providence,lil50.xml,111,2,0,MOT,715,1948,CHI
0,3,2,106,1.936941479,109,3,did,"('CHI', 'MOT')",Providence,lil50.xml,111,2,0,MOT,715,1948,CHI
1,2,12,140,1.85629799,142,2,this,"('MOT', 'CHI')",Providence,lil50.xml,155,13,1,CHI,3213,808,MOT
0,5,1,105,1.828127113,110,5,for,"('CHI', 'MOT')",Providence,lil50.xml,111,1,0,MOT,715,1948,CHI
1,3,9,142,1.812378756,145,3,have,"('MOT', 'CHI')",Providence,lil50.xml,155,10,1,CHI,3213,808,MOT
0,2,4,105,1.800976124,107,2,all,"('CHI', 'MOT')",Providence,lil50.xml,111,4,0,MOT,715,1948,CHI
1,0,2,12,1.722766598,12,0,the,"('MOT', 'OPE')",Providence,lil50.xml,15,3,1,OPE,190,63,MOT
0,2,7,146,1.714798428,148,2,was,"('MOT', 'CHI')",Providence,lil50.xml,155,7,0,CHI,3213,808,MOT
2,14,0,95,1.713797928,109,14,the,"('CHI', 'MOT')",Providence,lil50.xml,111,2,2,MOT,715,1948,CHI
1,0,0,6,1.673976434,6,0,some,"('CHI', 'OPE')",Providence,lil50.xml,7,1,1,OPE,58,26,CHI
0,1,12,142,1.644529232,143,1,with,"('MOT', 'CHI')",Providence,lil50.xml,155,12,0,CHI,3213,808,MOT
0,4,4,147,1.62924054,151,4,gonna,"('MOT', 'CHI')",Providence,lil50.xml,155,4,0,CHI,3213,808,MOT
0,2,8,145,1.602748924,147,2,for,"('MOT', 'CHI')",Providence,lil50.xml,155,8,0,CHI,3213,808,MOT
1,1,24,129,1.586965057,130,1,what,"('MOT', 'CHI')",Providence,lil50.xml,155,25,1,CHI,3213,808,MOT
0,7,1,103,1.540445041,110,7,of,"('CHI', 'MOT')",Providence,lil50.xml,111,1,0,MOT,715,1948,CHI
1,2,17,135,1.533276551,137,2,like,"('MOT', 'CHI')",Providence,lil50.xml,155,18,1,CHI,3213,808,MOT
2,9,3,97,1.532248274,106,9,in,"('CHI', 'MOT')",Providence,lil50.xml,111,5,2,MOT,715,1948,CHI
0,3,4,104,1.513294052,107,3,my,"('CHI', 'MOT')",Providence,lil50.xml,111,4,0,MOT,715,1948,CHI
1,5,5,100,1.494775004,105,5,have,"('CHI', 'MOT')",Providence,lil50.xml,111,6,1,MOT,715,1948,CHI
0,4,6,145,1.328400383,149,4,get,"('MOT', 'CHI')",Providence,lil50.xml,155,6,0,CHI,3213,808,MOT
0,9,1,101,1.31730149,110,9,like,"('CHI', 'MOT')",Providence,lil50.xml,111,1,0,MOT,715,1948,CHI
2,11,6,136,1.315066852,147,11,one,"('MOT', 'CHI')",Providence,lil50.xml,155,8,2,CHI,3213,808,MOT
0,1,17,137,1.304056263,138,1,on,"('MOT', 'CHI')",Providence,lil50.xml,155,17,0,CHI,3213,808,MOT
1,0,1,5,1.252762968,5,0,in,"('CHI', 'OPE')",Providence,lil50.xml,7,2,1,OPE,58,26,CHI
0,7,2,102,1.243794299,109,7,that,"('CHI', 'MOT')",Providence,lil50.xml,111,2,0,MOT,715,1948,CHI
0,3,9,143,1.21302264,146,3,at,"('MOT', 'CHI')",Providence,lil50.xml,155,9,0,CHI,3213,808,MOT
0,2,13,140,1.16315081,142,2,but,"('MOT', 'CHI')",Providence,lil50.xml,155,13,0,CHI,3213,808,MOT
2,15,5,133,1.139434283,148,15,yeah,"('MOT', 'CHI')",Providence,lil50.xml,155,7,2,CHI,3213,808,MOT
0,4,8,143,1.091923301,147,4,go,"('MOT', 'CHI')",Providence,lil50.xml,155,8,0,CHI,3213,808,MOT
0,2,14,139,1.091643619,141,2,of,"('MOT', 'CHI')",Providence,lil50.xml,155,14,0,CHI,3213,808,MOT
1,3,20,131,1.084013489,134,3,is,"('MOT', 'CHI')",Providence,lil50.xml,155,21,1,CHI,3213,808,MOT
3,6,21,125,1.072636802,131,6,it,"('MOT', 'CHI')",Providence,lil50.xml,155,24,3,CHI,3213,808,MOT
0,5,7,143,1.021651248,148,5,my,"('MOT', 'CHI')",Providence,lil50.xml,155,7,0,CHI,3213,808,MOT
3,16,4,88,1.019295534,104,16,to,"('CHI', 'MOT')",Providence,lil50.xml,111,7,3,MOT,715,1948,CHI
0,4,9,142,0.989879089,146,4,some,"('MOT', 'CHI')",Providence,lil50.xml,155,9,0,CHI,3213,808,MOT
0,1,1,13,0.980829253,14,1,yeah,"('MOT', 'OPE')",Providence,lil50.xml,15,1,0,OPE,190,63,MOT
0,1,1,13,0.980829253,14,1,think,"('MOT', 'OPE')",Providence,lil50.xml,15,1,0,OPE,190,63,MOT
5,5,37,108,0.960742494,113,5,you,"('MOT', 'CHI')",Providence,lil50.xml,155,42,5,CHI,3213,808,MOT
0,2,17,136,0.898591155,138,2,in,"('MOT', 'CHI')",Providence,lil50.xml,155,17,0,CHI,3213,808,MOT
1,11,8,135,0.807557532,146,11,can,"('MOT', 'CHI')",Providence,lil50.xml,155,9,1,CHI,3213,808,MOT
1,2,0,6,0.798507696,8,2,you,"('OPE', 'MOT')",Providence,lil50.xml,9,1,1,MOT,56,150,OPE
3,3,48,101,0.693147181,104,3,the,"('MOT', 'CHI')",Providence,lil50.xml,155,51,3,CHI,3213,808,MOT
0,18,1,92,0.675447603,110,18,do,"('CHI', 'MOT')",Providence,lil50.xml,111,1,0,MOT,715,1948,CHI
0,1,2,12,0.628608659,13,1,little,"('MOT', 'OPE')",Providence,lil50.xml,15,2,0,OPE,190,63,MOT
4,12,14,81,0.602633173,93,12,and,"('CHI', 'MOT')",Providence,lil50.xml,111,18,4,MOT,715,1948,CHI
4,33,3,71,0.549291905,104,33,you,"('CHI', 'MOT')",Providence,lil50.xml,111,7,4,MOT,715,1948,CHI
0,7,6,98,0.513945751,105,7,go,"('CHI', 'MOT')",Providence,lil50.xml,111,6,0,MOT,715,1948,CHI
0,1,1,7,0.510825624,8,1,yeah,"('OPE', 'MOT')",Providence,lil50.xml,9,1,0,MOT,56,150,OPE
0,1,1,7,0.510825624,8,1,it,"('OPE', 'MOT')",Providence,lil50.xml,9,1,0,MOT,56,150,OPE
0,1,1,7,0.510825624,8,1,was,"('OPE', 'MOT')",Providence,lil50.xml,9,1,0,MOT,56,150,OPE
0,22,1,88,0.484392367,110,22,what,"('CHI', 'MOT')",Providence,lil50.xml,111,1,0,MOT,715,1948,CHI
1,1,1,3,0.405465108,4,1,that,"('OPE', 'CHI')",Providence,lil50.xml,6,2,1,CHI,22,50,OPE
0,5,10,96,0.358062869,101,5,one,"('CHI', 'MOT')",Providence,lil50.xml,111,10,0,MOT,715,1948,CHI
0,7,11,137,0.339215723,144,7,all,"('MOT', 'CHI')",Providence,lil50.xml,155,11,0,CHI,3213,808,MOT
0,1,3,11,0.336472237,12,1,you,"('MOT', 'OPE')",Providence,lil50.xml,15,3,0,OPE,190,63,MOT
0,1,3,11,0.336472237,12,1,a,"('MOT', 'OPE')",Providence,lil50.xml,15,3,0,OPE,190,63,MOT
0,1,3,11,0.336472237,12,1,that,"('MOT', 'OPE')",Providence,lil50.xml,15,3,0,OPE,190,63,MOT
0,1,1,5,0.287682072,6,1,a,"('CHI', 'OPE')",Providence,lil50.xml,7,1,0,OPE,58,26,CHI
7,10,48,90,0.263467814,100,10,and,"('MOT', 'CHI')",Providence,lil50.xml,155,55,7,CHI,3213,808,MOT
1,4,35,115,0.241913654,119,4,to,"('MOT', 'CHI')",Providence,lil50.xml,155,36,1,CHI,3213,808,MOT
0,1,1,4,0.15415068,5,1,it,"('OPE', 'CHI')",Providence,lil50.xml,6,1,0,CHI,22,50,OPE
0,2,1,6,0.105360516,8,2,the,"('OPE', 'MOT')",Providence,lil50.xml,9,1,0,MOT,56,150,OPE
3,9,40,103,0.013245227,112,9,a,"('MOT', 'CHI')",Providence,lil50.xml,155,43,3,CHI,3213,808,MOT
1,16,9,85,0.009756175,101,16,a,"('CHI', 'MOT')",Providence,lil50.xml,111,10,1,MOT,715,1948,CHI
0,5,21,129,-0.014598799,134,5,that,"('MOT', 'CHI')",Providence,lil50.xml,155,21,0,CHI,3213,808,MOT
0,16,5,90,-0.096992266,106,16,is,"('CHI', 'MOT')",Providence,lil50.xml,111,5,0,MOT,715,1948,CHI
0,3,1,5,-0.182321557,8,3,and,"('OPE', 'MOT')",Providence,lil50.xml,9,1,0,MOT,56,150,OPE
0,14,8,89,-0.356674944,103,14,it,"('CHI', 'MOT')",Providence,lil50.xml,111,8,0,MOT,715,1948,CHI
0,3,3,9,-0.356674944,12,3,oh,"('MOT', 'OPE')",Providence,lil50.xml,15,3,0,OPE,190,63,MOT
0,3,1,2,-0.538996501,5,3,yeah,"('OPE', 'CHI')",Providence,lil50.xml,6,1,0,CHI,22,50,OPE
0,3,1,2,-0.538996501,5,3,is,"('OPE', 'CHI')",Providence,lil50.xml,6,1,0,CHI,22,50,OPE
1,0,4,201,4.060443011,201,0,but,"('MOT', 'CHI')",Providence,lil51.xml,206,5,1,CHI,2220,989,MOT
2,0,11,193,3.663561646,193,0,gonna,"('MOT', 'CHI')",Providence,lil51.xml,206,13,2,CHI,2220,989,MOT
0,1,1,210,3.569532696,211,1,make,"('CHI', 'MOT')",Providence,lil51.xml,212,1,0,MOT,934,2676,CHI
1,2,1,208,3.564826805,210,2,up,"('CHI', 'MOT')",Providence,lil51.xml,212,2,1,MOT,934,2676,CHI
5,3,2,202,3.540959324,205,3,they,"('CHI', 'MOT')",Providence,lil51.xml,212,7,5,MOT,934,2676,CHI
1,0,9,196,3.496507561,196,0,think,"('MOT', 'CHI')",Providence,lil51.xml,206,10,1,CHI,2220,989,MOT
1,0,12,193,3.258096538,193,0,see,"('MOT', 'CHI')",Providence,lil51.xml,206,13,1,CHI,2220,989,MOT
4,5,3,194,2.923758774,199,5,was,"('MOT', 'CHI')",Providence,lil51.xml,206,7,4,CHI,2220,989,MOT
1,5,1,205,2.871679625,210,5,some,"('CHI', 'MOT')",Providence,lil51.xml,212,2,1,MOT,934,2676,CHI
1,5,1,205,2.871679625,210,5,big,"('CHI', 'MOT')",Providence,lil51.xml,212,2,1,MOT,934,2676,CHI
0,2,2,208,2.871679625,210,2,not,"('CHI', 'MOT')",Providence,lil51.xml,212,2,0,MOT,934,2676,CHI
0,2,2,202,2.842969519,204,2,they,"('MOT', 'CHI')",Providence,lil51.xml,206,2,0,CHI,2220,989,MOT
2,6,2,202,2.708050201,208,6,no,"('CHI', 'MOT')",Providence,lil51.xml,212,4,2,MOT,934,2676,CHI
4,2,15,185,2.708050201,187,2,some,"('MOT', 'CHI')",Providence,lil51.xml,206,19,4,CHI,2220,989,MOT
1,3,4,204,2.703276922,207,3,one,"('CHI', 'MOT')",Providence,lil51.xml,212,5,1,MOT,934,2676,CHI
0,1,5,200,2.674148649,201,1,get,"('MOT', 'CHI')",Providence,lil51.xml,206,5,0,CHI,2220,989,MOT
0,4,1,207,2.653241965,211,4,she,"('CHI', 'MOT')",Providence,lil51.xml,212,1,0,MOT,934,2676,CHI
0,2,3,201,2.614959778,203,2,at,"('MOT', 'CHI')",Providence,lil51.xml,206,3,0,CHI,2220,989,MOT
2,9,1,200,2.538447417,209,9,with,"('CHI', 'MOT')",Providence,lil51.xml,212,3,2,MOT,934,2676,CHI
0,1,6,199,2.535678975,200,1,go,"('MOT', 'CHI')",Providence,lil51.xml,206,6,0,CHI,2220,989,MOT
0,1,6,199,2.535678975,200,1,we,"('MOT', 'CHI')",Providence,lil51.xml,206,6,0,CHI,2220,989,MOT
0,5,1,206,2.470920408,211,5,all,"('CHI', 'MOT')",Providence,lil51.xml,212,1,0,MOT,934,2676,CHI
1,1,14,190,2.429476845,191,1,in,"('MOT', 'CHI')",Providence,lil51.xml,206,15,1,CHI,2220,989,MOT
1,1,14,190,2.429476845,191,1,on,"('MOT', 'CHI')",Providence,lil51.xml,206,15,1,CHI,2220,989,MOT
1,3,6,196,2.41293315,199,3,he,"('MOT', 'CHI')",Providence,lil51.xml,206,7,1,CHI,2220,989,MOT
3,3,13,187,2.367123614,190,3,to,"('MOT', 'CHI')",Providence,lil51.xml,206,16,3,CHI,2220,989,MOT
1,1,15,189,2.367123614,190,1,with,"('MOT', 'CHI')",Providence,lil51.xml,206,16,1,CHI,2220,989,MOT
3,9,3,197,2.341805806,206,9,like,"('CHI', 'MOT')",Providence,lil51.xml,212,6,3,MOT,934,2676,CHI
5,14,1,192,2.341805806,206,14,are,"('CHI', 'MOT')",Providence,lil51.xml,212,6,5,MOT,934,2676,CHI
0,3,3,200,2.327277706,203,3,big,"('MOT', 'CHI')",Providence,lil51.xml,206,3,0,CHI,2220,989,MOT
2,12,1,197,2.276083152,209,12,in,"('CHI', 'MOT')",Providence,lil51.xml,212,3,2,MOT,934,2676,CHI
0,7,1,204,2.183238335,211,7,get,"('CHI', 'MOT')",Providence,lil51.xml,212,1,0,MOT,934,2676,CHI
1,15,0,196,2.183238335,211,15,little,"('CHI', 'MOT')",Providence,lil51.xml,212,1,1,MOT,934,2676,CHI
2,17,0,193,2.178532444,210,17,did,"('CHI', 'MOT')",Providence,lil51.xml,212,2,2,MOT,934,2676,CHI
1,9,2,200,2.132982309,209,9,at,"('CHI', 'MOT')",Providence,lil51.xml,212,3,1,MOT,934,2676,CHI
0,2,6,198,2.130213867,200,2,have,"('MOT', 'CHI')",Providence,lil51.xml,206,6,0,CHI,2220,989,MOT
0,4,3,199,2.104134154,203,4,one,"('MOT', 'CHI')",Providence,lil51.xml,206,3,0,CHI,2220,989,MOT
2,15,1,194,2.068443787,209,15,oh,"('CHI', 'MOT')",Providence,lil51.xml,212,3,2,MOT,934,2676,CHI
0,2,7,197,2.007468042,199,2,not,"('MOT', 'CHI')",Providence,lil51.xml,206,7,0,CHI,2220,989,MOT
1,2,15,188,1.961658506,190,2,of,"('MOT', 'CHI')",Providence,lil51.xml,206,16,1,CHI,2220,989,MOT
1,9,3,199,1.945910149,208,9,was,"('CHI', 'MOT')",Providence,lil51.xml,212,4,1,MOT,934,2676,CHI
0,4,4,198,1.916922612,202,4,my,"('MOT', 'CHI')",Providence,lil51.xml,206,4,0,CHI,2220,989,MOT
0,7,2,203,1.890850372,210,7,wanna,"('CHI', 'MOT')",Providence,lil51.xml,212,2,0,MOT,934,2676,CHI
1,7,5,199,1.871802177,206,7,gonna,"('CHI', 'MOT')",Providence,lil51.xml,212,6,1,MOT,934,2676,CHI
1,10,3,198,1.850599969,208,10,of,"('CHI', 'MOT')",Providence,lil51.xml,212,4,1,MOT,934,2676,CHI
0,6,3,203,1.796510072,209,6,but,"('CHI', 'MOT')",Providence,lil51.xml,212,3,0,MOT,934,2676,CHI
0,4,5,197,1.757857918,201,4,wanna,"('MOT', 'CHI')",Providence,lil51.xml,206,5,0,CHI,2220,989,MOT
1,7,6,198,1.749199855,205,7,can,"('CHI', 'MOT')",Providence,lil51.xml,212,7,1,MOT,934,2676,CHI
0,8,2,196,1.74435723,204,8,no,"('MOT', 'CHI')",Providence,lil51.xml,206,2,0,CHI,2220,989,MOT
0,9,2,201,1.667706821,210,9,this,"('CHI', 'MOT')",Providence,lil51.xml,212,2,0,MOT,934,2676,CHI
0,9,2,201,1.667706821,210,9,on,"('CHI', 'MOT')",Providence,lil51.xml,212,2,0,MOT,934,2676,CHI
1,19,1,191,1.667706821,210,19,to,"('CHI', 'MOT')",Providence,lil51.xml,212,2,1,MOT,934,2676,CHI
1,5,10,190,1.619642083,195,5,like,"('MOT', 'CHI')",Providence,lil51.xml,206,11,1,CHI,2220,989,MOT
5,22,4,181,1.58137996,203,22,see,"('CHI', 'MOT')",Providence,lil51.xml,212,9,5,MOT,934,2676,CHI
0,10,2,200,1.572396641,210,10,go,"('CHI', 'MOT')",Providence,lil51.xml,212,2,0,MOT,934,2676,CHI
2,8,10,186,1.540445041,194,8,want,"('MOT', 'CHI')",Providence,lil51.xml,206,12,2,CHI,2220,989,MOT
0,3,9,194,1.509115191,197,3,there,"('MOT', 'CHI')",Providence,lil51.xml,206,9,0,CHI,2220,989,MOT
0,1,20,185,1.452252329,186,1,little,"('MOT', 'CHI')",Providence,lil51.xml,206,20,0,CHI,2220,989,MOT
0,6,5,201,1.450513954,207,6,my,"('CHI', 'MOT')",Providence,lil51.xml,212,5,0,MOT,934,2676,CHI
0,9,3,200,1.439835128,209,9,have,"('CHI', 'MOT')",Providence,lil51.xml,212,3,0,MOT,934,2676,CHI
1,16,3,192,1.415281898,208,16,we,"('CHI', 'MOT')",Providence,lil51.xml,212,4,1,MOT,934,2676,CHI
4,5,33,164,1.295780354,169,5,the,"('MOT', 'CHI')",Providence,lil51.xml,206,37,4,CHI,2220,989,MOT
11,34,6,161,1.268323338,195,34,a,"('CHI', 'MOT')",Providence,lil51.xml,212,17,11,MOT,934,2676,CHI
0,20,1,191,1.218157439,211,20,think,"('CHI', 'MOT')",Providence,lil51.xml,212,1,0,MOT,934,2676,CHI
16,28,15,153,1.178896105,181,28,and,"('CHI', 'MOT')",Providence,lil51.xml,212,31,16,MOT,934,2676,CHI
0,3,13,190,1.178654996,193,3,are,"('MOT', 'CHI')",Providence,lil51.xml,206,13,0,CHI,2220,989,MOT
2,9,15,180,1.103861645,189,9,do,"('MOT', 'CHI')",Providence,lil51.xml,206,17,2,CHI,2220,989,MOT
11,38,7,156,1.103727389,194,38,that,"('CHI', 'MOT')",Providence,lil51.xml,212,18,11,MOT,934,2676,CHI
1,20,4,187,1.045048846,207,20,it,"('CHI', 'MOT')",Providence,lil51.xml,212,5,1,MOT,934,2676,CHI
0,7,7,192,1.026638789,199,7,this,"('MOT', 'CHI')",Providence,lil51.xml,206,7,0,CHI,2220,989,MOT
1,19,5,187,0.955511445,206,19,what,"('CHI', 'MOT')",Providence,lil51.xml,212,6,1,MOT,934,2676,CHI
5,10,30,161,0.936237878,171,10,a,"('MOT', 'CHI')",Providence,lil51.xml,206,35,5,CHI,2220,989,MOT
0,3,17,186,0.921540088,189,3,oh,"('MOT', 'CHI')",Providence,lil51.xml,206,17,0,CHI,2220,989,MOT
0,17,3,192,0.852048463,209,17,do,"('CHI', 'MOT')",Providence,lil51.xml,212,3,0,MOT,934,2676,CHI
3,4,49,150,0.837728409,154,4,that,"('MOT', 'CHI')",Providence,lil51.xml,206,52,3,CHI,2220,989,MOT
6,20,20,160,0.773189888,180,20,it,"('MOT', 'CHI')",Providence,lil51.xml,206,26,6,CHI,2220,989,MOT
4,57,3,148,0.684489118,205,57,you,"('CHI', 'MOT')",Providence,lil51.xml,212,7,4,MOT,934,2676,CHI
5,56,5,146,0.581921545,202,56,is,"('CHI', 'MOT')",Providence,lil51.xml,212,10,5,MOT,934,2676,CHI
2,14,18,172,0.535961597,186,14,and,"('MOT', 'CHI')",Providence,lil51.xml,206,20,2,CHI,2220,989,MOT
4,39,11,158,0.380649939,197,39,the,"('CHI', 'MOT')",Providence,lil51.xml,212,15,4,MOT,934,2676,CHI
1,15,14,176,0.350035303,191,15,what,"('MOT', 'CHI')",Providence,lil51.xml,206,15,1,CHI,2220,989,MOT
0,12,9,185,0.330460194,197,12,yeah,"('MOT', 'CHI')",Providence,lil51.xml,206,9,0,CHI,2220,989,MOT
6,11,60,129,0.197322852,140,11,you,"('MOT', 'CHI')",Providence,lil51.xml,206,66,6,CHI,2220,989,MOT
2,18,21,171,0.187570913,189,18,yeah,"('CHI', 'MOT')",Providence,lil51.xml,212,23,2,MOT,934,2676,CHI
0,16,10,180,-0.029852963,196,16,can,"('MOT', 'CHI')",Providence,lil51.xml,206,10,0,CHI,2220,989,MOT
4,13,53,136,-0.089877024,149,13,is,"('MOT', 'CHI')",Providence,lil51.xml,206,57,4,CHI,2220,989,MOT
0,1,1,1,-0.405465108,2,1,it,"('MOT', 'OPE')",Providence,lil51.xml,3,1,0,OPE,43,13,MOT
0,1,1,1,-0.405465108,2,1,is,"('MOT', 'OPE')",Providence,lil51.xml,3,1,0,OPE,43,13,MOT
1,0,3,314,4.657129925,314,0,big,"('MOT', 'CHI')",Providence,lil52.xml,318,4,1,CHI,4807,1445,MOT
1,1,0,164,4.019381524,165,1,some,"('CHI', 'MOT')",Providence,lil52.xml,166,1,1,MOT,644,1386,CHI
1,2,3,312,3.558517636,314,2,where,"('MOT', 'CHI')",Providence,lil52.xml,318,4,1,CHI,4807,1445,MOT
1,1,2,162,3.496507561,163,1,my,"('CHI', 'MOT')",Providence,lil52.xml,166,3,1,MOT,644,1386,CHI
0,1,3,314,3.456316681,315,1,some,"('MOT', 'CHI')",Providence,lil52.xml,318,3,0,CHI,4807,1445,MOT
2,1,12,303,3.356461488,304,1,did,"('MOT', 'CHI')",Providence,lil52.xml,318,14,2,CHI,4807,1445,MOT
0,1,1,164,3.326234343,165,1,not,"('CHI', 'MOT')",Providence,lil52.xml,166,1,0,MOT,644,1386,CHI
3,1,17,297,3.305887202,298,1,he,"('MOT', 'CHI')",Providence,lil52.xml,318,20,3,CHI,4807,1445,MOT
2,3,1,160,3.208825489,163,3,can,"('CHI', 'MOT')",Providence,lil52.xml,166,3,2,MOT,644,1386,CHI
1,0,24,293,3.084285671,293,0,they,"('MOT', 'CHI')",Providence,lil52.xml,318,25,1,CHI,4807,1445,MOT
0,1,2,163,3.032546247,164,1,where,"('CHI', 'MOT')",Providence,lil52.xml,166,2,0,MOT,644,1386,CHI
1,3,1,161,3.032546247,164,3,like,"('CHI', 'MOT')",Providence,lil52.xml,166,2,1,MOT,644,1386,CHI
1,3,1,161,3.032546247,164,3,one,"('CHI', 'MOT')",Providence,lil52.xml,166,2,1,MOT,644,1386,CHI
0,2,1,163,2.920769235,165,2,they,"('CHI', 'MOT')",Providence,lil52.xml,166,1,0,MOT,644,1386,CHI
0,2,1,163,2.920769235,165,2,he,"('CHI', 'MOT')",Providence,lil52.xml,166,1,0,MOT,644,1386,CHI
1,1,14,302,2.887098433,303,1,go,"('MOT', 'CHI')",Providence,lil52.xml,318,15,1,CHI,4807,1445,MOT
1,3,2,160,2.803360381,163,3,all,"('CHI', 'MOT')",Providence,lil52.xml,166,3,1,MOT,644,1386,CHI
1,6,0,159,2.766618555,165,6,want,"('CHI', 'MOT')",Providence,lil52.xml,166,1,1,MOT,644,1386,CHI
0,3,3,312,2.7631695,315,3,put,"('MOT', 'CHI')",Providence,lil52.xml,318,3,0,CHI,4807,1445,MOT
0,3,1,162,2.633087163,165,3,of,"('CHI', 'MOT')",Providence,lil52.xml,166,1,0,MOT,644,1386,CHI
0,3,1,162,2.633087163,165,3,was,"('CHI', 'MOT')",Providence,lil52.xml,166,1,0,MOT,644,1386,CHI
0,3,1,162,2.633087163,165,3,wanna,"('CHI', 'MOT')",Providence,lil52.xml,166,1,0,MOT,644,1386,CHI
0,1,10,307,2.558518467,308,1,like,"('MOT', 'CHI')",Providence,lil52.xml,318,10,0,CHI,4807,1445,MOT
1,2,13,302,2.545531272,304,2,gonna,"('MOT', 'CHI')",Providence,lil52.xml,318,14,1,CHI,4807,1445,MOT
3,5,4,154,2.47871468,159,5,no,"('CHI', 'MOT')",Providence,lil52.xml,166,7,3,MOT,644,1386,CHI
0,2,7,309,2.450366325,311,2,wanna,"('MOT', 'CHI')",Providence,lil52.xml,318,7,0,CHI,4807,1445,MOT
2,10,0,154,2.426410443,164,10,go,"('CHI', 'MOT')",Providence,lil52.xml,166,2,2,MOT,644,1386,CHI
0,4,1,161,2.409943611,165,4,look,"('CHI', 'MOT')",Providence,lil52.xml,166,1,0,MOT,644,1386,CHI
0,3,6,309,2.283657083,312,3,look,"('MOT', 'CHI')",Providence,lil52.xml,318,6,0,CHI,4807,1445,MOT
1,6,2,157,2.243744593,163,6,are,"('CHI', 'MOT')",Providence,lil52.xml,166,3,1,MOT,644,1386,CHI
0,5,1,160,2.227622055,165,5,big,"('CHI', 'MOT')",Providence,lil52.xml,166,1,0,MOT,644,1386,CHI
0,1,15,302,2.193951252,303,1,little,"('MOT', 'CHI')",Providence,lil52.xml,318,15,0,CHI,4807,1445,MOT
1,12,0,153,2.147579347,165,12,with,"('CHI', 'MOT')",Providence,lil52.xml,166,1,1,MOT,644,1386,CHI
1,0,1,14,2.079441542,14,0,it,"('MOT', 'OPE')",Providence,lil52.xml,16,2,1,OPE,109,78,MOT
1,5,11,301,1.992430165,306,5,was,"('MOT', 'CHI')",Providence,lil52.xml,318,12,1,CHI,4807,1445,MOT
0,2,12,304,1.992430165,306,2,see,"('MOT', 'CHI')",Providence,lil52.xml,318,12,0,CHI,4807,1445,MOT
0,2,13,303,1.920185258,305,2,at,"('MOT', 'CHI')",Providence,lil52.xml,318,13,0,CHI,4807,1445,MOT
0,1,20,297,1.919592841,298,1,for,"('MOT', 'CHI')",Providence,lil52.xml,318,20,0,CHI,4807,1445,MOT
1,4,15,298,1.910365212,302,4,not,"('MOT', 'CHI')",Providence,lil52.xml,318,16,1,CHI,4807,1445,MOT
0,3,10,305,1.865371287,308,3,want,"('MOT', 'CHI')",Providence,lil52.xml,318,10,0,CHI,4807,1445,MOT
0,8,1,157,1.822156946,165,8,we,"('CHI', 'MOT')",Providence,lil52.xml,166,1,0,MOT,644,1386,CHI
0,1,23,294,1.781709133,295,1,with,"('MOT', 'CHI')",Providence,lil52.xml,318,23,0,CHI,4807,1445,MOT
8,13,7,138,1.755391825,151,13,the,"('CHI', 'MOT')",Providence,lil52.xml,166,15,8,MOT,644,1386,CHI
1,4,18,295,1.746297095,299,4,all,"('MOT', 'CHI')",Providence,lil52.xml,318,19,1,CHI,4807,1445,MOT
1,3,24,290,1.69799131,293,3,are,"('MOT', 'CHI')",Providence,lil52.xml,318,25,1,CHI,4807,1445,MOT
0,10,1,155,1.621486251,165,10,on,"('CHI', 'MOT')",Providence,lil52.xml,166,1,0,MOT,644,1386,CHI
1,1,52,264,1.579915473,265,1,to,"('MOT', 'CHI')",Providence,lil52.xml,318,53,1,CHI,4807,1445,MOT
0,1,29,288,1.546188882,289,1,of,"('MOT', 'CHI')",Providence,lil52.xml,318,29,0,CHI,4807,1445,MOT
0,4,5,157,1.538402139,161,4,this,"('CHI', 'MOT')",Providence,lil52.xml,166,5,0,MOT,644,1386,CHI
0,8,2,156,1.52846885,164,8,oh,"('CHI', 'MOT')",Providence,lil52.xml,166,2,0,MOT,644,1386,CHI
8,5,32,121,1.519825754,126,5,yeah,"('CHI', 'MOT')",Providence,lil52.xml,166,40,8,MOT,644,1386,CHI
0,3,18,297,1.328400383,300,3,my,"('MOT', 'CHI')",Providence,lil52.xml,318,18,0,CHI,4807,1445,MOT
8,21,7,130,1.303406701,151,21,and,"('CHI', 'MOT')",Providence,lil52.xml,166,15,8,MOT,644,1386,CHI
1,1,0,8,1.299282984,9,1,on,"('OPE', 'MOT')",Providence,lil52.xml,10,1,1,MOT,45,152,OPE
1,14,3,148,1.293203938,162,14,is,"('CHI', 'MOT')",Providence,lil52.xml,166,4,1,MOT,644,1386,CHI
2,13,14,289,1.286210903,302,13,this,"('MOT', 'CHI')",Providence,lil52.xml,318,16,2,CHI,4807,1445,MOT
2,10,19,287,1.265666373,297,10,one,"('MOT', 'CHI')",Providence,lil52.xml,318,21,2,CHI,4807,1445,MOT
0,2,26,290,1.252762968,292,2,on,"('MOT', 'CHI')",Providence,lil52.xml,318,26,0,CHI,4807,1445,MOT
10,10,64,234,1.174598196,244,10,you,"('MOT', 'CHI')",Providence,lil52.xml,318,74,10,CHI,4807,1445,MOT
0,2,29,287,1.140723774,289,2,do,"('MOT', 'CHI')",Providence,lil52.xml,318,29,0,CHI,4807,1445,MOT
3,9,32,274,1.125280536,283,9,what,"('MOT', 'CHI')",Providence,lil52.xml,318,35,3,CHI,4807,1445,MOT
2,22,3,139,1.110958124,161,22,a,"('CHI', 'MOT')",Providence,lil52.xml,166,5,2,MOT,644,1386,CHI
1,1,2,12,1.098612289,13,1,you,"('MOT', 'OPE')",Providence,lil52.xml,16,3,1,OPE,109,78,MOT
8,11,56,243,1.06784063,254,11,a,"('MOT', 'CHI')",Providence,lil52.xml,318,64,8,CHI,4807,1445,MOT
0,4,19,295,1.053149915,299,4,think,"('MOT', 'CHI')",Providence,lil52.xml,318,19,0,CHI,4807,1445,MOT
0,1,1,14,1.041453875,15,1,gonna,"('MOT', 'OPE')",Providence,lil52.xml,16,1,0,OPE,109,78,MOT
0,1,1,14,1.041453875,15,1,yeah,"('MOT', 'OPE')",Providence,lil52.xml,16,1,0,OPE,109,78,MOT
0,1,1,14,1.041453875,15,1,on,"('MOT', 'OPE')",Providence,lil52.xml,16,1,0,OPE,109,78,MOT
0,14,2,150,1.017643226,164,14,that,"('CHI', 'MOT')",Providence,lil52.xml,166,2,0,MOT,644,1386,CHI
2,13,20,283,0.978594615,296,13,no,"('MOT', 'CHI')",Providence,lil52.xml,318,22,2,CHI,4807,1445,MOT
7,10,63,238,0.926341068,248,10,the,"('MOT', 'CHI')",Providence,lil52.xml,318,70,7,CHI,4807,1445,MOT
1,8,26,283,0.808799382,291,8,in,"('MOT', 'CHI')",Providence,lil52.xml,318,27,1,CHI,4807,1445,MOT
3,11,39,265,0.744819191,276,11,that,"('MOT', 'CHI')",Providence,lil52.xml,318,42,3,CHI,4807,1445,MOT
0,1,2,13,0.693147181,14,1,to,"('MOT', 'OPE')",Providence,lil52.xml,16,2,0,OPE,109,78,MOT
0,2,1,13,0.635988767,15,2,in,"('MOT', 'OPE')",Providence,lil52.xml,16,1,0,OPE,109,78,MOT
0,1,2,12,0.628608659,13,1,what,"('OPE', 'CHI')",Providence,lil52.xml,15,2,0,CHI,70,79,OPE
5,21,35,257,0.597837001,278,21,is,"('MOT', 'CHI')",Providence,lil52.xml,318,40,5,CHI,4807,1445,MOT
0,2,1,12,0.575364145,14,2,and,"('OPE', 'CHI')",Providence,lil52.xml,15,1,0,CHI,70,79,OPE
5,39,22,252,0.415756794,291,39,yeah,"('MOT', 'CHI')",Providence,lil52.xml,318,27,5,CHI,4807,1445,MOT
0,9,18,291,0.412109651,300,9,can,"('MOT', 'CHI')",Providence,lil52.xml,318,18,0,CHI,4807,1445,MOT
0,9,9,148,0.368423836,157,9,it,"('CHI', 'MOT')",Providence,lil52.xml,166,9,0,MOT,644,1386,CHI
0,18,4,144,0.363667979,162,18,what,"('CHI', 'MOT')",Providence,lil52.xml,166,4,0,MOT,644,1386,CHI
0,1,1,5,0.287682072,6,1,a,"('CHI', 'OPE')",Providence,lil52.xml,7,1,0,OPE,39,43,CHI
3,12,59,244,0.215421505,256,12,and,"('MOT', 'CHI')",Providence,lil52.xml,318,62,3,CHI,4807,1445,MOT
1,37,4,124,0.203401073,161,37,you,"('CHI', 'MOT')",Providence,lil52.xml,166,5,1,MOT,644,1386,CHI
0,1,4,11,0.15415068,12,1,a,"('MOT', 'OPE')",Providence,lil52.xml,16,4,0,OPE,109,78,MOT
3,21,42,252,0.061875404,273,21,it,"('MOT', 'CHI')",Providence,lil52.xml,318,45,3,CHI,4807,1445,MOT
0,3,2,11,0,14,3,like,"('MOT', 'OPE')",Providence,lil52.xml,16,2,0,OPE,109,78,MOT
0,3,1,6,-0.087011377,9,3,a,"('OPE', 'MOT')",Providence,lil52.xml,10,1,0,MOT,45,152,OPE
0,3,1,6,-0.087011377,9,3,do,"('OPE', 'MOT')",Providence,lil52.xml,10,1,0,MOT,45,152,OPE
0,4,1,5,-0.310154928,9,4,you,"('OPE', 'MOT')",Providence,lil52.xml,10,1,0,MOT,45,152,OPE
0,1,2,345,3.772760938,346,1,was,"('MOT', 'CHI')",Providence,lil53.xml,348,2,0,CHI,6287,1479,MOT
1,1,6,340,3.64050587,341,1,he,"('MOT', 'CHI')",Providence,lil53.xml,348,7,1,CHI,6287,1479,MOT
1,0,16,331,3.556850691,331,0,there,"('MOT', 'CHI')",Providence,lil53.xml,348,17,1,CHI,6287,1479,MOT
1,1,10,336,3.26105075,337,1,where,"('MOT', 'CHI')",Providence,lil53.xml,348,11,1,CHI,6287,1479,MOT
0,1,5,342,3.204487087,343,1,big,"('MOT', 'CHI')",Providence,lil53.xml,348,5,0,CHI,6287,1479,MOT
4,3,14,327,3.032546247,330,3,did,"('MOT', 'CHI')",Providence,lil53.xml,348,18,4,CHI,6287,1479,MOT
2,6,6,334,2.684927784,340,6,want,"('MOT', 'CHI')",Providence,lil53.xml,348,8,2,CHI,6287,1479,MOT
4,2,31,311,2.65248035,313,2,look,"('MOT', 'CHI')",Providence,lil53.xml,348,35,4,CHI,6287,1479,MOT
5,7,11,325,2.633087163,332,7,not,"('MOT', 'CHI')",Providence,lil53.xml,348,16,5,CHI,6287,1479,MOT
2,5,9,332,2.567903569,337,5,wanna,"('MOT', 'CHI')",Providence,lil53.xml,348,11,2,CHI,6287,1479,MOT
0,2,7,339,2.541893581,341,2,put,"('MOT', 'CHI')",Providence,lil53.xml,348,7,0,CHI,6287,1479,MOT
0,1,12,335,2.490841385,336,1,think,"('MOT', 'CHI')",Providence,lil53.xml,348,12,0,CHI,6287,1479,MOT
0,4,4,340,2.445241393,344,4,my,"('MOT', 'CHI')",Providence,lil53.xml,348,4,0,CHI,6287,1479,MOT
1,1,29,317,2.302585093,318,1,with,"('MOT', 'CHI')",Providence,lil53.xml,348,30,1,CHI,6287,1479,MOT
3,3,29,313,2.235690858,316,3,like,"('MOT', 'CHI')",Providence,lil53.xml,348,32,3,CHI,6287,1479,MOT
0,1,19,328,2.064448757,329,1,all,"('MOT', 'CHI')",Providence,lil53.xml,348,19,0,CHI,6287,1479,MOT
1,10,5,332,2.056452023,342,10,no,"('MOT', 'CHI')",Providence,lil53.xml,348,6,1,CHI,6287,1479,MOT
0,1,22,325,1.921812597,326,1,see,"('MOT', 'CHI')",Providence,lil53.xml,348,22,0,CHI,6287,1479,MOT
0,1,24,323,1.835653663,324,1,we,"('MOT', 'CHI')",Providence,lil53.xml,348,24,0,CHI,6287,1479,MOT
3,7,22,316,1.794841136,323,7,they,"('MOT', 'CHI')",Providence,lil53.xml,348,25,3,CHI,6287,1479,MOT
7,13,24,304,1.709067753,317,13,can,"('MOT', 'CHI')",Providence,lil53.xml,348,31,7,CHI,6287,1479,MOT
1,3,27,317,1.680206983,320,3,at,"('MOT', 'CHI')",Providence,lil53.xml,348,28,1,CHI,6287,1479,MOT
1,3,27,317,1.680206983,320,3,do,"('MOT', 'CHI')",Providence,lil53.xml,348,28,1,CHI,6287,1479,MOT
0,1,29,318,1.644306738,319,1,for,"('MOT', 'CHI')",Providence,lil53.xml,348,29,0,CHI,6287,1479,MOT
0,1,30,317,1.609437912,318,1,oh,"('MOT', 'CHI')",Providence,lil53.xml,348,30,0,CHI,6287,1479,MOT
12,7,77,252,1.539168717,259,7,a,"('MOT', 'CHI')",Providence,lil53.xml,348,89,12,CHI,6287,1479,MOT
0,5,13,330,1.32027326,335,5,get,"('MOT', 'CHI')",Providence,lil53.xml,348,13,0,CHI,6287,1479,MOT
0,4,17,327,1.254265598,331,4,have,"('MOT', 'CHI')",Providence,lil53.xml,348,17,0,CHI,6287,1479,MOT
1,11,13,323,1.252762968,334,11,one,"('MOT', 'CHI')",Providence,lil53.xml,348,14,1,CHI,6287,1479,MOT
0,2,29,317,1.23884163,319,2,on,"('MOT', 'CHI')",Providence,lil53.xml,348,29,0,CHI,6287,1479,MOT
3,10,29,306,1.224089946,316,10,this,"('MOT', 'CHI')",Providence,lil53.xml,348,32,3,CHI,6287,1479,MOT
9,15,50,274,1.092445774,289,15,it,"('MOT', 'CHI')",Providence,lil53.xml,348,59,9,CHI,6287,1479,MOT
1,3,48,296,1.082137451,299,3,of,"('MOT', 'CHI')",Providence,lil53.xml,348,49,1,CHI,6287,1479,MOT
2,14,19,313,1.051125622,327,14,some,"('MOT', 'CHI')",Providence,lil53.xml,348,21,2,CHI,6287,1479,MOT
1,4,44,299,0.953873443,303,4,in,"('MOT', 'CHI')",Providence,lil53.xml,348,45,1,CHI,6287,1479,MOT
2,5,57,284,0.869302222,289,5,to,"('MOT', 'CHI')",Providence,lil53.xml,348,59,2,CHI,6287,1479,MOT
2,15,22,309,0.85482441,324,15,what,"('MOT', 'CHI')",Providence,lil53.xml,348,24,2,CHI,6287,1479,MOT
4,8,73,263,0.652237278,271,8,that,"('MOT', 'CHI')",Providence,lil53.xml,348,77,4,CHI,6287,1479,MOT
4,12,60,272,0.510825624,284,12,and,"('MOT', 'CHI')",Providence,lil53.xml,348,64,4,CHI,6287,1479,MOT
8,12,96,232,0.474167662,244,12,is,"('MOT', 'CHI')",Providence,lil53.xml,348,104,8,CHI,6287,1479,MOT
2,13,44,289,0.30538165,302,13,are,"('MOT', 'CHI')",Providence,lil53.xml,348,46,2,CHI,6287,1479,MOT
9,13,113,213,0.272591827,226,13,you,"('MOT', 'CHI')",Providence,lil53.xml,348,122,9,CHI,6287,1479,MOT
4,13,84,247,0.038915416,260,13,the,"('MOT', 'CHI')",Providence,lil53.xml,348,88,4,CHI,6287,1479,MOT
3,40,26,279,0.010176213,319,40,yeah,"('MOT', 'CHI')",Providence,lil53.xml,348,29,3,CHI,6287,1479,MOT
0,16,27,305,-0.422856851,321,16,but,"('MOT', 'CHI')",Providence,lil53.xml,348,27,0,CHI,6287,1479,MOT
1,1,4,324,3.844050022,325,1,he,"('MOT', 'CHI')",Providence,lil54.xml,330,5,1,CHI,3232,1673,MOT
2,2,9,317,3.206491766,319,2,where,"('MOT', 'CHI')",Providence,lil54.xml,330,11,2,CHI,3232,1673,MOT
1,2,7,320,3.072693315,322,2,she,"('MOT', 'CHI')",Providence,lil54.xml,330,8,1,CHI,3232,1673,MOT
0,1,6,323,3.014308659,324,1,look,"('MOT', 'CHI')",Providence,lil54.xml,330,6,0,CHI,3232,1673,MOT
2,4,0,129,3.008154794,133,4,was,"('CHI', 'MOT')",Providence,lil54.xml,135,2,2,MOT,685,1306,CHI
4,4,10,312,2.989462661,316,4,with,"('MOT', 'CHI')",Providence,lil54.xml,330,14,4,CHI,3232,1673,MOT
2,2,12,314,2.989462661,316,2,on,"('MOT', 'CHI')",Providence,lil54.xml,330,14,2,CHI,3232,1673,MOT
1,4,0,130,2.897751865,134,4,look,"('CHI', 'MOT')",Providence,lil54.xml,135,1,1,MOT,685,1306,CHI
1,2,10,317,2.801026658,319,2,have,"('MOT', 'CHI')",Providence,lil54.xml,330,11,1,CHI,3232,1673,MOT
0,2,1,132,2.715430308,134,2,there,"('CHI', 'MOT')",Providence,lil54.xml,135,1,0,MOT,685,1306,CHI
1,5,0,129,2.715430308,134,5,did,"('CHI', 'MOT')",Providence,lil54.xml,135,1,1,MOT,685,1306,CHI
0,2,1,132,2.715430308,134,2,she,"('CHI', 'MOT')",Providence,lil54.xml,135,1,0,MOT,685,1306,CHI
0,2,1,132,2.715430308,134,2,no,"('CHI', 'MOT')",Providence,lil54.xml,135,1,0,MOT,685,1306,CHI
0,2,1,132,2.715430308,134,2,on,"('CHI', 'MOT')",Providence,lil54.xml,135,1,0,MOT,685,1306,CHI
1,2,3,129,2.693124551,131,2,put,"('CHI', 'MOT')",Providence,lil54.xml,135,4,1,MOT,685,1306,CHI
1,3,8,318,2.68660987,321,3,for,"('MOT', 'CHI')",Providence,lil54.xml,330,9,1,CHI,3232,1673,MOT
1,4,1,129,2.602689685,133,4,for,"('CHI', 'MOT')",Providence,lil54.xml,135,2,1,MOT,685,1306,CHI
2,5,8,315,2.596497715,320,5,up,"('MOT', 'CHI')",Providence,lil54.xml,330,10,2,CHI,3232,1673,MOT
1,4,7,318,2.561867691,322,4,was,"('MOT', 'CHI')",Providence,lil54.xml,330,8,1,CHI,3232,1673,MOT
3,3,5,124,2.557227311,127,3,like,"('CHI', 'MOT')",Providence,lil54.xml,135,8,3,MOT,685,1306,CHI
1,3,10,316,2.513344585,319,3,gonna,"('MOT', 'CHI')",Providence,lil54.xml,330,11,1,CHI,3232,1673,MOT
0,3,1,131,2.427748236,134,3,where,"('CHI', 'MOT')",Providence,lil54.xml,135,1,0,MOT,685,1306,CHI
1,1,0,31,2.427748236,32,1,no,"('OPE', 'CHI')",Providence,lil54.xml,33,1,1,CHI,198,233,OPE
0,2,8,320,2.379546134,322,2,they,"('MOT', 'CHI')",Providence,lil54.xml,330,8,0,CHI,3232,1673,MOT
1,4,2,128,2.372111156,132,4,this,"('CHI', 'MOT')",Providence,lil54.xml,135,3,1,MOT,685,1306,CHI
2,5,3,125,2.243744593,130,5,in,"('CHI', 'MOT')",Providence,lil54.xml,135,5,2,MOT,685,1306,CHI
0,4,5,321,2.234612109,325,4,all,"('MOT', 'CHI')",Providence,lil54.xml,330,5,0,CHI,3232,1673,MOT
0,2,3,130,2.189789599,132,2,up,"('CHI', 'MOT')",Providence,lil54.xml,135,3,0,MOT,685,1306,CHI
0,3,2,130,2.132686056,133,3,are,"('CHI', 'MOT')",Providence,lil54.xml,135,2,0,MOT,685,1306,CHI
1,10,0,124,2.109294505,134,10,little,"('CHI', 'MOT')",Providence,lil54.xml,135,1,1,MOT,685,1306,CHI
1,10,0,124,2.109294505,134,10,think,"('CHI', 'MOT')",Providence,lil54.xml,135,1,1,MOT,685,1306,CHI
0,2,11,317,2.107879477,319,2,at,"('MOT', 'CHI')",Providence,lil54.xml,330,11,0,CHI,3232,1673,MOT
1,0,0,10,2.079441542,10,0,a,"('CHI', 'OPE')",Providence,lil54.xml,11,1,1,OPE,73,46,CHI
0,1,18,311,2.060513532,312,1,think,"('MOT', 'CHI')",Providence,lil54.xml,330,18,0,CHI,3232,1673,MOT
1,2,24,303,2.025545773,305,2,little,"('MOT', 'CHI')",Providence,lil54.xml,330,25,1,CHI,3232,1673,MOT
1,3,18,308,2.008533572,311,3,put,"('MOT', 'CHI')",Providence,lil54.xml,330,19,1,CHI,3232,1673,MOT
1,5,3,126,1.99997737,131,5,have,"('CHI', 'MOT')",Providence,lil54.xml,135,4,1,MOT,685,1306,CHI
3,3,35,289,1.994700313,292,3,what,"('MOT', 'CHI')",Providence,lil54.xml,330,38,3,CHI,3232,1673,MOT
0,4,7,319,1.977162693,323,4,go,"('MOT', 'CHI')",Providence,lil54.xml,330,7,0,CHI,3232,1673,MOT
1,5,12,312,1.958528613,317,5,there,"('MOT', 'CHI')",Providence,lil54.xml,330,13,1,CHI,3232,1673,MOT
0,4,2,129,1.909542505,133,4,go,"('CHI', 'MOT')",Providence,lil54.xml,135,2,0,MOT,685,1306,CHI
0,4,2,129,1.909542505,133,4,big,"('CHI', 'MOT')",Providence,lil54.xml,135,2,0,MOT,685,1306,CHI
1,0,1,10,1.791759469,10,0,the,"('MOT', 'OPE')",Providence,lil54.xml,12,2,1,OPE,260,45,MOT
2,8,14,306,1.766758167,314,8,like,"('MOT', 'CHI')",Providence,lil54.xml,330,16,2,CHI,3232,1673,MOT
1,7,11,311,1.742969305,318,7,can,"('MOT', 'CHI')",Providence,lil54.xml,330,12,1,CHI,3232,1673,MOT
0,3,12,315,1.742969305,318,3,did,"('MOT', 'CHI')",Providence,lil54.xml,330,12,0,CHI,3232,1673,MOT
0,7,1,127,1.734601055,134,7,but,"('CHI', 'MOT')",Providence,lil54.xml,135,1,0,MOT,685,1306,CHI
0,1,1,31,1.734601055,32,1,gonna,"('OPE', 'CHI')",Providence,lil54.xml,33,1,0,CHI,198,233,OPE
0,1,1,31,1.734601055,32,1,have,"('OPE', 'CHI')",Providence,lil54.xml,33,1,0,CHI,198,233,OPE
0,1,1,31,1.734601055,32,1,of,"('OPE', 'CHI')",Providence,lil54.xml,33,1,0,CHI,198,233,OPE
0,1,1,31,1.734601055,32,1,little,"('OPE', 'CHI')",Providence,lil54.xml,33,1,0,CHI,198,233,OPE
0,1,1,31,1.734601055,32,1,big,"('OPE', 'CHI')",Providence,lil54.xml,33,1,0,CHI,198,233,OPE
0,1,1,31,1.734601055,32,1,to,"('OPE', 'CHI')",Providence,lil54.xml,33,1,0,CHI,198,233,OPE
6,11,5,113,1.732336049,124,11,a,"('CHI', 'MOT')",Providence,lil54.xml,135,11,6,MOT,685,1306,CHI
1,0,1,9,1.704748092,9,0,they,"('CHI', 'OPE')",Providence,lil54.xml,11,2,1,OPE,73,46,CHI
0,4,3,128,1.678963975,132,4,gonna,"('CHI', 'MOT')",Providence,lil54.xml,135,3,0,MOT,685,1306,CHI
3,9,19,299,1.642227735,308,9,to,"('MOT', 'CHI')",Providence,lil54.xml,330,22,3,CHI,3232,1673,MOT
0,6,7,317,1.640690456,323,6,one,"('MOT', 'CHI')",Providence,lil54.xml,330,7,0,CHI,3232,1673,MOT
0,2,20,308,1.553348446,310,2,see,"('MOT', 'CHI')",Providence,lil54.xml,330,20,0,CHI,3232,1673,MOT
3,10,5,117,1.5456264,127,10,it,"('CHI', 'MOT')",Providence,lil54.xml,135,8,3,MOT,685,1306,CHI
1,13,7,309,1.532248274,322,13,my,"('MOT', 'CHI')",Providence,lil54.xml,330,8,1,CHI,3232,1673,MOT
0,5,3,127,1.496642418,132,5,at,"('CHI', 'MOT')",Providence,lil54.xml,135,3,0,MOT,685,1306,CHI
1,1,0,10,1.466337069,11,1,did,"('MOT', 'OPE')",Providence,lil54.xml,12,1,1,OPE,260,45,MOT
0,1,2,30,1.41706602,31,1,in,"('OPE', 'CHI')",Providence,lil54.xml,33,2,0,CHI,198,233,OPE
0,3,6,126,1.40946142,129,3,want,"('CHI', 'MOT')",Providence,lil54.xml,135,6,0,MOT,685,1306,CHI
0,11,5,314,1.359143372,325,11,no,"('MOT', 'CHI')",Providence,lil54.xml,330,5,0,CHI,3232,1673,MOT
1,2,18,114,1.320697079,116,2,yeah,"('CHI', 'MOT')",Providence,lil54.xml,135,19,1,MOT,685,1306,CHI
4,8,12,111,1.317632123,119,8,the,"('CHI', 'MOT')",Providence,lil54.xml,135,16,4,MOT,685,1306,CHI
0,4,15,311,1.316250517,315,4,some,"('MOT', 'CHI')",Providence,lil54.xml,330,15,0,CHI,3232,1673,MOT
0,5,4,126,1.30683019,131,5,with,"('CHI', 'MOT')",Providence,lil54.xml,135,4,0,MOT,685,1306,CHI
0,5,4,126,1.30683019,131,5,my,"('CHI', 'MOT')",Providence,lil54.xml,135,4,0,MOT,685,1306,CHI
0,5,4,126,1.30683019,131,5,wanna,"('CHI', 'MOT')",Providence,lil54.xml,135,4,0,MOT,685,1306,CHI
0,5,4,126,1.30683019,131,5,he,"('CHI', 'MOT')",Providence,lil54.xml,135,4,0,MOT,685,1306,CHI
1,17,7,305,1.280933845,322,17,wanna,"('MOT', 'CHI')",Providence,lil54.xml,330,8,1,CHI,3232,1673,MOT
2,7,29,292,1.22977345,299,7,do,"('MOT', 'CHI')",Providence,lil54.xml,330,31,2,CHI,3232,1673,MOT
0,2,28,300,1.217218031,302,2,oh,"('MOT', 'CHI')",Providence,lil54.xml,330,28,0,CHI,3232,1673,MOT
0,9,2,124,1.216395324,133,9,do,"('CHI', 'MOT')",Providence,lil54.xml,135,2,0,MOT,685,1306,CHI
2,15,14,299,1.191394022,314,15,want,"('MOT', 'CHI')",Providence,lil54.xml,330,16,2,CHI,3232,1673,MOT
0,13,1,121,1.174985267,134,13,we,"('CHI', 'MOT')",Providence,lil54.xml,135,1,0,MOT,685,1306,CHI
1,7,7,120,1.17093295,127,7,and,"('CHI', 'MOT')",Providence,lil54.xml,135,8,1,MOT,685,1306,CHI
0,1,3,29,1.16315081,30,1,oh,"('OPE', 'CHI')",Providence,lil54.xml,33,3,0,CHI,198,233,OPE
0,1,3,29,1.16315081,30,1,is,"('OPE', 'CHI')",Providence,lil54.xml,33,3,0,CHI,198,233,OPE
0,1,3,29,1.16315081,30,1,can,"('OPE', 'CHI')",Providence,lil54.xml,33,3,0,CHI,198,233,OPE
7,16,34,273,1.158351349,289,16,the,"('MOT', 'CHI')",Providence,lil54.xml,330,41,7,CHI,3232,1673,MOT
0,6,4,125,1.15267951,131,6,one,"('CHI', 'MOT')",Providence,lil54.xml,135,4,0,MOT,685,1306,CHI
9,29,22,270,1.111990415,299,29,it,"('MOT', 'CHI')",Providence,lil54.xml,330,31,9,CHI,3232,1673,MOT
1,4,36,289,1.107122978,293,4,that,"('MOT', 'CHI')",Providence,lil54.xml,330,37,1,CHI,3232,1673,MOT
4,10,39,277,1.071306838,287,10,in,"('MOT', 'CHI')",Providence,lil54.xml,330,43,4,CHI,3232,1673,MOT
0,7,4,124,1.019148117,131,7,get,"('CHI', 'MOT')",Providence,lil54.xml,135,4,0,MOT,685,1306,CHI
0,5,17,308,1.01637419,313,5,of,"('MOT', 'CHI')",Providence,lil54.xml,330,17,0,CHI,3232,1673,MOT
0,5,6,124,1.003996312,129,5,is,"('CHI', 'MOT')",Providence,lil54.xml,135,6,0,MOT,685,1306,CHI
1,14,4,116,0.921988753,130,14,to,"('CHI', 'MOT')",Providence,lil54.xml,135,5,1,MOT,685,1306,CHI
4,43,10,273,0.814710939,316,43,yeah,"('MOT', 'CHI')",Providence,lil54.xml,330,14,4,CHI,3232,1673,MOT
2,13,25,290,0.812570906,303,13,is,"('MOT', 'CHI')",Providence,lil54.xml,330,27,2,CHI,3232,1673,MOT
0,11,3,121,0.803495238,132,11,what,"('CHI', 'MOT')",Providence,lil54.xml,135,3,0,MOT,685,1306,CHI
1,1,2,8,0.78845736,9,1,you,"('MOT', 'OPE')",Providence,lil54.xml,12,3,1,OPE,260,45,MOT
0,1,1,10,0.773189888,11,1,yeah,"('MOT', 'OPE')",Providence,lil54.xml,12,1,0,OPE,260,45,MOT
0,1,1,10,0.773189888,11,1,up,"('MOT', 'OPE')",Providence,lil54.xml,12,1,0,OPE,260,45,MOT
0,4,10,121,0.749842524,125,4,can,"('CHI', 'MOT')",Providence,lil54.xml,135,10,0,MOT,685,1306,CHI
0,1,1,9,0.693147181,10,1,is,"('CHI', 'OPE')",Providence,lil54.xml,11,1,0,OPE,73,46,CHI
5,15,46,264,0.687233503,279,15,a,"('MOT', 'CHI')",Providence,lil54.xml,330,51,5,CHI,3232,1673,MOT
0,14,9,307,0.671706849,321,14,this,"('MOT', 'CHI')",Providence,lil54.xml,330,9,0,CHI,3232,1673,MOT
4,15,40,271,0.671168274,286,15,and,"('MOT', 'CHI')",Providence,lil54.xml,330,44,4,CHI,3232,1673,MOT
0,11,4,120,0.613683009,131,11,oh,"('CHI', 'MOT')",Providence,lil54.xml,135,4,0,MOT,685,1306,CHI
6,33,6,90,0.608806032,123,33,you,"('CHI', 'MOT')",Providence,lil54.xml,135,12,6,MOT,685,1306,CHI
0,1,6,26,0.594707108,27,1,it,"('OPE', 'CHI')",Providence,lil54.xml,33,6,0,CHI,198,233,OPE
1,8,34,287,0.578736829,295,8,are,"('MOT', 'CHI')",Providence,lil54.xml,330,35,1,CHI,3232,1673,MOT
9,12,94,215,0.517397389,227,12,you,"('MOT', 'CHI')",Providence,lil54.xml,330,103,9,CHI,3232,1673,MOT
1,6,3,23,0.389464767,29,6,a,"('OPE', 'CHI')",Providence,lil54.xml,33,4,1,CHI,198,233,OPE
0,1,2,8,0.318453731,9,1,like,"('CHI', 'OPE')",Providence,lil54.xml,11,2,0,OPE,73,46,CHI
0,2,1,8,0.287682072,10,2,to,"('CHI', 'OPE')",Providence,lil54.xml,11,1,0,OPE,73,46,CHI
1,8,3,21,0.138150338,29,8,yeah,"('OPE', 'CHI')",Providence,lil54.xml,33,4,1,CHI,198,233,OPE
0,1,3,8,0.09531018,9,1,a,"('MOT', 'OPE')",Providence,lil54.xml,12,3,0,OPE,260,45,MOT
0,3,1,7,0,10,3,yeah,"('CHI', 'OPE')",Providence,lil54.xml,11,1,0,OPE,73,46,CHI
0,2,8,23,-0.105360516,25,2,you,"('OPE', 'CHI')",Providence,lil54.xml,33,8,0,CHI,198,233,OPE
2,0,5,186,4.137829674,186,0,big,"('MOT', 'CHI')",Providence,lil55.xml,193,7,2,CHI,2436,892,MOT
2,1,1,195,4.084294226,196,1,up,"('CHI', 'MOT')",Providence,lil55.xml,199,3,2,MOT,1101,2433,CHI
2,1,3,187,3.706579031,188,1,he,"('MOT', 'CHI')",Providence,lil55.xml,193,5,2,CHI,2436,892,MOT
1,1,2,189,3.64805746,190,1,she,"('MOT', 'CHI')",Providence,lil55.xml,193,3,1,CHI,2436,892,MOT
7,2,7,177,3.406737562,179,2,was,"('MOT', 'CHI')",Providence,lil55.xml,193,14,7,CHI,2436,892,MOT
0,1,2,196,3.213863283,197,1,look,"('CHI', 'MOT')",Providence,lil55.xml,199,2,0,MOT,1101,2433,CHI
2,3,2,192,3.203762187,195,3,big,"('CHI', 'MOT')",Providence,lil55.xml,199,4,2,MOT,1101,2433,CHI
0,2,1,196,3.101092789,198,2,gonna,"('CHI', 'MOT')",Providence,lil55.xml,199,1,0,MOT,1101,2433,CHI
0,2,1,190,3.070633582,192,2,my,"('MOT', 'CHI')",Providence,lil55.xml,193,1,0,CHI,2436,892,MOT
1,4,1,193,2.990719732,197,4,she,"('CHI', 'MOT')",Providence,lil55.xml,199,2,1,MOT,1101,2433,CHI
1,3,2,193,2.985681938,196,3,some,"('CHI', 'MOT')",Providence,lil55.xml,199,3,1,MOT,1101,2433,CHI
2,1,10,180,2.975893931,181,1,on,"('MOT', 'CHI')",Providence,lil55.xml,193,12,2,CHI,2436,892,MOT
4,4,4,187,2.960105096,191,4,like,"('CHI', 'MOT')",Providence,lil55.xml,199,8,4,MOT,1101,2433,CHI
1,0,17,175,2.87356464,175,0,little,"('MOT', 'CHI')",Providence,lil55.xml,193,18,1,CHI,2436,892,MOT
1,7,0,191,2.813410717,198,7,think,"('CHI', 'MOT')",Providence,lil55.xml,199,1,1,MOT,1101,2433,CHI
3,5,3,188,2.788092909,193,5,he,"('CHI', 'MOT')",Providence,lil55.xml,199,6,3,MOT,1101,2433,CHI
1,2,5,191,2.788092909,193,2,no,"('CHI', 'MOT')",Providence,lil55.xml,199,6,1,MOT,1101,2433,CHI
0,1,4,188,2.767366778,189,1,look,"('MOT', 'CHI')",Providence,lil55.xml,193,4,0,CHI,2436,892,MOT
0,1,4,188,2.767366778,189,1,but,"('MOT', 'CHI')",Providence,lil55.xml,193,4,0,CHI,2436,892,MOT
1,4,2,192,2.762538386,196,4,all,"('CHI', 'MOT')",Providence,lil55.xml,199,3,1,MOT,1101,2433,CHI
3,1,19,170,2.668384945,171,1,to,"('MOT', 'CHI')",Providence,lil55.xml,193,22,3,CHI,2436,892,MOT
2,6,2,189,2.644146399,195,6,can,"('CHI', 'MOT')",Providence,lil55.xml,199,4,2,MOT,1101,2433,CHI
0,1,5,187,2.607966743,188,1,not,"('MOT', 'CHI')",Providence,lil55.xml,193,5,0,CHI,2436,892,MOT
0,3,2,194,2.520716102,197,3,put,"('CHI', 'MOT')",Providence,lil55.xml,199,2,0,MOT,1101,2433,CHI
0,3,2,194,2.520716102,197,3,where,"('CHI', 'MOT')",Providence,lil55.xml,199,2,0,MOT,1101,2433,CHI
1,3,5,184,2.469158293,187,3,where,"('MOT', 'CHI')",Providence,lil55.xml,193,6,1,CHI,2436,892,MOT
1,4,4,190,2.415913778,194,4,they,"('CHI', 'MOT')",Providence,lil55.xml,199,5,1,MOT,1101,2433,CHI
1,5,3,190,2.392831971,195,5,have,"('CHI', 'MOT')",Providence,lil55.xml,199,4,1,MOT,1101,2433,CHI
0,1,7,191,2.377486401,192,1,my,"('CHI', 'MOT')",Providence,lil55.xml,199,7,0,MOT,1101,2433,CHI
0,2,4,187,2.36190167,189,2,gonna,"('MOT', 'CHI')",Providence,lil55.xml,193,4,0,CHI,2436,892,MOT
1,1,14,177,2.359743507,178,1,what,"('MOT', 'CHI')",Providence,lil55.xml,193,15,1,CHI,2436,892,MOT
3,12,1,183,2.312789263,195,12,was,"('CHI', 'MOT')",Providence,lil55.xml,199,4,3,MOT,1101,2433,CHI
0,6,1,192,2.253794929,198,6,go,"('CHI', 'MOT')",Providence,lil55.xml,199,1,0,MOT,1101,2433,CHI
0,1,8,184,2.235376343,185,1,did,"('MOT', 'CHI')",Providence,lil55.xml,193,8,0,CHI,2436,892,MOT
2,3,11,177,2.208274414,180,3,up,"('MOT', 'CHI')",Providence,lil55.xml,193,13,2,CHI,2436,892,MOT
1,0,1,15,2.140066163,15,0,get,"('OPE', 'CHI')",Providence,lil55.xml,17,2,1,CHI,87,69,OPE
0,7,1,191,2.120263536,198,7,of,"('CHI', 'MOT')",Providence,lil55.xml,199,1,0,MOT,1101,2433,CHI
1,11,1,186,2.115250994,197,11,did,"('CHI', 'MOT')",Providence,lil55.xml,199,2,1,MOT,1101,2433,CHI
8,7,15,169,2.080690761,176,7,yeah,"('CHI', 'MOT')",Providence,lil55.xml,199,23,8,MOT,1101,2433,CHI
1,3,9,180,2.042301995,183,3,we,"('MOT', 'CHI')",Providence,lil55.xml,193,10,1,CHI,2436,892,MOT
0,8,1,190,2.002480501,198,8,wanna,"('CHI', 'MOT')",Providence,lil55.xml,199,1,0,MOT,1101,2433,CHI
0,2,7,184,1.940605097,186,2,like,"('MOT', 'CHI')",Providence,lil55.xml,193,7,0,CHI,2436,892,MOT
0,2,7,184,1.940605097,186,2,make,"('MOT', 'CHI')",Providence,lil55.xml,193,7,0,CHI,2436,892,MOT
0,2,7,184,1.940605097,186,2,wanna,"('MOT', 'CHI')",Providence,lil55.xml,193,7,0,CHI,2436,892,MOT
3,10,5,175,1.916922612,185,10,no,"('MOT', 'CHI')",Providence,lil55.xml,193,8,3,CHI,2436,892,MOT
0,3,5,185,1.914819562,188,3,have,"('MOT', 'CHI')",Providence,lil55.xml,193,5,0,CHI,2436,892,MOT
0,3,5,185,1.914819562,188,3,some,"('MOT', 'CHI')",Providence,lil55.xml,193,5,0,CHI,2436,892,MOT
1,14,1,183,1.892107443,197,14,we,"('CHI', 'MOT')",Providence,lil55.xml,199,2,1,MOT,1101,2433,CHI
0,5,3,191,1.887069649,196,5,get,"('CHI', 'MOT')",Providence,lil55.xml,199,3,0,MOT,1101,2433,CHI
1,9,3,186,1.882006347,195,9,but,"('CHI', 'MOT')",Providence,lil55.xml,199,4,1,MOT,1101,2433,CHI
0,1,12,180,1.877281643,181,1,for,"('MOT', 'CHI')",Providence,lil55.xml,193,12,0,CHI,2436,892,MOT
1,3,11,178,1.877281643,181,3,can,"('MOT', 'CHI')",Providence,lil55.xml,193,12,1,CHI,2436,892,MOT
3,3,22,165,1.839961571,168,3,oh,"('MOT', 'CHI')",Providence,lil55.xml,193,25,3,CHI,2436,892,MOT
0,2,8,183,1.829911235,185,2,at,"('MOT', 'CHI')",Providence,lil55.xml,193,8,0,CHI,2436,892,MOT
1,12,2,184,1.807026941,196,12,do,"('CHI', 'MOT')",Providence,lil55.xml,199,3,1,MOT,1101,2433,CHI
0,10,1,188,1.801809805,198,10,at,"('CHI', 'MOT')",Providence,lil55.xml,199,1,0,MOT,1101,2433,CHI
2,8,8,181,1.66875449,189,8,one,"('CHI', 'MOT')",Providence,lil55.xml,199,10,2,MOT,1101,2433,CHI
0,2,10,181,1.636836887,183,2,get,"('MOT', 'CHI')",Providence,lil55.xml,193,10,0,CHI,2436,892,MOT
0,9,2,188,1.604425371,197,9,see,"('CHI', 'MOT')",Providence,lil55.xml,199,2,0,MOT,1101,2433,CHI
1,0,0,5,1.540445041,5,0,what,"('CHI', 'OPE')",Providence,lil55.xml,6,1,1,OPE,29,44,CHI
1,0,0,5,1.540445041,5,0,some,"('CHI', 'OPE')",Providence,lil55.xml,6,1,1,OPE,29,44,CHI
1,0,3,12,1.540445041,12,0,she,"('MOT', 'OPE')",Providence,lil55.xml,16,4,1,OPE,390,103,MOT
0,5,5,189,1.540445041,194,5,want,"('CHI', 'MOT')",Providence,lil55.xml,199,5,0,MOT,1101,2433,CHI
1,6,9,183,1.51460381,189,6,this,"('CHI', 'MOT')",Providence,lil55.xml,199,10,1,MOT,1101,2433,CHI
0,10,2,187,1.509115191,197,10,are,"('CHI', 'MOT')",Providence,lil55.xml,199,2,0,MOT,1101,2433,CHI
4,23,3,169,1.502017664,192,23,to,"('CHI', 'MOT')",Providence,lil55.xml,199,7,4,MOT,1101,2433,CHI
0,2,12,179,1.471816535,181,2,with,"('MOT', 'CHI')",Providence,lil55.xml,193,12,0,CHI,2436,892,MOT
2,3,26,162,1.429114358,165,3,is,"('MOT', 'CHI')",Providence,lil55.xml,193,28,2,CHI,2436,892,MOT
0,2,13,178,1.397344197,180,2,of,"('MOT', 'CHI')",Providence,lil55.xml,193,13,0,CHI,2436,892,MOT
1,6,10,176,1.397223432,182,6,one,"('MOT', 'CHI')",Providence,lil55.xml,193,11,1,CHI,2436,892,MOT
0,7,4,182,1.381072417,189,7,want,"('MOT', 'CHI')",Providence,lil55.xml,193,4,0,CHI,2436,892,MOT
4,6,24,159,1.380324194,165,6,a,"('MOT', 'CHI')",Providence,lil55.xml,193,28,4,CHI,2436,892,MOT
0,3,10,180,1.349154814,183,3,go,"('MOT', 'CHI')",Providence,lil55.xml,193,10,0,CHI,2436,892,MOT
0,8,4,187,1.294219682,195,8,on,"('CHI', 'MOT')",Providence,lil55.xml,199,4,0,MOT,1101,2433,CHI
2,1,2,11,1.252762968,12,1,is,"('MOT', 'OPE')",Providence,lil55.xml,16,4,2,OPE,390,103,MOT
3,20,6,170,1.201372023,190,20,in,"('CHI', 'MOT')",Providence,lil55.xml,199,9,3,MOT,1101,2433,CHI
0,2,17,174,1.138732282,176,2,do,"('MOT', 'CHI')",Providence,lil55.xml,193,17,0,CHI,2436,892,MOT
0,6,7,186,1.124723433,192,6,for,"('CHI', 'MOT')",Providence,lil55.xml,199,7,0,MOT,1101,2433,CHI
1,0,5,10,1.098612289,10,0,the,"('MOT', 'OPE')",Providence,lil55.xml,16,6,1,OPE,390,103,MOT
0,1,1,15,1.098612289,16,1,oh,"('OPE', 'CHI')",Providence,lil55.xml,17,1,0,CHI,87,69,OPE
0,1,1,15,1.098612289,16,1,in,"('OPE', 'CHI')",Providence,lil55.xml,17,1,0,CHI,87,69,OPE
0,1,1,15,1.098612289,16,1,we,"('OPE', 'CHI')",Providence,lil55.xml,17,1,0,CHI,87,69,OPE
0,1,1,15,1.098612289,16,1,what,"('OPE', 'CHI')",Providence,lil55.xml,17,1,0,CHI,87,69,OPE
0,1,1,15,1.098612289,16,1,a,"('OPE', 'CHI')",Providence,lil55.xml,17,1,0,CHI,87,69,OPE
0,1,1,15,1.098612289,16,1,put,"('OPE', 'CHI')",Providence,lil55.xml,17,1,0,CHI,87,69,OPE
0,1,1,15,1.098612289,16,1,wanna,"('OPE', 'CHI')",Providence,lil55.xml,17,1,0,CHI,87,69,OPE
0,1,1,15,1.098612289,16,1,the,"('OPE', 'CHI')",Providence,lil55.xml,17,1,0,CHI,87,69,OPE
0,1,1,15,1.098612289,16,1,on,"('OPE', 'CHI')",Providence,lil55.xml,17,1,0,CHI,87,69,OPE
1,1,2,12,1.098612289,13,1,yeah,"('MOT', 'OPE')",Providence,lil55.xml,16,3,1,OPE,390,103,MOT
7,25,10,157,1.091841782,182,25,the,"('CHI', 'MOT')",Providence,lil55.xml,199,17,7,MOT,1101,2433,CHI
0,1,1,14,1.041453875,15,1,have,"('MOT', 'OPE')",Providence,lil55.xml,16,1,0,OPE,390,103,MOT
0,1,1,14,1.041453875,15,1,what,"('MOT', 'OPE')",Providence,lil55.xml,16,1,0,OPE,390,103,MOT
0,1,1,14,1.041453875,15,1,see,"('MOT', 'OPE')",Providence,lil55.xml,16,1,0,OPE,390,103,MOT
0,1,1,14,1.041453875,15,1,little,"('MOT', 'OPE')",Providence,lil55.xml,16,1,0,OPE,390,103,MOT
0,4,11,178,1.040548488,182,4,put,"('MOT', 'CHI')",Providence,lil55.xml,193,11,0,CHI,2436,892,MOT
2,1,3,10,1.024504317,11,1,that,"('MOT', 'OPE')",Providence,lil55.xml,16,5,2,OPE,390,103,MOT
0,5,10,178,0.943689706,183,5,think,"('MOT', 'CHI')",Providence,lil55.xml,193,10,0,CHI,2436,892,MOT
9,15,29,140,0.897362722,155,15,it,"('MOT', 'CHI')",Providence,lil55.xml,193,38,9,CHI,2436,892,MOT
5,12,25,151,0.867019683,163,12,the,"('MOT', 'CHI')",Providence,lil55.xml,193,30,5,CHI,2436,892,MOT
8,34,10,147,0.855630395,181,34,a,"('CHI', 'MOT')",Providence,lil55.xml,199,18,8,MOT,1101,2433,CHI
0,28,1,170,0.832409248,198,28,oh,"('CHI', 'MOT')",Providence,lil55.xml,199,1,0,MOT,1101,2433,CHI
2,1,4,9,0.810930216,10,1,it,"('MOT', 'OPE')",Providence,lil55.xml,16,6,2,OPE,390,103,MOT
5,22,15,157,0.763719831,179,22,it,"('CHI', 'MOT')",Providence,lil55.xml,199,20,5,MOT,1101,2433,CHI
1,36,2,160,0.761058386,196,36,that,"('CHI', 'MOT')",Providence,lil55.xml,199,3,1,MOT,1101,2433,CHI
0,1,2,13,0.693147181,14,1,they,"('MOT', 'OPE')",Providence,lil55.xml,16,2,0,OPE,390,103,MOT
0,1,2,13,0.693147181,14,1,up,"('MOT', 'OPE')",Providence,lil55.xml,16,2,0,OPE,390,103,MOT
0,2,1,14,0.693147181,16,2,this,"('OPE', 'CHI')",Providence,lil55.xml,17,1,0,CHI,87,69,OPE
0,2,1,14,0.693147181,16,2,can,"('OPE', 'CHI')",Providence,lil55.xml,17,1,0,CHI,87,69,OPE
9,44,10,136,0.655406853,180,44,you,"('CHI', 'MOT')",Providence,lil55.xml,199,19,9,MOT,1101,2433,CHI
0,20,3,176,0.634306681,196,20,and,"('CHI', 'MOT')",Providence,lil55.xml,199,3,0,MOT,1101,2433,CHI
5,6,55,127,0.623989714,133,6,you,"('MOT', 'CHI')",Providence,lil55.xml,193,60,5,CHI,2436,892,MOT
0,1,1,7,0.510825624,8,1,oh,"('OPE', 'MOT')",Providence,lil55.xml,9,1,0,MOT,42,144,OPE
1,3,0,5,0.510825624,8,3,you,"('OPE', 'MOT')",Providence,lil55.xml,9,1,1,MOT,42,144,OPE
0,1,1,7,0.510825624,8,1,like,"('OPE', 'MOT')",Providence,lil55.xml,9,1,0,MOT,42,144,OPE
0,11,8,174,0.443616874,185,11,this,"('MOT', 'CHI')",Providence,lil55.xml,193,8,0,CHI,2436,892,MOT
1,8,22,162,0.424541255,170,8,and,"('MOT', 'CHI')",Providence,lil55.xml,193,23,1,CHI,2436,892,MOT
0,1,3,12,0.405465108,13,1,in,"('MOT', 'OPE')",Providence,lil55.xml,16,3,0,OPE,390,103,MOT
0,1,3,12,0.405465108,13,1,we,"('MOT', 'OPE')",Providence,lil55.xml,16,3,0,OPE,390,103,MOT
0,1,3,12,0.405465108,13,1,this,"('MOT', 'OPE')",Providence,lil55.xml,16,3,0,OPE,390,103,MOT
0,1,3,12,0.405465108,13,1,can,"('MOT', 'OPE')",Providence,lil55.xml,16,3,0,OPE,390,103,MOT
0,2,2,13,0.348306694,15,2,that,"('OPE', 'CHI')",Providence,lil55.xml,17,2,0,CHI,87,69,OPE
1,16,13,169,0.318453731,185,16,what,"('CHI', 'MOT')",Providence,lil55.xml,199,14,1,MOT,1101,2433,CHI
0,2,2,12,0.287682072,14,2,a,"('MOT', 'OPE')",Providence,lil55.xml,16,2,0,OPE,390,103,MOT
0,15,7,171,0.266628663,186,15,yeah,"('MOT', 'CHI')",Providence,lil55.xml,193,7,0,CHI,2436,892,MOT
4,43,11,141,0.217781608,184,43,is,"('CHI', 'MOT')",Providence,lil55.xml,199,15,4,MOT,1101,2433,CHI
0,1,4,11,0.15415068,12,1,of,"('MOT', 'OPE')",Providence,lil55.xml,16,4,0,OPE,390,103,MOT
0,1,1,4,0.15415068,5,1,a,"('CHI', 'OPE')",Providence,lil55.xml,6,1,0,OPE,29,44,CHI
1,2,5,9,0.080042708,11,2,you,"('OPE', 'CHI')",Providence,lil55.xml,17,6,1,CHI,87,69,OPE
0,2,3,11,0,13,2,on,"('MOT', 'OPE')",Providence,lil55.xml,16,3,0,OPE,390,103,MOT
0,1,5,10,-0.074107972,11,1,like,"('MOT', 'OPE')",Providence,lil55.xml,16,5,0,OPE,390,103,MOT
0,7,23,163,-0.15082289,170,7,in,"('MOT', 'CHI')",Providence,lil55.xml,193,23,0,CHI,2436,892,MOT
0,2,1,3,-0.251314428,5,2,in,"('CHI', 'OPE')",Providence,lil55.xml,6,1,0,OPE,29,44,CHI
0,6,29,158,-0.267909565,164,6,that,"('MOT', 'CHI')",Providence,lil55.xml,193,29,0,CHI,2436,892,MOT
1,5,1,472,3.686793948,477,5,he,"('CHI', 'MOT')",Providence,lil56.xml,479,2,1,MOT,2816,4685,CHI
2,8,2,467,3.277144733,475,8,big,"('CHI', 'MOT')",Providence,lil56.xml,479,4,2,MOT,2816,4685,CHI
1,12,0,466,3.203371638,478,12,get,"('CHI', 'MOT')",Providence,lil56.xml,479,1,1,MOT,2816,4685,CHI
0,6,1,472,3.129263666,478,6,where,"('CHI', 'MOT')",Providence,lil56.xml,479,1,0,MOT,2816,4685,CHI
1,2,11,465,3.106080331,467,2,no,"('CHI', 'MOT')",Providence,lil56.xml,479,12,1,MOT,2816,4685,CHI
1,15,0,463,2.995732274,478,15,think,"('CHI', 'MOT')",Providence,lil56.xml,479,1,1,MOT,2816,4685,CHI
2,9,6,462,2.652537491,471,9,have,"('CHI', 'MOT')",Providence,lil56.xml,479,8,2,MOT,2816,4685,CHI
0,5,4,470,2.583997552,475,5,put,"('CHI', 'MOT')",Providence,lil56.xml,479,4,0,MOT,2816,4685,CHI
2,13,4,460,2.543428221,473,13,at,"('CHI', 'MOT')",Providence,lil56.xml,479,6,2,MOT,2816,4685,CHI
1,10,5,463,2.37912517,473,10,one,"('CHI', 'MOT')",Providence,lil56.xml,479,6,1,MOT,2816,4685,CHI
1,10,6,462,2.259234652,472,10,want,"('CHI', 'MOT')",Providence,lil56.xml,479,7,1,MOT,2816,4685,CHI
2,21,3,453,2.22707754,474,21,for,"('CHI', 'MOT')",Providence,lil56.xml,479,5,2,MOT,2816,4685,CHI
1,17,3,458,2.178532444,475,17,there,"('CHI', 'MOT')",Providence,lil56.xml,479,4,1,MOT,2816,4685,CHI
4,20,7,448,2.152698812,468,20,see,"('CHI', 'MOT')",Providence,lil56.xml,479,11,4,MOT,2816,4685,CHI
3,10,15,451,2.130393869,461,10,she,"('CHI', 'MOT')",Providence,lil56.xml,479,18,3,MOT,2816,4685,CHI
1,18,3,457,2.124465223,475,18,look,"('CHI', 'MOT')",Providence,lil56.xml,479,4,1,MOT,2816,4685,CHI
3,25,4,447,2.092180567,472,25,go,"('CHI', 'MOT')",Providence,lil56.xml,479,7,3,MOT,2816,4685,CHI
1,0,3,21,2.036881927,21,0,oh,"('MOT', 'CHI')",Providence,lil56.xml,25,4,1,CHI,171,157,MOT
0,8,5,466,2.022283128,474,8,but,"('CHI', 'MOT')",Providence,lil56.xml,479,5,0,MOT,2816,4685,CHI
0,8,5,466,2.022283128,474,8,up,"('CHI', 'MOT')",Providence,lil56.xml,479,5,0,MOT,2816,4685,CHI
0,6,7,466,2.018072595,472,6,gonna,"('CHI', 'MOT')",Providence,lil56.xml,479,7,0,MOT,2816,4685,CHI
1,13,6,459,2.018072595,472,13,was,"('CHI', 'MOT')",Providence,lil56.xml,479,7,1,MOT,2816,4685,CHI
0,15,2,462,2.012817514,477,15,some,"('CHI', 'MOT')",Providence,lil56.xml,479,2,0,MOT,2816,4685,CHI
6,19,15,439,1.945910149,458,19,is,"('CHI', 'MOT')",Providence,lil56.xml,479,21,6,MOT,2816,4685,CHI
8,22,16,433,1.928317214,455,22,it,"('CHI', 'MOT')",Providence,lil56.xml,479,24,8,MOT,2816,4685,CHI
2,12,12,453,1.907403467,465,12,they,"('CHI', 'MOT')",Providence,lil56.xml,479,14,2,MOT,2816,4685,CHI
2,25,5,447,1.804498495,472,25,we,"('CHI', 'MOT')",Providence,lil56.xml,479,7,2,MOT,2816,4685,CHI
6,13,29,431,1.796253859,444,13,yeah,"('CHI', 'MOT')",Providence,lil56.xml,479,35,6,MOT,2816,4685,CHI
1,17,6,455,1.766758167,472,17,are,"('CHI', 'MOT')",Providence,lil56.xml,479,7,1,MOT,2816,4685,CHI
1,2,0,22,1.754019141,24,2,no,"('MOT', 'CHI')",Providence,lil56.xml,25,1,1,CHI,171,157,MOT
2,9,20,448,1.747023575,457,9,my,"('CHI', 'MOT')",Providence,lil56.xml,479,22,2,MOT,2816,4685,CHI
5,28,11,435,1.676129287,463,28,little,"('CHI', 'MOT')",Providence,lil56.xml,479,16,5,MOT,2816,4685,CHI
0,14,4,461,1.667706821,475,14,with,"('CHI', 'MOT')",Providence,lil56.xml,479,4,0,MOT,2816,4685,CHI
2,14,15,448,1.586007661,462,14,wanna,"('CHI', 'MOT')",Providence,lil56.xml,479,17,2,MOT,2816,4685,CHI
2,27,7,443,1.525491491,470,27,like,"('CHI', 'MOT')",Providence,lil56.xml,479,9,2,MOT,2816,4685,CHI
1,20,7,451,1.505135038,471,20,on,"('CHI', 'MOT')",Providence,lil56.xml,479,8,1,MOT,2816,4685,CHI
1,14,11,453,1.496642418,467,14,can,"('CHI', 'MOT')",Providence,lil56.xml,479,12,1,MOT,2816,4685,CHI
0,1,1,23,1.466337069,24,1,a,"('MOT', 'CHI')",Providence,lil56.xml,25,1,0,CHI,171,157,MOT
0,1,1,23,1.466337069,24,1,all,"('MOT', 'CHI')",Providence,lil56.xml,25,1,0,CHI,171,157,MOT
0,13,6,460,1.444815933,473,13,this,"('CHI', 'MOT')",Providence,lil56.xml,479,6,0,MOT,2816,4685,CHI
2,24,10,443,1.391281903,467,24,of,"('CHI', 'MOT')",Providence,lil56.xml,479,12,2,MOT,2816,4685,CHI
3,31,11,434,1.294298994,465,31,in,"('CHI', 'MOT')",Providence,lil56.xml,479,14,3,MOT,2816,4685,CHI
3,39,9,428,1.208960346,467,39,that,"('CHI', 'MOT')",Providence,lil56.xml,479,12,3,MOT,2816,4685,CHI
12,38,30,399,1.20169749,437,38,the,"('CHI', 'MOT')",Providence,lil56.xml,479,42,12,MOT,2816,4685,CHI
19,48,32,380,1.197405271,428,48,a,"('CHI', 'MOT')",Providence,lil56.xml,479,51,19,MOT,2816,4685,CHI
2,86,1,390,1.19287699,476,86,oh,"('CHI', 'MOT')",Providence,lil56.xml,479,3,2,MOT,2816,4685,CHI
2,43,6,428,1.17093295,471,43,do,"('CHI', 'MOT')",Providence,lil56.xml,479,8,2,MOT,2816,4685,CHI
0,1,2,22,1.139434283,23,1,go,"('MOT', 'CHI')",Providence,lil56.xml,25,2,0,CHI,171,157,MOT
0,9,13,457,1.137833002,466,9,all,"('CHI', 'MOT')",Providence,lil56.xml,479,13,0,MOT,2816,4685,CHI
8,46,18,407,1.135169884,453,46,to,"('CHI', 'MOT')",Providence,lil56.xml,479,26,8,MOT,2816,4685,CHI
0,1,3,21,0.875468737,22,1,the,"('MOT', 'CHI')",Providence,lil56.xml,25,3,0,CHI,171,157,MOT
1,0,0,1,0.693147181,1,0,you,"('OPE', 'MOT')",Providence,lil56.xml,2,1,1,MOT,7,16,OPE
0,4,1,20,0.550046337,24,4,yeah,"('MOT', 'CHI')",Providence,lil56.xml,25,1,0,CHI,171,157,MOT
0,28,11,440,0.220487507,468,28,what,"('CHI', 'MOT')",Providence,lil56.xml,479,11,0,MOT,2816,4685,CHI
8,117,18,336,0.214632862,453,117,you,"('CHI', 'MOT')",Providence,lil56.xml,479,26,8,MOT,2816,4685,CHI
7,41,59,372,0.150542738,413,41,and,"('CHI', 'MOT')",Providence,lil56.xml,479,66,7,MOT,2816,4685,CHI
0,1,2,330,3.728700948,331,1,want,"('CHI', 'MOT')",Providence,lil57.xml,333,2,0,MOT,1362,5604,CHI
1,11,0,321,2.920769235,332,11,get,"('CHI', 'MOT')",Providence,lil57.xml,333,1,1,MOT,1362,5604,CHI
1,8,1,323,2.917770732,331,8,she,"('CHI', 'MOT')",Providence,lil57.xml,333,2,1,MOT,1362,5604,CHI
1,1,2,79,2.797281335,80,1,one,"('MOT', 'CHI')",Providence,lil57.xml,83,3,1,CHI,1169,335,MOT
1,0,7,75,2.734367509,75,0,of,"('MOT', 'CHI')",Providence,lil57.xml,83,8,1,CHI,1169,335,MOT
1,10,1,321,2.717100037,331,10,can,"('CHI', 'MOT')",Providence,lil57.xml,333,2,1,MOT,1362,5604,CHI
0,1,1,81,2.63905733,82,1,have,"('MOT', 'CHI')",Providence,lil57.xml,83,1,0,CHI,1169,335,MOT
0,1,1,81,2.63905733,82,1,did,"('MOT', 'CHI')",Providence,lil57.xml,83,1,0,CHI,1169,335,MOT
1,11,1,320,2.63008866,331,11,like,"('CHI', 'MOT')",Providence,lil57.xml,333,2,1,MOT,1362,5604,CHI
2,11,2,318,2.624064545,329,11,they,"('CHI', 'MOT')",Providence,lil57.xml,333,4,2,MOT,1362,5604,CHI
2,0,12,69,2.588703443,69,0,and,"('MOT', 'CHI')",Providence,lil57.xml,83,14,2,CHI,1169,335,MOT
1,16,0,316,2.572462541,332,16,did,"('CHI', 'MOT')",Providence,lil57.xml,333,1,1,MOT,1362,5604,CHI
5,14,3,311,2.571084346,325,14,have,"('CHI', 'MOT')",Providence,lil57.xml,333,8,5,MOT,1362,5604,CHI
1,6,5,321,2.463853241,327,6,gonna,"('CHI', 'MOT')",Providence,lil57.xml,333,6,1,MOT,1362,5604,CHI
2,17,1,313,2.403937587,330,17,he,"('CHI', 'MOT')",Providence,lil57.xml,333,3,2,MOT,1362,5604,CHI
0,1,2,80,2.339399066,81,1,but,"('MOT', 'CHI')",Providence,lil57.xml,83,2,0,CHI,1169,335,MOT
0,1,2,80,2.339399066,81,1,no,"('MOT', 'CHI')",Providence,lil57.xml,83,2,0,CHI,1169,335,MOT
2,11,4,316,2.330321848,327,11,one,"('CHI', 'MOT')",Providence,lil57.xml,333,6,2,MOT,1362,5604,CHI
0,10,1,322,2.314633432,332,10,with,"('CHI', 'MOT')",Providence,lil57.xml,333,1,0,MOT,1362,5604,CHI
1,13,2,317,2.249786907,330,13,big,"('CHI', 'MOT')",Providence,lil57.xml,333,3,1,MOT,1362,5604,CHI
0,11,1,321,2.227622055,332,11,for,"('CHI', 'MOT')",Providence,lil57.xml,333,1,0,MOT,1362,5604,CHI
2,12,5,314,2.129451962,326,12,up,"('CHI', 'MOT')",Providence,lil57.xml,333,7,2,MOT,1362,5604,CHI
0,1,3,79,2.104134154,80,1,look,"('MOT', 'CHI')",Providence,lil57.xml,83,3,0,CHI,1169,335,MOT
1,8,6,318,2.091711634,326,8,wanna,"('CHI', 'MOT')",Providence,lil57.xml,333,7,1,MOT,1362,5604,CHI
3,16,5,309,2.040456095,325,16,look,"('CHI', 'MOT')",Providence,lil57.xml,333,8,3,MOT,1362,5604,CHI
2,25,1,305,2.036212807,330,25,think,"('CHI', 'MOT')",Providence,lil57.xml,333,3,2,MOT,1362,5604,CHI
3,1,14,65,1.968215907,66,1,is,"('MOT', 'CHI')",Providence,lil57.xml,83,17,3,CHI,1169,335,MOT
3,22,3,305,1.967416354,327,22,we,"('CHI', 'MOT')",Providence,lil57.xml,333,6,3,MOT,1362,5604,CHI
0,11,2,320,1.936941479,331,11,my,"('CHI', 'MOT')",Providence,lil57.xml,333,2,0,MOT,1362,5604,CHI
1,0,17,65,1.902107526,65,0,that,"('MOT', 'CHI')",Providence,lil57.xml,83,18,1,CHI,1169,335,MOT
0,16,1,316,1.87931536,332,16,at,"('CHI', 'MOT')",Providence,lil57.xml,333,1,0,MOT,1362,5604,CHI
6,31,3,293,1.869176355,324,31,on,"('CHI', 'MOT')",Providence,lil57.xml,333,9,6,MOT,1362,5604,CHI
1,26,1,305,1.819158443,331,26,see,"('CHI', 'MOT')",Providence,lil57.xml,333,2,1,MOT,1362,5604,CHI
1,26,1,305,1.819158443,331,26,do,"('CHI', 'MOT')",Providence,lil57.xml,333,2,1,MOT,1362,5604,CHI
0,9,4,320,1.707773813,329,9,where,"('CHI', 'MOT')",Providence,lil57.xml,333,4,0,MOT,1362,5604,CHI
9,16,24,284,1.624450705,300,16,yeah,"('CHI', 'MOT')",Providence,lil57.xml,333,33,9,MOT,1362,5604,CHI
0,16,2,315,1.588634785,331,16,little,"('CHI', 'MOT')",Providence,lil57.xml,333,2,0,MOT,1362,5604,CHI
0,2,4,77,1.504077397,79,2,oh,"('MOT', 'CHI')",Providence,lil57.xml,83,4,0,CHI,1169,335,MOT
0,1,7,75,1.466337069,76,1,to,"('MOT', 'CHI')",Providence,lil57.xml,83,7,0,CHI,1169,335,MOT
0,13,4,316,1.371301577,329,13,was,"('CHI', 'MOT')",Providence,lil57.xml,333,4,0,MOT,1362,5604,CHI
1,3,7,72,1.348073148,75,3,what,"('MOT', 'CHI')",Providence,lil57.xml,83,8,1,CHI,1169,335,MOT
0,1,8,74,1.348073148,75,1,gonna,"('MOT', 'CHI')",Providence,lil57.xml,83,8,0,CHI,1169,335,MOT
0,17,3,313,1.305325299,330,17,all,"('CHI', 'MOT')",Providence,lil57.xml,333,3,0,MOT,1362,5604,CHI
0,30,1,302,1.2785415,332,30,of,"('CHI', 'MOT')",Providence,lil57.xml,333,1,0,MOT,1362,5604,CHI
0,1,9,73,1.239690887,74,1,can,"('MOT', 'CHI')",Providence,lil57.xml,83,9,0,CHI,1169,335,MOT
2,4,10,67,1.140576488,71,4,it,"('MOT', 'CHI')",Providence,lil57.xml,83,12,2,CHI,1169,335,MOT
0,1,10,72,1.139434283,73,1,do,"('MOT', 'CHI')",Providence,lil57.xml,83,10,0,CHI,1169,335,MOT
2,10,3,68,1.136833501,78,10,want,"('MOT', 'CHI')",Providence,lil57.xml,83,5,2,CHI,1169,335,MOT
24,53,18,238,1.125874753,291,53,a,"('CHI', 'MOT')",Providence,lil57.xml,333,42,24,MOT,1362,5604,CHI
0,27,2,304,1.089643619,331,27,there,"('CHI', 'MOT')",Providence,lil57.xml,333,2,0,MOT,1362,5604,CHI
2,25,9,297,1.056309909,322,25,what,"('CHI', 'MOT')",Providence,lil57.xml,333,11,2,MOT,1362,5604,CHI
1,17,11,304,0.941370416,321,17,are,"('CHI', 'MOT')",Providence,lil57.xml,333,12,1,MOT,1362,5604,CHI
17,66,13,237,0.940255012,303,66,the,"('CHI', 'MOT')",Providence,lil57.xml,333,30,17,MOT,1362,5604,CHI
3,38,8,284,0.938526873,322,38,in,"('CHI', 'MOT')",Providence,lil57.xml,333,11,3,MOT,1362,5604,CHI
3,33,11,286,0.858786237,319,33,oh,"('CHI', 'MOT')",Providence,lil57.xml,333,14,3,MOT,1362,5604,CHI
15,56,19,243,0.853128781,299,56,and,"('CHI', 'MOT')",Providence,lil57.xml,333,34,15,MOT,1362,5604,CHI
0,11,1,71,0.84729786,82,11,yeah,"('MOT', 'CHI')",Providence,lil57.xml,83,1,0,CHI,1169,335,MOT
0,17,6,310,0.826244451,327,17,this,"('CHI', 'MOT')",Providence,lil57.xml,333,6,0,MOT,1362,5604,CHI
0,17,6,310,0.826244451,327,17,no,"('CHI', 'MOT')",Providence,lil57.xml,333,6,0,MOT,1362,5604,CHI
6,65,7,255,0.822756751,320,65,that,"('CHI', 'MOT')",Providence,lil57.xml,333,13,6,MOT,1362,5604,CHI
5,52,9,267,0.820319957,319,52,it,"('CHI', 'MOT')",Providence,lil57.xml,333,14,5,MOT,1362,5604,CHI
1,48,3,281,0.811685789,329,48,to,"('CHI', 'MOT')",Providence,lil57.xml,333,4,1,MOT,1362,5604,CHI
0,5,4,74,0.810930216,79,5,wanna,"('MOT', 'CHI')",Providence,lil57.xml,83,4,0,CHI,1169,335,MOT
1,3,17,62,0.515813165,65,3,the,"('MOT', 'CHI')",Providence,lil57.xml,83,18,1,CHI,1169,335,MOT
6,106,5,216,0.488875473,322,106,is,"('CHI', 'MOT')",Providence,lil57.xml,333,11,6,MOT,1362,5604,CHI
2,4,25,52,0.182321557,56,4,you,"('MOT', 'CHI')",Providence,lil57.xml,83,27,2,CHI,1169,335,MOT
1,68,7,257,-0.053584246,325,68,you,"('CHI', 'MOT')",Providence,lil57.xml,333,8,1,MOT,1362,5604,CHI
1,10,14,58,-0.289466194,68,10,a,"('MOT', 'CHI')",Providence,lil57.xml,83,15,1,CHI,1169,335,MOT
0,1,1,391,4.18459144,392,1,put,"('CHI', 'MOT')",Providence,lil58.xml,393,1,0,MOT,1580,4923,CHI
1,2,1,389,4.182050143,391,2,she,"('CHI', 'MOT')",Providence,lil58.xml,393,2,1,MOT,1580,4923,CHI
0,2,3,388,3.263211639,390,2,want,"('CHI', 'MOT')",Providence,lil58.xml,393,3,0,MOT,1580,4923,CHI
0,3,3,387,2.975529566,390,3,not,"('CHI', 'MOT')",Providence,lil58.xml,393,3,0,MOT,1580,4923,CHI
1,8,2,382,2.857746531,390,8,big,"('CHI', 'MOT')",Providence,lil58.xml,393,3,1,MOT,1580,4923,CHI
3,10,4,376,2.752179851,386,10,all,"('CHI', 'MOT')",Providence,lil58.xml,393,7,3,MOT,1580,4923,CHI
1,8,3,381,2.672870694,389,8,no,"('CHI', 'MOT')",Providence,lil58.xml,393,4,1,MOT,1580,4923,CHI
1,13,1,378,2.641605102,391,13,for,"('CHI', 'MOT')",Providence,lil58.xml,393,2,1,MOT,1580,4923,CHI
4,19,1,369,2.633942229,388,19,little,"('CHI', 'MOT')",Providence,lil58.xml,393,5,4,MOT,1580,4923,CHI
2,21,0,370,2.595085086,391,21,think,"('CHI', 'MOT')",Providence,lil58.xml,393,2,2,MOT,1580,4923,CHI
0,9,1,383,2.575153528,392,9,wanna,"('CHI', 'MOT')",Providence,lil58.xml,393,1,0,MOT,1580,4923,CHI
2,8,6,377,2.557227311,385,8,up,"('CHI', 'MOT')",Providence,lil58.xml,393,8,2,MOT,1580,4923,CHI
6,5,29,353,2.429336799,358,5,yeah,"('CHI', 'MOT')",Providence,lil58.xml,393,35,6,MOT,1580,4923,CHI
1,12,3,377,2.305145914,389,12,with,"('CHI', 'MOT')",Providence,lil58.xml,393,4,1,MOT,1580,4923,CHI
1,9,5,378,2.27469989,387,9,like,"('CHI', 'MOT')",Providence,lil58.xml,393,6,1,MOT,1580,4923,CHI
0,13,1,379,2.238681291,392,13,there,"('CHI', 'MOT')",Providence,lil58.xml,393,1,0,MOT,1580,4923,CHI
1,11,4,377,2.228477121,388,11,where,"('CHI', 'MOT')",Providence,lil58.xml,393,5,1,MOT,1580,4923,CHI
1,16,2,374,2.221757764,390,16,go,"('CHI', 'MOT')",Providence,lil58.xml,393,3,1,MOT,1580,4923,CHI
0,10,2,381,2.189619978,391,10,was,"('CHI', 'MOT')",Providence,lil58.xml,393,2,0,MOT,1580,4923,CHI
0,14,1,378,2.16968842,392,14,at,"('CHI', 'MOT')",Providence,lil58.xml,393,1,0,MOT,1580,4923,CHI
0,12,2,379,2.022565893,391,12,they,"('CHI', 'MOT')",Providence,lil58.xml,393,2,0,MOT,1580,4923,CHI
0,12,2,379,2.022565893,391,12,but,"('CHI', 'MOT')",Providence,lil58.xml,393,2,0,MOT,1580,4923,CHI
5,16,11,361,2.005710572,377,16,one,"('CHI', 'MOT')",Providence,lil58.xml,393,16,5,MOT,1580,4923,CHI
0,10,3,380,1.963928655,390,10,he,"('CHI', 'MOT')",Providence,lil58.xml,393,3,0,MOT,1580,4923,CHI
3,30,3,357,1.836444959,387,30,are,"('CHI', 'MOT')",Providence,lil58.xml,393,6,3,MOT,1580,4923,CHI
1,13,6,373,1.817870613,386,13,look,"('CHI', 'MOT')",Providence,lil58.xml,393,7,1,MOT,1580,4923,CHI
1,31,1,360,1.814926529,391,31,of,"('CHI', 'MOT')",Providence,lil58.xml,393,2,1,MOT,1580,4923,CHI
0,17,2,374,1.697143493,391,17,can,"('CHI', 'MOT')",Providence,lil58.xml,393,2,0,MOT,1580,4923,CHI
4,39,5,345,1.478500555,384,39,in,"('CHI', 'MOT')",Providence,lil58.xml,393,9,4,MOT,1580,4923,CHI
2,38,3,350,1.455287233,388,38,do,"('CHI', 'MOT')",Providence,lil58.xml,393,5,2,MOT,1580,4923,CHI
1,28,5,359,1.209989153,387,28,oh,"('CHI', 'MOT')",Providence,lil58.xml,393,6,1,MOT,1580,4923,CHI
0,19,4,370,1.181215817,389,19,this,"('CHI', 'MOT')",Providence,lil58.xml,393,4,0,MOT,1580,4923,CHI
1,27,6,359,1.124723433,386,27,on,"('CHI', 'MOT')",Providence,lil58.xml,393,7,1,MOT,1580,4923,CHI
13,63,12,305,1.097840386,368,63,the,"('CHI', 'MOT')",Providence,lil58.xml,393,25,13,MOT,1580,4923,CHI
4,38,11,340,1.052834175,378,38,it,"('CHI', 'MOT')",Providence,lil58.xml,393,15,4,MOT,1580,4923,CHI
0,34,2,357,1.032167189,391,34,to,"('CHI', 'MOT')",Providence,lil58.xml,393,2,0,MOT,1580,4923,CHI
25,71,19,278,1.013575246,349,71,a,"('CHI', 'MOT')",Providence,lil58.xml,393,44,25,MOT,1580,4923,CHI
0,9,12,372,1.006392567,381,9,my,"('CHI', 'MOT')",Providence,lil58.xml,393,12,0,MOT,1580,4923,CHI
0,35,2,356,1.003996312,391,35,we,"('CHI', 'MOT')",Providence,lil58.xml,393,2,0,MOT,1580,4923,CHI
10,59,14,310,0.961656235,369,59,is,"('CHI', 'MOT')",Providence,lil58.xml,393,24,10,MOT,1580,4923,CHI
11,53,19,310,0.930084054,363,53,and,"('CHI', 'MOT')",Providence,lil58.xml,393,30,11,MOT,1580,4923,CHI
6,47,20,320,0.653301272,367,47,that,"('CHI', 'MOT')",Providence,lil58.xml,393,26,6,MOT,1580,4923,CHI
8,94,9,282,0.633802902,376,94,you,"('CHI', 'MOT')",Providence,lil58.xml,393,17,8,MOT,1580,4923,CHI
4,62,11,316,0.573261095,378,62,what,"('CHI', 'MOT')",Providence,lil58.xml,393,15,4,MOT,1580,4923,CHI
1,0,12,258,3.54577861,258,0,they,"('MOT', 'CHI')",Providence,lil59.xml,271,13,1,CHI,6742,1061,MOT
1,0,18,252,3.18595901,252,0,look,"('MOT', 'CHI')",Providence,lil59.xml,271,19,1,CHI,6742,1061,MOT
1,0,19,251,3.135494216,251,0,at,"('MOT', 'CHI')",Providence,lil59.xml,271,20,1,CHI,6742,1061,MOT
1,1,9,260,3.087247382,261,1,big,"('MOT', 'CHI')",Providence,lil59.xml,271,10,1,CHI,6742,1061,MOT
1,0,22,248,2.995732274,248,0,was,"('MOT', 'CHI')",Providence,lil59.xml,271,23,1,CHI,6742,1061,MOT
0,1,8,262,2.583997552,263,1,wanna,"('MOT', 'CHI')",Providence,lil59.xml,271,8,0,CHI,6742,1061,MOT
0,2,6,263,2.409194828,265,2,where,"('MOT', 'CHI')",Providence,lil59.xml,271,6,0,CHI,6742,1061,MOT
1,1,21,248,2.347399109,249,1,think,"('MOT', 'CHI')",Providence,lil59.xml,271,22,1,CHI,6742,1061,MOT
1,4,8,258,2.261763098,262,4,she,"('MOT', 'CHI')",Providence,lil59.xml,271,9,1,CHI,6742,1061,MOT
0,1,12,258,2.232315897,259,1,get,"('MOT', 'CHI')",Providence,lil59.xml,271,12,0,CHI,6742,1061,MOT
2,1,35,233,2.205735267,234,1,on,"('MOT', 'CHI')",Providence,lil59.xml,271,37,2,CHI,6742,1061,MOT
1,2,16,252,2.195273357,254,2,gonna,"('MOT', 'CHI')",Providence,lil59.xml,271,17,1,CHI,6742,1061,MOT
0,3,6,262,2.121512756,265,3,some,"('MOT', 'CHI')",Providence,lil59.xml,271,6,0,CHI,6742,1061,MOT
2,5,13,251,2.02659906,256,5,like,"('MOT', 'CHI')",Providence,lil59.xml,271,15,2,CHI,6742,1061,MOT
1,4,11,255,2.009172346,259,4,no,"('MOT', 'CHI')",Providence,lil59.xml,271,12,1,CHI,6742,1061,MOT
0,1,16,254,1.965557146,255,1,there,"('MOT', 'CHI')",Providence,lil59.xml,271,16,0,CHI,6742,1061,MOT
0,1,16,254,1.965557146,255,1,up,"('MOT', 'CHI')",Providence,lil59.xml,271,16,0,CHI,6742,1061,MOT
0,1,17,253,1.907591285,254,1,put,"('MOT', 'CHI')",Providence,lil59.xml,271,17,0,CHI,6742,1061,MOT
0,1,18,252,1.852384091,253,1,not,"('MOT', 'CHI')",Providence,lil59.xml,271,18,0,CHI,6742,1061,MOT
1,2,29,239,1.621860432,241,2,are,"('MOT', 'CHI')",Providence,lil59.xml,271,30,1,CHI,6742,1061,MOT
1,2,30,238,1.586965057,240,2,he,"('MOT', 'CHI')",Providence,lil59.xml,271,31,1,CHI,6742,1061,MOT
2,6,26,237,1.252762968,243,6,what,"('MOT', 'CHI')",Providence,lil59.xml,271,28,2,CHI,6742,1061,MOT
6,10,35,220,1.233552132,230,10,that,"('MOT', 'CHI')",Providence,lil59.xml,271,41,6,CHI,6742,1061,MOT
1,4,28,238,1.146890289,242,4,we,"('MOT', 'CHI')",Providence,lil59.xml,271,29,1,CHI,6742,1061,MOT
1,4,28,238,1.146890289,242,4,my,"('MOT', 'CHI')",Providence,lil59.xml,271,29,1,CHI,6742,1061,MOT
0,4,16,251,1.049266415,255,4,have,"('MOT', 'CHI')",Providence,lil59.xml,271,16,0,CHI,6742,1061,MOT
13,13,61,184,0.962571484,197,13,a,"('MOT', 'CHI')",Providence,lil59.xml,271,74,13,CHI,6742,1061,MOT
9,9,65,188,0.962571484,197,9,you,"('MOT', 'CHI')",Providence,lil59.xml,271,74,9,CHI,6742,1061,MOT
0,2,30,239,0.928713252,241,2,do,"('MOT', 'CHI')",Providence,lil59.xml,271,30,0,CHI,6742,1061,MOT
0,4,19,248,0.883373917,252,4,this,"('MOT', 'CHI')",Providence,lil59.xml,271,19,0,CHI,6742,1061,MOT
8,8,72,183,0.855970942,191,8,the,"('MOT', 'CHI')",Providence,lil59.xml,271,80,8,CHI,6742,1061,MOT
1,12,14,244,0.847944064,256,12,can,"('MOT', 'CHI')",Providence,lil59.xml,271,15,1,CHI,6742,1061,MOT
11,11,72,177,0.804372816,188,11,and,"('MOT', 'CHI')",Providence,lil59.xml,271,83,11,CHI,6742,1061,MOT
3,11,34,223,0.70165787,234,11,it,"('MOT', 'CHI')",Providence,lil59.xml,271,37,3,CHI,6742,1061,MOT
0,4,24,243,0.649918446,247,4,with,"('MOT', 'CHI')",Providence,lil59.xml,271,24,0,CHI,6742,1061,MOT
2,27,13,229,0.486154019,256,27,yeah,"('MOT', 'CHI')",Providence,lil59.xml,271,15,2,CHI,6742,1061,MOT
0,4,29,238,0.453743108,242,4,but,"('MOT', 'CHI')",Providence,lil59.xml,271,29,0,CHI,6742,1061,MOT
2,13,30,226,0.417991368,239,13,one,"('MOT', 'CHI')",Providence,lil59.xml,271,32,2,CHI,6742,1061,MOT
1,5,49,216,0.357315764,221,5,to,"('MOT', 'CHI')",Providence,lil59.xml,271,50,1,CHI,6742,1061,MOT
0,3,48,220,0.117783036,223,3,in,"('MOT', 'CHI')",Providence,lil59.xml,271,48,0,CHI,6742,1061,MOT
0,9,48,214,-0.798507696,223,9,is,"('MOT', 'CHI')",Providence,lil59.xml,271,48,0,CHI,6742,1061,MOT
0,1,5,389,3.33220451,390,1,want,"('MOT', 'CHI')",Providence,lil60.xml,395,5,0,CHI,5551,1651,MOT
1,2,7,385,3.255529143,387,2,some,"('MOT', 'CHI')",Providence,lil60.xml,395,8,1,CHI,5551,1651,MOT
3,2,16,374,3.17805383,376,2,there,"('MOT', 'CHI')",Providence,lil60.xml,395,19,3,CHI,5551,1651,MOT
0,1,7,387,3.075774981,388,1,did,"('MOT', 'CHI')",Providence,lil60.xml,395,7,0,CHI,5551,1651,MOT
1,3,6,385,3.075774981,388,3,not,"('MOT', 'CHI')",Providence,lil60.xml,395,7,1,CHI,5551,1651,MOT
5,3,21,366,2.989462661,369,3,they,"('MOT', 'CHI')",Providence,lil60.xml,395,26,5,CHI,5551,1651,MOT
0,2,5,388,2.926739402,390,2,gonna,"('MOT', 'CHI')",Providence,lil60.xml,395,5,0,CHI,5551,1651,MOT
10,5,26,354,2.857427602,359,5,are,"('MOT', 'CHI')",Providence,lil60.xml,395,36,10,CHI,5551,1651,MOT
1,1,20,373,2.794094927,374,1,see,"('MOT', 'CHI')",Providence,lil60.xml,395,21,1,CHI,5551,1651,MOT
2,8,4,381,2.79065373,389,8,get,"('MOT', 'CHI')",Providence,lil60.xml,395,6,2,CHI,5551,1651,MOT
1,2,15,377,2.646962509,379,2,big,"('MOT', 'CHI')",Providence,lil60.xml,395,16,1,CHI,5551,1651,MOT
0,2,8,385,2.562381962,387,2,wanna,"('MOT', 'CHI')",Providence,lil60.xml,395,8,0,CHI,5551,1651,MOT
0,1,13,381,2.549445171,382,1,was,"('MOT', 'CHI')",Providence,lil60.xml,395,13,0,CHI,5551,1651,MOT
0,1,15,379,2.419060084,380,1,we,"('MOT', 'CHI')",Providence,lil60.xml,395,15,0,CHI,5551,1651,MOT
0,4,5,386,2.415913778,390,4,put,"('MOT', 'CHI')",Providence,lil60.xml,395,5,0,CHI,5551,1651,MOT
1,0,0,13,2.302585093,13,0,no,"('CHI', 'MOT')",Providence,lil60.xml,14,1,1,MOT,73,93,CHI
1,0,0,13,2.302585093,13,0,he,"('CHI', 'MOT')",Providence,lil60.xml,14,1,1,MOT,73,93,CHI
0,2,11,382,2.292275723,384,2,go,"('MOT', 'CHI')",Providence,lil60.xml,395,11,0,CHI,5551,1651,MOT
2,9,8,376,2.269545239,385,9,no,"('MOT', 'CHI')",Providence,lil60.xml,395,10,2,CHI,5551,1651,MOT
0,2,12,381,2.215573716,383,2,all,"('MOT', 'CHI')",Providence,lil60.xml,395,12,0,CHI,5551,1651,MOT
1,9,6,379,2.159484249,388,9,she,"('MOT', 'CHI')",Providence,lil60.xml,395,7,1,CHI,5551,1651,MOT
0,2,13,380,2.143980063,382,2,where,"('MOT', 'CHI')",Providence,lil60.xml,395,13,0,CHI,5551,1651,MOT
0,2,14,379,2.076833978,381,2,but,"('MOT', 'CHI')",Providence,lil60.xml,395,14,0,CHI,5551,1651,MOT
1,5,14,375,2.013594976,380,5,up,"('MOT', 'CHI')",Providence,lil60.xml,395,15,1,CHI,5551,1651,MOT
3,7,21,364,1.970334701,371,7,think,"('MOT', 'CHI')",Providence,lil60.xml,395,24,3,CHI,5551,1651,MOT
5,8,31,351,1.84582669,359,8,on,"('MOT', 'CHI')",Providence,lil60.xml,395,36,5,CHI,5551,1651,MOT
0,2,19,374,1.791759469,376,2,little,"('MOT', 'CHI')",Providence,lil60.xml,395,19,0,CHI,5551,1651,MOT
0,2,19,374,1.791759469,376,2,he,"('MOT', 'CHI')",Providence,lil60.xml,395,19,0,CHI,5551,1651,MOT
11,13,37,334,1.788898237,347,13,that,"('MOT', 'CHI')",Providence,lil60.xml,395,48,11,CHI,5551,1651,MOT
4,13,17,361,1.76447551,374,13,one,"('MOT', 'CHI')",Providence,lil60.xml,395,21,4,CHI,5551,1651,MOT
10,12,41,332,1.709092777,344,12,what,"('MOT', 'CHI')",Providence,lil60.xml,395,51,10,CHI,5551,1651,MOT
1,1,0,12,1.609437912,13,1,wanna,"('CHI', 'MOT')",Providence,lil60.xml,14,1,1,MOT,73,93,CHI
4,9,34,348,1.501295754,357,9,it,"('MOT', 'CHI')",Providence,lil60.xml,395,38,4,CHI,5551,1651,MOT
1,0,0,4,1.386294361,4,0,on,"('CHI', 'OPE')",Providence,lil60.xml,5,1,1,OPE,26,28,CHI
1,0,0,4,1.386294361,4,0,and,"('CHI', 'OPE')",Providence,lil60.xml,5,1,1,OPE,26,28,CHI
1,2,0,13,1.329135947,15,2,a,"('OPE', 'CHI')",Providence,lil60.xml,16,1,1,CHI,78,89,OPE
5,9,49,332,1.301553133,341,9,of,"('MOT', 'CHI')",Providence,lil60.xml,395,54,5,CHI,5551,1651,MOT
1,9,19,366,1.231764822,375,9,oh,"('MOT', 'CHI')",Providence,lil60.xml,395,20,1,CHI,5551,1651,MOT
0,5,18,372,1.150044462,377,5,my,"('MOT', 'CHI')",Providence,lil60.xml,395,18,0,CHI,5551,1651,MOT
1,13,17,364,0.995893782,377,13,this,"('MOT', 'CHI')",Providence,lil60.xml,395,18,1,CHI,5551,1651,MOT
1,2,1,12,0.980829253,14,2,it,"('OPE', 'CHI')",Providence,lil60.xml,16,2,1,CHI,78,89,OPE
11,17,76,291,0.84247082,308,17,the,"('MOT', 'CHI')",Providence,lil60.xml,395,87,11,CHI,5551,1651,MOT
0,7,19,369,0.810930216,376,7,have,"('MOT', 'CHI')",Providence,lil60.xml,395,19,0,CHI,5551,1651,MOT
1,14,20,360,0.779191907,374,14,look,"('MOT', 'CHI')",Providence,lil60.xml,395,21,1,CHI,5551,1651,MOT
0,1,1,10,0.773189888,11,1,did,"('MOT', 'OPE')",Providence,lil60.xml,12,1,0,OPE,123,76,MOT
0,1,1,10,0.773189888,11,1,she,"('MOT', 'OPE')",Providence,lil60.xml,12,1,0,OPE,123,76,MOT
0,7,21,367,0.714653386,374,7,at,"('MOT', 'CHI')",Providence,lil60.xml,395,21,0,CHI,5551,1651,MOT
0,1,2,13,0.693147181,14,1,you,"('OPE', 'CHI')",Providence,lil60.xml,16,2,0,CHI,78,89,OPE
8,22,57,308,0.662172711,330,22,is,"('MOT', 'CHI')",Providence,lil60.xml,395,65,8,CHI,5551,1651,MOT
4,36,20,335,0.662001881,371,36,yeah,"('MOT', 'CHI')",Providence,lil60.xml,395,24,4,CHI,5551,1651,MOT
0,2,1,13,0.635988767,15,2,he,"('OPE', 'CHI')",Providence,lil60.xml,16,1,0,CHI,78,89,OPE
1,10,34,350,0.575978207,360,10,in,"('MOT', 'CHI')",Providence,lil60.xml,395,35,1,CHI,5551,1651,MOT
0,1,2,11,0.559615788,12,1,it,"('CHI', 'MOT')",Providence,lil60.xml,14,2,0,MOT,73,93,CHI
1,0,2,2,0.470003629,2,0,yeah,"('CHI', 'OPE')",Providence,lil60.xml,5,3,1,OPE,26,28,CHI
10,26,72,287,0.423814247,313,26,a,"('MOT', 'CHI')",Providence,lil60.xml,395,82,10,CHI,5551,1651,MOT
1,3,1,7,0.405465108,10,3,you,"('MOT', 'OPE')",Providence,lil60.xml,12,2,1,OPE,123,76,MOT
0,5,39,351,0.37520145,356,5,to,"('MOT', 'CHI')",Providence,lil60.xml,395,39,0,CHI,5551,1651,MOT
1,6,0,7,0.356674944,13,6,you,"('CHI', 'MOT')",Providence,lil60.xml,14,1,1,MOT,73,93,CHI
3,18,51,323,0.254234138,341,18,and,"('MOT', 'CHI')",Providence,lil60.xml,395,54,3,CHI,5551,1651,MOT
0,3,1,8,0.080042708,11,3,a,"('MOT', 'OPE')",Providence,lil60.xml,12,1,0,OPE,123,76,MOT
0,2,2,8,0,10,2,that,"('MOT', 'OPE')",Providence,lil60.xml,12,2,0,OPE,123,76,MOT
0,5,1,10,-0.057158414,15,5,and,"('OPE', 'CHI')",Providence,lil60.xml,16,1,0,CHI,78,89,OPE
0,22,17,356,-0.139761942,378,22,can,"('MOT', 'CHI')",Providence,lil60.xml,395,17,0,CHI,5551,1651,MOT
5,20,97,273,-0.210178511,293,20,you,"('MOT', 'CHI')",Providence,lil60.xml,395,102,5,CHI,5551,1651,MOT
1,0,0,78,3.976561527,78,0,gonna,"('CHI', 'MOT')",Providence,lil61.xml,79,1,1,MOT,411,556,CHI
0,1,4,290,3.195265959,291,1,some,"('MOT', 'CHI')",Providence,lil61.xml,295,4,0,CHI,4949,1757,MOT
1,2,5,287,3.188416617,289,2,get,"('MOT', 'CHI')",Providence,lil61.xml,295,6,1,CHI,4949,1757,MOT
2,1,15,277,3.095815732,278,1,with,"('MOT', 'CHI')",Providence,lil61.xml,295,17,2,CHI,4949,1757,MOT
0,1,5,289,3.037696473,290,1,want,"('MOT', 'CHI')",Providence,lil61.xml,295,5,0,CHI,4949,1757,MOT
0,1,5,289,3.037696473,290,1,big,"('MOT', 'CHI')",Providence,lil61.xml,295,5,0,CHI,4949,1757,MOT
5,6,5,279,3.020424886,285,6,no,"('MOT', 'CHI')",Providence,lil61.xml,295,10,5,CHI,4949,1757,MOT
1,2,7,285,2.958376487,287,2,she,"('MOT', 'CHI')",Providence,lil61.xml,295,8,1,CHI,4949,1757,MOT
0,1,7,287,2.779509165,288,1,up,"('MOT', 'CHI')",Providence,lil61.xml,295,7,0,CHI,4949,1757,MOT
1,2,9,283,2.769110458,285,2,see,"('MOT', 'CHI')",Providence,lil61.xml,295,10,1,CHI,4949,1757,MOT
0,2,5,288,2.632231365,290,2,gonna,"('MOT', 'CHI')",Providence,lil61.xml,295,5,0,CHI,4949,1757,MOT
0,1,1,77,2.590267165,78,1,some,"('CHI', 'MOT')",Providence,lil61.xml,79,1,0,MOT,411,556,CHI
1,2,1,75,2.577688383,77,2,with,"('CHI', 'MOT')",Providence,lil61.xml,79,2,1,MOT,411,556,CHI
1,2,1,75,2.577688383,77,2,look,"('CHI', 'MOT')",Providence,lil61.xml,79,2,1,MOT,411,556,CHI
1,2,1,75,2.577688383,77,2,to,"('CHI', 'MOT')",Providence,lil61.xml,79,2,1,MOT,411,556,CHI
1,1,3,74,2.552045953,75,1,for,"('CHI', 'MOT')",Providence,lil61.xml,79,4,1,MOT,411,556,CHI
2,1,28,264,2.526977864,265,1,we,"('MOT', 'CHI')",Providence,lil61.xml,295,30,2,CHI,4949,1757,MOT
0,2,6,287,2.495269437,289,2,put,"('MOT', 'CHI')",Providence,lil61.xml,295,6,0,CHI,4949,1757,MOT
0,2,6,287,2.495269437,289,2,wanna,"('MOT', 'CHI')",Providence,lil61.xml,295,6,0,CHI,4949,1757,MOT
2,5,9,279,2.397895273,284,5,have,"('MOT', 'CHI')",Providence,lil61.xml,295,11,2,CHI,4949,1757,MOT
0,1,2,76,2.290006311,77,1,this,"('CHI', 'MOT')",Providence,lil61.xml,79,2,0,MOT,411,556,CHI
1,1,26,267,2.231126129,268,1,oh,"('MOT', 'CHI')",Providence,lil61.xml,295,27,1,CHI,4949,1757,MOT
0,2,1,76,2.184802057,78,2,go,"('CHI', 'MOT')",Providence,lil61.xml,79,1,0,MOT,411,556,CHI
1,2,3,73,2.146580845,75,2,my,"('CHI', 'MOT')",Providence,lil61.xml,79,4,1,MOT,411,556,CHI
2,0,0,9,2.1102132,9,0,no,"('OPE', 'CHI')",Providence,lil61.xml,11,2,2,CHI,68,47,OPE
1,0,0,10,2.079441542,10,0,for,"('OPE', 'CHI')",Providence,lil61.xml,11,1,1,CHI,68,47,OPE
0,2,10,283,2.075963277,285,2,think,"('MOT', 'CHI')",Providence,lil61.xml,295,10,0,CHI,4949,1757,MOT
2,4,2,71,2.041220329,75,4,is,"('CHI', 'MOT')",Providence,lil61.xml,79,4,2,MOT,411,556,CHI
1,2,21,271,2.033252159,273,2,are,"('MOT', 'CHI')",Providence,lil61.xml,295,22,1,CHI,4949,1757,MOT
0,2,2,75,1.884541203,77,2,the,"('CHI', 'MOT')",Providence,lil61.xml,79,2,0,MOT,411,556,CHI
1,6,10,278,1.838279485,284,6,but,"('MOT', 'CHI')",Providence,lil61.xml,295,11,1,CHI,4949,1757,MOT
1,0,2,13,1.791759469,13,0,can,"('CHI', 'OPE')",Providence,lil61.xml,16,3,1,OPE,85,76,CHI
1,1,0,14,1.734601055,15,1,gonna,"('CHI', 'OPE')",Providence,lil61.xml,16,1,1,OPE,85,76,CHI
1,6,1,71,1.730390523,77,6,oh,"('CHI', 'MOT')",Providence,lil61.xml,79,2,1,MOT,411,556,CHI
0,4,1,74,1.673976434,78,4,we,"('CHI', 'MOT')",Providence,lil61.xml,79,1,0,MOT,411,556,CHI
1,4,3,71,1.635755221,75,4,that,"('CHI', 'MOT')",Providence,lil61.xml,79,4,1,MOT,411,556,CHI
0,3,12,280,1.62713749,283,3,there,"('MOT', 'CHI')",Providence,lil61.xml,295,12,0,CHI,4949,1757,MOT
2,3,7,67,1.591088774,70,3,and,"('CHI', 'MOT')",Providence,lil61.xml,79,9,2,MOT,411,556,CHI
1,10,0,68,1.578666254,78,10,what,"('CHI', 'MOT')",Providence,lil61.xml,79,1,1,MOT,411,556,CHI
1,6,14,274,1.555930758,280,6,go,"('MOT', 'CHI')",Providence,lil61.xml,295,15,1,CHI,4949,1757,MOT
1,7,12,275,1.554629676,282,7,can,"('MOT', 'CHI')",Providence,lil61.xml,295,13,1,CHI,4949,1757,MOT
2,7,19,267,1.504077397,274,7,do,"('MOT', 'CHI')",Providence,lil61.xml,295,21,2,CHI,4949,1757,MOT
5,17,14,259,1.484486387,276,17,one,"('MOT', 'CHI')",Providence,lil61.xml,295,19,5,CHI,4949,1757,MOT
1,9,10,275,1.481604541,284,9,my,"('MOT', 'CHI')",Providence,lil61.xml,295,11,1,CHI,4949,1757,MOT
0,9,5,281,1.42825856,290,9,where,"('MOT', 'CHI')",Providence,lil61.xml,295,5,0,CHI,4949,1757,MOT
0,7,7,281,1.393214804,288,7,not,"('MOT', 'CHI')",Providence,lil61.xml,295,7,0,CHI,4949,1757,MOT
2,7,22,264,1.370546004,271,7,of,"('MOT', 'CHI')",Providence,lil61.xml,295,24,2,CHI,4949,1757,MOT
0,3,3,73,1.360976553,76,3,see,"('CHI', 'MOT')",Providence,lil61.xml,79,3,0,MOT,411,556,CHI
0,3,3,73,1.360976553,76,3,can,"('CHI', 'MOT')",Providence,lil61.xml,79,3,0,MOT,411,556,CHI
2,6,26,261,1.346216138,267,6,like,"('MOT', 'CHI')",Providence,lil61.xml,295,28,2,CHI,4949,1757,MOT
5,11,29,250,1.295487913,261,11,on,"('MOT', 'CHI')",Providence,lil61.xml,295,34,5,CHI,4949,1757,MOT
2,13,13,267,1.268248686,280,13,look,"('MOT', 'CHI')",Providence,lil61.xml,295,15,2,CHI,4949,1757,MOT
0,7,9,279,1.185623666,286,7,for,"('MOT', 'CHI')",Providence,lil61.xml,295,9,0,CHI,4949,1757,MOT
4,11,30,250,1.113166356,261,11,what,"('MOT', 'CHI')",Providence,lil61.xml,295,34,4,CHI,4949,1757,MOT
0,9,8,278,1.061256502,287,9,all,"('MOT', 'CHI')",Providence,lil61.xml,295,8,0,CHI,4949,1757,MOT
6,17,28,244,1.044173485,261,17,that,"('MOT', 'CHI')",Providence,lil61.xml,295,34,6,CHI,4949,1757,MOT
0,1,1,14,1.041453875,15,1,that,"('CHI', 'OPE')",Providence,lil61.xml,16,1,0,OPE,85,76,CHI
0,6,13,276,0.995013888,282,6,they,"('MOT', 'CHI')",Providence,lil61.xml,295,13,0,CHI,4949,1757,MOT
2,14,2,61,0.94260804,75,14,you,"('CHI', 'MOT')",Providence,lil61.xml,79,4,2,MOT,411,556,CHI
2,14,18,261,0.92353714,275,14,yeah,"('MOT', 'CHI')",Providence,lil61.xml,295,20,2,CHI,4949,1757,MOT
2,8,6,63,0.889262059,71,8,a,"('CHI', 'MOT')",Providence,lil61.xml,79,8,2,MOT,411,556,CHI
1,14,13,267,0.857955155,281,14,he,"('MOT', 'CHI')",Providence,lil61.xml,295,14,1,CHI,4949,1757,MOT
0,5,4,70,0.760286483,75,5,it,"('CHI', 'MOT')",Providence,lil61.xml,79,4,0,MOT,411,556,CHI
0,4,25,266,0.700527288,270,4,little,"('MOT', 'CHI')",Providence,lil61.xml,295,25,0,CHI,4949,1757,MOT
1,1,2,7,0.693147181,8,1,you,"('MOT', 'OPE')",Providence,lil61.xml,11,3,1,OPE,89,55,MOT
0,1,2,13,0.693147181,14,1,look,"('CHI', 'OPE')",Providence,lil61.xml,16,2,0,OPE,85,76,CHI
0,1,1,9,0.693147181,10,1,it,"('MOT', 'OPE')",Providence,lil61.xml,11,1,0,OPE,89,55,MOT
0,1,1,9,0.693147181,10,1,did,"('MOT', 'OPE')",Providence,lil61.xml,11,1,0,OPE,89,55,MOT
0,1,1,9,0.693147181,10,1,have,"('OPE', 'CHI')",Providence,lil61.xml,11,1,0,CHI,68,47,OPE
0,1,1,9,0.693147181,10,1,and,"('OPE', 'CHI')",Providence,lil61.xml,11,1,0,CHI,68,47,OPE
2,12,27,254,0.690662707,266,12,was,"('MOT', 'CHI')",Providence,lil61.xml,295,29,2,CHI,4949,1757,MOT
6,20,36,233,0.658461623,253,20,is,"('MOT', 'CHI')",Providence,lil61.xml,295,42,6,CHI,4949,1757,MOT
0,8,15,272,0.61146915,280,8,this,"('MOT', 'CHI')",Providence,lil61.xml,295,15,0,CHI,4949,1757,MOT
1,6,38,250,0.58662455,256,6,in,"('MOT', 'CHI')",Providence,lil61.xml,295,39,1,CHI,4949,1757,MOT
0,6,22,267,0.492807118,273,6,at,"('MOT', 'CHI')",Providence,lil61.xml,295,22,0,CHI,4949,1757,MOT
10,20,62,203,0.465408144,223,20,the,"('MOT', 'CHI')",Providence,lil61.xml,295,72,10,CHI,4949,1757,MOT
3,16,35,241,0.421029625,257,16,it,"('MOT', 'CHI')",Providence,lil61.xml,295,38,3,CHI,4949,1757,MOT
3,12,49,231,0.333619168,243,12,to,"('MOT', 'CHI')",Providence,lil61.xml,295,52,3,CHI,4949,1757,MOT
5,16,54,220,0.319942935,236,16,a,"('MOT', 'CHI')",Providence,lil61.xml,295,59,5,CHI,4949,1757,MOT
0,1,2,8,0.318453731,9,1,up,"('MOT', 'OPE')",Providence,lil61.xml,11,2,0,OPE,89,55,MOT
0,1,2,8,0.318453731,9,1,the,"('OPE', 'CHI')",Providence,lil61.xml,11,2,0,CHI,68,47,OPE
0,2,2,12,0.287682072,14,2,the,"('CHI', 'OPE')",Providence,lil61.xml,16,2,0,OPE,85,76,CHI
4,16,56,219,0.117150324,235,16,you,"('MOT', 'CHI')",Providence,lil61.xml,295,60,4,CHI,4949,1757,MOT
6,25,51,213,0.09091509,238,25,and,"('MOT', 'CHI')",Providence,lil61.xml,295,57,6,CHI,4949,1757,MOT
1,0,4,221,4.154408803,221,0,they,"('MOT', 'CHI')",Providence,lil62.xml,226,5,1,CHI,2856,946,MOT
3,2,3,218,3.610917913,220,2,but,"('MOT', 'CHI')",Providence,lil62.xml,226,6,3,CHI,2856,946,MOT
1,2,2,221,3.401197382,223,2,not,"('MOT', 'CHI')",Providence,lil62.xml,226,3,1,CHI,2856,946,MOT
1,0,13,212,3.286534473,212,0,see,"('MOT', 'CHI')",Providence,lil62.xml,226,14,1,CHI,2856,946,MOT
1,1,8,216,2.991176457,217,1,with,"('MOT', 'CHI')",Providence,lil62.xml,226,9,1,CHI,2856,946,MOT
2,2,7,215,2.991176457,217,2,look,"('MOT', 'CHI')",Providence,lil62.xml,226,9,2,CHI,2856,946,MOT
0,1,4,221,2.926739402,222,1,big,"('MOT', 'CHI')",Providence,lil62.xml,226,4,0,CHI,2856,946,MOT
1,1,9,215,2.899588413,216,1,at,"('MOT', 'CHI')",Providence,lil62.xml,226,10,1,CHI,2856,946,MOT
2,2,0,64,2.833213344,66,2,are,"('CHI', 'MOT')",Providence,lil62.xml,68,2,2,MOT,343,1149,CHI
1,1,10,214,2.814947996,215,1,are,"('MOT', 'CHI')",Providence,lil62.xml,226,11,1,CHI,2856,946,MOT
0,2,3,221,2.708050201,223,2,want,"('MOT', 'CHI')",Providence,lil62.xml,226,3,0,CHI,2856,946,MOT
1,1,2,64,2.595254707,65,1,little,"('CHI', 'MOT')",Providence,lil62.xml,68,3,1,MOT,343,1149,CHI
1,2,8,215,2.585711349,217,2,in,"('MOT', 'CHI')",Providence,lil62.xml,226,9,1,CHI,2856,946,MOT
1,2,8,215,2.585711349,217,2,he,"('MOT', 'CHI')",Providence,lil62.xml,226,9,1,CHI,2856,946,MOT
1,4,4,217,2.544970891,221,4,was,"('MOT', 'CHI')",Providence,lil62.xml,226,5,1,CHI,2856,946,MOT
0,1,7,218,2.507790944,219,1,go,"('MOT', 'CHI')",Providence,lil62.xml,226,7,0,CHI,2856,946,MOT
0,1,1,66,2.442347035,67,1,wanna,"('CHI', 'MOT')",Providence,lil62.xml,68,1,0,MOT,343,1149,CHI
1,1,3,63,2.397895273,64,1,one,"('CHI', 'MOT')",Providence,lil62.xml,68,4,1,MOT,343,1149,CHI
2,4,0,62,2.32238772,66,4,they,"('CHI', 'MOT')",Providence,lil62.xml,68,2,2,MOT,343,1149,CHI
8,4,26,188,2.272125886,192,4,like,"('MOT', 'CHI')",Providence,lil62.xml,226,34,8,CHI,2856,946,MOT
9,4,29,184,2.251291799,188,4,what,"('MOT', 'CHI')",Providence,lil62.xml,226,38,9,CHI,2856,946,MOT
1,4,7,214,2.174751721,218,4,up,"('MOT', 'CHI')",Providence,lil62.xml,226,8,1,CHI,2856,946,MOT
0,1,2,65,2.140066163,66,1,this,"('CHI', 'MOT')",Providence,lil62.xml,68,2,0,MOT,343,1149,CHI
4,12,4,206,2.135531008,218,12,no,"('MOT', 'CHI')",Providence,lil62.xml,226,8,4,CHI,2856,946,MOT
0,2,7,217,2.102325836,219,2,my,"('MOT', 'CHI')",Providence,lil62.xml,226,7,0,CHI,2856,946,MOT
0,2,1,65,2.036881927,67,2,but,"('CHI', 'MOT')",Providence,lil62.xml,68,1,0,MOT,343,1149,CHI
0,2,1,65,2.036881927,67,2,up,"('CHI', 'MOT')",Providence,lil62.xml,68,1,0,MOT,343,1149,CHI
0,2,1,65,2.036881927,67,2,can,"('CHI', 'MOT')",Providence,lil62.xml,68,1,0,MOT,343,1149,CHI
0,2,1,65,2.036881927,67,2,do,"('CHI', 'MOT')",Providence,lil62.xml,68,1,0,MOT,343,1149,CHI
0,2,8,216,1.992430165,218,2,some,"('MOT', 'CHI')",Providence,lil62.xml,226,8,0,CHI,2856,946,MOT
1,4,9,212,1.983297681,216,4,can,"('MOT', 'CHI')",Providence,lil62.xml,226,10,1,CHI,2856,946,MOT
1,1,25,199,1.976063187,200,1,to,"('MOT', 'CHI')",Providence,lil62.xml,226,26,1,CHI,2856,946,MOT
5,5,21,195,1.976063187,200,5,is,"('MOT', 'CHI')",Providence,lil62.xml,226,26,5,CHI,2856,946,MOT
0,1,13,212,1.969440646,213,1,all,"('MOT', 'CHI')",Providence,lil62.xml,226,13,0,CHI,2856,946,MOT
1,6,6,213,1.948175156,219,6,gonna,"('MOT', 'CHI')",Providence,lil62.xml,226,7,1,CHI,2856,946,MOT
3,3,25,195,1.897119985,198,3,that,"('MOT', 'CHI')",Providence,lil62.xml,226,28,3,CHI,2856,946,MOT
1,6,0,61,1.882731247,67,6,for,"('CHI', 'MOT')",Providence,lil62.xml,68,1,1,MOT,343,1149,CHI
2,7,0,59,1.852384091,66,7,there,"('CHI', 'MOT')",Providence,lil62.xml,68,2,2,MOT,343,1149,CHI
0,1,15,210,1.834931641,211,1,think,"('MOT', 'CHI')",Providence,lil62.xml,226,15,0,CHI,2856,946,MOT
1,7,0,60,1.749199855,67,7,like,"('CHI', 'MOT')",Providence,lil62.xml,68,1,1,MOT,343,1149,CHI
0,3,1,64,1.749199855,67,3,did,"('CHI', 'MOT')",Providence,lil62.xml,68,1,0,MOT,343,1149,CHI
0,3,1,64,1.749199855,67,3,where,"('CHI', 'MOT')",Providence,lil62.xml,68,1,0,MOT,343,1149,CHI
3,5,3,57,1.673976434,62,5,it,"('CHI', 'MOT')",Providence,lil62.xml,68,6,3,MOT,343,1149,CHI
1,6,10,209,1.562185028,215,6,one,"('MOT', 'CHI')",Providence,lil62.xml,226,11,1,CHI,2856,946,MOT
0,1,5,62,1.53532994,63,1,no,"('CHI', 'MOT')",Providence,lil62.xml,68,5,0,MOT,343,1149,CHI
0,5,6,215,1.531476371,220,5,there,"('MOT', 'CHI')",Providence,lil62.xml,226,6,0,CHI,2856,946,MOT
1,7,1,59,1.446918983,66,7,oh,"('CHI', 'MOT')",Providence,lil62.xml,68,2,1,MOT,343,1149,CHI
1,4,17,204,1.435084525,208,4,for,"('MOT', 'CHI')",Providence,lil62.xml,226,18,1,CHI,2856,946,MOT
0,5,1,62,1.343734747,67,5,was,"('CHI', 'MOT')",Providence,lil62.xml,68,1,0,MOT,343,1149,CHI
0,5,1,62,1.343734747,67,5,he,"('CHI', 'MOT')",Providence,lil62.xml,68,1,0,MOT,343,1149,CHI
0,8,5,213,1.264037045,221,8,make,"('MOT', 'CHI')",Providence,lil62.xml,226,5,0,CHI,2856,946,MOT
3,7,24,192,1.242861898,199,7,the,"('MOT', 'CHI')",Providence,lil62.xml,226,27,3,CHI,2856,946,MOT
0,4,2,62,1.223775432,66,4,in,"('CHI', 'MOT')",Providence,lil62.xml,68,2,0,MOT,343,1149,CHI
0,7,1,60,1.056052674,67,7,of,"('CHI', 'MOT')",Providence,lil62.xml,68,1,0,MOT,343,1149,CHI
0,7,1,60,1.056052674,67,7,to,"('CHI', 'MOT')",Providence,lil62.xml,68,1,0,MOT,343,1149,CHI
0,5,2,61,1.041453875,66,5,is,"('CHI', 'MOT')",Providence,lil62.xml,68,2,0,MOT,343,1149,CHI
1,11,10,204,1.023188527,215,11,this,"('MOT', 'CHI')",Providence,lil62.xml,226,11,1,CHI,2856,946,MOT
0,4,14,208,0.98394938,212,4,little,"('MOT', 'CHI')",Providence,lil62.xml,226,14,0,CHI,2856,946,MOT
6,15,27,178,0.890972924,193,15,it,"('MOT', 'CHI')",Providence,lil62.xml,226,33,6,CHI,2856,946,MOT
2,6,32,186,0.83704136,192,6,and,"('MOT', 'CHI')",Providence,lil62.xml,226,34,2,CHI,2856,946,MOT
1,14,1,52,0.818310324,66,14,the,"('CHI', 'MOT')",Providence,lil62.xml,68,2,1,MOT,343,1149,CHI
0,1,2,15,0.810930216,16,1,with,"('MOT', 'ENV')",Providence,lil62.xml,18,2,0,ENV,193,157,MOT
0,1,2,15,0.810930216,16,1,a,"('MOT', 'ENV')",Providence,lil62.xml,18,2,0,ENV,193,157,MOT
0,1,2,15,0.810930216,16,1,is,"('MOT', 'ENV')",Providence,lil62.xml,18,2,0,ENV,193,157,MOT
0,5,14,207,0.801627824,212,5,do,"('MOT', 'CHI')",Providence,lil62.xml,226,14,0,CHI,2856,946,MOT
3,14,3,48,0.757685702,62,14,and,"('CHI', 'MOT')",Providence,lil62.xml,68,6,3,MOT,343,1149,CHI
4,3,23,38,0.617047837,41,3,yeah,"('CHI', 'MOT')",Providence,lil62.xml,68,27,4,MOT,343,1149,CHI
0,4,22,200,0.540384426,204,4,of,"('MOT', 'CHI')",Providence,lil62.xml,226,22,0,CHI,2856,946,MOT
1,5,1,11,0.405465108,16,5,the,"('MOT', 'ENV')",Providence,lil62.xml,18,2,1,ENV,193,157,MOT
4,12,42,168,0.377294231,180,12,a,"('MOT', 'CHI')",Providence,lil62.xml,226,46,4,CHI,2856,946,MOT
0,9,3,56,0.292669614,65,9,that,"('CHI', 'MOT')",Providence,lil62.xml,68,3,0,MOT,343,1149,CHI
0,10,3,55,0.197359434,65,10,you,"('CHI', 'MOT')",Providence,lil62.xml,68,3,0,MOT,343,1149,CHI
2,9,11,46,0.131028262,55,9,a,"('CHI', 'MOT')",Providence,lil62.xml,68,13,2,MOT,343,1149,CHI
0,2,3,13,0.125163143,15,2,do,"('MOT', 'ENV')",Providence,lil62.xml,18,3,0,ENV,193,157,MOT
0,1,2,6,0.117783036,7,1,and,"('ENV', 'MOT')",Providence,lil62.xml,9,2,0,MOT,84,70,ENV
0,3,2,13,0.117783036,16,3,for,"('MOT', 'ENV')",Providence,lil62.xml,18,2,0,ENV,193,157,MOT
0,12,3,53,0.030305349,65,12,what,"('CHI', 'MOT')",Providence,lil62.xml,68,3,0,MOT,343,1149,CHI
1,2,6,9,-0.037740328,11,2,you,"('MOT', 'ENV')",Providence,lil62.xml,18,7,1,ENV,193,157,MOT
4,53,15,154,-0.08173432,207,53,yeah,"('MOT', 'CHI')",Providence,lil62.xml,226,19,4,CHI,2856,946,MOT
3,11,60,152,-0.167054085,163,11,you,"('MOT', 'CHI')",Providence,lil62.xml,226,63,3,CHI,2856,946,MOT
0,7,28,191,-0.182321557,198,7,oh,"('MOT', 'CHI')",Providence,lil62.xml,226,28,0,CHI,2856,946,MOT
0,4,3,11,-0.385662481,15,4,and,"('MOT', 'ENV')",Providence,lil62.xml,18,3,0,ENV,193,157,MOT
1,2,0,315,4.261113706,317,2,put,"('CHI', 'MOT')",Providence,lil63.xml,318,1,1,MOT,1462,2656,CHI
2,2,2,312,3.963982744,314,2,big,"('CHI', 'MOT')",Providence,lil63.xml,318,4,2,MOT,1462,2656,CHI
5,4,1,308,3.852273001,312,4,she,"('CHI', 'MOT')",Providence,lil63.xml,318,6,5,MOT,1462,2656,CHI
1,2,2,313,3.743998753,315,2,see,"('CHI', 'MOT')",Providence,lil63.xml,318,3,1,MOT,1462,2656,CHI
0,2,1,315,3.567966525,317,2,want,"('CHI', 'MOT')",Providence,lil63.xml,318,1,0,MOT,1462,2656,CHI
1,5,0,312,3.567966525,317,5,are,"('CHI', 'MOT')",Providence,lil63.xml,318,1,1,MOT,1462,2656,CHI
1,4,1,312,3.45946629,316,4,wanna,"('CHI', 'MOT')",Providence,lil63.xml,318,2,1,MOT,1462,2656,CHI
1,2,4,311,3.401197382,313,2,some,"('CHI', 'MOT')",Providence,lil63.xml,318,5,1,MOT,1462,2656,CHI
0,3,1,314,3.280284453,317,3,gonna,"('CHI', 'MOT')",Providence,lil63.xml,318,1,0,MOT,1462,2656,CHI
0,3,1,314,3.280284453,317,3,make,"('CHI', 'MOT')",Providence,lil63.xml,318,1,0,MOT,1462,2656,CHI
0,2,2,314,3.277144733,316,2,up,"('CHI', 'MOT')",Providence,lil63.xml,318,2,0,MOT,1462,2656,CHI
2,5,2,309,3.270835564,314,5,there,"('CHI', 'MOT')",Providence,lil63.xml,318,4,2,MOT,1462,2656,CHI
1,0,10,164,3.240185611,164,0,he,"('MOT', 'CHI')",Providence,lil63.xml,175,11,1,CHI,2779,982,MOT
1,0,11,163,3.160035325,163,0,one,"('MOT', 'CHI')",Providence,lil63.xml,175,12,1,CHI,2779,982,MOT
1,6,1,310,3.122994053,316,6,one,"('CHI', 'MOT')",Providence,lil63.xml,318,2,1,MOT,1462,2656,CHI
2,5,3,308,3.113515309,313,5,at,"('CHI', 'MOT')",Providence,lil63.xml,318,5,2,MOT,1462,2656,CHI
7,5,10,296,3.056975899,301,5,no,"('CHI', 'MOT')",Providence,lil63.xml,318,17,7,MOT,1462,2656,CHI
2,4,5,307,3.038152989,311,4,look,"('CHI', 'MOT')",Providence,lil63.xml,318,7,2,MOT,1462,2656,CHI
3,7,3,305,2.976804264,312,7,was,"('CHI', 'MOT')",Providence,lil63.xml,318,6,3,MOT,1462,2656,CHI
1,1,6,167,2.93857386,168,1,but,"('MOT', 'CHI')",Providence,lil63.xml,175,7,1,CHI,2779,982,MOT
1,11,0,306,2.874819345,317,11,we,"('CHI', 'MOT')",Providence,lil63.xml,318,1,1,MOT,1462,2656,CHI
0,4,2,312,2.766319109,316,4,with,"('CHI', 'MOT')",Providence,lil63.xml,318,2,0,MOT,1462,2656,CHI
0,6,1,311,2.720668665,317,6,go,"('CHI', 'MOT')",Providence,lil63.xml,318,1,0,MOT,1462,2656,CHI
0,2,2,171,2.679879324,173,2,are,"('MOT', 'CHI')",Providence,lil63.xml,175,2,0,CHI,2779,982,MOT
0,1,4,170,2.668384945,171,1,want,"('MOT', 'CHI')",Providence,lil63.xml,175,4,0,CHI,2779,982,MOT
0,1,4,170,2.668384945,171,1,wanna,"('MOT', 'CHI')",Providence,lil63.xml,175,4,0,CHI,2779,982,MOT
1,8,2,307,2.645386465,315,8,like,"('CHI', 'MOT')",Providence,lil63.xml,318,3,1,MOT,1462,2656,CHI
1,8,2,307,2.645386465,315,8,not,"('CHI', 'MOT')",Providence,lil63.xml,318,3,1,MOT,1462,2656,CHI
1,1,10,163,2.547038431,164,1,there,"('MOT', 'CHI')",Providence,lil63.xml,175,11,1,CHI,2779,982,MOT
1,9,2,306,2.540025949,315,9,he,"('CHI', 'MOT')",Providence,lil63.xml,318,3,1,MOT,1462,2656,CHI
0,1,5,169,2.508437147,170,1,make,"('MOT', 'CHI')",Providence,lil63.xml,175,5,0,CHI,2779,982,MOT
0,1,5,169,2.508437147,170,1,up,"('MOT', 'CHI')",Providence,lil63.xml,175,5,0,CHI,2779,982,MOT
1,1,11,162,2.466888144,163,1,see,"('MOT', 'CHI')",Providence,lil63.xml,175,12,1,CHI,2779,982,MOT
1,5,6,306,2.450366325,311,5,get,"('CHI', 'MOT')",Providence,lil63.xml,318,7,1,MOT,1462,2656,CHI
1,11,2,304,2.357704392,315,11,did,"('CHI', 'MOT')",Providence,lil63.xml,318,3,1,MOT,1462,2656,CHI
1,11,2,304,2.357704392,315,11,little,"('CHI', 'MOT')",Providence,lil63.xml,318,3,1,MOT,1462,2656,CHI
1,8,4,305,2.302585093,313,8,can,"('CHI', 'MOT')",Providence,lil63.xml,318,5,1,MOT,1462,2656,CHI
1,2,9,163,2.227622055,165,2,get,"('MOT', 'CHI')",Providence,lil63.xml,175,10,1,CHI,2779,982,MOT
2,12,4,300,2.203614375,312,12,for,"('CHI', 'MOT')",Providence,lil63.xml,318,6,2,MOT,1462,2656,CHI
0,8,2,308,2.178532444,316,8,think,"('CHI', 'MOT')",Providence,lil63.xml,318,2,0,MOT,1462,2656,CHI
0,5,4,309,2.172223275,314,5,where,"('CHI', 'MOT')",Providence,lil63.xml,318,4,0,MOT,1462,2656,CHI
1,4,5,165,2.145931283,169,4,can,"('MOT', 'CHI')",Providence,lil63.xml,175,6,1,CHI,2779,982,MOT
0,1,8,166,2.134166441,167,1,all,"('MOT', 'CHI')",Providence,lil63.xml,175,8,0,CHI,2779,982,MOT
0,6,4,308,2.018072595,314,6,have,"('CHI', 'MOT')",Providence,lil63.xml,318,4,0,MOT,1462,2656,CHI
0,1,10,164,1.939939982,165,1,some,"('MOT', 'CHI')",Providence,lil63.xml,175,10,0,CHI,2779,982,MOT
12,11,32,263,1.871802177,274,11,yeah,"('CHI', 'MOT')",Providence,lil63.xml,318,44,12,MOT,1462,2656,CHI
2,9,4,160,1.85824921,169,9,no,"('MOT', 'CHI')",Providence,lil63.xml,175,6,2,CHI,2779,982,MOT
0,3,5,167,1.815289967,170,3,look,"('MOT', 'CHI')",Providence,lil63.xml,175,5,0,CHI,2779,982,MOT
2,12,8,296,1.785328579,308,12,in,"('CHI', 'MOT')",Providence,lil63.xml,318,10,2,MOT,1462,2656,CHI
4,23,5,286,1.773281721,309,23,is,"('CHI', 'MOT')",Providence,lil63.xml,318,9,4,MOT,1462,2656,CHI
0,13,2,303,1.736699692,316,13,on,"('CHI', 'MOT')",Providence,lil63.xml,318,2,0,MOT,1462,2656,CHI
0,7,5,306,1.727220948,313,7,this,"('CHI', 'MOT')",Providence,lil63.xml,318,5,0,MOT,1462,2656,CHI
6,44,1,267,1.688226272,311,44,oh,"('CHI', 'MOT')",Providence,lil63.xml,318,7,6,MOT,1462,2656,CHI
0,3,6,166,1.675927654,169,3,not,"('MOT', 'CHI')",Providence,lil63.xml,175,6,0,CHI,2779,982,MOT
0,1,14,160,1.628014298,161,1,of,"('MOT', 'CHI')",Providence,lil63.xml,175,14,0,CHI,2779,982,MOT
0,8,5,305,1.609437912,313,8,all,"('CHI', 'MOT')",Providence,lil63.xml,318,5,0,MOT,1462,2656,CHI
1,2,19,153,1.559738244,155,2,to,"('MOT', 'CHI')",Providence,lil63.xml,175,20,1,CHI,2779,982,MOT
9,22,17,270,1.518466134,292,22,the,"('CHI', 'MOT')",Providence,lil63.xml,318,26,9,MOT,1462,2656,CHI
0,11,4,303,1.479076095,314,11,but,"('CHI', 'MOT')",Providence,lil63.xml,318,4,0,MOT,1462,2656,CHI
9,25,15,269,1.476751471,294,25,a,"('CHI', 'MOT')",Providence,lil63.xml,318,24,9,MOT,1462,2656,CHI
3,28,5,282,1.459416626,310,28,that,"('CHI', 'MOT')",Providence,lil63.xml,318,8,3,MOT,1462,2656,CHI
2,4,18,151,1.454377728,155,4,like,"('MOT', 'CHI')",Providence,lil63.xml,175,20,2,CHI,2779,982,MOT
0,14,3,301,1.44141366,315,14,do,"('CHI', 'MOT')",Providence,lil63.xml,318,3,0,MOT,1462,2656,CHI
5,11,12,147,1.437587656,158,11,it,"('MOT', 'CHI')",Providence,lil63.xml,175,17,5,CHI,2779,982,MOT
2,13,12,291,1.410551339,304,13,my,"('CHI', 'MOT')",Providence,lil63.xml,318,14,2,MOT,1462,2656,CHI
4,7,19,145,1.348073148,152,7,what,"('MOT', 'CHI')",Providence,lil63.xml,175,23,4,CHI,2779,982,MOT
0,17,3,298,1.259092104,315,17,what,"('CHI', 'MOT')",Providence,lil63.xml,318,3,0,MOT,1462,2656,CHI
0,3,10,162,1.246792802,165,3,have,"('MOT', 'CHI')",Providence,lil63.xml,175,10,0,CHI,2779,982,MOT
0,3,10,162,1.246792802,165,3,we,"('MOT', 'CHI')",Providence,lil63.xml,175,10,0,CHI,2779,982,MOT
0,4,8,163,1.217875709,167,4,she,"('MOT', 'CHI')",Providence,lil63.xml,175,8,0,CHI,2779,982,MOT
7,28,17,266,1.144408628,294,28,it,"('CHI', 'MOT')",Providence,lil63.xml,318,24,7,MOT,1462,2656,CHI
5,22,18,273,1.131121567,295,22,and,"('CHI', 'MOT')",Providence,lil63.xml,318,23,5,MOT,1462,2656,CHI
0,15,5,298,1.034073768,313,15,of,"('CHI', 'MOT')",Providence,lil63.xml,318,5,0,MOT,1462,2656,CHI
3,36,7,272,1.027042096,308,36,to,"('CHI', 'MOT')",Providence,lil63.xml,318,10,3,MOT,1462,2656,CHI
0,4,10,161,1.02364925,165,4,go,"('MOT', 'CHI')",Providence,lil63.xml,175,10,0,CHI,2779,982,MOT
3,5,30,137,1.00900013,142,5,is,"('MOT', 'CHI')",Providence,lil63.xml,175,33,3,CHI,2779,982,MOT
0,4,12,159,0.857450232,163,4,with,"('MOT', 'CHI')",Providence,lil63.xml,175,12,0,CHI,2779,982,MOT
2,5,28,140,0.831549503,145,5,a,"('MOT', 'CHI')",Providence,lil63.xml,175,30,2,CHI,2779,982,MOT
0,6,9,160,0.780158558,166,6,my,"('MOT', 'CHI')",Providence,lil63.xml,175,9,0,CHI,2779,982,MOT
0,5,11,159,0.755278962,164,5,this,"('MOT', 'CHI')",Providence,lil63.xml,175,11,0,CHI,2779,982,MOT
0,2,27,146,0.544727175,148,2,that,"('MOT', 'CHI')",Providence,lil63.xml,175,27,0,CHI,2779,982,MOT
0,5,14,156,0.529402009,161,5,for,"('MOT', 'CHI')",Providence,lil63.xml,175,14,0,CHI,2779,982,MOT
0,5,16,154,0.399273138,159,5,in,"('MOT', 'CHI')",Providence,lil63.xml,175,16,0,CHI,2779,982,MOT
0,7,13,155,0.312374685,162,7,think,"('MOT', 'CHI')",Providence,lil63.xml,175,13,0,CHI,2779,982,MOT
0,4,22,149,0.255933374,153,4,oh,"('MOT', 'CHI')",Providence,lil63.xml,175,22,0,CHI,2779,982,MOT
0,4,22,149,0.255933374,153,4,and,"('MOT', 'CHI')",Providence,lil63.xml,175,22,0,CHI,2779,982,MOT
4,70,13,231,0.116051862,301,70,you,"('CHI', 'MOT')",Providence,lil63.xml,318,17,4,MOT,1462,2656,CHI
1,9,26,139,0.033901552,148,9,the,"('MOT', 'CHI')",Providence,lil63.xml,175,27,1,CHI,2779,982,MOT
0,6,20,149,0.019293203,155,6,do,"('MOT', 'CHI')",Providence,lil63.xml,175,20,0,CHI,2779,982,MOT
0,10,16,149,-0.206862666,159,10,on,"('MOT', 'CHI')",Providence,lil63.xml,175,16,0,CHI,2779,982,MOT
3,15,49,108,-0.54696467,123,15,you,"('MOT', 'CHI')",Providence,lil63.xml,175,52,3,CHI,2779,982,MOT
0,1,2,1,-0.693147181,2,1,a,"('OPE', 'CHI')",Providence,lil63.xml,4,2,0,CHI,22,33,OPE
0,28,14,133,-1.046134351,161,28,yeah,"('MOT', 'CHI')",Providence,lil63.xml,175,14,0,CHI,2779,982,MOT
1,0,11,470,4.211068837,470,0,up,"('MOT', 'CHI')",Providence,lil64.xml,482,12,1,CHI,4597,2328,MOT
1,0,1,88,3.80666249,88,0,not,"('CHI', 'MOT')",Providence,lil64.xml,90,2,1,MOT,454,602,CHI
2,0,2,86,3.784189634,86,0,all,"('CHI', 'MOT')",Providence,lil64.xml,90,4,2,MOT,454,602,CHI
3,6,6,467,3.205803743,473,6,they,"('MOT', 'CHI')",Providence,lil64.xml,482,9,3,CHI,4597,2328,MOT
1,3,7,471,3.169685581,474,3,not,"('MOT', 'CHI')",Providence,lil64.xml,482,8,1,CHI,4597,2328,MOT
2,1,2,85,3.091042453,86,1,get,"('CHI', 'MOT')",Providence,lil64.xml,90,4,2,MOT,454,602,CHI
6,13,3,460,3.072272351,473,13,no,"('MOT', 'CHI')",Providence,lil64.xml,482,9,6,CHI,4597,2328,MOT
1,2,12,467,3.041342785,469,2,did,"('MOT', 'CHI')",Providence,lil64.xml,482,13,1,CHI,4597,2328,MOT
0,5,2,475,2.999890284,480,5,want,"('MOT', 'CHI')",Providence,lil64.xml,482,2,0,CHI,4597,2328,MOT
0,2,6,474,2.991556902,476,2,make,"('MOT', 'CHI')",Providence,lil64.xml,482,6,0,CHI,4597,2328,MOT
1,1,2,86,2.879198457,87,1,is,"('CHI', 'MOT')",Providence,lil64.xml,90,3,1,MOT,454,602,CHI
1,1,2,86,2.879198457,87,1,at,"('CHI', 'MOT')",Providence,lil64.xml,90,3,1,MOT,454,602,CHI
0,1,12,469,2.824774475,470,1,for,"('MOT', 'CHI')",Providence,lil64.xml,482,12,0,CHI,4597,2328,MOT
2,4,14,462,2.747270914,466,4,was,"('MOT', 'CHI')",Providence,lil64.xml,482,16,2,CHI,4597,2328,MOT
0,1,1,88,2.719100037,89,1,look,"('CHI', 'MOT')",Providence,lil64.xml,90,1,0,MOT,454,602,CHI
0,1,1,88,2.719100037,89,1,some,"('CHI', 'MOT')",Providence,lil64.xml,90,1,0,MOT,454,602,CHI
1,2,1,86,2.708050201,88,2,go,"('CHI', 'MOT')",Providence,lil64.xml,90,2,1,MOT,454,602,CHI
0,5,4,473,2.590267165,478,5,she,"('MOT', 'CHI')",Providence,lil64.xml,482,4,0,CHI,4597,2328,MOT
0,3,7,472,2.583997552,475,3,see,"('MOT', 'CHI')",Providence,lil64.xml,482,7,0,CHI,4597,2328,MOT
5,7,20,450,2.545531272,457,7,in,"('MOT', 'CHI')",Providence,lil64.xml,482,25,5,CHI,4597,2328,MOT
1,6,9,466,2.423537703,472,6,where,"('MOT', 'CHI')",Providence,lil64.xml,482,10,1,CHI,4597,2328,MOT
1,5,11,465,2.419309367,470,5,look,"('MOT', 'CHI')",Providence,lil64.xml,482,12,1,CHI,4597,2328,MOT
1,4,14,463,2.401098693,467,4,go,"('MOT', 'CHI')",Providence,lil64.xml,482,15,1,CHI,4597,2328,MOT
0,3,9,470,2.37912517,473,3,but,"('MOT', 'CHI')",Providence,lil64.xml,482,9,0,CHI,4597,2328,MOT
4,3,4,79,2.351375257,82,3,to,"('CHI', 'MOT')",Providence,lil64.xml,90,8,4,MOT,454,602,CHI
0,2,13,467,2.348195604,469,2,at,"('MOT', 'CHI')",Providence,lil64.xml,482,13,0,CHI,4597,2328,MOT
0,2,1,87,2.313634929,89,2,can,"('CHI', 'MOT')",Providence,lil64.xml,90,1,0,MOT,454,602,CHI
1,5,0,84,2.313634929,89,5,on,"('CHI', 'MOT')",Providence,lil64.xml,90,1,1,MOT,454,602,CHI
1,0,0,13,2.302585093,13,0,a,"('MOT', 'OPE')",Providence,lil64.xml,14,1,1,OPE,76,54,MOT
2,8,12,460,2.281531684,468,8,there,"('MOT', 'CHI')",Providence,lil64.xml,482,14,2,CHI,4597,2328,MOT
1,10,6,465,2.265543821,475,10,some,"('MOT', 'CHI')",Providence,lil64.xml,482,7,1,CHI,4597,2328,MOT
0,2,15,465,2.218777136,467,2,get,"('MOT', 'CHI')",Providence,lil64.xml,482,15,0,CHI,4597,2328,MOT
1,6,12,463,2.194044924,469,6,gonna,"('MOT', 'CHI')",Providence,lil64.xml,482,13,1,CHI,4597,2328,MOT
1,3,2,84,2.186051277,87,3,in,"('CHI', 'MOT')",Providence,lil64.xml,90,3,1,MOT,454,602,CHI
0,4,9,469,2.155981619,473,4,have,"('MOT', 'CHI')",Providence,lil64.xml,482,9,0,CHI,4597,2328,MOT
1,4,19,458,2.132551367,462,4,we,"('MOT', 'CHI')",Providence,lil64.xml,482,20,1,CHI,4597,2328,MOT
0,4,10,468,2.066862759,472,4,put,"('MOT', 'CHI')",Providence,lil64.xml,482,10,0,CHI,4597,2328,MOT
2,11,11,458,2.060513532,469,11,one,"('MOT', 'CHI')",Providence,lil64.xml,482,13,2,CHI,4597,2328,MOT
0,3,1,86,2.025952857,89,3,there,"('CHI', 'MOT')",Providence,lil64.xml,90,1,0,MOT,454,602,CHI
0,2,2,86,2.014903021,88,2,this,"('CHI', 'MOT')",Providence,lil64.xml,90,2,0,MOT,454,602,CHI
1,2,5,82,1.969440646,84,2,my,"('CHI', 'MOT')",Providence,lil64.xml,90,6,1,MOT,454,602,CHI
0,4,13,465,1.83736998,469,4,big,"('MOT', 'CHI')",Providence,lil64.xml,482,13,0,CHI,4597,2328,MOT
2,5,3,80,1.826850789,85,5,like,"('CHI', 'MOT')",Providence,lil64.xml,90,5,2,MOT,454,602,CHI
1,4,27,450,1.805004696,454,4,do,"('MOT', 'CHI')",Providence,lil64.xml,482,28,1,CHI,4597,2328,MOT
0,2,24,456,1.774517663,458,2,little,"('MOT', 'CHI')",Providence,lil64.xml,482,24,0,CHI,4597,2328,MOT
4,5,6,75,1.739491041,80,5,it,"('CHI', 'MOT')",Providence,lil64.xml,90,10,4,MOT,454,602,CHI
0,3,2,85,1.727220948,88,3,no,"('CHI', 'MOT')",Providence,lil64.xml,90,2,0,MOT,454,602,CHI
0,3,2,85,1.727220948,88,3,where,"('CHI', 'MOT')",Providence,lil64.xml,90,2,0,MOT,454,602,CHI
0,3,2,85,1.727220948,88,3,and,"('CHI', 'MOT')",Providence,lil64.xml,90,2,0,MOT,454,602,CHI
2,5,4,79,1.681758574,84,5,a,"('CHI', 'MOT')",Providence,lil64.xml,90,6,2,MOT,454,602,CHI
6,2,21,61,1.6543893,63,2,yeah,"('CHI', 'MOT')",Providence,lil64.xml,90,27,6,MOT,454,602,CHI
2,4,47,429,1.632694775,433,4,oh,"('MOT', 'CHI')",Providence,lil64.xml,482,49,2,CHI,4597,2328,MOT
0,5,1,84,1.620487749,89,5,that,"('CHI', 'MOT')",Providence,lil64.xml,90,1,0,MOT,454,602,CHI
2,15,14,451,1.584120104,466,15,my,"('MOT', 'CHI')",Providence,lil64.xml,482,16,2,CHI,4597,2328,MOT
2,10,23,447,1.53393036,457,10,he,"('MOT', 'CHI')",Providence,lil64.xml,482,25,2,CHI,4597,2328,MOT
0,3,3,84,1.492904096,87,3,did,"('CHI', 'MOT')",Providence,lil64.xml,90,3,0,MOT,454,602,CHI
0,11,7,464,1.485385264,475,11,wanna,"('MOT', 'CHI')",Providence,lil64.xml,482,7,0,CHI,4597,2328,MOT
0,8,11,463,1.396921454,471,8,with,"('MOT', 'CHI')",Providence,lil64.xml,482,11,0,CHI,4597,2328,MOT
1,0,0,4,1.386294361,4,0,a,"('CHI', 'OPE')",Providence,lil64.xml,5,1,1,OPE,13,14,CHI
0,10,9,463,1.367524258,473,10,can,"('MOT', 'CHI')",Providence,lil64.xml,482,9,0,CHI,4597,2328,MOT
2,12,24,444,1.328327605,456,12,are,"('MOT', 'CHI')",Providence,lil64.xml,482,26,2,CHI,4597,2328,MOT
0,3,4,83,1.299282984,86,3,he,"('CHI', 'MOT')",Providence,lil64.xml,90,4,0,MOT,454,602,CHI
14,20,65,383,1.272965676,403,20,a,"('MOT', 'CHI')",Providence,lil64.xml,482,79,14,CHI,4597,2328,MOT
1,9,2,78,1.269760545,87,9,what,"('CHI', 'MOT')",Providence,lil64.xml,90,3,1,MOT,454,602,CHI
1,1,1,11,1.252762968,12,1,and,"('MOT', 'OPE')",Providence,lil64.xml,14,2,1,OPE,76,54,MOT
2,10,32,438,1.22644566,448,10,what,"('MOT', 'CHI')",Providence,lil64.xml,482,34,2,CHI,4597,2328,MOT
4,12,4,70,1.172720261,82,12,you,"('CHI', 'MOT')",Providence,lil64.xml,90,8,4,MOT,454,602,CHI
3,9,6,72,1.104654603,81,9,the,"('CHI', 'MOT')",Providence,lil64.xml,90,9,3,MOT,454,602,CHI
0,17,7,458,1.079920156,475,17,this,"('MOT', 'CHI')",Providence,lil64.xml,482,7,0,CHI,4597,2328,MOT
3,21,26,432,0.981562122,453,21,is,"('MOT', 'CHI')",Providence,lil64.xml,482,29,3,CHI,4597,2328,MOT
3,14,41,424,0.93637749,438,14,that,"('MOT', 'CHI')",Providence,lil64.xml,482,44,3,CHI,4597,2328,MOT
0,1,1,12,0.916290732,13,1,the,"('MOT', 'OPE')",Providence,lil64.xml,14,1,0,OPE,76,54,MOT
2,12,41,427,0.816045317,439,12,to,"('MOT', 'CHI')",Providence,lil64.xml,482,43,2,CHI,4597,2328,MOT
1,12,28,441,0.814508038,453,12,like,"('MOT', 'CHI')",Providence,lil64.xml,482,29,1,CHI,4597,2328,MOT
1,14,25,442,0.779761653,456,14,on,"('MOT', 'CHI')",Providence,lil64.xml,482,26,1,CHI,4597,2328,MOT
2,22,24,434,0.757782747,456,22,and,"('MOT', 'CHI')",Providence,lil64.xml,482,26,2,CHI,4597,2328,MOT
0,15,12,455,0.745332934,470,15,think,"('MOT', 'CHI')",Providence,lil64.xml,482,12,0,CHI,4597,2328,MOT
0,11,17,454,0.716983629,465,11,all,"('MOT', 'CHI')",Providence,lil64.xml,482,17,0,CHI,4597,2328,MOT
16,41,64,361,0.690239356,402,41,the,"('MOT', 'CHI')",Providence,lil64.xml,482,80,16,CHI,4597,2328,MOT
0,11,2,77,0.628608659,88,11,oh,"('CHI', 'MOT')",Providence,lil64.xml,90,2,0,MOT,454,602,CHI
9,58,30,385,0.609549865,443,58,yeah,"('MOT', 'CHI')",Providence,lil64.xml,482,39,9,CHI,4597,2328,MOT
0,12,22,448,0.392561703,460,12,of,"('MOT', 'CHI')",Providence,lil64.xml,482,22,0,CHI,4597,2328,MOT
3,30,36,413,0.336809372,443,30,it,"('MOT', 'CHI')",Providence,lil64.xml,482,39,3,CHI,4597,2328,MOT
0,1,1,5,0.287682072,6,1,yeah,"('OPE', 'CHI')",Providence,lil64.xml,7,1,0,CHI,27,40,OPE
0,1,1,5,0.287682072,6,1,is,"('OPE', 'CHI')",Providence,lil64.xml,7,1,0,CHI,27,40,OPE
0,2,2,10,0.15415068,12,2,you,"('MOT', 'OPE')",Providence,lil64.xml,14,2,0,OPE,76,54,MOT
5,23,88,366,0.028536307,389,23,you,"('MOT', 'CHI')",Providence,lil64.xml,482,93,5,CHI,4597,2328,MOT
0,1,2,4,-0.133531393,5,1,it,"('OPE', 'CHI')",Providence,lil64.xml,7,2,0,CHI,27,40,OPE
1,2,3,450,3.920872621,452,2,make,"('MOT', 'CHI')",Providence,lil65.xml,456,4,1,CHI,5083,2250,MOT
0,1,3,452,3.817712326,453,1,gonna,"('MOT', 'CHI')",Providence,lil65.xml,456,3,0,CHI,5083,2250,MOT
1,4,3,448,3.410046997,452,4,wanna,"('MOT', 'CHI')",Providence,lil65.xml,456,4,1,CHI,5083,2250,MOT
1,5,3,447,3.22772544,452,5,put,"('MOT', 'CHI')",Providence,lil65.xml,456,4,1,CHI,5083,2250,MOT
3,6,6,441,3.149511827,447,6,up,"('MOT', 'CHI')",Providence,lil65.xml,456,9,3,CHI,5083,2250,MOT
2,2,16,436,3.091042453,438,2,little,"('MOT', 'CHI')",Providence,lil65.xml,456,18,2,CHI,5083,2250,MOT
3,6,7,440,3.060270795,446,6,where,"('MOT', 'CHI')",Providence,lil65.xml,456,10,3,CHI,5083,2250,MOT
1,4,6,445,2.99795203,449,4,want,"('MOT', 'CHI')",Providence,lil65.xml,456,7,1,CHI,5083,2250,MOT
0,1,11,444,2.844462057,445,1,see,"('MOT', 'CHI')",Providence,lil65.xml,456,11,0,CHI,5083,2250,MOT
2,3,16,435,2.803360381,438,3,he,"('MOT', 'CHI')",Providence,lil65.xml,456,18,2,CHI,5083,2250,MOT
0,5,3,448,2.719100037,453,5,did,"('MOT', 'CHI')",Providence,lil65.xml,456,3,0,CHI,5083,2250,MOT
0,1,13,442,2.696876901,443,1,with,"('MOT', 'CHI')",Providence,lil65.xml,456,13,0,CHI,5083,2250,MOT
0,3,6,447,2.647946277,450,3,big,"('MOT', 'CHI')",Providence,lil65.xml,456,6,0,CHI,5083,2250,MOT
1,2,20,433,2.538973871,435,2,have,"('MOT', 'CHI')",Providence,lil65.xml,456,21,1,CHI,5083,2250,MOT
0,2,10,444,2.521274294,446,2,some,"('MOT', 'CHI')",Providence,lil65.xml,456,10,0,CHI,5083,2250,MOT
0,1,16,439,2.507790944,440,1,but,"('MOT', 'CHI')",Providence,lil65.xml,456,16,0,CHI,5083,2250,MOT
1,0,0,15,2.427748236,15,0,like,"('CHI', 'MOT')",Providence,lil65.xml,16,1,1,MOT,85,96,CHI
1,0,0,15,2.427748236,15,0,all,"('CHI', 'MOT')",Providence,lil65.xml,16,1,1,MOT,85,96,CHI
1,0,0,15,2.427748236,15,0,and,"('CHI', 'MOT')",Providence,lil65.xml,16,1,1,MOT,85,96,CHI
1,3,19,433,2.298029276,436,3,think,"('MOT', 'CHI')",Providence,lil65.xml,456,20,1,CHI,5083,2250,MOT
2,2,46,406,2.104134154,408,2,oh,"('MOT', 'CHI')",Providence,lil65.xml,456,48,2,CHI,5083,2250,MOT
0,3,13,440,2.00372972,443,3,not,"('MOT', 'CHI')",Providence,lil65.xml,456,13,0,CHI,5083,2250,MOT
0,4,11,441,1.928171325,445,4,can,"('MOT', 'CHI')",Providence,lil65.xml,456,11,0,CHI,5083,2250,MOT
0,3,15,438,1.874062065,441,3,all,"('MOT', 'CHI')",Providence,lil65.xml,456,15,0,CHI,5083,2250,MOT
0,4,12,440,1.85182371,444,4,there,"('MOT', 'CHI')",Providence,lil65.xml,456,12,0,CHI,5083,2250,MOT
0,3,17,436,1.758311535,439,3,they,"('MOT', 'CHI')",Providence,lil65.xml,456,17,0,CHI,5083,2250,MOT
0,2,24,430,1.716335707,432,2,we,"('MOT', 'CHI')",Providence,lil65.xml,456,24,0,CHI,5083,2250,MOT
0,4,14,438,1.713797928,442,4,go,"('MOT', 'CHI')",Providence,lil65.xml,456,14,0,CHI,5083,2250,MOT
1,5,27,423,1.563975538,428,5,do,"('MOT', 'CHI')",Providence,lil65.xml,456,28,1,CHI,5083,2250,MOT
3,19,14,420,1.535167984,439,19,one,"('MOT', 'CHI')",Providence,lil65.xml,456,17,3,CHI,5083,2250,MOT
2,1,1,12,1.504077397,13,1,yeah,"('CHI', 'MOT')",Providence,lil65.xml,16,3,2,MOT,85,96,CHI
0,5,16,435,1.409178655,440,5,get,"('MOT', 'CHI')",Providence,lil65.xml,456,16,0,CHI,5083,2250,MOT
4,11,39,402,1.346147293,413,11,that,"('MOT', 'CHI')",Providence,lil65.xml,456,43,4,CHI,5083,2250,MOT
2,14,23,417,1.16546295,431,14,no,"('MOT', 'CHI')",Providence,lil65.xml,456,25,2,CHI,5083,2250,MOT
0,7,16,433,1.121496583,440,7,was,"('MOT', 'CHI')",Providence,lil65.xml,456,16,0,CHI,5083,2250,MOT
0,5,22,429,1.107828944,434,5,at,"('MOT', 'CHI')",Providence,lil65.xml,456,22,0,CHI,5083,2250,MOT
3,14,34,405,1.057315348,419,14,in,"('MOT', 'CHI')",Providence,lil65.xml,456,37,3,CHI,5083,2250,MOT
0,1,1,14,1.041453875,15,1,it,"('CHI', 'MOT')",Providence,lil65.xml,16,1,0,MOT,85,96,CHI
0,1,1,14,1.041453875,15,1,the,"('CHI', 'MOT')",Providence,lil65.xml,16,1,0,MOT,85,96,CHI
3,28,17,408,1.010174988,436,28,like,"('MOT', 'CHI')",Providence,lil65.xml,456,20,3,CHI,5083,2250,MOT
11,23,59,363,0.99119204,386,23,the,"('MOT', 'CHI')",Providence,lil65.xml,456,70,11,CHI,5083,2250,MOT
1,12,22,421,0.984668029,433,12,are,"('MOT', 'CHI')",Providence,lil65.xml,456,23,1,CHI,5083,2250,MOT
1,0,0,2,0.980829253,2,0,you,"('OPE', 'MOT')",Providence,lil65.xml,3,1,1,MOT,18,40,OPE
5,29,26,396,0.950838539,425,29,what,"('MOT', 'CHI')",Providence,lil65.xml,456,31,5,CHI,5083,2250,MOT
2,10,41,403,0.922333046,413,10,to,"('MOT', 'CHI')",Providence,lil65.xml,456,43,2,CHI,5083,2250,MOT
0,7,22,427,0.820146871,434,7,look,"('MOT', 'CHI')",Providence,lil65.xml,456,22,0,CHI,5083,2250,MOT
2,0,0,1,0.810930216,1,0,that,"('OPE', 'MOT')",Providence,lil65.xml,3,2,2,MOT,18,40,OPE
4,29,26,397,0.801627824,426,29,this,"('MOT', 'CHI')",Providence,lil65.xml,456,30,4,CHI,5083,2250,MOT
19,33,78,326,0.763129857,359,33,a,"('MOT', 'CHI')",Providence,lil65.xml,456,97,19,CHI,5083,2250,MOT
0,9,19,428,0.737391882,437,9,my,"('MOT', 'CHI')",Providence,lil65.xml,456,19,0,CHI,5083,2250,MOT
0,7,24,425,0.735506454,432,7,of,"('MOT', 'CHI')",Providence,lil65.xml,456,24,0,CHI,5083,2250,MOT
5,31,38,382,0.547639597,413,31,it,"('MOT', 'CHI')",Providence,lil65.xml,456,43,5,CHI,5083,2250,MOT
5,29,43,379,0.494696242,408,29,is,"('MOT', 'CHI')",Providence,lil65.xml,456,48,5,CHI,5083,2250,MOT
0,13,21,422,0.30538165,435,13,on,"('MOT', 'CHI')",Providence,lil65.xml,456,21,0,CHI,5083,2250,MOT
1,1,0,1,0.287682072,2,1,is,"('OPE', 'MOT')",Providence,lil65.xml,3,1,1,MOT,18,40,OPE
4,23,61,368,0.200501075,391,23,you,"('MOT', 'CHI')",Providence,lil65.xml,456,65,4,CHI,5083,2250,MOT
3,23,53,377,0.144249609,400,23,and,"('MOT', 'CHI')",Providence,lil65.xml,456,56,3,CHI,5083,2250,MOT
3,48,27,378,0.087861356,426,48,yeah,"('MOT', 'CHI')",Providence,lil65.xml,456,30,3,CHI,5083,2250,MOT
0,1,1,1,-0.405465108,2,1,oh,"('OPE', 'MOT')",Providence,lil65.xml,3,1,0,MOT,18,40,OPE
1,0,0,135,4.514515818,135,0,gonna,"('CHI', 'MOT')",Providence,lil66.xml,136,1,1,MOT,631,1474,CHI
0,1,1,134,3.128221457,135,1,go,"('CHI', 'MOT')",Providence,lil66.xml,136,1,0,MOT,631,1474,CHI
0,1,1,134,3.128221457,135,1,get,"('CHI', 'MOT')",Providence,lil66.xml,136,1,0,MOT,631,1474,CHI
1,1,3,131,3.106080331,132,1,put,"('CHI', 'MOT')",Providence,lil66.xml,136,4,1,MOT,631,1474,CHI
0,2,2,248,3.044522438,250,2,was,"('MOT', 'CHI')",Providence,lil66.xml,252,2,0,CHI,3806,1219,MOT
1,3,3,245,3.036554268,248,3,where,"('MOT', 'CHI')",Providence,lil66.xml,252,4,1,CHI,3806,1219,MOT
0,1,5,246,2.878395567,247,1,look,"('MOT', 'CHI')",Providence,lil66.xml,252,5,0,CHI,3806,1219,MOT
0,1,2,133,2.833213344,134,1,all,"('CHI', 'MOT')",Providence,lil66.xml,136,2,0,MOT,631,1474,CHI
8,3,9,116,2.662281783,119,3,yeah,"('CHI', 'MOT')",Providence,lil66.xml,136,17,8,MOT,631,1474,CHI
0,1,7,244,2.619016579,245,1,did,"('MOT', 'CHI')",Providence,lil66.xml,252,7,0,CHI,3806,1219,MOT
1,2,9,240,2.606796467,242,2,for,"('MOT', 'CHI')",Providence,lil66.xml,252,10,1,CHI,3806,1219,MOT
1,6,0,129,2.568605669,135,6,in,"('CHI', 'MOT')",Providence,lil66.xml,136,1,1,MOT,631,1474,CHI
0,1,8,243,2.509599262,244,1,see,"('MOT', 'CHI')",Providence,lil66.xml,252,8,0,CHI,3806,1219,MOT
0,1,8,243,2.509599262,244,1,big,"('MOT', 'CHI')",Providence,lil66.xml,252,8,0,CHI,3806,1219,MOT
0,3,1,132,2.435074276,135,3,some,"('CHI', 'MOT')",Providence,lil66.xml,136,1,0,MOT,631,1474,CHI
0,1,9,242,2.410215757,243,1,not,"('MOT', 'CHI')",Providence,lil66.xml,252,9,0,CHI,3806,1219,MOT
1,1,19,231,2.364278662,232,1,they,"('MOT', 'CHI')",Providence,lil66.xml,252,20,1,CHI,3806,1219,MOT
0,2,6,244,2.335374916,246,2,but,"('MOT', 'CHI')",Providence,lil66.xml,252,6,0,CHI,3806,1219,MOT
8,5,8,115,2.319114395,120,5,one,"('CHI', 'MOT')",Providence,lil66.xml,136,16,8,MOT,631,1474,CHI
0,4,3,245,2.306577114,249,4,want,"('MOT', 'CHI')",Providence,lil66.xml,252,3,0,CHI,3806,1219,MOT
0,1,11,240,2.234964905,241,1,go,"('MOT', 'CHI')",Providence,lil66.xml,252,11,0,CHI,3806,1219,MOT
0,1,11,240,2.234964905,241,1,put,"('MOT', 'CHI')",Providence,lil66.xml,252,11,0,CHI,3806,1219,MOT
5,6,15,226,2.210127982,232,6,with,"('MOT', 'CHI')",Providence,lil66.xml,252,20,5,CHI,3806,1219,MOT
0,3,2,131,2.140066163,134,3,but,"('CHI', 'MOT')",Providence,lil66.xml,136,2,0,MOT,631,1474,CHI
1,3,5,127,2.1102132,130,3,he,"('CHI', 'MOT')",Providence,lil66.xml,136,6,1,MOT,631,1474,CHI
2,9,1,124,2.091864062,133,9,is,"('CHI', 'MOT')",Providence,lil66.xml,136,3,2,MOT,631,1474,CHI
0,3,6,243,2.047692843,246,3,can,"('MOT', 'CHI')",Providence,lil66.xml,252,6,0,CHI,3806,1219,MOT
0,5,1,130,2.029609168,135,5,they,"('CHI', 'MOT')",Providence,lil66.xml,136,1,0,MOT,631,1474,CHI
0,4,5,243,1.962104835,247,4,wanna,"('MOT', 'CHI')",Providence,lil66.xml,252,5,0,CHI,3806,1219,MOT
0,2,10,240,1.913649287,242,2,at,"('MOT', 'CHI')",Providence,lil66.xml,252,10,0,CHI,3806,1219,MOT
0,7,3,242,1.836573485,249,7,make,"('MOT', 'CHI')",Providence,lil66.xml,252,3,0,CHI,3806,1219,MOT
5,5,14,112,1.734601055,117,5,this,"('CHI', 'MOT')",Providence,lil66.xml,136,19,5,MOT,631,1474,CHI
2,9,9,232,1.724139282,241,9,she,"('MOT', 'CHI')",Providence,lil66.xml,252,11,2,CHI,3806,1219,MOT
0,3,4,129,1.71978597,132,3,no,"('CHI', 'MOT')",Providence,lil66.xml,136,4,0,MOT,631,1474,CHI
0,5,6,241,1.642227735,246,5,gonna,"('MOT', 'CHI')",Providence,lil66.xml,252,6,0,CHI,3806,1219,MOT
0,2,14,236,1.609437912,238,2,all,"('MOT', 'CHI')",Providence,lil66.xml,252,14,0,CHI,3806,1219,MOT
0,6,2,128,1.580450376,134,6,we,"('CHI', 'MOT')",Providence,lil66.xml,136,2,0,MOT,631,1474,CHI
0,1,22,229,1.575536361,230,1,oh,"('MOT', 'CHI')",Providence,lil66.xml,252,22,0,CHI,3806,1219,MOT
2,4,25,221,1.546828564,225,4,on,"('MOT', 'CHI')",Providence,lil66.xml,252,27,2,CHI,3806,1219,MOT
0,5,7,240,1.52040429,245,5,my,"('MOT', 'CHI')",Providence,lil66.xml,252,7,0,CHI,3806,1219,MOT
0,9,1,126,1.518783544,135,9,on,"('CHI', 'MOT')",Providence,lil66.xml,136,1,0,MOT,631,1474,CHI
2,4,27,219,1.471287574,223,4,think,"('MOT', 'CHI')",Providence,lil66.xml,252,29,2,CHI,3806,1219,MOT
1,15,1,119,1.446918983,134,15,and,"('CHI', 'MOT')",Providence,lil66.xml,136,2,1,MOT,631,1474,CHI
0,1,25,226,1.444737957,227,1,are,"('MOT', 'CHI')",Providence,lil66.xml,252,25,0,CHI,3806,1219,MOT
7,24,1,104,1.425515074,128,24,a,"('CHI', 'MOT')",Providence,lil66.xml,136,8,7,MOT,631,1474,CHI
0,2,17,233,1.425008873,235,2,in,"('MOT', 'CHI')",Providence,lil66.xml,252,17,0,CHI,3806,1219,MOT
1,12,2,121,1.424034689,133,12,of,"('CHI', 'MOT')",Providence,lil66.xml,136,3,1,MOT,631,1474,CHI
2,11,4,119,1.41706602,130,11,like,"('CHI', 'MOT')",Providence,lil66.xml,136,6,2,MOT,631,1474,CHI
6,7,37,202,1.411664251,209,7,you,"('MOT', 'CHI')",Providence,lil66.xml,252,43,6,CHI,3806,1219,MOT
0,4,10,238,1.402823663,242,4,get,"('MOT', 'CHI')",Providence,lil66.xml,252,10,0,CHI,3806,1219,MOT
2,6,21,223,1.376244025,229,6,like,"('MOT', 'CHI')",Providence,lil66.xml,252,23,2,CHI,3806,1219,MOT
0,4,12,236,1.240442484,240,4,he,"('MOT', 'CHI')",Providence,lil66.xml,252,12,0,CHI,3806,1219,MOT
0,4,6,126,1.193922468,130,4,do,"('CHI', 'MOT')",Providence,lil66.xml,136,6,0,MOT,631,1474,CHI
14,31,4,87,1.034073768,118,31,the,"('CHI', 'MOT')",Providence,lil66.xml,136,18,14,MOT,631,1474,CHI
1,0,2,5,1.029619417,5,0,you,"('OPE', 'CHI')",Providence,lil66.xml,8,3,1,CHI,54,33,OPE
3,12,9,112,1.018569581,124,12,it,"('CHI', 'MOT')",Providence,lil66.xml,136,12,3,MOT,631,1474,CHI
1,24,1,110,1.00063188,134,24,that,"('CHI', 'MOT')",Providence,lil66.xml,136,2,1,MOT,631,1474,CHI
4,21,14,213,0.986494991,234,21,what,"('MOT', 'CHI')",Providence,lil66.xml,252,18,4,CHI,3806,1219,MOT
5,19,22,206,0.853681383,225,19,it,"('MOT', 'CHI')",Providence,lil66.xml,252,27,5,CHI,3806,1219,MOT
0,11,7,234,0.82725711,245,11,no,"('MOT', 'CHI')",Providence,lil66.xml,252,7,0,CHI,3806,1219,MOT
0,2,31,219,0.812051921,221,2,of,"('MOT', 'CHI')",Providence,lil66.xml,252,31,0,CHI,3806,1219,MOT
0,3,24,225,0.79368841,228,3,to,"('MOT', 'CHI')",Providence,lil66.xml,252,24,0,CHI,3806,1219,MOT
0,5,16,231,0.790139447,236,5,there,"('MOT', 'CHI')",Providence,lil66.xml,252,16,0,CHI,3806,1219,MOT
4,17,24,207,0.738403772,224,17,one,"('MOT', 'CHI')",Providence,lil66.xml,252,28,4,CHI,3806,1219,MOT
0,12,3,121,0.730887509,133,12,oh,"('CHI', 'MOT')",Providence,lil66.xml,136,3,0,MOT,631,1474,CHI
4,16,31,201,0.554378386,217,16,is,"('MOT', 'CHI')",Providence,lil66.xml,252,35,4,CHI,3806,1219,MOT
4,8,59,181,0.490099493,189,8,a,"('MOT', 'CHI')",Providence,lil66.xml,252,63,4,CHI,3806,1219,MOT
0,13,4,119,0.467023001,132,13,you,"('CHI', 'MOT')",Providence,lil66.xml,136,4,0,MOT,631,1474,CHI
0,8,15,229,0.446025631,237,8,this,"('MOT', 'CHI')",Providence,lil66.xml,252,15,0,CHI,3806,1219,MOT
8,18,50,176,0.436555695,194,18,the,"('MOT', 'CHI')",Providence,lil66.xml,252,58,8,CHI,3806,1219,MOT
0,1,1,6,0.405465108,7,1,for,"('OPE', 'CHI')",Providence,lil66.xml,8,1,0,CHI,54,33,OPE
0,1,1,6,0.405465108,7,1,a,"('OPE', 'CHI')",Providence,lil66.xml,8,1,0,CHI,54,33,OPE
0,10,16,226,0.184003643,236,10,do,"('MOT', 'CHI')",Providence,lil66.xml,252,16,0,CHI,3806,1219,MOT
0,9,24,219,-0.122602322,228,9,that,"('MOT', 'CHI')",Providence,lil66.xml,252,24,0,CHI,3806,1219,MOT
2,25,27,198,-0.177371052,223,25,yeah,"('MOT', 'CHI')",Providence,lil66.xml,252,29,2,CHI,3806,1219,MOT
2,14,47,189,-0.218253566,203,14,and,"('MOT', 'CHI')",Providence,lil66.xml,252,49,2,CHI,3806,1219,MOT
1,8,29,98,-0.287682072,106,8,what,"('CHI', 'MOT')",Providence,lil66.xml,136,30,1,MOT,631,1474,CHI
0,1,1,1,-0.405465108,2,1,it,"('OPE', 'MOT')",Providence,lil66.xml,3,1,0,MOT,18,18,OPE
1,2,6,430,3.470354849,432,2,was,"('MOT', 'CHI')",Providence,lil67.xml,439,7,1,CHI,4624,2499,MOT
0,2,3,434,3.374168709,436,2,put,"('MOT', 'CHI')",Providence,lil67.xml,439,3,0,CHI,4624,2499,MOT
0,2,3,434,3.374168709,436,2,wanna,"('MOT', 'CHI')",Providence,lil67.xml,439,3,0,CHI,4624,2499,MOT
1,4,4,430,3.215441362,434,4,he,"('MOT', 'CHI')",Providence,lil67.xml,439,5,1,CHI,4624,2499,MOT
0,4,2,433,3.08876714,437,4,where,"('MOT', 'CHI')",Providence,lil67.xml,439,2,0,CHI,4624,2499,MOT
0,3,3,433,3.086486637,436,3,want,"('MOT', 'CHI')",Providence,lil67.xml,439,3,0,CHI,4624,2499,MOT
0,3,4,432,2.901879365,435,3,not,"('MOT', 'CHI')",Providence,lil67.xml,439,4,0,CHI,4624,2499,MOT
2,3,14,420,2.874035339,423,3,little,"('MOT', 'CHI')",Providence,lil67.xml,439,16,2,CHI,4624,2499,MOT
1,4,7,427,2.851861903,431,4,for,"('MOT', 'CHI')",Providence,lil67.xml,439,8,1,CHI,4624,2499,MOT
1,4,7,427,2.851861903,431,4,some,"('MOT', 'CHI')",Providence,lil67.xml,439,8,1,CHI,4624,2499,MOT
1,4,8,426,2.754239584,430,4,have,"('MOT', 'CHI')",Providence,lil67.xml,439,9,1,CHI,4624,2499,MOT
2,6,10,421,2.575101729,427,6,my,"('MOT', 'CHI')",Providence,lil67.xml,439,12,2,CHI,4624,2499,MOT
0,2,9,428,2.571918027,430,2,but,"('MOT', 'CHI')",Providence,lil67.xml,439,9,0,CHI,4624,2499,MOT
2,7,9,421,2.518006598,428,7,up,"('MOT', 'CHI')",Providence,lil67.xml,439,11,2,CHI,4624,2499,MOT
2,5,14,418,2.46857023,423,5,are,"('MOT', 'CHI')",Providence,lil67.xml,439,16,2,CHI,4624,2499,MOT
0,2,11,426,2.400223563,428,2,look,"('MOT', 'CHI')",Providence,lil67.xml,439,11,0,CHI,4624,2499,MOT
0,2,12,425,2.323787301,427,2,see,"('MOT', 'CHI')",Providence,lil67.xml,439,12,0,CHI,4624,2499,MOT
0,1,19,419,2.307335696,420,1,think,"('MOT', 'CHI')",Providence,lil67.xml,439,19,0,CHI,4624,2499,MOT
0,4,7,428,2.266382044,432,4,did,"('MOT', 'CHI')",Providence,lil67.xml,439,7,0,CHI,4624,2499,MOT
0,3,10,426,2.194907079,429,3,they,"('MOT', 'CHI')",Providence,lil67.xml,439,10,0,CHI,4624,2499,MOT
1,4,16,418,2.189003744,422,4,she,"('MOT', 'CHI')",Providence,lil67.xml,439,17,1,CHI,4624,2499,MOT
1,0,0,10,2.079441542,10,0,want,"('CHI', 'MOT')",Providence,lil67.xml,11,1,1,MOT,44,165,CHI
1,0,0,10,2.079441542,10,0,we,"('CHI', 'MOT')",Providence,lil67.xml,11,1,1,MOT,44,165,CHI
1,0,0,10,2.079441542,10,0,to,"('CHI', 'MOT')",Providence,lil67.xml,11,1,1,MOT,44,165,CHI
1,0,0,10,2.079441542,10,0,and,"('CHI', 'MOT')",Providence,lil67.xml,11,1,1,MOT,44,165,CHI
2,10,11,416,2.05179001,426,10,get,"('MOT', 'CHI')",Providence,lil67.xml,439,13,2,CHI,4624,2499,MOT
3,10,17,409,1.939989469,419,10,big,"('MOT', 'CHI')",Providence,lil67.xml,439,20,3,CHI,4624,2499,MOT
1,0,0,8,1.897119985,8,0,one,"('CHI', 'OPE')",Providence,lil67.xml,9,1,1,OPE,51,43,CHI
0,3,16,420,1.77542305,423,3,there,"('MOT', 'CHI')",Providence,lil67.xml,439,16,0,CHI,4624,2499,MOT
0,4,13,422,1.741635082,426,4,go,"('MOT', 'CHI')",Providence,lil67.xml,439,13,0,CHI,4624,2499,MOT
3,7,33,396,1.673153727,403,7,like,"('MOT', 'CHI')",Providence,lil67.xml,439,36,3,CHI,4624,2499,MOT
0,3,18,418,1.665345544,421,3,at,"('MOT', 'CHI')",Providence,lil67.xml,439,18,0,CHI,4624,2499,MOT
5,8,45,381,1.611998733,389,8,to,"('MOT', 'CHI')",Providence,lil67.xml,439,50,5,CHI,4624,2499,MOT
3,17,14,405,1.601217079,422,17,can,"('MOT', 'CHI')",Providence,lil67.xml,439,17,3,CHI,4624,2499,MOT
4,14,24,397,1.523637923,411,14,it,"('MOT', 'CHI')",Providence,lil67.xml,439,28,4,CHI,4624,2499,MOT
1,0,1,7,1.504077397,7,0,at,"('CHI', 'OPE')",Providence,lil67.xml,9,2,1,OPE,51,43,CHI
1,0,1,7,1.504077397,7,0,the,"('CHI', 'OPE')",Providence,lil67.xml,9,2,1,OPE,51,43,CHI
4,22,15,398,1.474426573,420,22,one,"('MOT', 'CHI')",Providence,lil67.xml,439,19,4,CHI,4624,2499,MOT
1,4,36,398,1.4215625,402,4,do,"('MOT', 'CHI')",Providence,lil67.xml,439,37,1,CHI,4624,2499,MOT
4,13,36,386,1.226672392,399,13,yeah,"('MOT', 'CHI')",Providence,lil67.xml,439,40,4,CHI,4624,2499,MOT
1,14,14,410,1.206322982,424,14,no,"('MOT', 'CHI')",Providence,lil67.xml,439,15,1,CHI,4624,2499,MOT
6,23,32,378,1.077913427,401,23,that,"('MOT', 'CHI')",Providence,lil67.xml,439,38,6,CHI,4624,2499,MOT
0,6,21,412,0.958850346,418,6,with,"('MOT', 'CHI')",Providence,lil67.xml,439,21,0,CHI,4624,2499,MOT
1,11,24,403,0.943088925,414,11,we,"('MOT', 'CHI')",Providence,lil67.xml,439,25,1,CHI,4624,2499,MOT
5,24,32,378,0.910736876,402,24,is,"('MOT', 'CHI')",Providence,lil67.xml,439,37,5,CHI,4624,2499,MOT
2,1,1,5,0.875468737,6,1,a,"('CHI', 'OPE')",Providence,lil67.xml,9,3,2,OPE,51,43,CHI
2,12,35,390,0.871516163,402,12,in,"('MOT', 'CHI')",Providence,lil67.xml,439,37,2,CHI,4624,2499,MOT
0,5,29,405,0.795276676,410,5,on,"('MOT', 'CHI')",Providence,lil67.xml,439,29,0,CHI,4624,2499,MOT
13,33,58,335,0.735740369,368,33,a,"('MOT', 'CHI')",Providence,lil67.xml,439,71,13,CHI,4624,2499,MOT
0,1,1,9,0.693147181,10,1,this,"('CHI', 'MOT')",Providence,lil67.xml,11,1,0,MOT,44,165,CHI
1,26,13,399,0.681505606,425,26,this,"('MOT', 'CHI')",Providence,lil67.xml,439,14,1,CHI,4624,2499,MOT
4,23,37,375,0.661648514,398,23,what,"('MOT', 'CHI')",Providence,lil67.xml,439,41,4,CHI,4624,2499,MOT
1,9,42,387,0.570351603,396,9,oh,"('MOT', 'CHI')",Providence,lil67.xml,439,43,1,CHI,4624,2499,MOT
0,1,1,7,0.510825624,8,1,you,"('CHI', 'OPE')",Providence,lil67.xml,9,1,0,OPE,51,43,CHI
0,5,39,395,0.491120553,400,5,of,"('MOT', 'CHI')",Providence,lil67.xml,439,39,0,CHI,4624,2499,MOT
0,1,2,8,0.318453731,9,1,no,"('CHI', 'MOT')",Providence,lil67.xml,11,2,0,MOT,44,165,CHI
5,43,42,349,0.092100446,392,43,and,"('MOT', 'CHI')",Providence,lil67.xml,439,47,5,CHI,4624,2499,MOT
0,1,1,3,0,4,1,yeah,"('MOT', 'OPE')",Providence,lil67.xml,5,1,0,OPE,82,11,MOT
5,24,89,321,-0.142139767,345,24,you,"('MOT', 'CHI')",Providence,lil67.xml,439,94,5,CHI,4624,2499,MOT
0,1,2,2,-0.470003629,3,1,you,"('MOT', 'OPE')",Providence,lil67.xml,5,2,0,OPE,82,11,MOT
3,38,69,329,-0.670535734,367,38,the,"('MOT', 'CHI')",Providence,lil67.xml,439,72,3,CHI,4624,2499,MOT
1,0,1,79,3.701301974,79,0,no,"('CHI', 'MOT')",Providence,lil68.xml,81,2,1,MOT,483,780,CHI
0,3,1,227,2.961830722,230,3,want,"('MOT', 'CHI')",Providence,lil68.xml,231,1,0,CHI,2963,1128,MOT
0,1,4,226,2.948815354,227,1,all,"('MOT', 'CHI')",Providence,lil68.xml,231,4,0,CHI,2963,1128,MOT
2,3,5,221,2.935628349,224,3,they,"('MOT', 'CHI')",Providence,lil68.xml,231,7,2,CHI,2963,1128,MOT
1,2,0,78,2.90264185,80,2,all,"('CHI', 'MOT')",Providence,lil68.xml,81,1,1,MOT,483,780,CHI
0,1,5,225,2.790288299,226,1,at,"('MOT', 'CHI')",Providence,lil68.xml,231,5,0,CHI,2963,1128,MOT
2,3,0,76,2.720472721,79,3,see,"('CHI', 'MOT')",Providence,lil68.xml,81,2,2,MOT,483,780,CHI
0,1,6,224,2.652361295,225,1,gonna,"('MOT', 'CHI')",Providence,lil68.xml,231,6,0,CHI,2963,1128,MOT
0,1,6,224,2.652361295,225,1,wanna,"('MOT', 'CHI')",Providence,lil68.xml,231,6,0,CHI,2963,1128,MOT
0,1,1,79,2.614959778,80,1,was,"('CHI', 'MOT')",Providence,lil68.xml,81,1,0,MOT,483,780,CHI
1,3,0,77,2.614959778,80,3,big,"('CHI', 'MOT')",Providence,lil68.xml,81,1,1,MOT,483,780,CHI
1,2,1,77,2.602689685,79,2,like,"('CHI', 'MOT')",Providence,lil68.xml,81,2,1,MOT,483,780,CHI
2,4,6,219,2.602689685,223,4,no,"('MOT', 'CHI')",Providence,lil68.xml,231,8,2,CHI,2963,1128,MOT
1,4,0,76,2.391816227,80,4,think,"('CHI', 'MOT')",Providence,lil68.xml,81,1,1,MOT,483,780,CHI
1,5,4,221,2.384823191,226,5,not,"('MOT', 'CHI')",Providence,lil68.xml,231,5,1,CHI,2963,1128,MOT
1,2,11,217,2.353640264,219,2,and,"('MOT', 'CHI')",Providence,lil68.xml,231,12,1,CHI,2963,1128,MOT
0,1,9,221,2.320603598,222,1,did,"('MOT', 'CHI')",Providence,lil68.xml,231,9,0,CHI,2963,1128,MOT
1,3,1,76,2.315007613,79,3,can,"('CHI', 'MOT')",Providence,lil68.xml,81,2,1,MOT,483,780,CHI
0,1,10,220,2.229117941,221,1,with,"('MOT', 'CHI')",Providence,lil68.xml,231,10,0,CHI,2963,1128,MOT
0,1,10,220,2.229117941,221,1,my,"('MOT', 'CHI')",Providence,lil68.xml,231,10,0,CHI,2963,1128,MOT
3,6,0,72,2.212972934,78,6,gonna,"('CHI', 'MOT')",Providence,lil68.xml,81,3,3,MOT,483,780,CHI
0,2,1,78,2.20949467,80,2,but,"('CHI', 'MOT')",Providence,lil68.xml,81,1,0,MOT,483,780,CHI
0,2,1,78,2.20949467,80,2,at,"('CHI', 'MOT')",Providence,lil68.xml,81,1,0,MOT,483,780,CHI
1,2,3,75,2.172223275,77,2,where,"('CHI', 'MOT')",Providence,lil68.xml,81,4,1,MOT,483,780,CHI
0,1,11,219,2.144580844,220,1,do,"('MOT', 'CHI')",Providence,lil68.xml,231,11,0,CHI,2963,1128,MOT
1,4,1,75,2.091864062,79,4,there,"('CHI', 'MOT')",Providence,lil68.xml,81,2,1,MOT,483,780,CHI
2,4,2,73,2.066862759,77,4,yeah,"('CHI', 'MOT')",Providence,lil68.xml,81,4,2,MOT,483,780,CHI
3,3,5,70,2.014903021,73,3,a,"('CHI', 'MOT')",Providence,lil68.xml,81,8,3,MOT,483,780,CHI
0,2,8,221,2.014903021,223,2,have,"('MOT', 'CHI')",Providence,lil68.xml,231,8,0,CHI,2963,1128,MOT
1,7,5,218,1.959214115,225,7,some,"('MOT', 'CHI')",Providence,lil68.xml,231,6,1,CHI,2963,1128,MOT
2,5,14,210,1.796378415,215,5,look,"('MOT', 'CHI')",Providence,lil68.xml,231,16,2,CHI,2963,1128,MOT
2,7,10,212,1.778276119,219,7,are,"('MOT', 'CHI')",Providence,lil68.xml,231,12,2,CHI,2963,1128,MOT
0,2,11,218,1.739115736,220,2,up,"('MOT', 'CHI')",Providence,lil68.xml,231,11,0,CHI,2963,1128,MOT
2,6,2,71,1.730390523,77,6,on,"('CHI', 'MOT')",Providence,lil68.xml,81,4,2,MOT,483,780,CHI
3,7,2,69,1.717651497,76,7,is,"('CHI', 'MOT')",Providence,lil68.xml,81,5,3,MOT,483,780,CHI
0,1,5,75,1.717651497,76,1,some,"('CHI', 'MOT')",Providence,lil68.xml,81,5,0,MOT,483,780,CHI
3,6,3,69,1.704748092,75,6,it,"('CHI', 'MOT')",Providence,lil68.xml,81,6,3,MOT,483,780,CHI
0,2,3,76,1.673976434,78,2,this,"('CHI', 'MOT')",Providence,lil68.xml,81,3,0,MOT,483,780,CHI
0,2,12,217,1.660493083,219,2,on,"('MOT', 'CHI')",Providence,lil68.xml,231,12,0,CHI,2963,1128,MOT
0,2,4,75,1.479076095,77,2,look,"('CHI', 'MOT')",Providence,lil68.xml,81,4,0,MOT,483,780,CHI
1,5,3,72,1.479076095,77,5,are,"('CHI', 'MOT')",Providence,lil68.xml,81,4,1,MOT,483,780,CHI
1,3,22,205,1.435084525,208,3,what,"('MOT', 'CHI')",Providence,lil68.xml,231,23,1,CHI,2963,1128,MOT
0,1,23,207,1.435084525,208,1,think,"('MOT', 'CHI')",Providence,lil68.xml,231,23,0,CHI,2963,1128,MOT
2,6,18,205,1.422951852,211,6,of,"('MOT', 'CHI')",Providence,lil68.xml,231,20,2,CHI,2963,1128,MOT
1,0,0,4,1.386294361,4,0,are,"('OPE', 'CHI')",Providence,lil68.xml,5,1,1,CHI,25,29,OPE
0,3,12,216,1.372811011,219,3,for,"('MOT', 'CHI')",Providence,lil68.xml,231,12,0,CHI,2963,1128,MOT
5,8,27,191,1.371479275,199,8,it,"('MOT', 'CHI')",Providence,lil68.xml,231,32,5,CHI,2963,1128,MOT
0,2,17,212,1.33222714,214,2,there,"('MOT', 'CHI')",Providence,lil68.xml,231,17,0,CHI,2963,1128,MOT
2,8,3,68,1.312186389,76,8,to,"('CHI', 'MOT')",Providence,lil68.xml,81,5,2,MOT,483,780,CHI
1,4,21,205,1.257513571,209,4,put,"('MOT', 'CHI')",Providence,lil68.xml,231,22,1,CHI,2963,1128,MOT
0,7,1,73,1.228665417,80,7,of,"('CHI', 'MOT')",Providence,lil68.xml,81,1,0,MOT,483,780,CHI
0,5,2,74,1.216395324,79,5,we,"('CHI', 'MOT')",Providence,lil68.xml,81,2,0,MOT,483,780,CHI
0,6,2,73,1.062244644,79,6,my,"('CHI', 'MOT')",Providence,lil68.xml,81,2,0,MOT,483,780,CHI
4,9,7,61,1.018569581,70,9,and,"('CHI', 'MOT')",Providence,lil68.xml,81,11,4,MOT,483,780,CHI
1,9,3,68,0.968250471,77,9,what,"('CHI', 'MOT')",Providence,lil68.xml,81,4,1,MOT,483,780,CHI
0,3,19,209,0.935159216,212,3,go,"('MOT', 'CHI')",Providence,lil68.xml,231,19,0,CHI,2963,1128,MOT
2,6,31,192,0.895671445,198,6,a,"('MOT', 'CHI')",Providence,lil68.xml,231,33,2,CHI,2963,1128,MOT
6,19,3,53,0.856347696,72,19,the,"('CHI', 'MOT')",Providence,lil68.xml,81,9,6,MOT,483,780,CHI
1,6,23,201,0.831474745,207,6,in,"('MOT', 'CHI')",Providence,lil68.xml,231,24,1,CHI,2963,1128,MOT
0,6,3,72,0.826678573,78,6,go,"('CHI', 'MOT')",Providence,lil68.xml,81,3,0,MOT,483,780,CHI
0,6,12,213,0.813195223,219,6,where,"('MOT', 'CHI')",Providence,lil68.xml,231,12,0,CHI,2963,1128,MOT
2,13,20,196,0.633359262,209,13,yeah,"('MOT', 'CHI')",Providence,lil68.xml,231,22,2,CHI,2963,1128,MOT
2,6,40,183,0.620785934,189,6,that,"('MOT', 'CHI')",Providence,lil68.xml,231,42,2,CHI,2963,1128,MOT
1,13,14,203,0.60537157,216,13,can,"('MOT', 'CHI')",Providence,lil68.xml,231,15,1,CHI,2963,1128,MOT
0,14,1,66,0.600056757,80,14,in,"('CHI', 'MOT')",Providence,lil68.xml,81,1,0,MOT,483,780,CHI
2,13,22,194,0.543792673,207,13,is,"('MOT', 'CHI')",Providence,lil68.xml,231,24,2,CHI,2963,1128,MOT
0,3,30,198,0.461175715,201,3,we,"('MOT', 'CHI')",Providence,lil68.xml,231,30,0,CHI,2963,1128,MOT
4,11,46,170,0.382773697,181,11,you,"('MOT', 'CHI')",Providence,lil68.xml,231,50,4,CHI,2963,1128,MOT
9,26,39,157,0.315081047,183,26,the,"('MOT', 'CHI')",Providence,lil68.xml,231,48,9,CHI,2963,1128,MOT
2,21,19,189,0.228661894,210,21,one,"('MOT', 'CHI')",Providence,lil68.xml,231,21,2,CHI,2963,1128,MOT
1,7,38,185,0.167991731,192,7,oh,"('MOT', 'CHI')",Providence,lil68.xml,231,39,1,CHI,2963,1128,MOT
1,19,18,193,0.018868484,212,19,this,"('MOT', 'CHI')",Providence,lil68.xml,231,19,1,CHI,2963,1128,MOT
0,1,1,3,0,4,1,oh,"('OPE', 'CHI')",Providence,lil68.xml,5,1,0,CHI,25,29,OPE
0,14,4,63,-0.130361818,77,14,oh,"('CHI', 'MOT')",Providence,lil68.xml,81,4,0,MOT,483,780,CHI
0,2,1,2,-0.405465108,4,2,you,"('OPE', 'CHI')",Providence,lil68.xml,5,1,0,CHI,25,29,OPE
0,20,7,54,-0.911013675,74,20,you,"('CHI', 'MOT')",Providence,lil68.xml,81,7,0,MOT,483,780,CHI
0,1,2,370,3.842136878,371,1,did,"('MOT', 'CHI')",Providence,lil69.xml,373,2,0,CHI,4324,1901,MOT
1,2,3,367,3.718977485,369,2,big,"('MOT', 'CHI')",Providence,lil69.xml,373,4,1,CHI,4324,1901,MOT
0,1,5,367,3.274445676,368,1,where,"('MOT', 'CHI')",Providence,lil69.xml,373,5,0,CHI,4324,1901,MOT
0,1,6,366,3.138207922,367,1,some,"('MOT', 'CHI')",Providence,lil69.xml,373,6,0,CHI,4324,1901,MOT
1,4,4,364,3.051302125,368,4,was,"('MOT', 'CHI')",Providence,lil69.xml,373,5,1,CHI,4324,1901,MOT
0,2,4,367,3.025830305,369,2,wanna,"('MOT', 'CHI')",Providence,lil69.xml,373,4,0,CHI,4324,1901,MOT
1,2,10,360,2.926739402,362,2,little,"('MOT', 'CHI')",Providence,lil69.xml,373,11,1,CHI,4324,1901,MOT
0,1,9,363,2.81159088,364,1,get,"('MOT', 'CHI')",Providence,lil69.xml,373,9,0,CHI,4324,1901,MOT
1,2,13,357,2.710824128,359,2,for,"('MOT', 'CHI')",Providence,lil69.xml,373,14,1,CHI,4324,1901,MOT
0,1,13,359,2.49044683,360,1,all,"('MOT', 'CHI')",Providence,lil69.xml,373,13,0,CHI,4324,1901,MOT
2,4,15,352,2.425268383,356,4,make,"('MOT', 'CHI')",Providence,lil69.xml,373,17,2,CHI,4324,1901,MOT
0,1,14,358,2.423142056,359,1,think,"('MOT', 'CHI')",Providence,lil69.xml,373,14,0,CHI,4324,1901,MOT
2,5,12,354,2.423142056,359,5,like,"('MOT', 'CHI')",Providence,lil69.xml,373,14,2,CHI,4324,1901,MOT
1,5,8,359,2.406125772,364,5,he,"('MOT', 'CHI')",Providence,lil69.xml,373,9,1,CHI,4324,1901,MOT
2,3,20,348,2.400732154,351,3,but,"('MOT', 'CHI')",Providence,lil69.xml,373,22,2,CHI,4324,1901,MOT
1,2,19,351,2.375610228,353,2,with,"('MOT', 'CHI')",Providence,lil69.xml,373,20,1,CHI,4324,1901,MOT
0,2,11,360,2.233592222,362,2,there,"('MOT', 'CHI')",Providence,lil69.xml,373,11,0,CHI,4324,1901,MOT
0,1,18,354,2.188856328,355,1,on,"('MOT', 'CHI')",Providence,lil69.xml,373,18,0,CHI,4324,1901,MOT
1,6,9,357,2.162227735,363,6,one,"('MOT', 'CHI')",Providence,lil69.xml,373,10,1,CHI,4324,1901,MOT
1,5,11,356,2.156733216,361,5,yeah,"('MOT', 'CHI')",Providence,lil69.xml,373,12,1,CHI,4324,1901,MOT
1,3,18,351,2.137261113,354,3,my,"('MOT', 'CHI')",Providence,lil69.xml,373,19,1,CHI,4324,1901,MOT
0,2,14,357,2.017676947,359,2,see,"('MOT', 'CHI')",Providence,lil69.xml,373,14,0,CHI,4324,1901,MOT
0,2,14,357,2.017676947,359,2,up,"('MOT', 'CHI')",Providence,lil69.xml,373,14,0,CHI,4324,1901,MOT
1,7,10,355,1.945910149,362,7,this,"('MOT', 'CHI')",Providence,lil69.xml,373,11,1,CHI,4324,1901,MOT
0,3,12,358,1.869051144,361,3,have,"('MOT', 'CHI')",Providence,lil69.xml,373,12,0,CHI,4324,1901,MOT
4,9,22,338,1.829720231,347,9,what,"('MOT', 'CHI')",Providence,lil69.xml,373,26,4,CHI,4324,1901,MOT
3,7,25,338,1.754980218,345,7,are,"('MOT', 'CHI')",Providence,lil69.xml,373,28,3,CHI,4324,1901,MOT
0,7,6,360,1.751913561,367,7,go,"('MOT', 'CHI')",Providence,lil69.xml,373,6,0,CHI,4324,1901,MOT
8,12,31,322,1.735814313,334,12,that,"('MOT', 'CHI')",Providence,lil69.xml,373,39,8,CHI,4324,1901,MOT
0,5,9,359,1.712978591,364,5,gonna,"('MOT', 'CHI')",Providence,lil69.xml,373,9,0,CHI,4324,1901,MOT
0,4,12,357,1.645907592,361,4,we,"('MOT', 'CHI')",Providence,lil69.xml,373,12,0,CHI,4324,1901,MOT
0,4,12,357,1.645907592,361,4,not,"('MOT', 'CHI')",Providence,lil69.xml,373,12,0,CHI,4324,1901,MOT
0,7,7,359,1.631416819,366,7,put,"('MOT', 'CHI')",Providence,lil69.xml,373,7,0,CHI,4324,1901,MOT
1,0,1,8,1.609437912,8,0,oh,"('MOT', 'OPE')",Providence,lil69.xml,10,2,1,OPE,57,36,MOT
0,2,22,349,1.589801938,351,2,do,"('MOT', 'CHI')",Providence,lil69.xml,373,22,0,CHI,4324,1901,MOT
1,0,0,5,1.540445041,5,0,you,"('OPE', 'CHI')",Providence,lil69.xml,6,1,1,CHI,22,33,OPE
1,0,0,5,1.540445041,5,0,no,"('OPE', 'CHI')",Providence,lil69.xml,6,1,1,CHI,22,33,OPE
0,2,24,347,1.504077397,349,2,of,"('MOT', 'CHI')",Providence,lil69.xml,373,24,0,CHI,4324,1901,MOT
1,1,0,10,1.466337069,11,1,not,"('CHI', 'MOT')",Providence,lil69.xml,12,1,1,MOT,79,123,CHI
0,7,9,357,1.425296519,364,7,want,"('MOT', 'CHI')",Providence,lil69.xml,373,9,0,CHI,4324,1901,MOT
6,10,44,313,1.38059634,323,10,oh,"('MOT', 'CHI')",Providence,lil69.xml,373,50,6,CHI,4324,1901,MOT
0,8,9,356,1.307513483,364,8,look,"('MOT', 'CHI')",Providence,lil69.xml,373,9,0,CHI,4324,1901,MOT
6,19,25,323,1.294311971,342,19,she,"('MOT', 'CHI')",Providence,lil69.xml,373,31,6,CHI,4324,1901,MOT
0,5,15,353,1.261131218,358,5,at,"('MOT', 'CHI')",Providence,lil69.xml,373,15,0,CHI,4324,1901,MOT
4,17,22,330,1.241933567,347,17,no,"('MOT', 'CHI')",Providence,lil69.xml,373,26,4,CHI,4324,1901,MOT
0,6,15,352,1.106980538,358,6,they,"('MOT', 'CHI')",Providence,lil69.xml,373,15,0,CHI,4324,1901,MOT
0,1,1,10,0.773189888,11,1,in,"('CHI', 'MOT')",Providence,lil69.xml,12,1,0,MOT,79,123,CHI
0,1,1,10,0.773189888,11,1,is,"('CHI', 'MOT')",Providence,lil69.xml,12,1,0,MOT,79,123,CHI
0,1,1,10,0.773189888,11,1,to,"('CHI', 'MOT')",Providence,lil69.xml,12,1,0,MOT,79,123,CHI
1,11,24,337,0.770336819,348,11,it,"('MOT', 'CHI')",Providence,lil69.xml,373,25,1,CHI,4324,1901,MOT
7,23,44,299,0.711839314,322,23,a,"('MOT', 'CHI')",Providence,lil69.xml,373,51,7,CHI,4324,1901,MOT
1,0,0,1,0.693147181,1,0,is,"('OPE', 'MOT')",Providence,lil69.xml,2,1,1,MOT,10,32,OPE
3,10,54,306,0.672913027,316,10,to,"('MOT', 'CHI')",Providence,lil69.xml,373,57,3,CHI,4324,1901,MOT
0,11,16,346,0.508043981,357,11,can,"('MOT', 'CHI')",Providence,lil69.xml,373,16,0,CHI,4324,1901,MOT
5,21,48,299,0.467935376,320,21,you,"('MOT', 'CHI')",Providence,lil69.xml,373,53,5,CHI,4324,1901,MOT
0,7,26,340,0.44342587,347,7,in,"('MOT', 'CHI')",Providence,lil69.xml,373,26,0,CHI,4324,1901,MOT
0,1,2,9,0.405465108,10,1,a,"('CHI', 'MOT')",Providence,lil69.xml,12,2,0,MOT,79,123,CHI
0,1,2,9,0.405465108,10,1,no,"('CHI', 'MOT')",Providence,lil69.xml,12,2,0,MOT,79,123,CHI
5,24,51,293,0.277631737,317,24,is,"('MOT', 'CHI')",Providence,lil69.xml,373,56,5,CHI,4324,1901,MOT
0,1,2,7,0.223143551,8,1,to,"('MOT', 'OPE')",Providence,lil69.xml,10,2,0,OPE,57,36,MOT
0,2,1,7,0.200670695,9,2,you,"('MOT', 'OPE')",Providence,lil69.xml,10,1,0,OPE,57,36,MOT
8,34,56,275,0.192014686,309,34,and,"('MOT', 'CHI')",Providence,lil69.xml,373,64,8,CHI,4324,1901,MOT
0,1,1,4,0.15415068,5,1,oh,"('OPE', 'CHI')",Providence,lil69.xml,6,1,0,CHI,22,33,OPE
5,27,66,275,-0.113876781,302,27,the,"('MOT', 'CHI')",Providence,lil69.xml,373,71,5,CHI,4324,1901,MOT
0,2,1,3,-0.251314428,5,2,a,"('OPE', 'CHI')",Providence,lil69.xml,6,1,0,CHI,22,33,OPE
9,8,9,429,3.194127655,437,8,no,"('CHI', 'MOT')",Providence,lil70.xml,455,18,9,MOT,2668,5274,CHI
0,4,2,449,3.124565145,453,4,wanna,"('CHI', 'MOT')",Providence,lil70.xml,455,2,0,MOT,2668,5274,CHI
0,3,3,449,3.122364924,452,3,make,"('CHI', 'MOT')",Providence,lil70.xml,455,3,0,MOT,2668,5274,CHI
2,7,6,440,2.823608542,447,7,big,"('CHI', 'MOT')",Providence,lil70.xml,455,8,2,MOT,2668,5274,CHI
3,12,4,436,2.733368009,448,12,they,"('CHI', 'MOT')",Providence,lil70.xml,455,7,3,MOT,2668,5274,CHI
0,9,1,445,2.721295428,454,9,she,"('CHI', 'MOT')",Providence,lil70.xml,455,1,0,MOT,2668,5274,CHI
0,9,1,445,2.721295428,454,9,put,"('CHI', 'MOT')",Providence,lil70.xml,455,1,0,MOT,2668,5274,CHI
1,14,1,439,2.719100037,453,14,with,"('CHI', 'MOT')",Providence,lil70.xml,455,2,1,MOT,2668,5274,CHI
4,9,11,431,2.564949357,440,9,gonna,"('CHI', 'MOT')",Providence,lil70.xml,455,15,4,MOT,2668,5274,CHI
4,9,11,431,2.564949357,440,9,he,"('CHI', 'MOT')",Providence,lil70.xml,455,15,4,MOT,2668,5274,CHI
0,5,4,446,2.532373187,451,5,want,"('CHI', 'MOT')",Providence,lil70.xml,455,4,0,MOT,2668,5274,CHI
4,15,7,429,2.372218785,444,15,this,"('CHI', 'MOT')",Providence,lil70.xml,455,11,4,MOT,2668,5274,CHI
4,18,6,427,2.282650878,445,18,was,"('CHI', 'MOT')",Providence,lil70.xml,455,10,4,MOT,2668,5274,CHI
3,16,6,430,2.259978977,446,16,there,"('CHI', 'MOT')",Providence,lil70.xml,455,9,3,MOT,2668,5274,CHI
3,23,3,426,2.240266329,449,23,have,"('CHI', 'MOT')",Providence,lil70.xml,455,6,3,MOT,2668,5274,CHI
3,23,3,426,2.240266329,449,23,for,"('CHI', 'MOT')",Providence,lil70.xml,455,6,3,MOT,2668,5274,CHI
1,11,5,438,2.240266329,449,11,up,"('CHI', 'MOT')",Providence,lil70.xml,455,6,1,MOT,2668,5274,CHI
5,23,7,420,2.072722591,443,23,in,"('CHI', 'MOT')",Providence,lil70.xml,455,12,5,MOT,2668,5274,CHI
1,23,2,429,2.023752636,452,23,think,"('CHI', 'MOT')",Providence,lil70.xml,455,3,1,MOT,2668,5274,CHI
2,10,12,431,2.021698064,441,10,one,"('CHI', 'MOT')",Providence,lil70.xml,455,14,2,MOT,2668,5274,CHI
1,10,8,436,2.002149867,446,10,not,"('CHI', 'MOT')",Providence,lil70.xml,455,9,1,MOT,2668,5274,CHI
2,16,7,430,1.972296904,446,16,did,"('CHI', 'MOT')",Providence,lil70.xml,455,9,2,MOT,2668,5274,CHI
0,6,7,442,1.966112856,448,6,where,"('CHI', 'MOT')",Providence,lil70.xml,455,7,0,MOT,2668,5274,CHI
0,21,1,433,1.932838067,454,21,little,"('CHI', 'MOT')",Providence,lil70.xml,455,1,0,MOT,2668,5274,CHI
2,20,6,427,1.858527646,447,20,at,"('CHI', 'MOT')",Providence,lil70.xml,455,8,2,MOT,2668,5274,CHI
2,14,10,429,1.84957904,443,14,look,"('CHI', 'MOT')",Providence,lil70.xml,455,12,2,MOT,2668,5274,CHI
0,18,2,435,1.789564079,453,18,all,"('CHI', 'MOT')",Providence,lil70.xml,455,2,0,MOT,2668,5274,CHI
2,18,8,427,1.771825254,445,18,like,"('CHI', 'MOT')",Providence,lil70.xml,455,10,2,MOT,2668,5274,CHI
0,12,4,439,1.759183299,451,12,can,"('CHI', 'MOT')",Providence,lil70.xml,455,4,0,MOT,2668,5274,CHI
3,21,9,422,1.75426886,443,21,are,"('CHI', 'MOT')",Providence,lil70.xml,455,12,3,MOT,2668,5274,CHI
4,34,6,411,1.671741796,445,34,do,"('CHI', 'MOT')",Providence,lil70.xml,455,10,4,MOT,2668,5274,CHI
0,17,3,435,1.618287528,452,17,see,"('CHI', 'MOT')",Providence,lil70.xml,455,3,0,MOT,2668,5274,CHI
3,19,13,420,1.589235205,439,19,some,"('CHI', 'MOT')",Providence,lil70.xml,455,16,3,MOT,2668,5274,CHI
2,37,5,411,1.373049134,448,37,yeah,"('CHI', 'MOT')",Providence,lil70.xml,455,7,2,MOT,2668,5274,CHI
1,20,8,426,1.355522702,446,20,go,"('CHI', 'MOT')",Providence,lil70.xml,455,9,1,MOT,2668,5274,CHI
3,21,16,415,1.33294838,436,21,on,"('CHI', 'MOT')",Providence,lil70.xml,455,19,3,MOT,2668,5274,CHI
10,38,21,386,1.292265411,424,38,it,"('CHI', 'MOT')",Providence,lil70.xml,455,31,10,MOT,2668,5274,CHI
11,48,20,376,1.151018136,424,48,that,"('CHI', 'MOT')",Providence,lil70.xml,455,31,11,MOT,2668,5274,CHI
0,10,11,434,1.137474322,444,10,get,"('CHI', 'MOT')",Providence,lil70.xml,455,11,0,MOT,2668,5274,CHI
4,25,23,403,1.047830753,428,25,is,"('CHI', 'MOT')",Providence,lil70.xml,455,27,4,MOT,2668,5274,CHI
10,47,23,375,1.021079656,422,47,a,"('CHI', 'MOT')",Providence,lil70.xml,455,33,10,MOT,2668,5274,CHI
1,20,13,421,0.969605791,441,20,my,"('CHI', 'MOT')",Providence,lil70.xml,455,14,1,MOT,2668,5274,CHI
15,64,23,353,0.947192918,417,64,oh,"('CHI', 'MOT')",Providence,lil70.xml,455,38,15,MOT,2668,5274,CHI
0,14,11,430,0.827319393,444,14,but,"('CHI', 'MOT')",Providence,lil70.xml,455,11,0,MOT,2668,5274,CHI
0,22,7,426,0.776528789,448,22,of,"('CHI', 'MOT')",Providence,lil70.xml,455,7,0,MOT,2668,5274,CHI
2,45,11,397,0.657745254,442,45,we,"('CHI', 'MOT')",Providence,lil70.xml,455,13,2,MOT,2668,5274,CHI
2,44,12,397,0.612930847,441,44,to,"('CHI', 'MOT')",Providence,lil70.xml,455,14,2,MOT,2668,5274,CHI
9,67,23,356,0.608806032,423,67,the,"('CHI', 'MOT')",Providence,lil70.xml,455,32,9,MOT,2668,5274,CHI
2,33,21,399,0.426420473,432,33,what,"('CHI', 'MOT')",Providence,lil70.xml,455,23,2,MOT,2668,5274,CHI
11,50,57,337,0.268165119,387,50,and,"('CHI', 'MOT')",Providence,lil70.xml,455,68,11,MOT,2668,5274,CHI
2,1,0,0,0.117783036,1,1,you,"('OPE', 'MOT')",Providence,lil70.xml,3,2,2,MOT,16,35,OPE
4,93,21,337,-0.161268148,430,93,you,"('CHI', 'MOT')",Providence,lil70.xml,455,25,4,MOT,2668,5274,CHI
0,1,1,1,-0.405465108,2,1,it,"('CHI', 'OPE')",Providence,lil70.xml,3,1,0,OPE,34,11,CHI
0,1,1,0,-0.693147181,1,1,yeah,"('MOT', 'OPE')",Providence,lil70.xml,2,1,0,OPE,11,6,MOT
1,1,2,219,3.793239469,220,1,he,"('MOT', 'CHI')",Providence,lil71.xml,223,3,1,CHI,1859,1316,MOT
0,1,1,221,3.619886583,222,1,look,"('MOT', 'CHI')",Providence,lil71.xml,223,1,0,CHI,1859,1316,MOT
0,2,1,312,3.558517636,314,2,some,"('CHI', 'MOT')",Providence,lil71.xml,315,1,0,MOT,1706,2860,CHI
1,1,6,307,3.53934772,308,1,all,"('CHI', 'MOT')",Providence,lil71.xml,315,7,1,MOT,1706,2860,CHI
2,1,6,214,3.482777369,215,1,where,"('MOT', 'CHI')",Providence,lil71.xml,223,8,2,CHI,1859,1316,MOT
0,1,2,220,3.32773023,221,1,want,"('MOT', 'CHI')",Providence,lil71.xml,223,2,0,CHI,1859,1316,MOT
2,3,3,215,3.160035325,218,3,there,"('MOT', 'CHI')",Providence,lil71.xml,223,5,2,CHI,1859,1316,MOT
1,6,1,307,3.113515309,313,6,there,"('CHI', 'MOT')",Providence,lil71.xml,315,2,1,MOT,1706,2860,CHI
0,1,5,309,3.103945858,310,1,not,"('CHI', 'MOT')",Providence,lil71.xml,315,5,0,MOT,1706,2860,CHI
1,5,2,307,3.041342785,312,5,see,"('CHI', 'MOT')",Providence,lil71.xml,315,3,1,MOT,1706,2860,CHI
5,3,9,206,2.984734519,209,3,like,"('MOT', 'CHI')",Providence,lil71.xml,223,14,5,CHI,1859,1316,MOT
0,3,2,310,2.979983917,313,3,put,"('CHI', 'MOT')",Providence,lil71.xml,315,2,0,MOT,1706,2860,CHI
3,6,4,302,2.979731932,308,6,up,"('CHI', 'MOT')",Providence,lil71.xml,315,7,3,MOT,1706,2860,CHI
1,1,8,213,2.977383135,214,1,put,"('MOT', 'CHI')",Providence,lil71.xml,223,9,1,CHI,1859,1316,MOT
0,2,2,219,2.922265122,221,2,with,"('MOT', 'CHI')",Providence,lil71.xml,223,2,0,CHI,1859,1316,MOT
0,2,2,219,2.922265122,221,2,make,"('MOT', 'CHI')",Providence,lil71.xml,223,2,0,CHI,1859,1316,MOT
2,3,9,301,2.870953672,304,3,can,"('CHI', 'MOT')",Providence,lil71.xml,315,11,2,MOT,1706,2860,CHI
1,5,3,306,2.855831433,311,5,gonna,"('CHI', 'MOT')",Providence,lil71.xml,315,4,1,MOT,1706,2860,CHI
2,8,2,303,2.855831433,311,8,have,"('CHI', 'MOT')",Providence,lil71.xml,315,4,2,MOT,1706,2860,CHI
2,5,5,303,2.84620054,308,5,they,"('CHI', 'MOT')",Providence,lil71.xml,315,7,2,MOT,1706,2860,CHI
2,4,4,213,2.798804564,217,4,they,"('MOT', 'CHI')",Providence,lil71.xml,223,6,2,CHI,1859,1316,MOT
0,4,2,309,2.756840365,313,4,with,"('CHI', 'MOT')",Providence,lil71.xml,315,2,0,MOT,1706,2860,CHI
1,1,11,210,2.722234836,211,1,did,"('MOT', 'CHI')",Providence,lil71.xml,223,12,1,CHI,1859,1316,MOT
1,6,3,305,2.701680753,311,6,but,"('CHI', 'MOT')",Providence,lil71.xml,315,4,1,MOT,1706,2860,CHI
0,2,3,218,2.694627181,220,2,see,"('MOT', 'CHI')",Providence,lil71.xml,223,3,0,CHI,1859,1316,MOT
0,2,3,218,2.694627181,220,2,she,"('MOT', 'CHI')",Providence,lil71.xml,223,3,0,CHI,1859,1316,MOT
1,10,1,303,2.661530185,313,10,big,"('CHI', 'MOT')",Providence,lil71.xml,315,2,1,MOT,1706,2860,CHI
3,7,6,299,2.63905733,306,7,he,"('CHI', 'MOT')",Providence,lil71.xml,315,9,3,MOT,1706,2860,CHI
0,1,6,216,2.616483008,217,1,of,"('MOT', 'CHI')",Providence,lil71.xml,223,6,0,CHI,1859,1316,MOT
2,9,3,301,2.593120234,310,9,at,"('CHI', 'MOT')",Providence,lil71.xml,315,5,2,MOT,1706,2860,CHI
2,11,2,300,2.56814936,311,11,get,"('CHI', 'MOT')",Providence,lil71.xml,315,4,2,MOT,1706,2860,CHI
2,8,4,301,2.561739082,309,8,where,"('CHI', 'MOT')",Providence,lil71.xml,315,6,2,MOT,1706,2860,CHI
1,4,4,214,2.531426665,218,4,get,"('MOT', 'CHI')",Providence,lil71.xml,223,5,1,CHI,1859,1316,MOT
1,4,4,214,2.531426665,218,4,can,"('MOT', 'CHI')",Providence,lil71.xml,223,5,1,CHI,1859,1316,MOT
0,8,1,306,2.459905348,314,8,go,"('CHI', 'MOT')",Providence,lil71.xml,315,1,0,MOT,1706,2860,CHI
1,8,3,303,2.450366325,311,8,think,"('CHI', 'MOT')",Providence,lil71.xml,315,4,1,MOT,1706,2860,CHI
0,4,2,217,2.411439498,221,4,all,"('MOT', 'CHI')",Providence,lil71.xml,223,2,0,CHI,1859,1316,MOT
0,4,2,217,2.411439498,221,4,big,"('MOT', 'CHI')",Providence,lil71.xml,223,2,0,CHI,1859,1316,MOT
0,1,8,214,2.38416508,215,1,was,"('MOT', 'CHI')",Providence,lil71.xml,223,8,0,CHI,1859,1316,MOT
1,3,7,212,2.38416508,215,3,one,"('MOT', 'CHI')",Providence,lil71.xml,223,8,1,CHI,1859,1316,MOT
5,3,21,194,2.366565423,197,3,what,"('MOT', 'CHI')",Providence,lil71.xml,223,26,5,CHI,1859,1316,MOT
1,2,11,209,2.316769728,211,2,little,"('MOT', 'CHI')",Providence,lil71.xml,223,12,1,CHI,1859,1316,MOT
0,1,9,213,2.284235954,214,1,are,"('MOT', 'CHI')",Providence,lil71.xml,223,9,0,CHI,1859,1316,MOT
0,3,6,306,2.274057009,309,3,this,"('CHI', 'MOT')",Providence,lil71.xml,315,6,0,MOT,1706,2860,CHI
0,5,2,216,2.229117941,221,5,but,"('MOT', 'CHI')",Providence,lil71.xml,223,2,0,CHI,1859,1316,MOT
0,2,6,215,2.211017899,217,2,some,"('MOT', 'CHI')",Providence,lil71.xml,223,6,0,CHI,1859,1316,MOT
2,0,0,10,2.197224577,10,0,was,"('OPE', 'CHI')",Providence,lil71.xml,12,2,2,CHI,55,62,OPE
1,11,3,300,2.162684252,311,11,of,"('CHI', 'MOT')",Providence,lil71.xml,315,4,1,MOT,1706,2860,CHI
2,10,6,297,2.1314732,307,10,one,"('CHI', 'MOT')",Providence,lil71.xml,315,8,2,MOT,1706,2860,CHI
2,7,6,208,2.096483008,215,7,we,"('MOT', 'CHI')",Providence,lil71.xml,223,8,2,CHI,1859,1316,MOT
0,2,7,214,2.088658197,216,2,go,"('MOT', 'CHI')",Providence,lil71.xml,223,7,0,CHI,1859,1316,MOT
1,0,0,10,2.079441542,10,0,a,"('OPE', 'MOT')",Providence,lil71.xml,11,1,1,MOT,47,173,OPE
0,6,2,215,2.074967261,221,6,up,"('MOT', 'CHI')",Providence,lil71.xml,223,2,0,CHI,1859,1316,MOT
6,19,6,284,2.031432322,303,19,we,"('CHI', 'MOT')",Providence,lil71.xml,315,12,6,MOT,1706,2860,CHI
0,6,4,305,2.008533572,311,6,want,"('CHI', 'MOT')",Providence,lil71.xml,315,4,0,MOT,1706,2860,CHI
4,13,9,289,1.979358083,302,13,was,"('CHI', 'MOT')",Providence,lil71.xml,315,13,4,MOT,1706,2860,CHI
5,21,5,284,1.942658114,305,21,in,"('CHI', 'MOT')",Providence,lil71.xml,315,10,5,MOT,1706,2860,CHI
1,12,4,298,1.925290862,310,12,little,"('CHI', 'MOT')",Providence,lil71.xml,315,5,1,MOT,1706,2860,CHI
0,11,2,302,1.881371628,313,11,did,"('CHI', 'MOT')",Providence,lil71.xml,315,2,0,MOT,1706,2860,CHI
0,11,2,302,1.881371628,313,11,are,"('CHI', 'MOT')",Providence,lil71.xml,315,2,0,MOT,1706,2860,CHI
2,8,7,206,1.878770846,214,8,on,"('MOT', 'CHI')",Providence,lil71.xml,223,9,2,CHI,1859,1316,MOT
2,5,13,203,1.820747006,208,5,it,"('MOT', 'CHI')",Providence,lil71.xml,223,15,2,CHI,1859,1316,MOT
1,14,4,296,1.782190018,310,14,on,"('CHI', 'MOT')",Providence,lil71.xml,315,5,1,MOT,1706,2860,CHI
9,12,27,267,1.738404245,279,12,yeah,"('CHI', 'MOT')",Providence,lil71.xml,315,36,9,MOT,1706,2860,CHI
1,5,10,207,1.702414369,212,5,that,"('MOT', 'CHI')",Providence,lil71.xml,223,11,1,CHI,1859,1316,MOT
1,3,16,203,1.69995192,206,3,to,"('MOT', 'CHI')",Providence,lil71.xml,223,17,1,CHI,1859,1316,MOT
1,8,6,208,1.683193089,216,8,not,"('MOT', 'CHI')",Providence,lil71.xml,223,7,1,CHI,1859,1316,MOT
2,2,32,187,1.66875449,189,2,oh,"('MOT', 'CHI')",Providence,lil71.xml,223,34,2,CHI,1859,1316,MOT
1,1,1,17,1.609437912,18,1,was,"('MOT', 'OPE')",Providence,lil71.xml,20,2,1,OPE,176,140,MOT
2,20,5,288,1.593437571,308,20,do,"('CHI', 'MOT')",Providence,lil71.xml,315,7,2,MOT,1706,2860,CHI
4,26,6,279,1.555542144,305,26,is,"('CHI', 'MOT')",Providence,lil71.xml,315,10,4,MOT,1706,2860,CHI
1,1,0,9,1.386294361,10,1,on,"('OPE', 'MOT')",Providence,lil71.xml,11,1,1,MOT,47,173,OPE
1,12,9,293,1.370138921,305,12,like,"('CHI', 'MOT')",Providence,lil71.xml,315,10,1,MOT,1706,2860,CHI
10,33,13,259,1.336238691,292,33,a,"('CHI', 'MOT')",Providence,lil71.xml,315,23,10,MOT,1706,2860,CHI
0,1,1,18,1.252762968,19,1,up,"('MOT', 'OPE')",Providence,lil71.xml,20,1,0,OPE,176,140,MOT
0,1,1,18,1.252762968,19,1,think,"('MOT', 'OPE')",Providence,lil71.xml,20,1,0,OPE,176,140,MOT
0,7,10,298,1.162499556,305,7,my,"('CHI', 'MOT')",Providence,lil71.xml,315,10,0,MOT,1706,2860,CHI
3,8,35,269,1.131402111,277,8,no,"('CHI', 'MOT')",Providence,lil71.xml,315,38,3,MOT,1706,2860,CHI
0,8,6,209,1.112405611,217,8,this,"('MOT', 'CHI')",Providence,lil71.xml,223,6,0,CHI,1859,1316,MOT
0,7,7,209,1.107828944,216,7,my,"('MOT', 'CHI')",Providence,lil71.xml,223,7,0,CHI,1859,1316,MOT
6,13,25,179,1.078203417,192,13,a,"('MOT', 'CHI')",Providence,lil71.xml,223,31,6,CHI,1859,1316,MOT
3,27,6,187,1.031472986,214,27,no,"('MOT', 'CHI')",Providence,lil71.xml,223,9,3,CHI,1859,1316,MOT
0,22,3,290,1.004460858,312,22,she,"('CHI', 'MOT')",Providence,lil71.xml,315,3,0,MOT,1706,2860,CHI
6,16,22,179,0.994703152,195,16,the,"('MOT', 'CHI')",Providence,lil71.xml,223,28,6,CHI,1859,1316,MOT
10,37,19,249,0.989282389,286,37,and,"('CHI', 'MOT')",Providence,lil71.xml,315,29,10,MOT,1706,2860,CHI
0,1,2,17,0.916290732,18,1,to,"('MOT', 'OPE')",Providence,lil71.xml,20,2,0,OPE,176,140,MOT
0,1,2,17,0.916290732,18,1,and,"('MOT', 'OPE')",Providence,lil71.xml,20,2,0,OPE,176,140,MOT
5,17,21,180,0.862488026,197,17,and,"('MOT', 'CHI')",Providence,lil71.xml,223,26,5,CHI,1859,1316,MOT
0,2,1,17,0.84729786,19,2,yeah,"('MOT', 'OPE')",Providence,lil71.xml,20,1,0,OPE,176,140,MOT
0,2,1,17,0.84729786,19,2,that,"('MOT', 'OPE')",Providence,lil71.xml,20,1,0,OPE,176,140,MOT
0,1,1,10,0.773189888,11,1,it,"('OPE', 'CHI')",Providence,lil71.xml,12,1,0,CHI,55,62,OPE
0,1,1,10,0.773189888,11,1,they,"('OPE', 'CHI')",Providence,lil71.xml,12,1,0,CHI,55,62,OPE
0,1,1,10,0.773189888,11,1,no,"('OPE', 'CHI')",Providence,lil71.xml,12,1,0,CHI,55,62,OPE
3,27,15,270,0.758801151,297,27,it,"('CHI', 'MOT')",Providence,lil71.xml,315,18,3,MOT,1706,2860,CHI
1,10,15,197,0.747214402,207,10,is,"('MOT', 'CHI')",Providence,lil71.xml,223,16,1,CHI,1859,1316,MOT
14,51,23,227,0.72803444,278,51,the,"('CHI', 'MOT')",Providence,lil71.xml,315,37,14,MOT,1706,2860,CHI
0,5,15,203,0.722134717,208,5,do,"('MOT', 'CHI')",Providence,lil71.xml,223,15,0,CHI,1859,1316,MOT
1,3,0,7,0.693147181,10,3,the,"('OPE', 'MOT')",Providence,lil71.xml,11,1,1,MOT,47,173,OPE
0,1,1,9,0.693147181,10,1,yeah,"('OPE', 'MOT')",Providence,lil71.xml,11,1,0,MOT,47,173,OPE
0,1,1,9,0.693147181,10,1,it,"('OPE', 'MOT')",Providence,lil71.xml,11,1,0,MOT,47,173,OPE
0,1,1,9,0.693147181,10,1,with,"('OPE', 'MOT')",Providence,lil71.xml,11,1,0,MOT,47,173,OPE
0,1,1,9,0.693147181,10,1,up,"('OPE', 'MOT')",Providence,lil71.xml,11,1,0,MOT,47,173,OPE
0,26,4,285,0.658606855,311,26,oh,"('CHI', 'MOT')",Providence,lil71.xml,315,4,0,MOT,1706,2860,CHI
1,12,14,196,0.64209201,208,12,have,"('MOT', 'CHI')",Providence,lil71.xml,223,15,1,CHI,1859,1316,MOT
0,1,3,16,0.641853886,17,1,you,"('MOT', 'OPE')",Providence,lil71.xml,20,3,0,OPE,176,140,MOT
1,3,2,14,0.641853886,17,3,it,"('MOT', 'OPE')",Providence,lil71.xml,20,3,1,OPE,176,140,MOT
1,26,9,279,0.639251412,305,26,that,"('CHI', 'MOT')",Providence,lil71.xml,315,10,1,MOT,1706,2860,CHI
11,63,17,224,0.591252873,287,63,you,"('CHI', 'MOT')",Providence,lil71.xml,315,28,11,MOT,1706,2860,CHI
0,6,15,202,0.567984038,208,6,in,"('MOT', 'CHI')",Providence,lil71.xml,223,15,0,CHI,1859,1316,MOT
1,4,2,13,0.418710335,17,4,they,"('MOT', 'OPE')",Providence,lil71.xml,20,3,1,OPE,176,140,MOT
0,1,4,15,0.405465108,16,1,but,"('MOT', 'OPE')",Providence,lil71.xml,20,4,0,OPE,176,140,MOT
0,1,2,9,0.405465108,10,1,there,"('OPE', 'CHI')",Providence,lil71.xml,12,2,0,CHI,55,62,OPE
0,2,1,8,0.287682072,10,2,was,"('OPE', 'MOT')",Providence,lil71.xml,11,1,0,MOT,47,173,OPE
0,2,1,8,0.287682072,10,2,she,"('OPE', 'MOT')",Providence,lil71.xml,11,1,0,MOT,47,173,OPE
8,18,50,147,0.276434848,165,18,you,"('MOT', 'CHI')",Providence,lil71.xml,223,58,8,CHI,1859,1316,MOT
2,25,15,181,0.233614851,206,25,yeah,"('MOT', 'CHI')",Providence,lil71.xml,223,17,2,CHI,1859,1316,MOT
1,25,16,273,0.194394138,298,25,what,"('CHI', 'MOT')",Providence,lil71.xml,315,17,1,MOT,1706,2860,CHI
0,1,1,4,0.15415068,5,1,the,"('CHI', 'OPE')",Providence,lil71.xml,6,1,0,OPE,25,27,CHI
0,26,9,280,0.036367644,306,26,to,"('CHI', 'MOT')",Providence,lil71.xml,315,9,0,MOT,1706,2860,CHI
0,2,4,14,0,16,2,the,"('MOT', 'OPE')",Providence,lil71.xml,20,4,0,OPE,176,140,MOT
0,3,3,14,-0.051293294,17,3,a,"('MOT', 'OPE')",Providence,lil71.xml,20,3,0,OPE,176,140,MOT
0,2,6,12,-0.405465108,14,2,oh,"('MOT', 'OPE')",Providence,lil71.xml,20,6,0,OPE,176,140,MOT
1,0,2,280,4.725616339,280,0,they,"('MOT', 'CHI')",Providence,lil72.xml,283,3,1,CHI,3394,1516,MOT
2,1,6,274,3.726897521,275,1,up,"('MOT', 'CHI')",Providence,lil72.xml,283,8,2,CHI,3394,1516,MOT
0,2,1,280,3.451749661,282,2,where,"('MOT', 'CHI')",Providence,lil72.xml,283,1,0,CHI,3394,1516,MOT
2,2,5,274,3.430396536,276,2,one,"('MOT', 'CHI')",Providence,lil72.xml,283,7,2,CHI,3394,1516,MOT
1,2,0,133,3.415903529,135,2,look,"('CHI', 'MOT')",Providence,lil72.xml,136,1,1,MOT,744,1429,CHI
1,2,0,133,3.415903529,135,2,some,"('CHI', 'MOT')",Providence,lil72.xml,136,1,1,MOT,744,1429,CHI
1,0,16,266,3.339695182,266,0,look,"('MOT', 'CHI')",Providence,lil72.xml,283,17,1,CHI,3394,1516,MOT
0,1,3,279,3.339321978,280,1,he,"('MOT', 'CHI')",Providence,lil72.xml,283,3,0,CHI,3394,1516,MOT
3,3,7,270,3.131864448,273,3,for,"('MOT', 'CHI')",Providence,lil72.xml,283,10,3,CHI,3394,1516,MOT
0,1,1,134,3.128221457,135,1,can,"('CHI', 'MOT')",Providence,lil72.xml,136,1,0,MOT,744,1429,CHI
1,2,1,132,3.120895417,134,2,was,"('CHI', 'MOT')",Providence,lil72.xml,136,2,1,MOT,744,1429,CHI
1,2,1,132,3.120895417,134,2,she,"('CHI', 'MOT')",Providence,lil72.xml,136,2,1,MOT,744,1429,CHI
1,1,10,271,3.048178749,272,1,gonna,"('MOT', 'CHI')",Providence,lil72.xml,283,11,1,CHI,3394,1516,MOT
1,4,0,131,2.905077905,135,4,wanna,"('CHI', 'MOT')",Providence,lil72.xml,136,1,1,MOT,744,1429,CHI
0,1,2,133,2.833213344,134,1,he,"('CHI', 'MOT')",Providence,lil72.xml,136,2,0,MOT,744,1429,CHI
0,2,1,133,2.722756348,135,2,little,"('CHI', 'MOT')",Providence,lil72.xml,136,1,0,MOT,744,1429,CHI
1,4,1,130,2.610069793,134,4,go,"('CHI', 'MOT')",Providence,lil72.xml,136,2,1,MOT,744,1429,CHI
0,1,3,132,2.602689685,133,1,want,"('CHI', 'MOT')",Providence,lil72.xml,136,3,0,MOT,744,1429,CHI
2,5,1,128,2.602689685,133,5,get,"('CHI', 'MOT')",Providence,lil72.xml,136,3,2,MOT,744,1429,CHI
0,1,3,132,2.602689685,133,1,one,"('CHI', 'MOT')",Providence,lil72.xml,136,3,0,MOT,744,1429,CHI
0,1,9,273,2.529358412,274,1,with,"('MOT', 'CHI')",Providence,lil72.xml,283,9,0,CHI,3394,1516,MOT
0,3,1,132,2.435074276,135,3,all,"('CHI', 'MOT')",Providence,lil72.xml,136,1,0,MOT,744,1429,CHI
0,2,2,132,2.427748236,134,2,this,"('CHI', 'MOT')",Providence,lil72.xml,136,2,0,MOT,744,1429,CHI
0,2,2,132,2.427748236,134,2,but,"('CHI', 'MOT')",Providence,lil72.xml,136,2,0,MOT,744,1429,CHI
3,5,12,263,2.359743507,268,5,was,"('MOT', 'CHI')",Providence,lil72.xml,283,15,3,CHI,3394,1516,MOT
0,1,11,271,2.355031568,272,1,there,"('MOT', 'CHI')",Providence,lil72.xml,283,11,0,CHI,3394,1516,MOT
0,3,5,275,2.302585093,278,3,she,"('MOT', 'CHI')",Providence,lil72.xml,283,5,0,CHI,3394,1516,MOT
0,3,5,275,2.302585093,278,3,all,"('MOT', 'CHI')",Providence,lil72.xml,283,5,0,CHI,3394,1516,MOT
1,0,0,13,2.302585093,13,0,the,"('CHI', 'OPE')",Providence,lil72.xml,14,1,1,OPE,98,95,CHI
2,5,3,126,2.251291799,131,5,on,"('CHI', 'MOT')",Providence,lil72.xml,136,5,2,MOT,744,1429,CHI
0,2,8,273,2.222820125,275,2,get,"('MOT', 'CHI')",Providence,lil72.xml,283,8,0,CHI,3394,1516,MOT
0,2,8,273,2.222820125,275,2,not,"('MOT', 'CHI')",Providence,lil72.xml,283,8,0,CHI,3394,1516,MOT
0,4,1,131,2.211930725,135,4,gonna,"('CHI', 'MOT')",Providence,lil72.xml,136,1,0,MOT,744,1429,CHI
0,4,1,131,2.211930725,135,4,have,"('CHI', 'MOT')",Providence,lil72.xml,136,1,0,MOT,744,1429,CHI
0,4,1,131,2.211930725,135,4,are,"('CHI', 'MOT')",Providence,lil72.xml,136,1,0,MOT,744,1429,CHI
0,1,13,269,2.204604685,270,1,are,"('MOT', 'CHI')",Providence,lil72.xml,283,13,0,CHI,3394,1516,MOT
1,5,2,128,2.197224577,133,5,with,"('CHI', 'MOT')",Providence,lil72.xml,136,3,1,MOT,744,1429,CHI
0,3,2,131,2.140066163,134,3,up,"('CHI', 'MOT')",Providence,lil72.xml,136,2,0,MOT,744,1429,CHI
1,4,10,268,2.131888017,272,4,did,"('MOT', 'CHI')",Providence,lil72.xml,283,11,1,CHI,3394,1516,MOT
2,7,2,125,2.125251078,132,7,they,"('CHI', 'MOT')",Providence,lil72.xml,136,4,2,MOT,744,1429,CHI
7,17,6,253,2.086821649,270,17,no,"('MOT', 'CHI')",Providence,lil72.xml,283,13,7,CHI,3394,1516,MOT
0,4,5,274,2.079441542,278,4,want,"('MOT', 'CHI')",Providence,lil72.xml,283,5,0,CHI,3394,1516,MOT
0,3,7,273,2.044102175,276,3,this,"('MOT', 'CHI')",Providence,lil72.xml,283,7,0,CHI,3394,1516,MOT
3,9,2,122,2.028148247,131,9,in,"('CHI', 'MOT')",Providence,lil72.xml,136,5,3,MOT,744,1429,CHI
0,1,16,266,2.011192441,267,1,at,"('MOT', 'CHI')",Providence,lil72.xml,283,16,0,CHI,3394,1516,MOT
1,3,6,126,1.984825565,129,3,no,"('CHI', 'MOT')",Providence,lil72.xml,136,7,1,MOT,744,1429,CHI
1,3,16,263,1.953400821,266,3,on,"('MOT', 'CHI')",Providence,lil72.xml,283,17,1,CHI,3394,1516,MOT
1,0,1,12,1.945910149,12,0,and,"('CHI', 'OPE')",Providence,lil72.xml,14,2,1,OPE,98,95,CHI
0,3,9,271,1.836211232,274,3,some,"('MOT', 'CHI')",Providence,lil72.xml,283,9,0,CHI,3394,1516,MOT
0,2,14,267,1.73091781,269,2,make,"('MOT', 'CHI')",Providence,lil72.xml,283,14,0,CHI,3394,1516,MOT
1,3,21,258,1.700953021,261,3,of,"('MOT', 'CHI')",Providence,lil72.xml,283,22,1,CHI,3394,1516,MOT
0,4,3,129,1.686398954,133,4,for,"('CHI', 'MOT')",Providence,lil72.xml,136,3,0,MOT,744,1429,CHI
0,4,9,270,1.61306768,274,4,but,"('MOT', 'CHI')",Providence,lil72.xml,283,9,0,CHI,3394,1516,MOT
1,13,1,121,1.580450376,134,13,think,"('CHI', 'MOT')",Providence,lil72.xml,136,2,1,MOT,744,1429,CHI
9,14,25,235,1.536468893,249,14,it,"('MOT', 'CHI')",Providence,lil72.xml,283,34,9,CHI,3394,1516,MOT
5,13,5,113,1.519825754,126,13,the,"('CHI', 'MOT')",Providence,lil72.xml,136,10,5,MOT,744,1429,CHI
0,9,1,126,1.518783544,135,9,we,"('CHI', 'MOT')",Providence,lil72.xml,136,1,0,MOT,744,1429,CHI
1,0,1,7,1.504077397,7,0,oh,"('OPE', 'MOT')",Providence,lil72.xml,9,2,1,MOT,41,141,OPE
0,5,3,128,1.504077397,133,5,see,"('CHI', 'MOT')",Providence,lil72.xml,136,3,0,MOT,744,1429,CHI
2,6,21,254,1.502170819,260,6,oh,"('MOT', 'CHI')",Providence,lil72.xml,283,23,2,CHI,3394,1516,MOT
3,12,4,117,1.49931775,129,12,like,"('CHI', 'MOT')",Providence,lil72.xml,136,7,3,MOT,744,1429,CHI
1,5,17,260,1.492904096,265,5,see,"('MOT', 'CHI')",Providence,lil72.xml,283,18,1,CHI,3394,1516,MOT
0,7,2,127,1.446918983,134,7,put,"('CHI', 'MOT')",Providence,lil72.xml,136,2,0,MOT,744,1429,CHI
7,15,6,108,1.427116356,123,15,a,"('CHI', 'MOT')",Providence,lil72.xml,136,13,7,MOT,744,1429,CHI
5,9,11,111,1.402823663,120,9,it,"('CHI', 'MOT')",Providence,lil72.xml,136,16,5,MOT,744,1429,CHI
0,2,20,261,1.390075084,263,2,little,"('MOT', 'CHI')",Providence,lil72.xml,283,20,0,CHI,3394,1516,MOT
0,2,20,261,1.390075084,263,2,put,"('MOT', 'CHI')",Providence,lil72.xml,283,20,0,CHI,3394,1516,MOT
2,20,1,113,1.349926717,133,20,that,"('CHI', 'MOT')",Providence,lil72.xml,136,3,2,MOT,744,1429,CHI
5,8,14,109,1.329135947,117,8,yeah,"('CHI', 'MOT')",Providence,lil72.xml,136,19,5,MOT,744,1429,CHI
0,3,16,264,1.318045261,267,3,have,"('MOT', 'CHI')",Providence,lil72.xml,283,16,0,CHI,3394,1516,MOT
0,2,22,259,1.295487913,261,2,think,"('MOT', 'CHI')",Providence,lil72.xml,283,22,0,CHI,3394,1516,MOT
0,6,9,268,1.276595444,274,6,my,"('MOT', 'CHI')",Providence,lil72.xml,283,9,0,CHI,3394,1516,MOT
2,10,6,118,1.265666373,128,10,to,"('CHI', 'MOT')",Providence,lil72.xml,136,8,2,MOT,744,1429,CHI
1,2,0,11,1.203972804,13,2,a,"('CHI', 'OPE')",Providence,lil72.xml,14,1,1,OPE,98,95,CHI
0,4,6,126,1.193922468,130,4,my,"('CHI', 'MOT')",Providence,lil72.xml,136,6,0,MOT,744,1429,CHI
1,20,1,114,1.174985267,134,20,do,"('CHI', 'MOT')",Providence,lil72.xml,136,2,1,MOT,744,1429,CHI
0,4,15,264,1.155770703,268,4,go,"('MOT', 'CHI')",Providence,lil72.xml,283,15,0,CHI,3394,1516,MOT
0,4,15,264,1.155770703,268,4,wanna,"('MOT', 'CHI')",Providence,lil72.xml,283,15,0,CHI,3394,1516,MOT
4,6,47,226,1.148556965,232,6,a,"('MOT', 'CHI')",Providence,lil72.xml,283,51,4,CHI,3394,1516,MOT
0,1,1,15,1.098612289,16,1,one,"('MOT', 'OPE')",Providence,lil72.xml,17,1,0,OPE,516,61,MOT
0,1,1,15,1.098612289,16,1,not,"('MOT', 'OPE')",Providence,lil72.xml,17,1,0,OPE,516,61,MOT
6,13,33,231,1.098612289,244,13,what,"('MOT', 'CHI')",Providence,lil72.xml,283,39,6,CHI,3394,1516,MOT
1,20,2,113,0.944461609,133,20,oh,"('CHI', 'MOT')",Providence,lil72.xml,136,3,1,MOT,744,1429,CHI
1,5,30,247,0.942214417,252,5,that,"('MOT', 'CHI')",Providence,lil72.xml,283,31,1,CHI,3394,1516,MOT
0,8,10,265,0.934639871,273,8,can,"('MOT', 'CHI')",Providence,lil72.xml,283,10,0,CHI,3394,1516,MOT
0,1,1,12,0.916290732,13,1,like,"('CHI', 'OPE')",Providence,lil72.xml,14,1,0,OPE,98,95,CHI
0,1,1,12,0.916290732,13,1,it,"('CHI', 'OPE')",Providence,lil72.xml,14,1,0,OPE,98,95,CHI
0,1,1,12,0.916290732,13,1,to,"('CHI', 'OPE')",Providence,lil72.xml,14,1,0,OPE,98,95,CHI
3,10,13,110,0.902048375,120,10,and,"('CHI', 'MOT')",Providence,lil72.xml,136,16,3,MOT,744,1429,CHI
1,14,5,116,0.78845736,130,14,is,"('CHI', 'MOT')",Providence,lil72.xml,136,6,1,MOT,744,1429,CHI
1,6,31,245,0.754265996,251,6,in,"('MOT', 'CHI')",Providence,lil72.xml,283,32,1,CHI,3394,1516,MOT
0,1,2,14,0.753771802,15,1,no,"('MOT', 'OPE')",Providence,lil72.xml,17,2,0,OPE,516,61,MOT
0,5,20,258,0.696927903,263,5,like,"('MOT', 'CHI')",Providence,lil72.xml,283,20,0,CHI,3394,1516,MOT
0,2,1,14,0.693147181,16,2,think,"('MOT', 'OPE')",Providence,lil72.xml,17,1,0,OPE,516,61,MOT
1,19,4,112,0.641853886,131,19,what,"('CHI', 'MOT')",Providence,lil72.xml,136,5,1,MOT,744,1429,CHI
0,6,19,258,0.593063722,264,6,is,"('MOT', 'CHI')",Providence,lil72.xml,283,19,0,CHI,3394,1516,MOT
0,1,2,11,0.559615788,12,1,yeah,"('CHI', 'OPE')",Providence,lil72.xml,14,2,0,OPE,98,95,CHI
0,1,1,7,0.510825624,8,1,a,"('OPE', 'CHI')",Providence,lil72.xml,9,1,0,CHI,81,29,OPE
0,1,1,7,0.510825624,8,1,can,"('OPE', 'MOT')",Providence,lil72.xml,9,1,0,MOT,41,141,OPE
1,3,0,5,0.510825624,8,3,the,"('OPE', 'MOT')",Providence,lil72.xml,9,1,1,MOT,41,141,OPE
0,1,3,13,0.470003629,14,1,it,"('MOT', 'OPE')",Providence,lil72.xml,17,3,0,OPE,516,61,MOT
0,1,3,13,0.470003629,14,1,have,"('MOT', 'OPE')",Providence,lil72.xml,17,3,0,OPE,516,61,MOT
0,1,3,13,0.470003629,14,1,for,"('MOT', 'OPE')",Providence,lil72.xml,17,3,0,OPE,516,61,MOT
0,3,38,242,0.434214521,245,3,we,"('MOT', 'CHI')",Providence,lil72.xml,283,38,0,CHI,3394,1516,MOT
16,20,81,166,0.430013019,186,20,you,"('MOT', 'CHI')",Providence,lil72.xml,283,97,16,CHI,3394,1516,MOT
7,15,65,196,0.364079892,211,15,the,"('MOT', 'CHI')",Providence,lil72.xml,283,72,7,CHI,3394,1516,MOT
0,2,2,13,0.348306694,15,2,yeah,"('MOT', 'OPE')",Providence,lil72.xml,17,2,0,OPE,516,61,MOT
2,13,35,233,0.309422059,246,13,and,"('MOT', 'CHI')",Providence,lil72.xml,283,37,2,CHI,3394,1516,MOT
0,5,31,247,0.249067236,252,5,do,"('MOT', 'CHI')",Providence,lil72.xml,283,31,0,CHI,3394,1516,MOT
0,1,4,12,0.223143551,13,1,do,"('MOT', 'OPE')",Providence,lil72.xml,17,4,0,OPE,516,61,MOT
1,10,35,237,0.175118644,247,10,to,"('MOT', 'CHI')",Providence,lil72.xml,283,36,1,CHI,3394,1516,MOT
2,37,5,92,0.138998875,129,37,you,"('CHI', 'MOT')",Providence,lil72.xml,136,7,2,MOT,744,1429,CHI
0,1,2,6,0.117783036,7,1,yeah,"('OPE', 'CHI')",Providence,lil72.xml,9,2,0,CHI,81,29,OPE
0,1,2,6,0.117783036,7,1,it,"('OPE', 'CHI')",Providence,lil72.xml,9,2,0,CHI,81,29,OPE
0,1,2,6,0.117783036,7,1,is,"('OPE', 'CHI')",Providence,lil72.xml,9,2,0,CHI,81,29,OPE
0,2,1,6,0.105360516,8,2,you,"('OPE', 'MOT')",Providence,lil72.xml,9,1,0,MOT,41,141,OPE
0,2,1,6,0.105360516,8,2,and,"('OPE', 'MOT')",Providence,lil72.xml,9,1,0,MOT,41,141,OPE
0,4,1,9,0,13,4,you,"('CHI', 'OPE')",Providence,lil72.xml,14,1,0,OPE,98,95,CHI
0,4,1,4,-0.405465108,8,4,with,"('OPE', 'MOT')",Providence,lil72.xml,9,1,0,MOT,41,141,OPE
1,37,20,225,-0.503984092,262,37,yeah,"('MOT', 'CHI')",Providence,lil72.xml,283,21,1,CHI,3394,1516,MOT
0,1,9,7,-0.78845736,8,1,you,"('MOT', 'OPE')",Providence,lil72.xml,17,9,0,OPE,516,61,MOT
1,0,1,299,5.013963084,299,0,where,"('MOT', 'CHI')",Providence,lil73.xml,301,2,1,CHI,2284,1748,MOT
2,0,2,297,5.007296393,297,0,he,"('MOT', 'CHI')",Providence,lil73.xml,301,4,2,CHI,2284,1748,MOT
3,1,6,291,3.978831675,292,1,she,"('MOT', 'CHI')",Providence,lil73.xml,301,9,3,CHI,2284,1748,MOT
0,1,1,299,3.918667548,300,1,some,"('MOT', 'CHI')",Providence,lil73.xml,301,1,0,CHI,2284,1748,MOT
1,2,1,297,3.915350796,299,2,they,"('MOT', 'CHI')",Providence,lil73.xml,301,2,1,CHI,2284,1748,MOT
2,1,9,289,3.517269553,290,1,gonna,"('MOT', 'CHI')",Providence,lil73.xml,301,11,2,CHI,2284,1748,MOT
0,3,1,297,3.225520368,300,3,at,"('MOT', 'CHI')",Providence,lil73.xml,301,1,0,CHI,2284,1748,MOT
0,1,6,294,2.921143417,295,1,big,"('MOT', 'CHI')",Providence,lil73.xml,301,6,0,CHI,2284,1748,MOT
1,3,5,292,2.921143417,295,3,was,"('MOT', 'CHI')",Providence,lil73.xml,301,6,1,CHI,2284,1748,MOT
0,1,1,103,2.871679625,104,1,where,"('CHI', 'MOT')",Providence,lil73.xml,105,1,0,MOT,640,1655,CHI
1,2,1,101,2.862200881,103,2,yeah,"('CHI', 'MOT')",Providence,lil73.xml,105,2,1,MOT,640,1655,CHI
1,2,1,101,2.862200881,103,2,but,"('CHI', 'MOT')",Providence,lil73.xml,105,2,1,MOT,640,1655,CHI
4,7,5,285,2.815680865,292,7,in,"('MOT', 'CHI')",Providence,lil73.xml,301,9,4,CHI,2284,1748,MOT
1,4,5,291,2.697999865,295,4,one,"('MOT', 'CHI')",Providence,lil73.xml,301,6,1,CHI,2284,1748,MOT
0,1,8,292,2.691243083,293,1,of,"('MOT', 'CHI')",Providence,lil73.xml,301,8,0,CHI,2284,1748,MOT
0,2,5,294,2.652571049,296,2,all,"('MOT', 'CHI')",Providence,lil73.xml,301,5,0,CHI,2284,1748,MOT
1,4,0,100,2.648536074,104,4,was,"('CHI', 'MOT')",Providence,lil73.xml,105,1,1,MOT,640,1655,CHI
1,4,0,100,2.648536074,104,4,all,"('CHI', 'MOT')",Providence,lil73.xml,105,1,1,MOT,640,1655,CHI
2,3,12,284,2.606155893,287,3,we,"('MOT', 'CHI')",Providence,lil73.xml,301,14,2,CHI,2284,1748,MOT
0,1,2,102,2.574518808,103,1,put,"('CHI', 'MOT')",Providence,lil73.xml,105,2,0,MOT,640,1655,CHI
1,3,1,100,2.574518808,103,3,go,"('CHI', 'MOT')",Providence,lil73.xml,105,2,1,MOT,640,1655,CHI
0,5,2,294,2.529056434,299,5,up,"('MOT', 'CHI')",Providence,lil73.xml,301,2,0,CHI,2284,1748,MOT
0,3,4,294,2.522389743,297,3,there,"('MOT', 'CHI')",Providence,lil73.xml,301,4,0,CHI,2284,1748,MOT
1,7,3,290,2.522389743,297,7,want,"('MOT', 'CHI')",Providence,lil73.xml,301,4,1,CHI,2284,1748,MOT
0,2,1,102,2.466214517,104,2,gonna,"('CHI', 'MOT')",Providence,lil73.xml,105,1,0,MOT,640,1655,CHI
0,2,1,102,2.466214517,104,2,look,"('CHI', 'MOT')",Providence,lil73.xml,105,1,0,MOT,640,1655,CHI
1,0,0,15,2.427748236,15,0,she,"('OPE', 'CHI')",Providence,lil73.xml,16,1,1,CHI,84,61,OPE
0,6,2,293,2.374905755,299,6,put,"('MOT', 'CHI')",Providence,lil73.xml,301,2,0,CHI,2284,1748,MOT
2,5,1,97,2.341805806,102,5,he,"('CHI', 'MOT')",Providence,lil73.xml,105,3,2,MOT,640,1655,CHI
1,0,0,13,2.302585093,13,0,he,"('CHI', 'OPE')",Providence,lil73.xml,14,1,1,OPE,216,82,CHI
0,4,4,293,2.299246192,297,4,but,"('MOT', 'CHI')",Providence,lil73.xml,301,4,0,CHI,2284,1748,MOT
1,4,9,287,2.278975227,291,4,have,"('MOT', 'CHI')",Providence,lil73.xml,301,10,1,CHI,2284,1748,MOT
0,3,1,101,2.178532444,104,3,for,"('CHI', 'MOT')",Providence,lil73.xml,105,1,0,MOT,640,1655,CHI
1,5,9,286,2.096653671,291,5,with,"('MOT', 'CHI')",Providence,lil73.xml,301,10,1,CHI,2284,1748,MOT
0,3,8,290,1.998095902,293,3,for,"('MOT', 'CHI')",Providence,lil73.xml,301,8,0,CHI,2284,1748,MOT
0,3,8,290,1.998095902,293,3,wanna,"('MOT', 'CHI')",Providence,lil73.xml,301,8,0,CHI,2284,1748,MOT
1,3,17,280,1.963609726,283,3,are,"('MOT', 'CHI')",Providence,lil73.xml,301,18,1,CHI,2284,1748,MOT
0,4,1,100,1.955388893,104,4,want,"('CHI', 'MOT')",Providence,lil73.xml,105,1,0,MOT,640,1655,CHI
0,4,1,100,1.955388893,104,4,have,"('CHI', 'MOT')",Providence,lil73.xml,105,1,0,MOT,640,1655,CHI
0,4,1,100,1.955388893,104,4,at,"('CHI', 'MOT')",Providence,lil73.xml,105,1,0,MOT,640,1655,CHI
0,2,3,100,1.936340698,102,2,this,"('CHI', 'MOT')",Providence,lil73.xml,105,3,0,MOT,640,1655,CHI
0,2,12,287,1.935653649,289,2,like,"('MOT', 'CHI')",Providence,lil73.xml,301,12,0,CHI,2284,1748,MOT
0,3,9,289,1.899390133,292,3,little,"('MOT', 'CHI')",Providence,lil73.xml,301,9,0,CHI,2284,1748,MOT
1,0,0,8,1.897119985,8,0,it,"('OPE', 'MOT')",Providence,lil73.xml,9,1,1,MOT,51,53,OPE
1,0,2,13,1.791759469,13,0,is,"('OPE', 'CHI')",Providence,lil73.xml,16,3,1,CHI,84,61,OPE
0,4,8,289,1.774952351,293,4,can,"('MOT', 'CHI')",Providence,lil73.xml,301,8,0,CHI,2284,1748,MOT
0,5,1,99,1.773067336,104,5,wanna,"('CHI', 'MOT')",Providence,lil73.xml,105,1,0,MOT,640,1655,CHI
0,5,7,289,1.701375408,294,5,get,"('MOT', 'CHI')",Providence,lil73.xml,301,7,0,CHI,2284,1748,MOT
3,4,9,89,1.691676011,93,4,on,"('CHI', 'MOT')",Providence,lil73.xml,105,12,3,MOT,640,1655,CHI
2,14,7,278,1.676246582,292,14,no,"('MOT', 'CHI')",Providence,lil73.xml,301,9,2,CHI,2284,1748,MOT
0,3,3,99,1.648658626,102,3,up,"('CHI', 'MOT')",Providence,lil73.xml,105,3,0,MOT,640,1655,CHI
1,1,0,12,1.609437912,13,1,yeah,"('CHI', 'OPE')",Providence,lil73.xml,14,1,1,OPE,216,82,CHI
1,1,0,12,1.609437912,13,1,what,"('CHI', 'OPE')",Providence,lil73.xml,14,1,1,OPE,216,82,CHI
1,8,10,282,1.607727048,290,8,is,"('MOT', 'CHI')",Providence,lil73.xml,301,11,1,CHI,2284,1748,MOT
1,6,3,95,1.590206551,101,6,are,"('CHI', 'MOT')",Providence,lil73.xml,105,4,1,MOT,640,1655,CHI
0,10,4,287,1.510788831,297,10,this,"('MOT', 'CHI')",Providence,lil73.xml,301,4,0,CHI,2284,1748,MOT
2,13,10,276,1.493820897,289,13,my,"('MOT', 'CHI')",Providence,lil73.xml,301,12,2,CHI,2284,1748,MOT
2,13,10,276,1.493820897,289,13,on,"('MOT', 'CHI')",Providence,lil73.xml,301,12,2,CHI,2284,1748,MOT
1,4,6,94,1.491654877,98,4,can,"('CHI', 'MOT')",Providence,lil73.xml,105,7,1,MOT,640,1655,CHI
0,7,1,97,1.485385264,104,7,we,"('CHI', 'MOT')",Providence,lil73.xml,105,1,0,MOT,640,1655,CHI
2,7,6,90,1.311705504,97,7,to,"('CHI', 'MOT')",Providence,lil73.xml,105,8,2,MOT,640,1655,CHI
0,9,1,95,1.262241712,104,9,that,"('CHI', 'MOT')",Providence,lil73.xml,105,1,0,MOT,640,1655,CHI
0,5,3,97,1.243193517,102,5,little,"('CHI', 'MOT')",Providence,lil73.xml,105,3,0,MOT,640,1655,CHI
0,7,2,96,1.188224447,103,7,do,"('CHI', 'MOT')",Providence,lil73.xml,105,2,0,MOT,640,1655,CHI
1,8,4,92,1.174985267,100,8,the,"('CHI', 'MOT')",Providence,lil73.xml,105,5,1,MOT,640,1655,CHI
4,15,21,261,1.168633438,276,15,to,"('MOT', 'CHI')",Providence,lil73.xml,301,25,4,CHI,2284,1748,MOT
0,10,1,94,1.166931533,104,10,is,"('CHI', 'MOT')",Providence,lil73.xml,105,1,0,MOT,640,1655,CHI
0,3,6,96,1.149384614,99,3,and,"('CHI', 'MOT')",Providence,lil73.xml,105,6,0,MOT,640,1655,CHI
1,0,4,9,1.145132304,9,0,oh,"('MOT', 'OPE')",Providence,lil73.xml,14,5,1,OPE,157,70,MOT
1,12,12,276,1.090028545,288,12,and,"('MOT', 'CHI')",Providence,lil73.xml,301,13,1,CHI,2284,1748,MOT
0,4,5,96,1.069624752,100,4,in,"('CHI', 'MOT')",Providence,lil73.xml,105,5,0,MOT,640,1655,CHI
0,4,18,279,1.047318994,283,4,that,"('MOT', 'CHI')",Providence,lil73.xml,301,18,0,CHI,2284,1748,MOT
0,1,1,14,1.041453875,15,1,the,"('OPE', 'CHI')",Providence,lil73.xml,16,1,0,CHI,84,61,OPE
3,16,19,263,1.013381856,279,16,the,"('MOT', 'CHI')",Providence,lil73.xml,301,22,3,CHI,2284,1748,MOT
1,2,1,12,0.980829253,14,2,a,"('OPE', 'CHI')",Providence,lil73.xml,16,2,1,CHI,84,61,OPE
0,7,3,95,0.955511445,102,7,like,"('CHI', 'MOT')",Providence,lil73.xml,105,3,0,MOT,640,1655,CHI
0,4,6,95,0.926241063,99,4,no,"('CHI', 'MOT')",Providence,lil73.xml,105,6,0,MOT,640,1655,CHI
0,1,1,12,0.916290732,13,1,was,"('CHI', 'OPE')",Providence,lil73.xml,14,1,0,OPE,216,82,CHI
0,1,1,12,0.916290732,13,1,all,"('MOT', 'OPE')",Providence,lil73.xml,14,1,0,OPE,157,70,MOT
0,1,1,12,0.916290732,13,1,that,"('MOT', 'OPE')",Providence,lil73.xml,14,1,0,OPE,157,70,MOT
0,1,1,12,0.916290732,13,1,and,"('MOT', 'OPE')",Providence,lil73.xml,14,1,0,OPE,157,70,MOT
0,6,4,95,0.89705937,101,6,my,"('CHI', 'MOT')",Providence,lil73.xml,105,4,0,MOT,640,1655,CHI
0,6,15,280,0.883836987,286,6,go,"('MOT', 'CHI')",Providence,lil73.xml,301,15,0,CHI,2284,1748,MOT
1,14,3,87,0.828066498,101,14,what,"('CHI', 'MOT')",Providence,lil73.xml,105,4,1,MOT,640,1655,CHI
6,12,13,74,0.813775168,86,12,a,"('CHI', 'MOT')",Providence,lil73.xml,105,19,6,MOT,640,1655,CHI
2,7,12,84,0.779181518,91,7,it,"('CHI', 'MOT')",Providence,lil73.xml,105,14,2,MOT,640,1655,CHI
0,16,1,88,0.731613461,104,16,oh,"('CHI', 'MOT')",Providence,lil73.xml,105,1,0,MOT,640,1655,CHI
0,11,10,280,0.710359309,291,11,yeah,"('MOT', 'CHI')",Providence,lil73.xml,301,10,0,CHI,2284,1748,MOT
1,9,25,266,0.682375084,275,9,what,"('MOT', 'CHI')",Providence,lil73.xml,301,26,1,CHI,2284,1748,MOT
0,7,18,276,0.577315365,283,7,do,"('MOT', 'CHI')",Providence,lil73.xml,301,18,0,CHI,2284,1748,MOT
0,1,2,11,0.559615788,12,1,have,"('CHI', 'OPE')",Providence,lil73.xml,14,2,0,OPE,216,82,CHI
0,1,2,11,0.559615788,12,1,that,"('CHI', 'OPE')",Providence,lil73.xml,14,2,0,OPE,216,82,CHI
1,2,2,9,0.550046337,11,2,you,"('CHI', 'OPE')",Providence,lil73.xml,14,3,1,OPE,216,82,CHI
0,2,1,11,0.510825624,13,2,of,"('CHI', 'OPE')",Providence,lil73.xml,14,1,0,OPE,216,82,CHI
0,2,1,11,0.510825624,13,2,no,"('CHI', 'OPE')",Providence,lil73.xml,14,1,0,OPE,216,82,CHI
0,1,1,7,0.510825624,8,1,go,"('OPE', 'MOT')",Providence,lil73.xml,9,1,0,MOT,51,53,OPE
0,1,1,7,0.510825624,8,1,in,"('OPE', 'MOT')",Providence,lil73.xml,9,1,0,MOT,51,53,OPE
2,11,37,251,0.476082675,262,11,a,"('MOT', 'CHI')",Providence,lil73.xml,301,39,2,CHI,2284,1748,MOT
7,26,9,63,0.404092424,89,26,you,"('CHI', 'MOT')",Providence,lil73.xml,105,16,7,MOT,640,1655,CHI
0,3,1,10,0.223143551,13,3,do,"('MOT', 'OPE')",Providence,lil73.xml,14,1,0,OPE,157,70,MOT
0,2,2,10,0.15415068,12,2,the,"('MOT', 'OPE')",Providence,lil73.xml,14,2,0,OPE,157,70,MOT
0,1,2,6,0.117783036,7,1,yeah,"('OPE', 'MOT')",Providence,lil73.xml,9,2,0,MOT,51,53,OPE
1,8,48,244,0.101431238,252,8,oh,"('MOT', 'CHI')",Providence,lil73.xml,301,49,1,CHI,2284,1748,MOT
5,18,61,217,0.095872926,235,18,you,"('MOT', 'CHI')",Providence,lil73.xml,301,66,5,CHI,2284,1748,MOT
0,1,4,9,0,10,1,a,"('CHI', 'OPE')",Providence,lil73.xml,14,4,0,OPE,216,82,CHI
0,20,13,268,-0.082691716,288,20,it,"('MOT', 'CHI')",Providence,lil73.xml,301,13,0,CHI,2284,1748,MOT
0,3,2,9,-0.133531393,12,3,you,"('MOT', 'OPE')",Providence,lil73.xml,14,2,0,OPE,157,70,MOT
0,3,1,5,-0.182321557,8,3,oh,"('OPE', 'MOT')",Providence,lil73.xml,9,1,0,MOT,51,53,OPE
1,0,3,388,4.86753445,388,0,where,"('MOT', 'CHI')",Providence,lil74.xml,392,4,1,CHI,4620,2102,MOT
1,0,9,382,4.158883083,382,0,some,"('MOT', 'CHI')",Providence,lil74.xml,392,10,1,CHI,4620,2102,MOT
0,2,1,389,3.776585035,391,2,make,"('MOT', 'CHI')",Providence,lil74.xml,392,1,0,CHI,4620,2102,MOT
1,2,9,380,3.060270795,382,2,gonna,"('MOT', 'CHI')",Providence,lil74.xml,392,10,1,CHI,4620,2102,MOT
0,1,8,383,2.960105096,384,1,put,"('MOT', 'CHI')",Providence,lil74.xml,392,8,0,CHI,4620,2102,MOT
3,6,9,374,2.746747491,380,6,she,"('MOT', 'CHI')",Providence,lil74.xml,392,12,3,CHI,4620,2102,MOT
4,6,14,368,2.597384633,374,6,big,"('MOT', 'CHI')",Providence,lil74.xml,392,18,4,CHI,4620,2102,MOT
0,2,8,382,2.554639988,384,2,little,"('MOT', 'CHI')",Providence,lil74.xml,392,8,0,CHI,4620,2102,MOT
0,2,8,382,2.554639988,384,2,not,"('MOT', 'CHI')",Providence,lil74.xml,392,8,0,CHI,4620,2102,MOT
1,3,12,376,2.541601993,379,3,go,"('MOT', 'CHI')",Providence,lil74.xml,392,13,1,CHI,4620,2102,MOT
1,6,6,379,2.508437147,385,6,want,"('MOT', 'CHI')",Providence,lil74.xml,392,7,1,CHI,4620,2102,MOT
0,2,10,380,2.367123614,382,2,get,"('MOT', 'CHI')",Providence,lil74.xml,392,10,0,CHI,4620,2102,MOT
3,8,11,370,2.356652314,378,8,they,"('MOT', 'CHI')",Providence,lil74.xml,392,14,3,CHI,4620,2102,MOT
1,3,15,373,2.351375257,376,3,think,"('MOT', 'CHI')",Providence,lil74.xml,392,16,1,CHI,4620,2102,MOT
1,7,8,376,2.1690537,383,7,one,"('MOT', 'CHI')",Providence,lil74.xml,392,9,1,CHI,4620,2102,MOT
0,3,10,379,2.079441542,382,3,for,"('MOT', 'CHI')",Providence,lil74.xml,392,10,0,CHI,4620,2102,MOT
1,1,43,347,2.029291758,348,1,do,"('MOT', 'CHI')",Providence,lil74.xml,392,44,1,CHI,4620,2102,MOT
0,3,12,377,1.920068918,380,3,did,"('MOT', 'CHI')",Providence,lil74.xml,392,12,0,CHI,4620,2102,MOT
0,6,7,379,1.815289967,385,6,up,"('MOT', 'CHI')",Providence,lil74.xml,392,7,0,CHI,4620,2102,MOT
2,5,26,359,1.808288771,364,5,are,"('MOT', 'CHI')",Providence,lil74.xml,392,28,2,CHI,4620,2102,MOT
0,5,9,378,1.763588592,383,5,at,"('MOT', 'CHI')",Providence,lil74.xml,392,9,0,CHI,4620,2102,MOT
2,7,20,363,1.760010771,370,7,like,"('MOT', 'CHI')",Providence,lil74.xml,392,22,2,CHI,4620,2102,MOT
0,4,12,376,1.696925367,380,4,he,"('MOT', 'CHI')",Providence,lil74.xml,392,12,0,CHI,4620,2102,MOT
1,6,18,367,1.62964062,373,6,with,"('MOT', 'CHI')",Providence,lil74.xml,392,19,1,CHI,4620,2102,MOT
0,4,13,375,1.625311262,379,4,there,"('MOT', 'CHI')",Providence,lil74.xml,392,13,0,CHI,4620,2102,MOT
1,5,23,363,1.556794179,368,5,my,"('MOT', 'CHI')",Providence,lil74.xml,392,24,1,CHI,4620,2102,MOT
1,11,13,367,1.375823061,378,11,no,"('MOT', 'CHI')",Providence,lil74.xml,392,14,1,CHI,4620,2102,MOT
0,5,15,372,1.312563392,377,5,was,"('MOT', 'CHI')",Providence,lil74.xml,392,15,0,CHI,4620,2102,MOT
3,10,32,347,1.260803564,357,10,what,"('MOT', 'CHI')",Providence,lil74.xml,392,35,3,CHI,4620,2102,MOT
0,10,8,374,1.255357004,384,10,look,"('MOT', 'CHI')",Providence,lil74.xml,392,8,0,CHI,4620,2102,MOT
0,9,9,374,1.252762968,383,9,this,"('MOT', 'CHI')",Providence,lil74.xml,392,9,0,CHI,4620,2102,MOT
1,8,23,360,1.151329071,368,8,on,"('MOT', 'CHI')",Providence,lil74.xml,392,24,1,CHI,4620,2102,MOT
0,4,22,366,1.131402111,370,4,we,"('MOT', 'CHI')",Providence,lil74.xml,392,22,0,CHI,4620,2102,MOT
1,8,25,358,1.071801031,366,8,is,"('MOT', 'CHI')",Providence,lil74.xml,392,26,1,CHI,4620,2102,MOT
5,16,37,334,1.037987667,350,16,a,"('MOT', 'CHI')",Providence,lil74.xml,392,42,5,CHI,4620,2102,MOT
6,31,23,332,0.946084395,363,31,and,"('MOT', 'CHI')",Providence,lil74.xml,392,29,6,CHI,4620,2102,MOT
0,9,14,369,0.864997437,378,9,all,"('MOT', 'CHI')",Providence,lil74.xml,392,14,0,CHI,4620,2102,MOT
1,12,23,356,0.783604291,368,12,in,"('MOT', 'CHI')",Providence,lil74.xml,392,24,1,CHI,4620,2102,MOT
3,16,35,338,0.739132294,354,16,to,"('MOT', 'CHI')",Providence,lil74.xml,392,38,3,CHI,4620,2102,MOT
0,14,11,367,0.675035431,381,14,have,"('MOT', 'CHI')",Providence,lil74.xml,392,11,0,CHI,4620,2102,MOT
0,10,18,364,0.535961597,374,10,see,"('MOT', 'CHI')",Providence,lil74.xml,392,18,0,CHI,4620,2102,MOT
0,14,13,365,0.526698973,379,14,but,"('MOT', 'CHI')",Providence,lil74.xml,392,13,0,CHI,4620,2102,MOT
0,19,10,363,0.470003629,382,19,can,"('MOT', 'CHI')",Providence,lil74.xml,392,10,0,CHI,4620,2102,MOT
5,10,102,275,0.36199853,285,10,you,"('MOT', 'CHI')",Providence,lil74.xml,392,107,5,CHI,4620,2102,MOT
0,13,17,362,0.348748879,375,13,yeah,"('MOT', 'CHI')",Providence,lil74.xml,392,17,0,CHI,4620,2102,MOT
0,8,29,355,0.268685572,363,8,of,"('MOT', 'CHI')",Providence,lil74.xml,392,29,0,CHI,4620,2102,MOT
0,1,1,4,0.15415068,5,1,was,"('OPE', 'CHI')",Providence,lil74.xml,6,1,0,CHI,37,40,OPE
0,1,1,4,0.15415068,5,1,there,"('OPE', 'CHI')",Providence,lil74.xml,6,1,0,CHI,37,40,OPE
1,5,93,293,0.040821995,298,5,oh,"('MOT', 'CHI')",Providence,lil74.xml,392,94,1,CHI,4620,2102,MOT
3,39,31,319,0,358,39,it,"('MOT', 'CHI')",Providence,lil74.xml,392,34,3,CHI,4620,2102,MOT
2,20,46,324,-0.011494379,344,20,the,"('MOT', 'CHI')",Providence,lil74.xml,392,48,2,CHI,4620,2102,MOT
0,1,2,3,-0.287682072,4,1,you,"('OPE', 'CHI')",Providence,lil74.xml,6,2,0,CHI,37,40,OPE
0,13,34,345,-0.336472237,358,13,that,"('MOT', 'CHI')",Providence,lil74.xml,392,34,0,CHI,4620,2102,MOT
2,4,1,362,3.787819402,366,4,he,"('CHI', 'FAT')",Providence,lil76.xml,369,3,2,FAT,2626,3045,CHI
1,5,0,363,3.716278428,368,5,make,"('CHI', 'FAT')",Providence,lil76.xml,369,1,1,FAT,2626,3045,CHI
1,1,8,359,3.493748939,360,1,my,"('CHI', 'FAT')",Providence,lil76.xml,369,9,1,FAT,2626,3045,CHI
0,2,2,365,3.425889994,367,2,up,"('CHI', 'FAT')",Providence,lil76.xml,369,2,0,FAT,2626,3045,CHI
0,3,2,364,3.138207922,367,3,was,"('CHI', 'FAT')",Providence,lil76.xml,369,2,0,FAT,2626,3045,CHI
3,5,7,354,2.9985062,359,5,want,"('CHI', 'FAT')",Providence,lil76.xml,369,10,3,FAT,2626,3045,CHI
0,4,2,363,2.91506437,367,4,did,"('CHI', 'FAT')",Providence,lil76.xml,369,2,0,FAT,2626,3045,CHI
0,3,3,363,2.912350665,366,3,they,"('CHI', 'FAT')",Providence,lil76.xml,369,3,0,FAT,2626,3045,CHI
0,3,3,363,2.912350665,366,3,where,"('CHI', 'FAT')",Providence,lil76.xml,369,3,0,FAT,2626,3045,CHI
1,5,4,359,2.858110896,364,5,big,"('CHI', 'FAT')",Providence,lil76.xml,369,5,1,FAT,2626,3045,CHI
0,1,1,96,2.803360381,97,1,want,"('MOT', 'CHI')",Providence,lil76.xml,98,1,0,CHI,1265,612,MOT
0,1,1,96,2.803360381,97,1,up,"('MOT', 'CHI')",Providence,lil76.xml,98,1,0,CHI,1265,612,MOT
0,1,1,96,2.803360381,97,1,some,"('MOT', 'CHI')",Providence,lil76.xml,98,1,0,CHI,1265,612,MOT
0,1,1,96,2.803360381,97,1,can,"('MOT', 'CHI')",Providence,lil76.xml,98,1,0,CHI,1265,612,MOT
0,3,4,362,2.727308018,365,3,with,"('CHI', 'FAT')",Providence,lil76.xml,369,4,0,FAT,2626,3045,CHI
1,7,3,358,2.727308018,365,7,not,"('CHI', 'FAT')",Providence,lil76.xml,369,4,1,FAT,2626,3045,CHI
2,4,1,91,2.454447442,95,4,they,"('MOT', 'CHI')",Providence,lil76.xml,98,3,2,CHI,1265,612,MOT
1,0,12,85,2.451005098,85,0,it,"('MOT', 'CHI')",Providence,lil76.xml,98,13,1,CHI,1265,612,MOT
1,6,6,356,2.447166322,362,6,are,"('CHI', 'FAT')",Providence,lil76.xml,369,7,1,FAT,2626,3045,CHI
1,2,3,92,2.367123614,94,2,gonna,"('MOT', 'CHI')",Providence,lil76.xml,98,4,1,CHI,1265,612,MOT
1,13,2,353,2.352734877,366,13,see,"('CHI', 'FAT')",Providence,lil76.xml,369,3,1,FAT,2626,3045,CHI
1,9,4,355,2.347285272,364,9,all,"('CHI', 'FAT')",Providence,lil76.xml,369,5,1,FAT,2626,3045,CHI
0,1,3,94,2.272125886,95,1,this,"('MOT', 'CHI')",Providence,lil76.xml,98,3,0,CHI,1265,612,MOT
1,12,3,353,2.241800202,365,12,wanna,"('CHI', 'FAT')",Providence,lil76.xml,369,4,1,FAT,2626,3045,CHI
2,7,11,349,2.191653532,356,7,get,"('CHI', 'FAT')",Providence,lil76.xml,369,13,2,FAT,2626,3045,CHI
0,8,3,358,2.101420448,366,8,go,"('CHI', 'FAT')",Providence,lil76.xml,369,3,0,FAT,2626,3045,CHI
0,1,4,93,2.079441542,94,1,do,"('MOT', 'CHI')",Providence,lil76.xml,98,4,0,CHI,1265,612,MOT
0,7,4,358,2.034160837,365,7,for,"('CHI', 'FAT')",Providence,lil76.xml,369,4,0,FAT,2626,3045,CHI
2,13,7,347,1.953303898,360,13,like,"('CHI', 'FAT')",Providence,lil76.xml,369,9,2,FAT,2626,3045,CHI
0,1,5,92,1.914819562,93,1,there,"('MOT', 'CHI')",Providence,lil76.xml,98,5,0,CHI,1265,612,MOT
0,1,5,92,1.914819562,93,1,see,"('MOT', 'CHI')",Providence,lil76.xml,98,5,0,CHI,1265,612,MOT
0,1,5,92,1.914819562,93,1,little,"('MOT', 'CHI')",Providence,lil76.xml,98,5,0,CHI,1265,612,MOT
0,1,5,92,1.914819562,93,1,at,"('MOT', 'CHI')",Providence,lil76.xml,98,5,0,CHI,1265,612,MOT
0,1,5,92,1.914819562,93,1,not,"('MOT', 'CHI')",Providence,lil76.xml,98,5,0,CHI,1265,612,MOT
0,2,3,93,1.866660777,95,2,get,"('MOT', 'CHI')",Providence,lil76.xml,98,3,0,CHI,1265,612,MOT
1,18,3,347,1.86231058,365,18,there,"('CHI', 'FAT')",Providence,lil76.xml,369,4,1,FAT,2626,3045,CHI
0,9,4,356,1.811017286,365,9,on,"('CHI', 'FAT')",Providence,lil76.xml,369,4,0,FAT,2626,3045,CHI
1,10,8,350,1.789000847,360,10,at,"('CHI', 'FAT')",Providence,lil76.xml,369,9,1,FAT,2626,3045,CHI
0,1,6,91,1.77070606,92,1,like,"('MOT', 'CHI')",Providence,lil76.xml,98,6,0,CHI,1265,612,MOT
4,16,12,337,1.7579706,353,16,in,"('CHI', 'FAT')",Providence,lil76.xml,369,16,4,FAT,2626,3045,CHI
4,19,11,335,1.655423026,354,19,to,"('CHI', 'FAT')",Providence,lil76.xml,369,15,4,FAT,2626,3045,CHI
2,9,17,341,1.615135934,350,9,look,"('CHI', 'FAT')",Providence,lil76.xml,369,19,2,FAT,2626,3045,CHI
0,14,3,352,1.590594825,366,14,little,"('CHI', 'FAT')",Providence,lil76.xml,369,3,0,FAT,2626,3045,CHI
0,3,3,92,1.578978705,95,3,no,"('MOT', 'CHI')",Providence,lil76.xml,98,3,0,CHI,1265,612,MOT
0,1,8,89,1.526056303,90,1,for,"('MOT', 'CHI')",Providence,lil76.xml,98,8,0,CHI,1265,612,MOT
0,2,5,91,1.509354454,93,2,look,"('MOT', 'CHI')",Providence,lil76.xml,98,5,0,CHI,1265,612,MOT
0,2,5,91,1.509354454,93,2,he,"('MOT', 'CHI')",Providence,lil76.xml,98,5,0,CHI,1265,612,MOT
2,19,9,339,1.424034689,358,19,put,"('CHI', 'FAT')",Providence,lil76.xml,369,11,2,FAT,2626,3045,CHI
1,3,8,86,1.419817053,89,3,yeah,"('MOT', 'CHI')",Providence,lil76.xml,98,9,1,CHI,1265,612,MOT
0,1,9,88,1.419817053,89,1,my,"('MOT', 'CHI')",Providence,lil76.xml,98,9,0,CHI,1265,612,MOT
0,3,4,91,1.386294361,94,3,on,"('MOT', 'CHI')",Providence,lil76.xml,98,4,0,CHI,1265,612,MOT
0,2,6,90,1.365240952,92,2,but,"('MOT', 'CHI')",Providence,lil76.xml,98,6,0,CHI,1265,612,MOT
0,15,4,350,1.341013657,365,15,some,"('CHI', 'FAT')",Providence,lil76.xml,369,4,0,FAT,2626,3045,CHI
0,11,6,352,1.335549162,363,11,gonna,"('CHI', 'FAT')",Providence,lil76.xml,369,6,0,FAT,2626,3045,CHI
1,4,7,86,1.302912752,90,4,go,"('MOT', 'CHI')",Providence,lil76.xml,98,8,1,CHI,1265,612,MOT
2,19,11,337,1.2753628,356,19,of,"('CHI', 'FAT')",Providence,lil76.xml,369,13,2,FAT,2626,3045,CHI
1,16,9,343,1.263905145,359,16,have,"('CHI', 'FAT')",Providence,lil76.xml,369,10,1,FAT,2626,3045,CHI
2,4,11,81,1.247032294,85,4,oh,"('MOT', 'CHI')",Providence,lil76.xml,98,13,2,CHI,1265,612,MOT
0,3,5,90,1.221672381,93,3,are,"('MOT', 'CHI')",Providence,lil76.xml,98,5,0,CHI,1265,612,MOT
12,39,19,299,1.208507959,338,39,it,"('CHI', 'FAT')",Providence,lil76.xml,369,31,12,FAT,2626,3045,CHI
3,3,20,72,1.124929597,75,3,a,"('MOT', 'CHI')",Providence,lil76.xml,98,23,3,CHI,1265,612,MOT
4,23,18,324,1.108402174,347,23,one,"('CHI', 'FAT')",Providence,lil76.xml,369,22,4,FAT,2626,3045,CHI
0,3,6,89,1.077558879,92,3,in,"('MOT', 'CHI')",Providence,lil76.xml,98,6,0,CHI,1265,612,MOT
2,24,11,332,1.052219249,356,24,think,"('CHI', 'FAT')",Providence,lil76.xml,369,13,2,FAT,2626,3045,CHI
1,4,10,83,1.00739628,87,4,what,"('MOT', 'CHI')",Providence,lil76.xml,98,11,1,CHI,1265,612,MOT
0,13,8,348,0.952760412,361,13,no,"('CHI', 'FAT')",Providence,lil76.xml,369,8,0,FAT,2626,3045,CHI
8,35,24,302,0.913345222,337,35,the,"('CHI', 'FAT')",Providence,lil76.xml,369,32,8,FAT,2626,3045,CHI
1,13,18,337,0.873198589,350,13,but,"('CHI', 'FAT')",Providence,lil76.xml,369,19,1,FAT,2626,3045,CHI
0,1,17,80,0.781254448,81,1,is,"('MOT', 'CHI')",Providence,lil76.xml,98,17,0,CHI,1265,612,MOT
3,33,15,318,0.73066962,351,33,we,"('CHI', 'FAT')",Providence,lil76.xml,369,18,3,FAT,2626,3045,CHI
3,25,21,320,0.719426065,345,25,what,"('CHI', 'FAT')",Providence,lil76.xml,369,24,3,FAT,2626,3045,CHI
12,52,30,275,0.606525561,327,52,a,"('CHI', 'FAT')",Providence,lil76.xml,369,42,12,FAT,2626,3045,CHI
8,90,10,261,0.557100854,351,90,is,"('CHI', 'FAT')",Providence,lil76.xml,369,18,8,FAT,2626,3045,CHI
0,3,11,84,0.537392651,87,3,have,"('MOT', 'CHI')",Providence,lil76.xml,98,11,0,CHI,1265,612,MOT
4,38,20,307,0.537104508,345,38,this,"('CHI', 'FAT')",Providence,lil76.xml,369,24,4,FAT,2626,3045,CHI
1,1,0,2,0.510825624,3,1,is,"('FAT', 'MOT')",Providence,lil76.xml,4,1,1,MOT,19,64,FAT
0,4,9,85,0.503526321,89,4,with,"('MOT', 'CHI')",Providence,lil76.xml,98,9,0,CHI,1265,612,MOT
0,4,9,85,0.503526321,89,4,of,"('MOT', 'CHI')",Providence,lil76.xml,98,9,0,CHI,1265,612,MOT
1,27,13,328,0.46608973,355,27,oh,"('CHI', 'FAT')",Providence,lil76.xml,369,14,1,FAT,2626,3045,CHI
0,3,14,81,0.295464213,84,3,that,"('MOT', 'CHI')",Providence,lil76.xml,98,14,0,CHI,1265,612,MOT
0,17,16,336,0.091374274,353,17,can,"('CHI', 'FAT')",Providence,lil76.xml,369,16,0,FAT,2626,3045,CHI
1,19,29,320,0.063561481,339,19,and,"('CHI', 'FAT')",Providence,lil76.xml,369,30,1,FAT,2626,3045,CHI
3,71,16,279,-0.07126302,350,71,that,"('CHI', 'FAT')",Providence,lil76.xml,369,19,3,FAT,2626,3045,CHI
6,71,28,264,-0.094191978,335,71,you,"('CHI', 'FAT')",Providence,lil76.xml,369,34,6,FAT,2626,3045,CHI
1,6,27,64,-0.377294231,70,6,you,"('MOT', 'CHI')",Providence,lil76.xml,98,28,1,CHI,1265,612,MOT
0,30,15,324,-0.392269818,354,30,do,"('CHI', 'FAT')",Providence,lil76.xml,369,15,0,FAT,2626,3045,CHI
0,1,1,1,-0.405465108,2,1,yeah,"('FAT', 'CHI')",Providence,lil76.xml,3,1,0,CHI,30,6,FAT
1,31,34,303,-0.566395475,334,31,yeah,"('CHI', 'FAT')",Providence,lil76.xml,369,35,1,FAT,2626,3045,CHI
0,8,16,74,-0.656779536,82,8,the,"('MOT', 'CHI')",Providence,lil76.xml,98,16,0,CHI,1265,612,MOT
0,6,22,70,-0.767255153,76,6,to,"('MOT', 'CHI')",Providence,lil76.xml,98,22,0,CHI,1265,612,MOT
0,9,19,70,-0.952658376,79,9,and,"('MOT', 'CHI')",Providence,lil76.xml,98,19,0,CHI,1265,612,MOT
0,2,2,0,-1.098612289,2,2,yeah,"('FAT', 'MOT')",Providence,lil76.xml,4,2,0,MOT,19,64,FAT
1,1,3,308,3.948033443,309,1,wanna,"('MOT', 'CHI')",Providence,lil77.xml,313,4,1,CHI,2491,2274,MOT
0,1,2,310,3.666761649,311,1,want,"('MOT', 'CHI')",Providence,lil77.xml,313,2,0,CHI,2491,2274,MOT
1,2,3,307,3.542568335,309,2,this,"('MOT', 'CHI')",Providence,lil77.xml,313,4,1,CHI,2491,2274,MOT
2,3,3,305,3.502980076,308,3,they,"('MOT', 'CHI')",Providence,lil77.xml,313,5,2,CHI,2491,2274,MOT
1,0,1,62,3.465735903,62,0,she,"('CHI', 'MOT')",Providence,lil77.xml,64,2,1,MOT,473,481,CHI
1,2,4,306,3.38519704,308,2,he,"('MOT', 'CHI')",Providence,lil77.xml,313,5,1,CHI,2491,2274,MOT
0,1,4,308,3.254886262,309,1,think,"('MOT', 'CHI')",Providence,lil77.xml,313,4,0,CHI,2491,2274,MOT
1,0,2,61,3.226843995,61,0,up,"('CHI', 'MOT')",Providence,lil77.xml,64,3,1,MOT,473,481,CHI
0,2,3,308,3.034952987,310,2,make,"('MOT', 'CHI')",Providence,lil77.xml,313,3,0,CHI,2491,2274,MOT
1,3,6,303,2.839728025,306,3,look,"('MOT', 'CHI')",Providence,lil77.xml,313,7,1,CHI,2491,2274,MOT
0,1,7,305,2.839728025,306,1,little,"('MOT', 'CHI')",Providence,lil77.xml,313,7,0,CHI,2491,2274,MOT
1,1,1,61,2.772588722,62,1,there,"('CHI', 'MOT')",Providence,lil77.xml,64,2,1,MOT,473,481,CHI
0,4,2,307,2.750470917,311,4,some,"('MOT', 'CHI')",Providence,lil77.xml,313,2,0,CHI,2491,2274,MOT
2,1,2,59,2.740840024,60,1,what,"('CHI', 'MOT')",Providence,lil77.xml,64,4,2,MOT,473,481,CHI
1,3,8,301,2.632542649,304,3,big,"('MOT', 'CHI')",Providence,lil77.xml,313,9,1,CHI,2491,2274,MOT
1,8,2,302,2.629487879,310,8,no,"('MOT', 'CHI')",Providence,lil77.xml,313,3,1,CHI,2491,2274,MOT
2,9,3,299,2.586689344,308,9,put,"('MOT', 'CHI')",Providence,lil77.xml,313,5,2,CHI,2491,2274,MOT
1,1,2,60,2.533696814,61,1,gonna,"('CHI', 'MOT')",Providence,lil77.xml,64,3,1,MOT,473,481,CHI
0,4,3,306,2.524127363,310,4,she,"('MOT', 'CHI')",Providence,lil77.xml,313,3,0,CHI,2491,2274,MOT
0,6,2,305,2.41399868,311,6,there,"('MOT', 'CHI')",Providence,lil77.xml,313,2,0,CHI,2491,2274,MOT
1,2,15,295,2.404606707,297,2,like,"('MOT', 'CHI')",Providence,lil77.xml,313,16,1,CHI,2491,2274,MOT
0,3,5,305,2.404367787,308,3,go,"('MOT', 'CHI')",Providence,lil77.xml,313,5,0,CHI,2491,2274,MOT
0,3,5,305,2.404367787,308,3,we,"('MOT', 'CHI')",Providence,lil77.xml,313,5,0,CHI,2491,2274,MOT
0,1,1,62,2.382627801,63,1,like,"('CHI', 'MOT')",Providence,lil77.xml,64,1,0,MOT,473,481,CHI
0,1,1,62,2.382627801,63,1,where,"('CHI', 'MOT')",Providence,lil77.xml,64,1,0,MOT,473,481,CHI
1,9,3,300,2.338595531,309,9,one,"('MOT', 'CHI')",Providence,lil77.xml,313,4,1,CHI,2491,2274,MOT
0,4,4,305,2.338595531,309,4,all,"('MOT', 'CHI')",Providence,lil77.xml,313,4,0,CHI,2491,2274,MOT
3,5,16,289,2.240371908,294,5,are,"('MOT', 'CHI')",Providence,lil77.xml,313,19,3,CHI,2491,2274,MOT
0,4,5,304,2.181224236,308,4,where,"('MOT', 'CHI')",Providence,lil77.xml,313,5,0,CHI,2491,2274,MOT
1,0,0,11,2.159484249,11,0,go,"('MOT', 'OPE')",Providence,lil77.xml,12,1,1,OPE,255,127,MOT
1,0,0,11,2.159484249,11,0,there,"('MOT', 'OPE')",Providence,lil77.xml,12,1,1,OPE,255,127,MOT
0,5,4,304,2.156273974,309,5,but,"('MOT', 'CHI')",Providence,lil77.xml,313,4,0,CHI,2491,2274,MOT
0,5,4,304,2.156273974,309,5,can,"('MOT', 'CHI')",Providence,lil77.xml,313,4,0,CHI,2491,2274,MOT
1,2,2,59,2.128231706,61,2,a,"('CHI', 'MOT')",Providence,lil77.xml,64,3,1,MOT,473,481,CHI
2,10,6,295,2.12497967,305,10,gonna,"('MOT', 'CHI')",Providence,lil77.xml,313,8,2,CHI,2491,2274,MOT
0,1,2,61,2.079441542,62,1,in,"('CHI', 'MOT')",Providence,lil77.xml,64,2,0,MOT,473,481,CHI
0,1,2,61,2.079441542,62,1,did,"('CHI', 'MOT')",Providence,lil77.xml,64,2,0,MOT,473,481,CHI
0,1,2,61,2.079441542,62,1,not,"('CHI', 'MOT')",Providence,lil77.xml,64,2,0,MOT,473,481,CHI
0,2,11,300,2.053466055,302,2,did,"('MOT', 'CHI')",Providence,lil77.xml,313,11,0,CHI,2491,2274,MOT
0,5,5,303,1.998902679,308,5,was,"('MOT', 'CHI')",Providence,lil77.xml,313,5,0,CHI,2491,2274,MOT
3,12,9,289,1.89602048,301,12,on,"('MOT', 'CHI')",Providence,lil77.xml,313,12,3,CHI,2491,2274,MOT
1,4,1,58,1.85629799,62,4,my,"('CHI', 'MOT')",Providence,lil77.xml,64,2,1,MOT,473,481,CHI
0,3,10,300,1.849110766,303,3,see,"('MOT', 'CHI')",Providence,lil77.xml,313,10,0,CHI,2491,2274,MOT
1,9,9,294,1.625967214,303,9,of,"('MOT', 'CHI')",Providence,lil77.xml,313,10,1,CHI,2491,2274,MOT
1,4,2,57,1.617406082,61,4,are,"('CHI', 'MOT')",Providence,lil77.xml,64,3,1,MOT,473,481,CHI
0,7,6,300,1.574458194,307,7,up,"('MOT', 'CHI')",Providence,lil77.xml,313,6,0,CHI,2491,2274,MOT
2,6,23,282,1.526746197,288,6,that,"('MOT', 'CHI')",Providence,lil77.xml,313,25,2,CHI,2491,2274,MOT
0,9,5,299,1.488077055,308,9,yeah,"('MOT', 'CHI')",Providence,lil77.xml,313,5,0,CHI,2491,2274,MOT
1,0,2,9,1.481604541,9,0,to,"('MOT', 'OPE')",Providence,lil77.xml,12,3,1,OPE,255,127,MOT
0,6,8,299,1.478352506,305,6,at,"('MOT', 'CHI')",Providence,lil77.xml,313,8,0,CHI,2491,2274,MOT
1,3,4,56,1.471816535,59,3,that,"('CHI', 'MOT')",Providence,lil77.xml,64,5,1,MOT,473,481,CHI
0,4,1,59,1.466337069,63,4,yeah,"('CHI', 'MOT')",Providence,lil77.xml,64,1,0,MOT,473,481,CHI
0,4,1,59,1.466337069,63,4,was,"('CHI', 'MOT')",Providence,lil77.xml,64,1,0,MOT,473,481,CHI
1,1,0,10,1.466337069,11,1,yeah,"('MOT', 'OPE')",Providence,lil77.xml,12,1,1,OPE,255,127,MOT
0,2,3,59,1.435084525,61,2,no,"('CHI', 'MOT')",Providence,lil77.xml,64,3,0,MOT,473,481,CHI
0,3,2,59,1.386294361,62,3,we,"('CHI', 'MOT')",Providence,lil77.xml,64,2,0,MOT,473,481,CHI
3,0,3,6,1.386294361,6,0,she,"('MOT', 'OPE')",Providence,lil77.xml,12,6,3,OPE,255,127,MOT
0,3,17,293,1.366360146,296,3,do,"('MOT', 'CHI')",Providence,lil77.xml,313,17,0,CHI,2491,2274,MOT
6,14,26,267,1.356946321,281,14,to,"('MOT', 'CHI')",Providence,lil77.xml,313,32,6,CHI,2491,2274,MOT
1,5,3,55,1.236762627,60,5,on,"('CHI', 'MOT')",Providence,lil77.xml,64,4,1,MOT,473,481,CHI
2,10,1,51,1.23441383,61,10,oh,"('CHI', 'MOT')",Providence,lil77.xml,64,3,2,MOT,473,481,CHI
1,3,6,54,1.187165686,57,3,go,"('CHI', 'MOT')",Providence,lil77.xml,64,7,1,MOT,473,481,CHI
4,21,17,271,1.06648101,292,21,it,"('MOT', 'CHI')",Providence,lil77.xml,313,21,4,CHI,2491,2274,MOT
3,14,23,273,1.012466338,287,14,the,"('MOT', 'CHI')",Providence,lil77.xml,313,26,3,CHI,2491,2274,MOT
1,0,0,2,0.980829253,2,0,it,"('CHI', 'OPE')",Providence,lil77.xml,3,1,1,OPE,16,22,CHI
1,0,0,2,0.980829253,2,0,what,"('CHI', 'OPE')",Providence,lil77.xml,3,1,1,OPE,16,22,CHI
1,10,18,284,0.941088924,294,10,in,"('MOT', 'CHI')",Providence,lil77.xml,313,19,1,CHI,2491,2274,MOT
2,6,6,50,0.910560057,56,6,and,"('CHI', 'MOT')",Providence,lil77.xml,64,8,2,MOT,473,481,CHI
0,1,1,10,0.773189888,11,1,it,"('MOT', 'OPE')",Providence,lil77.xml,12,1,0,OPE,255,127,MOT
0,1,1,10,0.773189888,11,1,of,"('MOT', 'OPE')",Providence,lil77.xml,12,1,0,OPE,255,127,MOT
0,1,1,10,0.773189888,11,1,they,"('MOT', 'OPE')",Providence,lil77.xml,12,1,0,OPE,255,127,MOT
0,1,1,10,0.773189888,11,1,what,"('MOT', 'OPE')",Providence,lil77.xml,12,1,0,OPE,255,127,MOT
0,1,1,10,0.773189888,11,1,the,"('MOT', 'OPE')",Providence,lil77.xml,12,1,0,OPE,255,127,MOT
0,1,1,10,0.773189888,11,1,on,"('MOT', 'OPE')",Providence,lil77.xml,12,1,0,OPE,255,127,MOT
0,14,8,291,0.716212453,305,14,for,"('MOT', 'CHI')",Providence,lil77.xml,313,8,0,CHI,2491,2274,MOT
0,1,1,9,0.693147181,10,1,yeah,"('OPE', 'MOT')",Providence,lil77.xml,11,1,0,MOT,88,88,OPE
0,1,1,9,0.693147181,10,1,a,"('OPE', 'MOT')",Providence,lil77.xml,11,1,0,MOT,88,88,OPE
1,8,4,51,0.660886318,59,8,you,"('CHI', 'MOT')",Providence,lil77.xml,64,5,1,MOT,473,481,CHI
0,11,12,290,0.589768826,301,11,with,"('MOT', 'CHI')",Providence,lil77.xml,313,12,0,CHI,2491,2274,MOT
1,5,8,50,0.546543706,55,5,is,"('CHI', 'MOT')",Providence,lil77.xml,64,9,1,MOT,473,481,CHI
1,1,3,7,0.510825624,8,1,was,"('MOT', 'OPE')",Providence,lil77.xml,12,4,1,OPE,255,127,MOT
1,6,7,50,0.505094949,56,6,to,"('CHI', 'MOT')",Providence,lil77.xml,64,8,1,MOT,473,481,CHI
3,7,11,43,0.485507816,50,7,the,"('CHI', 'MOT')",Providence,lil77.xml,64,14,3,MOT,473,481,CHI
0,4,6,54,0.405465108,58,4,it,"('CHI', 'MOT')",Providence,lil77.xml,64,6,0,MOT,473,481,CHI
0,5,5,54,0.373204246,59,5,have,"('CHI', 'MOT')",Providence,lil77.xml,64,5,0,MOT,473,481,CHI
6,30,36,241,0.337205106,271,30,is,"('MOT', 'CHI')",Providence,lil77.xml,313,42,6,CHI,2491,2274,MOT
0,1,2,8,0.318453731,9,1,in,"('OPE', 'MOT')",Providence,lil77.xml,11,2,0,MOT,88,88,OPE
0,1,2,8,0.318453731,9,1,like,"('OPE', 'MOT')",Providence,lil77.xml,11,2,0,MOT,88,88,OPE
1,3,1,6,0.318453731,9,3,is,"('OPE', 'MOT')",Providence,lil77.xml,11,2,1,MOT,88,88,OPE
2,1,4,4,0.271933715,5,1,the,"('OPE', 'MOT')",Providence,lil77.xml,11,6,2,MOT,88,88,OPE
0,16,13,284,0.169163472,300,16,have,"('MOT', 'CHI')",Providence,lil77.xml,313,13,0,CHI,2491,2274,MOT
0,1,3,8,0.09531018,9,1,like,"('MOT', 'OPE')",Providence,lil77.xml,12,3,0,OPE,255,127,MOT
0,1,3,8,0.09531018,9,1,a,"('MOT', 'OPE')",Providence,lil77.xml,12,3,0,OPE,255,127,MOT
0,1,3,8,0.09531018,9,1,do,"('MOT', 'OPE')",Providence,lil77.xml,12,3,0,OPE,255,127,MOT
0,3,1,7,0,10,3,you,"('OPE', 'MOT')",Providence,lil77.xml,11,1,0,MOT,88,88,OPE
0,2,2,7,-0.087011377,9,2,on,"('OPE', 'MOT')",Providence,lil77.xml,11,2,0,MOT,88,88,OPE
0,2,2,7,-0.087011377,9,2,and,"('OPE', 'MOT')",Providence,lil77.xml,11,2,0,MOT,88,88,OPE
0,1,4,7,-0.182321557,8,1,that,"('MOT', 'OPE')",Providence,lil77.xml,12,4,0,OPE,255,127,MOT
1,29,22,261,-0.250172224,290,29,my,"('MOT', 'CHI')",Providence,lil77.xml,313,23,1,CHI,2491,2274,MOT
0,2,3,7,-0.310154928,9,2,this,"('MOT', 'OPE')",Providence,lil77.xml,12,3,0,OPE,255,127,MOT
0,2,3,7,-0.310154928,9,2,is,"('MOT', 'OPE')",Providence,lil77.xml,12,3,0,OPE,255,127,MOT
2,32,31,248,-0.311336263,280,32,a,"('MOT', 'CHI')",Providence,lil77.xml,313,33,2,CHI,2491,2274,MOT
11,39,81,182,-0.340095815,221,39,you,"('MOT', 'CHI')",Providence,lil77.xml,313,92,11,CHI,2491,2274,MOT
1,2,5,4,-0.405465108,6,2,and,"('MOT', 'OPE')",Providence,lil77.xml,12,6,1,OPE,255,127,MOT
0,1,1,1,-0.405465108,2,1,you,"('CHI', 'OPE')",Providence,lil77.xml,3,1,0,OPE,16,22,CHI
2,30,38,243,-0.456273436,273,30,what,"('MOT', 'CHI')",Providence,lil77.xml,313,40,2,CHI,2491,2274,MOT
1,45,22,245,-0.677616239,290,45,and,"('MOT', 'CHI')",Providence,lil77.xml,313,23,1,CHI,2491,2274,MOT
1,3,5,3,-0.693147181,6,3,you,"('MOT', 'OPE')",Providence,lil77.xml,12,6,1,OPE,255,127,MOT
0,10,49,254,-0.746224597,264,10,oh,"('MOT', 'CHI')",Providence,lil77.xml,313,49,0,CHI,2491,2274,MOT
1,5,2,438,3.390024081,443,5,get,"('CHI', 'MOT')",Providence,lil78a.xml,446,3,1,MOT,2034,6046,CHI
0,7,1,438,2.924504764,445,7,where,"('CHI', 'MOT')",Providence,lil78a.xml,446,1,0,MOT,2034,6046,CHI
2,12,2,430,2.837728024,442,12,he,"('CHI', 'MOT')",Providence,lil78a.xml,446,4,2,MOT,2034,6046,CHI
1,4,8,433,2.770313408,437,4,want,"('CHI', 'MOT')",Providence,lil78a.xml,446,9,1,MOT,2034,6046,CHI
0,6,2,438,2.768114442,444,6,did,"('CHI', 'MOT')",Providence,lil78a.xml,446,2,0,MOT,2034,6046,CHI
4,13,4,425,2.754570217,438,13,look,"('CHI', 'MOT')",Providence,lil78a.xml,446,8,4,MOT,2034,6046,CHI
4,13,4,425,2.754570217,438,13,she,"('CHI', 'MOT')",Providence,lil78a.xml,446,8,4,MOT,2034,6046,CHI
1,14,1,430,2.69912157,444,14,there,"('CHI', 'MOT')",Providence,lil78a.xml,446,2,1,MOT,2034,6046,CHI
0,7,2,437,2.634583049,444,7,gonna,"('CHI', 'MOT')",Providence,lil78a.xml,446,2,0,MOT,2034,6046,CHI
1,15,1,429,2.634583049,444,15,little,"('CHI', 'MOT')",Providence,lil78a.xml,446,2,1,MOT,2034,6046,CHI
1,16,1,428,2.573958427,444,16,at,"('CHI', 'MOT')",Providence,lil78a.xml,446,2,1,MOT,2034,6046,CHI
0,11,1,434,2.519039656,445,11,they,"('CHI', 'MOT')",Providence,lil78a.xml,446,1,0,MOT,2034,6046,CHI
1,7,6,432,2.505525937,439,7,wanna,"('CHI', 'MOT')",Providence,lil78a.xml,446,7,1,MOT,2034,6046,CHI
3,14,5,424,2.462433794,438,14,with,"('CHI', 'MOT')",Providence,lil78a.xml,446,8,3,MOT,2034,6046,CHI
1,12,3,430,2.432262916,442,12,up,"('CHI', 'MOT')",Providence,lil78a.xml,446,4,1,MOT,2034,6046,CHI
3,17,5,421,2.280112237,438,17,on,"('CHI', 'MOT')",Providence,lil78a.xml,446,8,3,MOT,2034,6046,CHI
2,19,3,422,2.250539636,441,19,see,"('CHI', 'MOT')",Providence,lil78a.xml,446,5,2,MOT,2034,6046,CHI
0,15,1,430,2.231357584,445,15,some,"('CHI', 'MOT')",Providence,lil78a.xml,446,1,0,MOT,2034,6046,CHI
2,18,4,422,2.16604165,440,18,have,"('CHI', 'MOT')",Providence,lil78a.xml,446,6,2,MOT,2034,6046,CHI
0,10,3,433,2.090741097,443,10,put,"('CHI', 'MOT')",Providence,lil78a.xml,446,3,0,MOT,2034,6046,CHI
3,16,8,419,2.068064855,435,16,can,"('CHI', 'MOT')",Providence,lil78a.xml,446,11,3,MOT,2034,6046,CHI
1,12,6,427,2.020018121,439,12,go,"('CHI', 'MOT')",Providence,lil78a.xml,446,7,1,MOT,2034,6046,CHI
1,33,1,411,1.880811247,444,33,of,"('CHI', 'MOT')",Providence,lil78a.xml,446,2,1,MOT,2034,6046,CHI
0,19,2,425,1.718292317,444,19,are,"('CHI', 'MOT')",Providence,lil78a.xml,446,2,0,MOT,2034,6046,CHI
2,29,4,411,1.709283247,440,29,was,"('CHI', 'MOT')",Providence,lil78a.xml,446,6,2,MOT,2034,6046,CHI
3,19,11,413,1.691017899,432,19,do,"('CHI', 'MOT')",Providence,lil78a.xml,446,14,3,MOT,2034,6046,CHI
0,21,2,423,1.622982138,444,21,think,"('CHI', 'MOT')",Providence,lil78a.xml,446,2,0,MOT,2034,6046,CHI
12,29,22,383,1.606099011,412,29,it,"('CHI', 'MOT')",Providence,lil78a.xml,446,34,12,MOT,2034,6046,CHI
1,20,6,419,1.540445041,439,20,not,"('CHI', 'MOT')",Providence,lil78a.xml,446,7,1,MOT,2034,6046,CHI
1,0,1,7,1.504077397,7,0,yeah,"('MOT', 'OPE')",Providence,lil78a.xml,9,2,1,OPE,121,69,MOT
1,0,1,7,1.504077397,7,0,and,"('MOT', 'OPE')",Providence,lil78a.xml,9,2,1,OPE,121,69,MOT
4,22,16,404,1.442024439,426,22,one,"('CHI', 'MOT')",Providence,lil78a.xml,446,20,4,MOT,2034,6046,CHI
1,0,1,6,1.386294361,6,0,gonna,"('MOT', 'CHI')",Providence,lil78a.xml,8,2,1,CHI,78,36,MOT
12,55,11,368,1.372811011,423,55,a,"('CHI', 'MOT')",Providence,lil78a.xml,446,23,12,MOT,2034,6046,CHI
6,34,15,391,1.311851885,425,34,is,"('CHI', 'MOT')",Providence,lil78a.xml,446,21,6,MOT,2034,6046,CHI
0,19,4,423,1.30833282,442,19,for,"('CHI', 'MOT')",Providence,lil78a.xml,446,4,0,MOT,2034,6046,CHI
2,25,10,409,1.279100664,434,25,but,"('CHI', 'MOT')",Providence,lil78a.xml,446,12,2,MOT,2034,6046,CHI
0,22,4,420,1.168570877,442,22,like,"('CHI', 'MOT')",Providence,lil78a.xml,446,4,0,MOT,2034,6046,CHI
0,19,5,422,1.151927347,441,19,all,"('CHI', 'MOT')",Providence,lil78a.xml,446,5,0,MOT,2034,6046,CHI
1,31,6,408,1.119231576,439,31,we,"('CHI', 'MOT')",Providence,lil78a.xml,446,7,1,MOT,2034,6046,CHI
7,47,16,376,1.041453875,423,47,and,"('CHI', 'MOT')",Providence,lil78a.xml,446,23,7,MOT,2034,6046,CHI
1,41,5,399,0.967345903,440,41,my,"('CHI', 'MOT')",Providence,lil78a.xml,446,6,1,MOT,2034,6046,CHI
1,30,8,407,0.945764116,437,30,in,"('CHI', 'MOT')",Providence,lil78a.xml,446,9,1,MOT,2034,6046,CHI
6,69,9,362,0.934939291,431,69,the,"('CHI', 'MOT')",Providence,lil78a.xml,446,15,6,MOT,2034,6046,CHI
6,52,15,373,0.896908033,425,52,oh,"('CHI', 'MOT')",Providence,lil78a.xml,446,21,6,MOT,2034,6046,CHI
9,73,15,349,0.790156917,422,73,you,"('CHI', 'MOT')",Providence,lil78a.xml,446,24,9,MOT,2034,6046,CHI
0,22,7,417,0.756326082,439,22,this,"('CHI', 'MOT')",Providence,lil78a.xml,446,7,0,MOT,2034,6046,CHI
2,31,16,397,0.700929321,428,31,what,"('CHI', 'MOT')",Providence,lil78a.xml,446,18,2,MOT,2034,6046,CHI
3,15,48,380,0.627350006,395,15,no,"('CHI', 'MOT')",Providence,lil78a.xml,446,51,3,MOT,2034,6046,CHI
3,40,19,384,0.54910781,424,40,that,"('CHI', 'MOT')",Providence,lil78a.xml,446,22,3,MOT,2034,6046,CHI
0,1,1,7,0.510825624,8,1,go,"('MOT', 'OPE')",Providence,lil78a.xml,9,1,0,OPE,121,69,MOT
0,1,1,7,0.510825624,8,1,we,"('MOT', 'OPE')",Providence,lil78a.xml,9,1,0,OPE,121,69,MOT
0,1,1,7,0.510825624,8,1,was,"('MOT', 'OPE')",Providence,lil78a.xml,9,1,0,OPE,121,69,MOT
0,1,1,7,0.510825624,8,1,but,"('MOT', 'OPE')",Providence,lil78a.xml,9,1,0,OPE,121,69,MOT
0,1,1,7,0.510825624,8,1,think,"('MOT', 'OPE')",Providence,lil78a.xml,9,1,0,OPE,121,69,MOT
1,2,1,5,0.405465108,7,2,a,"('MOT', 'OPE')",Providence,lil78a.xml,9,2,1,OPE,121,69,MOT
0,1,1,6,0.405465108,7,1,it,"('MOT', 'CHI')",Providence,lil78a.xml,8,1,0,CHI,78,36,MOT
0,1,1,6,0.405465108,7,1,a,"('MOT', 'CHI')",Providence,lil78a.xml,8,1,0,CHI,78,36,MOT
0,1,1,6,0.405465108,7,1,up,"('MOT', 'CHI')",Providence,lil78a.xml,8,1,0,CHI,78,36,MOT
0,1,1,6,0.405465108,7,1,no,"('MOT', 'CHI')",Providence,lil78a.xml,8,1,0,CHI,78,36,MOT
0,1,1,6,0.405465108,7,1,and,"('MOT', 'CHI')",Providence,lil78a.xml,8,1,0,CHI,78,36,MOT
0,1,1,6,0.405465108,7,1,is,"('OPE', 'MOT')",Providence,lil78a.xml,8,1,0,MOT,49,48,OPE
0,1,1,6,0.405465108,7,1,do,"('OPE', 'MOT')",Providence,lil78a.xml,8,1,0,MOT,49,48,OPE
1,16,30,399,0.396512497,415,16,yeah,"('CHI', 'MOT')",Providence,lil78a.xml,446,31,1,MOT,2034,6046,CHI
0,1,2,6,0.117783036,7,1,to,"('MOT', 'OPE')",Providence,lil78a.xml,9,2,0,OPE,121,69,MOT
1,51,13,381,0.042359274,432,51,to,"('CHI', 'MOT')",Providence,lil78a.xml,446,14,1,MOT,2034,6046,CHI
0,2,1,5,0,7,2,you,"('OPE', 'MOT')",Providence,lil78a.xml,8,1,0,MOT,49,48,OPE
0,2,2,5,-0.287682072,7,2,there,"('MOT', 'OPE')",Providence,lil78a.xml,9,2,0,OPE,121,69,MOT
0,3,2,4,-0.575364145,7,3,in,"('MOT', 'OPE')",Providence,lil78a.xml,9,2,0,OPE,121,69,MOT
3,1,10,335,3.808142875,336,1,little,"('MOT', 'CHI')",Providence,lil78b.xml,349,13,3,CHI,5321,1558,MOT
2,0,0,43,3.518980417,43,0,big,"('CHI', 'MOT')",Providence,lil78b.xml,45,2,2,MOT,208,445,CHI
2,2,7,338,3.436915464,340,2,put,"('MOT', 'CHI')",Providence,lil78b.xml,349,9,2,CHI,5321,1558,MOT
7,1,37,304,3.284500712,305,1,we,"('MOT', 'CHI')",Providence,lil78b.xml,349,44,7,CHI,5321,1558,MOT
1,1,10,337,3.26399626,338,1,she,"('MOT', 'CHI')",Providence,lil78b.xml,349,11,1,CHI,5321,1558,MOT
1,2,7,339,3.129680246,341,2,was,"('MOT', 'CHI')",Providence,lil78b.xml,349,8,1,CHI,5321,1558,MOT
1,1,13,334,3.047494208,335,1,there,"('MOT', 'CHI')",Providence,lil78b.xml,349,14,1,CHI,5321,1558,MOT
1,1,17,330,2.812410216,331,1,get,"('MOT', 'CHI')",Providence,lil78b.xml,349,18,1,CHI,5321,1558,MOT
2,2,18,327,2.711075922,329,2,see,"('MOT', 'CHI')",Providence,lil78b.xml,349,20,2,CHI,5321,1558,MOT
1,2,13,333,2.6420291,335,2,big,"('MOT', 'CHI')",Providence,lil78b.xml,349,14,1,CHI,5321,1558,MOT
0,2,7,340,2.544804791,342,2,did,"('MOT', 'CHI')",Providence,lil78b.xml,349,7,0,CHI,5321,1558,MOT
1,1,23,324,2.531863633,325,1,they,"('MOT', 'CHI')",Providence,lil78b.xml,349,24,1,CHI,5321,1558,MOT
2,2,23,322,2.491060515,324,2,where,"('MOT', 'CHI')",Providence,lil78b.xml,349,25,2,CHI,5321,1558,MOT
4,5,17,323,2.481276882,328,5,gonna,"('MOT', 'CHI')",Providence,lil78b.xml,349,21,4,CHI,5321,1558,MOT
1,4,9,335,2.430685096,339,4,want,"('MOT', 'CHI')",Providence,lil78b.xml,349,10,1,CHI,5321,1558,MOT
2,1,2,40,2.374905755,41,1,and,"('CHI', 'MOT')",Providence,lil78b.xml,45,4,2,MOT,208,445,CHI
3,6,13,327,2.364142986,333,6,some,"('MOT', 'CHI')",Providence,lil78b.xml,349,16,3,CHI,5321,1558,MOT
0,1,14,334,2.354347028,335,1,like,"('MOT', 'CHI')",Providence,lil78b.xml,349,14,0,CHI,5321,1558,MOT
1,2,0,42,2.324564,44,2,see,"('CHI', 'MOT')",Providence,lil78b.xml,45,1,1,MOT,208,445,CHI
1,3,14,331,2.290750635,334,3,for,"('MOT', 'CHI')",Providence,lil78b.xml,349,15,1,CHI,5321,1558,MOT
3,2,1,39,2.257122719,41,2,are,"('CHI', 'MOT')",Providence,lil78b.xml,45,4,3,MOT,208,445,CHI
1,1,31,316,2.238830578,317,1,that,"('MOT', 'CHI')",Providence,lil78b.xml,349,32,1,CHI,5321,1558,MOT
2,1,45,301,2.230672511,302,1,oh,"('MOT', 'CHI')",Providence,lil78b.xml,349,47,2,CHI,5321,1558,MOT
3,6,16,324,2.200996743,330,6,go,"('MOT', 'CHI')",Providence,lil78b.xml,349,19,3,CHI,5321,1558,MOT
0,1,18,330,2.119263036,331,1,but,"('MOT', 'CHI')",Providence,lil78b.xml,349,18,0,CHI,5321,1558,MOT
0,2,12,335,2.088330489,337,2,wanna,"('MOT', 'CHI')",Providence,lil78b.xml,349,12,0,CHI,5321,1558,MOT
1,2,1,41,2.014903021,43,2,little,"('CHI', 'MOT')",Providence,lil78b.xml,45,2,1,MOT,208,445,CHI
4,4,0,37,1.969440646,41,4,the,"('CHI', 'MOT')",Providence,lil78b.xml,45,4,4,MOT,208,445,CHI
0,2,14,333,1.948881919,335,2,at,"('MOT', 'CHI')",Providence,lil78b.xml,349,14,0,CHI,5321,1558,MOT
1,4,18,326,1.844321799,330,4,of,"('MOT', 'CHI')",Providence,lil78b.xml,349,19,1,CHI,5321,1558,MOT
0,4,9,336,1.827477552,340,4,not,"('MOT', 'CHI')",Providence,lil78b.xml,349,9,0,CHI,5321,1558,MOT
1,4,0,40,1.813738376,44,4,it,"('CHI', 'MOT')",Providence,lil78b.xml,45,1,1,MOT,208,445,CHI
1,1,1,20,1.749199855,21,1,oh,"('MOT', 'OPE')",Providence,lil78b.xml,23,2,1,OPE,330,113,MOT
0,1,2,42,1.727220948,43,1,with,"('CHI', 'MOT')",Providence,lil78b.xml,45,2,0,MOT,208,445,CHI
0,3,14,332,1.661199847,335,3,up,"('MOT', 'CHI')",Providence,lil78b.xml,349,14,0,CHI,5321,1558,MOT
2,1,7,35,1.645155995,36,1,yeah,"('CHI', 'MOT')",Providence,lil78b.xml,45,9,2,MOT,208,445,CHI
0,2,1,42,1.631416819,44,2,look,"('CHI', 'MOT')",Providence,lil78b.xml,45,1,0,MOT,208,445,CHI
3,4,45,297,1.578566249,301,4,in,"('MOT', 'CHI')",Providence,lil78b.xml,349,48,3,CHI,5321,1558,MOT
1,3,31,314,1.545683398,317,3,are,"('MOT', 'CHI')",Providence,lil78b.xml,349,32,1,CHI,5321,1558,MOT
1,4,1,39,1.504077397,43,4,on,"('CHI', 'MOT')",Providence,lil78b.xml,45,2,1,MOT,208,445,CHI
1,6,0,38,1.477266139,44,6,is,"('CHI', 'MOT')",Providence,lil78b.xml,45,1,1,MOT,208,445,CHI
4,5,2,34,1.451808968,39,5,a,"('CHI', 'MOT')",Providence,lil78b.xml,45,6,4,MOT,208,445,CHI
0,1,1,21,1.386294361,22,1,go,"('MOT', 'OPE')",Providence,lil78b.xml,23,1,0,OPE,330,113,MOT
0,1,1,21,1.386294361,22,1,in,"('MOT', 'OPE')",Providence,lil78b.xml,23,1,0,OPE,330,113,MOT
0,1,1,21,1.386294361,22,1,we,"('MOT', 'OPE')",Providence,lil78b.xml,23,1,0,OPE,330,113,MOT
1,15,8,325,1.357473923,340,15,my,"('MOT', 'CHI')",Providence,lil78b.xml,349,9,1,CHI,5321,1558,MOT
0,3,1,41,1.343734747,44,3,to,"('CHI', 'MOT')",Providence,lil78b.xml,45,1,0,MOT,208,445,CHI
2,9,23,315,1.287087711,324,9,on,"('MOT', 'CHI')",Providence,lil78b.xml,349,25,2,CHI,5321,1558,MOT
0,6,12,331,1.241032629,337,6,make,"('MOT', 'CHI')",Providence,lil78b.xml,349,12,0,CHI,5321,1558,MOT
0,8,9,332,1.239690887,340,8,look,"('MOT', 'CHI')",Providence,lil78b.xml,349,9,0,CHI,5321,1558,MOT
5,10,42,292,1.2190716,302,10,a,"('MOT', 'CHI')",Providence,lil78b.xml,349,47,5,CHI,5321,1558,MOT
6,10,0,29,1.182145401,39,10,you,"('CHI', 'MOT')",Providence,lil78b.xml,45,6,6,MOT,208,445,CHI
1,6,1,37,1.16760516,43,6,oh,"('CHI', 'MOT')",Providence,lil78b.xml,45,2,1,MOT,208,445,CHI
4,7,53,285,1.136038694,292,7,what,"('MOT', 'CHI')",Providence,lil78b.xml,349,57,4,CHI,5321,1558,MOT
1,14,12,322,1.100092674,336,14,one,"('MOT', 'CHI')",Providence,lil78b.xml,349,13,1,CHI,5321,1558,MOT
0,1,2,20,1.056052674,21,1,can,"('MOT', 'OPE')",Providence,lil78b.xml,23,2,0,OPE,330,113,MOT
0,1,2,20,1.056052674,21,1,are,"('MOT', 'OPE')",Providence,lil78b.xml,23,2,0,OPE,330,113,MOT
1,1,4,17,1.049822124,18,1,a,"('MOT', 'OPE')",Providence,lil78b.xml,23,5,1,OPE,330,113,MOT
0,5,18,326,1.020650747,331,5,with,"('MOT', 'CHI')",Providence,lil78b.xml,349,18,0,CHI,5321,1558,MOT
0,2,1,20,0.980829253,22,2,of,"('MOT', 'OPE')",Providence,lil78b.xml,23,1,0,OPE,330,113,MOT
2,24,12,311,0.927230672,335,24,no,"('MOT', 'CHI')",Providence,lil78b.xml,349,14,2,CHI,5321,1558,MOT
1,13,16,319,0.920791865,332,13,this,"('MOT', 'CHI')",Providence,lil78b.xml,349,17,1,CHI,5321,1558,MOT
0,8,14,327,0.850269631,335,8,have,"('MOT', 'CHI')",Providence,lil78b.xml,349,14,0,CHI,5321,1558,MOT
3,9,47,290,0.839575814,299,9,to,"('MOT', 'CHI')",Providence,lil78b.xml,349,50,3,CHI,5321,1558,MOT
0,1,3,19,0.78845736,20,1,that,"('MOT', 'OPE')",Providence,lil78b.xml,23,3,0,OPE,330,113,MOT
2,22,18,307,0.674193995,329,22,can,"('MOT', 'CHI')",Providence,lil78b.xml,349,20,2,CHI,5321,1558,MOT
5,14,53,277,0.669537315,291,14,is,"('MOT', 'CHI')",Providence,lil78b.xml,349,58,5,CHI,5321,1558,MOT
0,7,1,37,0.650587566,44,7,he,"('CHI', 'MOT')",Providence,lil78b.xml,45,1,0,MOT,208,445,CHI
0,1,4,18,0.559615788,19,1,it,"('MOT', 'OPE')",Providence,lil78b.xml,23,4,0,OPE,330,113,MOT
0,1,4,18,0.559615788,19,1,what,"('MOT', 'OPE')",Providence,lil78b.xml,23,4,0,OPE,330,113,MOT
0,1,4,18,0.559615788,19,1,the,"('MOT', 'OPE')",Providence,lil78b.xml,23,4,0,OPE,330,113,MOT
6,24,45,274,0.460524885,298,24,and,"('MOT', 'CHI')",Providence,lil78b.xml,349,51,6,CHI,5321,1558,MOT
0,2,3,18,0.382992252,20,2,like,"('MOT', 'OPE')",Providence,lil78b.xml,23,3,0,OPE,330,113,MOT
0,1,5,17,0.356674944,18,1,she,"('MOT', 'OPE')",Providence,lil78b.xml,23,5,0,OPE,330,113,MOT
1,26,15,307,0.321069088,333,26,yeah,"('MOT', 'CHI')",Providence,lil78b.xml,349,16,1,CHI,5321,1558,MOT
6,21,59,263,0.306166887,284,21,the,"('MOT', 'CHI')",Providence,lil78b.xml,349,65,6,CHI,5321,1558,MOT
5,28,45,271,0.180330185,299,28,it,"('MOT', 'CHI')",Providence,lil78b.xml,349,50,5,CHI,5321,1558,MOT
0,2,4,17,0.15415068,19,2,is,"('MOT', 'OPE')",Providence,lil78b.xml,23,4,0,OPE,330,113,MOT
4,12,92,241,0.000784621,253,12,you,"('MOT', 'CHI')",Providence,lil78b.xml,349,96,4,CHI,5321,1558,MOT
1,2,1,2,0,4,2,and,"('OPE', 'CHI')",Providence,lil78b.xml,6,2,1,CHI,28,40,OPE
0,1,1,3,0,4,1,a,"('OPE', 'MOT')",Providence,lil78b.xml,5,1,0,MOT,15,32,OPE
0,1,1,3,0,4,1,is,"('OPE', 'MOT')",Providence,lil78b.xml,5,1,0,MOT,15,32,OPE
0,3,7,13,-0.693147181,16,3,you,"('MOT', 'OPE')",Providence,lil78b.xml,23,7,0,OPE,330,113,MOT
1,0,0,51,3.564826805,51,0,did,"('MOT', 'OPE')",Providence,lil79.xml,52,1,1,OPE,764,394,MOT
1,2,9,408,3.130651591,410,2,get,"('MOT', 'CHI')",Providence,lil79.xml,420,10,1,CHI,4537,2452,MOT
0,4,2,414,3.044522438,418,4,did,"('MOT', 'CHI')",Providence,lil79.xml,420,2,0,CHI,4537,2452,MOT
2,4,9,405,2.942818233,409,4,not,"('MOT', 'CHI')",Providence,lil79.xml,420,11,2,CHI,4537,2452,MOT
1,8,3,408,2.739644567,416,8,some,"('MOT', 'CHI')",Providence,lil79.xml,420,4,1,CHI,4537,2452,MOT
0,1,12,407,2.68395265,408,1,up,"('MOT', 'CHI')",Providence,lil79.xml,420,12,0,CHI,4537,2452,MOT
0,5,3,412,2.636673538,417,5,there,"('MOT', 'CHI')",Providence,lil79.xml,420,3,0,CHI,4537,2452,MOT
0,5,3,412,2.636673538,417,5,big,"('MOT', 'CHI')",Providence,lil79.xml,420,3,0,CHI,4537,2452,MOT
0,3,6,411,2.564949357,414,3,he,"('MOT', 'CHI')",Providence,lil79.xml,420,6,0,CHI,4537,2452,MOT
0,4,5,411,2.47773816,415,4,where,"('MOT', 'CHI')",Providence,lil79.xml,420,5,0,CHI,4537,2452,MOT
0,3,8,409,2.33698652,412,3,all,"('MOT', 'CHI')",Providence,lil79.xml,420,8,0,CHI,4537,2452,MOT
0,2,13,405,2.207052666,407,2,my,"('MOT', 'CHI')",Providence,lil79.xml,420,13,0,CHI,4537,2452,MOT
0,1,1,50,2.178532444,51,1,where,"('MOT', 'OPE')",Providence,lil79.xml,52,1,0,OPE,764,394,MOT
1,0,0,11,2.159484249,11,0,what,"('OPE', 'MOT')",Providence,lil79.xml,12,1,1,MOT,116,162,OPE
1,0,0,11,2.159484249,11,0,can,"('OPE', 'MOT')",Providence,lil79.xml,12,1,1,MOT,116,162,OPE
0,3,10,407,2.149822338,410,3,they,"('MOT', 'CHI')",Providence,lil79.xml,420,10,0,CHI,4537,2452,MOT
0,1,1,43,2.036881927,44,1,go,"('CHI', 'MOT')",Providence,lil79.xml,45,1,0,MOT,202,580,CHI
0,1,1,43,2.036881927,44,1,but,"('CHI', 'MOT')",Providence,lil79.xml,45,1,0,MOT,202,580,CHI
0,1,1,43,2.036881927,44,1,did,"('CHI', 'MOT')",Providence,lil79.xml,45,1,0,MOT,202,580,CHI
0,1,1,43,2.036881927,44,1,are,"('CHI', 'MOT')",Providence,lil79.xml,45,1,0,MOT,202,580,CHI
0,2,18,400,1.907070316,402,2,put,"('MOT', 'CHI')",Providence,lil79.xml,420,18,0,CHI,4537,2452,MOT
0,1,2,49,1.871802177,50,1,up,"('MOT', 'OPE')",Providence,lil79.xml,52,2,0,OPE,764,394,MOT
0,4,11,405,1.844205945,409,4,was,"('MOT', 'CHI')",Providence,lil79.xml,420,11,0,CHI,4537,2452,MOT
0,2,1,49,1.773067336,51,2,look,"('MOT', 'OPE')",Providence,lil79.xml,52,1,0,OPE,764,394,MOT
6,12,29,373,1.728467572,385,12,what,"('MOT', 'CHI')",Providence,lil79.xml,420,35,6,CHI,4537,2452,MOT
1,3,1,40,1.727220948,43,3,little,"('CHI', 'MOT')",Providence,lil79.xml,45,2,1,MOT,202,580,CHI
0,2,1,42,1.631416819,44,2,was,"('CHI', 'MOT')",Providence,lil79.xml,45,1,0,MOT,202,580,CHI
0,1,3,48,1.62924054,49,1,some,"('MOT', 'OPE')",Providence,lil79.xml,52,3,0,OPE,764,394,MOT
0,4,14,402,1.62924054,406,4,think,"('MOT', 'CHI')",Providence,lil79.xml,420,14,0,CHI,4537,2452,MOT
1,8,15,396,1.611904005,404,8,but,"('MOT', 'CHI')",Providence,lil79.xml,420,16,1,CHI,4537,2452,MOT
1,10,12,397,1.600916863,407,10,look,"('MOT', 'CHI')",Providence,lil79.xml,420,13,1,CHI,4537,2452,MOT
0,4,15,401,1.566161929,405,4,little,"('MOT', 'CHI')",Providence,lil79.xml,420,15,0,CHI,4537,2452,MOT
2,11,18,389,1.519115274,400,11,wanna,"('MOT', 'CHI')",Providence,lil79.xml,420,20,2,CHI,4537,2452,MOT
2,17,11,390,1.513905486,407,17,want,"('MOT', 'CHI')",Providence,lil79.xml,420,13,2,CHI,4537,2452,MOT
0,6,11,403,1.507733708,409,6,at,"('MOT', 'CHI')",Providence,lil79.xml,420,11,0,CHI,4537,2452,MOT
2,1,0,9,1.504077397,10,1,in,"('OPE', 'MOT')",Providence,lil79.xml,12,2,2,MOT,116,162,OPE
2,1,0,9,1.504077397,10,1,like,"('OPE', 'MOT')",Providence,lil79.xml,12,2,2,MOT,116,162,OPE
2,7,29,382,1.491370746,389,7,make,"('MOT', 'CHI')",Providence,lil79.xml,420,31,2,CHI,4537,2452,MOT
0,3,1,48,1.485385264,51,3,see,"('MOT', 'OPE')",Providence,lil79.xml,52,1,0,OPE,764,394,MOT
1,3,2,39,1.481604541,42,3,at,"('CHI', 'MOT')",Providence,lil79.xml,45,3,1,MOT,202,580,CHI
1,0,2,9,1.481604541,9,0,she,"('OPE', 'MOT')",Providence,lil79.xml,12,3,1,MOT,116,162,OPE
0,1,3,41,1.481604541,42,1,can,"('CHI', 'MOT')",Providence,lil79.xml,45,3,0,MOT,202,580,CHI
0,2,2,48,1.466337069,50,2,for,"('MOT', 'OPE')",Providence,lil79.xml,52,2,0,OPE,764,394,MOT
0,2,2,48,1.466337069,50,2,no,"('MOT', 'OPE')",Providence,lil79.xml,52,2,0,OPE,764,394,MOT
2,12,18,388,1.439072566,400,12,have,"('MOT', 'CHI')",Providence,lil79.xml,420,20,2,CHI,4537,2452,MOT
0,8,9,403,1.428327743,411,8,go,"('MOT', 'CHI')",Providence,lil79.xml,420,9,0,CHI,4537,2452,MOT
0,1,4,47,1.427116356,48,1,have,"('MOT', 'OPE')",Providence,lil79.xml,52,4,0,OPE,764,394,MOT
0,1,4,47,1.427116356,48,1,they,"('MOT', 'OPE')",Providence,lil79.xml,52,4,0,OPE,764,394,MOT
0,1,4,47,1.427116356,48,1,can,"('MOT', 'OPE')",Providence,lil79.xml,52,4,0,OPE,764,394,MOT
0,1,4,47,1.427116356,48,1,do,"('MOT', 'OPE')",Providence,lil79.xml,52,4,0,OPE,764,394,MOT
1,1,8,42,1.408767217,43,1,she,"('MOT', 'OPE')",Providence,lil79.xml,52,9,1,OPE,764,394,MOT
6,24,20,370,1.376244025,394,24,yeah,"('MOT', 'CHI')",Providence,lil79.xml,420,26,6,CHI,4537,2452,MOT
1,10,16,393,1.354699996,403,10,for,"('MOT', 'CHI')",Providence,lil79.xml,420,17,1,CHI,4537,2452,MOT
1,7,0,37,1.343734747,44,7,see,"('CHI', 'MOT')",Providence,lil79.xml,45,1,1,MOT,202,580,CHI
0,3,1,41,1.343734747,44,3,that,"('CHI', 'MOT')",Providence,lil79.xml,45,1,0,MOT,202,580,CHI
1,2,6,43,1.247457916,45,2,it,"('MOT', 'OPE')",Providence,lil79.xml,52,7,1,OPE,764,394,MOT
0,2,3,47,1.223775432,49,2,gonna,"('MOT', 'OPE')",Providence,lil79.xml,52,3,0,OPE,764,394,MOT
5,12,44,359,1.216562899,371,12,a,"('MOT', 'CHI')",Providence,lil79.xml,420,49,5,CHI,4537,2452,MOT
0,3,2,47,1.178654996,50,3,there,"('MOT', 'OPE')",Providence,lil79.xml,52,2,0,OPE,764,394,MOT
0,3,2,47,1.178654996,50,3,at,"('MOT', 'OPE')",Providence,lil79.xml,52,2,0,OPE,764,394,MOT
2,10,0,33,1.121085145,43,10,is,"('CHI', 'MOT')",Providence,lil79.xml,45,2,2,MOT,202,580,CHI
0,4,1,40,1.120591195,44,4,yeah,"('CHI', 'MOT')",Providence,lil79.xml,45,1,0,MOT,202,580,CHI
0,4,1,40,1.120591195,44,4,no,"('CHI', 'MOT')",Providence,lil79.xml,45,1,0,MOT,202,580,CHI
0,5,20,395,1.113650166,400,5,gonna,"('MOT', 'CHI')",Providence,lil79.xml,420,20,0,CHI,4537,2452,MOT
1,11,20,388,1.066707742,399,11,see,"('MOT', 'CHI')",Providence,lil79.xml,420,21,1,CHI,4537,2452,MOT
5,13,48,354,1.056165598,367,13,do,"('MOT', 'CHI')",Providence,lil79.xml,420,53,5,CHI,4537,2452,MOT
0,3,2,40,1.034073768,43,3,in,"('CHI', 'MOT')",Providence,lil79.xml,45,2,0,MOT,202,580,CHI
0,2,4,46,1.021651248,48,2,go,"('MOT', 'OPE')",Providence,lil79.xml,52,4,0,OPE,764,394,MOT
0,2,4,46,1.021651248,48,2,but,"('MOT', 'OPE')",Providence,lil79.xml,52,4,0,OPE,764,394,MOT
0,2,4,46,1.021651248,48,2,all,"('MOT', 'OPE')",Providence,lil79.xml,52,4,0,OPE,764,394,MOT
0,2,4,46,1.021651248,48,2,is,"('MOT', 'OPE')",Providence,lil79.xml,52,4,0,OPE,764,394,MOT
0,2,4,46,1.021651248,48,2,think,"('MOT', 'OPE')",Providence,lil79.xml,52,4,0,OPE,764,394,MOT
0,2,4,46,1.021651248,48,2,not,"('MOT', 'OPE')",Providence,lil79.xml,52,4,0,OPE,764,394,MOT
0,6,19,395,1.008503975,401,6,of,"('MOT', 'CHI')",Providence,lil79.xml,420,19,0,CHI,4537,2452,MOT
4,9,62,345,0.962275845,354,9,we,"('MOT', 'CHI')",Providence,lil79.xml,420,66,4,CHI,4537,2452,MOT
0,4,2,46,0.955511445,50,4,in,"('MOT', 'OPE')",Providence,lil79.xml,52,2,0,OPE,764,394,MOT
0,5,1,39,0.938269639,44,5,we,"('CHI', 'MOT')",Providence,lil79.xml,45,1,0,MOT,202,580,CHI
1,6,2,36,0.921988753,42,6,you,"('CHI', 'MOT')",Providence,lil79.xml,45,3,1,MOT,202,580,CHI
1,6,2,36,0.921988753,42,6,look,"('CHI', 'MOT')",Providence,lil79.xml,45,3,1,MOT,202,580,CHI
0,8,16,396,0.918756824,404,8,are,"('MOT', 'CHI')",Providence,lil79.xml,420,16,0,CHI,4537,2452,MOT
1,8,1,35,0.916290732,43,8,it,"('CHI', 'MOT')",Providence,lil79.xml,45,2,1,MOT,202,580,CHI
1,15,18,386,0.874972583,401,15,no,"('MOT', 'CHI')",Providence,lil79.xml,420,19,1,CHI,4537,2452,MOT
1,7,39,373,0.821456629,380,7,on,"('MOT', 'CHI')",Providence,lil79.xml,420,40,1,CHI,4537,2452,MOT
0,3,3,39,0.78845736,42,3,this,"('CHI', 'MOT')",Providence,lil79.xml,45,3,0,MOT,202,580,CHI
0,6,1,38,0.784118959,44,6,a,"('CHI', 'MOT')",Providence,lil79.xml,45,1,0,MOT,202,580,CHI
4,17,42,357,0.777454287,374,17,and,"('MOT', 'CHI')",Providence,lil79.xml,420,46,4,CHI,4537,2452,MOT
0,1,1,10,0.773189888,11,1,yeah,"('OPE', 'MOT')",Providence,lil79.xml,12,1,0,MOT,116,162,OPE
0,1,1,10,0.773189888,11,1,all,"('OPE', 'MOT')",Providence,lil79.xml,12,1,0,MOT,116,162,OPE
0,1,1,10,0.773189888,11,1,my,"('OPE', 'MOT')",Providence,lil79.xml,12,1,0,MOT,116,162,OPE
0,1,1,10,0.773189888,11,1,do,"('OPE', 'MOT')",Providence,lil79.xml,12,1,0,MOT,116,162,OPE
0,1,1,10,0.773189888,11,1,to,"('OPE', 'MOT')",Providence,lil79.xml,12,1,0,MOT,116,162,OPE
0,1,1,10,0.773189888,11,1,and,"('OPE', 'MOT')",Providence,lil79.xml,12,1,0,MOT,116,162,OPE
0,5,29,386,0.748062938,391,5,like,"('MOT', 'CHI')",Providence,lil79.xml,420,29,0,CHI,4537,2452,MOT
0,3,4,45,0.733969175,48,3,this,"('MOT', 'OPE')",Providence,lil79.xml,52,4,0,OPE,764,394,MOT
4,31,24,361,0.718855537,392,31,one,"('MOT', 'CHI')",Providence,lil79.xml,420,28,4,CHI,4537,2452,MOT
1,12,27,380,0.703351351,392,12,with,"('MOT', 'CHI')",Providence,lil79.xml,420,28,1,CHI,4537,2452,MOT
1,5,4,35,0.693147181,40,5,what,"('CHI', 'MOT')",Providence,lil79.xml,45,5,1,MOT,202,580,CHI
4,17,48,351,0.643585114,368,17,to,"('MOT', 'CHI')",Providence,lil79.xml,420,52,4,CHI,4537,2452,MOT
9,37,41,333,0.632649069,370,37,it,"('MOT', 'CHI')",Providence,lil79.xml,420,50,9,CHI,4537,2452,MOT
1,4,7,40,0.609765572,44,4,that,"('MOT', 'OPE')",Providence,lil79.xml,52,8,1,OPE,764,394,MOT
1,2,12,37,0.600056757,39,2,oh,"('MOT', 'OPE')",Providence,lil79.xml,52,13,1,OPE,764,394,MOT
0,2,7,43,0.554310736,45,2,are,"('MOT', 'OPE')",Providence,lil79.xml,52,7,0,OPE,764,394,MOT
0,8,1,36,0.53280453,44,8,like,"('CHI', 'MOT')",Providence,lil79.xml,45,1,0,MOT,202,580,CHI
1,12,36,371,0.417879511,383,12,oh,"('MOT', 'CHI')",Providence,lil79.xml,420,37,1,CHI,4537,2452,MOT
0,1,2,9,0.405465108,10,1,there,"('OPE', 'MOT')",Providence,lil79.xml,12,2,0,MOT,116,162,OPE
0,2,1,9,0.36772478,11,2,are,"('OPE', 'MOT')",Providence,lil79.xml,12,1,0,MOT,116,162,OPE
1,9,3,32,0.360002734,41,9,the,"('CHI', 'MOT')",Providence,lil79.xml,45,4,1,MOT,202,580,CHI
1,4,1,6,0.182321557,10,4,you,"('OPE', 'MOT')",Providence,lil79.xml,12,2,1,MOT,116,162,OPE
0,6,4,42,0.174353387,48,6,of,"('MOT', 'OPE')",Providence,lil79.xml,52,4,0,OPE,764,394,MOT
0,9,2,34,0.117783036,43,9,and,"('CHI', 'MOT')",Providence,lil79.xml,45,2,0,MOT,202,580,CHI
0,7,41,372,0.102157718,379,7,in,"('MOT', 'CHI')",Providence,lil79.xml,420,41,0,CHI,4537,2452,MOT
0,1,3,8,0.09531018,9,1,a,"('OPE', 'MOT')",Providence,lil79.xml,12,3,0,MOT,116,162,OPE
0,3,1,8,0.080042708,11,3,oh,"('OPE', 'MOT')",Providence,lil79.xml,12,1,0,MOT,116,162,OPE
0,4,7,41,0.043485112,45,4,like,"('MOT', 'OPE')",Providence,lil79.xml,52,7,0,OPE,764,394,MOT
0,8,39,373,0.037238345,381,8,this,"('MOT', 'CHI')",Providence,lil79.xml,420,39,0,CHI,4537,2452,MOT
0,3,9,40,0.022472856,43,3,was,"('MOT', 'OPE')",Providence,lil79.xml,52,9,0,OPE,764,394,MOT
0,5,6,41,0,46,5,we,"('MOT', 'OPE')",Providence,lil79.xml,52,6,0,OPE,764,394,MOT
0,5,6,41,0,46,5,to,"('MOT', 'OPE')",Providence,lil79.xml,52,6,0,OPE,764,394,MOT
0,2,2,8,0,10,2,the,"('OPE', 'MOT')",Providence,lil79.xml,12,2,0,MOT,116,162,OPE
0,10,34,376,-0.020408872,386,10,is,"('MOT', 'CHI')",Providence,lil79.xml,420,34,0,CHI,4537,2452,MOT
15,43,102,260,-0.070412628,303,43,you,"('MOT', 'CHI')",Providence,lil79.xml,420,117,15,CHI,4537,2452,MOT
1,5,12,34,-0.093090423,39,5,a,"('MOT', 'OPE')",Providence,lil79.xml,52,13,1,OPE,764,394,MOT
1,40,21,358,-0.207014169,398,40,can,"('MOT', 'CHI')",Providence,lil79.xml,420,22,1,CHI,4537,2452,MOT
0,2,3,7,-0.310154928,9,2,that,"('OPE', 'MOT')",Providence,lil79.xml,12,3,0,MOT,116,162,OPE
0,3,13,36,-0.380772496,39,3,and,"('MOT', 'OPE')",Providence,lil79.xml,52,13,0,OPE,764,394,MOT
1,11,8,32,-0.382992252,43,11,yeah,"('MOT', 'OPE')",Providence,lil79.xml,52,9,1,OPE,764,394,MOT
0,5,9,38,-0.382992252,43,5,the,"('MOT', 'OPE')",Providence,lil79.xml,52,9,0,OPE,764,394,MOT
0,2,2,4,-0.405465108,6,2,the,"('CHI', 'OPE')",Providence,lil79.xml,8,2,0,OPE,28,55,CHI
2,36,53,329,-0.649995044,365,36,the,"('MOT', 'CHI')",Providence,lil79.xml,420,55,2,CHI,4537,2452,MOT
0,20,47,353,-1.00941671,373,20,that,"('MOT', 'CHI')",Providence,lil79.xml,420,47,0,CHI,4537,2452,MOT
0,7,14,31,-1.16315081,38,7,you,"('MOT', 'OPE')",Providence,lil79.xml,52,14,0,OPE,764,394,MOT
1,0,9,362,4.105394398,362,0,big,"('MOT', 'CHI')",Providence,lil80.xml,372,10,1,CHI,5478,1615,MOT
1,0,0,69,3.857214769,69,0,have,"('CHI', 'MOT')",Providence,lil80.xml,70,1,1,MOT,315,613,CHI
1,0,1,68,3.555348061,68,0,not,"('CHI', 'MOT')",Providence,lil80.xml,70,2,1,MOT,315,613,CHI
1,0,0,38,3.283414346,38,0,they,"('MOT', 'OPE')",Providence,lil80.xml,39,1,1,OPE,325,168,MOT
1,1,0,68,3.164067588,69,1,she,"('CHI', 'MOT')",Providence,lil80.xml,70,1,1,MOT,315,613,CHI
0,1,6,365,3.135494216,366,1,put,"('MOT', 'CHI')",Providence,lil80.xml,372,6,0,CHI,5478,1615,MOT
0,1,6,365,3.135494216,366,1,wanna,"('MOT', 'CHI')",Providence,lil80.xml,372,6,0,CHI,5478,1615,MOT
1,0,1,37,2.970414466,37,0,he,"('MOT', 'OPE')",Providence,lil80.xml,39,2,1,OPE,325,168,MOT
0,2,5,365,2.866274206,367,2,he,"('MOT', 'CHI')",Providence,lil80.xml,372,5,0,CHI,5478,1615,MOT
1,1,1,67,2.862200881,68,1,my,"('CHI', 'MOT')",Providence,lil80.xml,70,2,1,MOT,315,613,CHI
0,1,9,362,2.8088549,363,1,up,"('MOT', 'CHI')",Providence,lil80.xml,372,9,0,CHI,5478,1615,MOT
1,3,8,360,2.8088549,363,3,some,"('MOT', 'CHI')",Providence,lil80.xml,372,9,1,CHI,5478,1615,MOT
1,2,0,67,2.75860248,69,2,are,"('CHI', 'MOT')",Providence,lil80.xml,70,1,1,MOT,315,613,CHI
2,3,0,65,2.574518808,68,3,little,"('CHI', 'MOT')",Providence,lil80.xml,70,2,2,MOT,315,613,CHI
6,2,4,58,2.489525596,60,2,a,"('CHI', 'MOT')",Providence,lil80.xml,70,10,6,MOT,315,613,CHI
0,1,13,358,2.487680577,359,1,but,"('MOT', 'CHI')",Providence,lil80.xml,372,13,0,CHI,5478,1615,MOT
0,1,13,358,2.487680577,359,1,she,"('MOT', 'CHI')",Providence,lil80.xml,372,13,0,CHI,5478,1615,MOT
0,1,1,68,2.470920408,69,1,of,"('CHI', 'MOT')",Providence,lil80.xml,70,1,0,MOT,315,613,CHI
0,1,1,68,2.470920408,69,1,but,"('CHI', 'MOT')",Providence,lil80.xml,70,1,0,MOT,315,613,CHI
0,1,14,357,2.420368129,358,1,go,"('MOT', 'CHI')",Providence,lil80.xml,372,14,0,CHI,5478,1615,MOT
0,2,9,361,2.403389792,363,2,did,"('MOT', 'CHI')",Providence,lil80.xml,372,9,0,CHI,5478,1615,MOT
0,2,10,360,2.313634929,362,2,get,"('MOT', 'CHI')",Providence,lil80.xml,372,10,0,CHI,5478,1615,MOT
4,5,24,339,2.262919837,344,5,like,"('MOT', 'CHI')",Providence,lil80.xml,372,28,4,CHI,5478,1615,MOT
1,4,0,65,2.247776856,69,4,is,"('CHI', 'MOT')",Providence,lil80.xml,70,1,1,MOT,315,613,CHI
1,4,0,65,2.247776856,69,4,he,"('CHI', 'MOT')",Providence,lil80.xml,70,1,1,MOT,315,613,CHI
1,4,0,65,2.247776856,69,4,on,"('CHI', 'MOT')",Providence,lil80.xml,70,1,1,MOT,315,613,CHI
1,3,1,65,2.1690537,68,3,that,"('CHI', 'MOT')",Providence,lil80.xml,70,2,1,MOT,315,613,CHI
2,5,17,348,2.134448171,353,5,they,"('MOT', 'CHI')",Providence,lil80.xml,372,19,2,CHI,5478,1615,MOT
2,4,1,63,2.113842968,67,4,was,"('CHI', 'MOT')",Providence,lil80.xml,70,3,2,MOT,315,613,CHI
0,4,7,361,2.098699358,365,4,gonna,"('MOT', 'CHI')",Providence,lil80.xml,372,7,0,CHI,5478,1615,MOT
0,4,7,361,2.098699358,365,4,want,"('MOT', 'CHI')",Providence,lil80.xml,372,7,0,CHI,5478,1615,MOT
0,2,13,357,2.082215469,359,2,where,"('MOT', 'CHI')",Providence,lil80.xml,372,13,0,CHI,5478,1615,MOT
0,2,1,67,2.0654553,69,2,see,"('CHI', 'MOT')",Providence,lil80.xml,70,1,0,MOT,315,613,CHI
0,2,1,67,2.0654553,69,2,at,"('CHI', 'MOT')",Providence,lil80.xml,70,1,0,MOT,315,613,CHI
1,1,2,35,2.028148247,36,1,this,"('OPE', 'MOT')",Providence,lil80.xml,39,3,1,MOT,177,401,OPE
2,2,1,34,2.028148247,36,2,that,"('MOT', 'OPE')",Providence,lil80.xml,39,3,2,OPE,325,168,MOT
0,6,5,361,2.018976346,367,6,not,"('MOT', 'CHI')",Providence,lil80.xml,372,5,0,CHI,5478,1615,MOT
2,1,9,58,1.951389615,59,1,yeah,"('CHI', 'MOT')",Providence,lil80.xml,70,11,2,MOT,315,613,CHI
1,3,2,64,1.931521412,67,3,with,"('CHI', 'MOT')",Providence,lil80.xml,70,3,1,MOT,315,613,CHI
0,1,1,37,1.897119985,38,1,in,"('MOT', 'OPE')",Providence,lil80.xml,39,1,0,OPE,325,168,MOT
0,1,1,37,1.897119985,38,1,at,"('MOT', 'OPE')",Providence,lil80.xml,39,1,0,OPE,325,168,MOT
0,1,25,346,1.866087876,347,1,for,"('MOT', 'CHI')",Providence,lil80.xml,372,25,0,CHI,5478,1615,MOT
0,1,26,345,1.826850789,346,1,see,"('MOT', 'CHI')",Providence,lil80.xml,372,26,0,CHI,5478,1615,MOT
0,3,1,66,1.777773227,69,3,oh,"('CHI', 'MOT')",Providence,lil80.xml,70,1,0,MOT,315,613,CHI
0,3,1,66,1.777773227,69,3,we,"('CHI', 'MOT')",Providence,lil80.xml,70,1,0,MOT,315,613,CHI
0,2,2,66,1.763588592,68,2,can,"('CHI', 'MOT')",Providence,lil80.xml,70,2,0,MOT,315,613,CHI
1,4,2,63,1.70837786,67,4,in,"('CHI', 'MOT')",Providence,lil80.xml,70,3,1,MOT,315,613,CHI
0,3,15,354,1.663814683,357,3,little,"('MOT', 'CHI')",Providence,lil80.xml,372,15,0,CHI,5478,1615,MOT
1,1,1,18,1.658228077,19,1,that,"('OPE', 'CHI')",Providence,lil80.xml,21,2,1,CHI,70,98,OPE
1,2,2,34,1.622683139,36,2,a,"('OPE', 'MOT')",Providence,lil80.xml,39,3,1,MOT,177,401,OPE
0,5,10,357,1.620487749,362,5,look,"('MOT', 'CHI')",Providence,lil80.xml,372,10,0,CHI,5478,1615,MOT
1,8,13,350,1.609437912,358,8,there,"('MOT', 'CHI')",Providence,lil80.xml,372,14,1,CHI,5478,1615,MOT
1,6,1,62,1.609437912,68,6,to,"('CHI', 'MOT')",Providence,lil80.xml,70,2,1,MOT,315,613,CHI
0,1,2,36,1.584120104,37,1,was,"('MOT', 'OPE')",Providence,lil80.xml,39,2,0,OPE,325,168,MOT
0,1,2,36,1.584120104,37,1,see,"('MOT', 'OPE')",Providence,lil80.xml,39,2,0,OPE,325,168,MOT
0,1,2,36,1.584120104,37,1,she,"('MOT', 'OPE')",Providence,lil80.xml,39,2,0,OPE,325,168,MOT
0,1,2,36,1.584120104,37,1,is,"('MOT', 'OPE')",Providence,lil80.xml,39,2,0,OPE,325,168,MOT
0,1,2,36,1.584120104,37,1,where,"('MOT', 'OPE')",Providence,lil80.xml,39,2,0,OPE,325,168,MOT
0,1,2,36,1.584120104,37,1,to,"('MOT', 'OPE')",Providence,lil80.xml,39,2,0,OPE,325,168,MOT
0,1,2,36,1.584120104,37,1,for,"('OPE', 'MOT')",Providence,lil80.xml,39,2,0,MOT,177,401,OPE
1,3,1,34,1.584120104,37,3,was,"('OPE', 'MOT')",Providence,lil80.xml,39,2,1,MOT,177,401,OPE
0,4,1,65,1.554629676,69,4,do,"('CHI', 'MOT')",Providence,lil80.xml,70,1,0,MOT,315,613,CHI
5,12,28,327,1.503344528,339,12,what,"('MOT', 'CHI')",Providence,lil80.xml,372,33,5,CHI,5478,1615,MOT
0,2,1,36,1.491654877,38,2,it,"('MOT', 'OPE')",Providence,lil80.xml,39,1,0,OPE,325,168,MOT
0,2,1,36,1.491654877,38,2,are,"('MOT', 'OPE')",Providence,lil80.xml,39,1,0,OPE,325,168,MOT
0,2,1,36,1.491654877,38,2,do,"('MOT', 'OPE')",Providence,lil80.xml,39,1,0,OPE,325,168,MOT
0,2,1,36,1.491654877,38,2,with,"('OPE', 'MOT')",Providence,lil80.xml,39,1,0,MOT,177,401,OPE
0,2,1,36,1.491654877,38,2,but,"('OPE', 'MOT')",Providence,lil80.xml,39,1,0,MOT,177,401,OPE
0,2,1,36,1.491654877,38,2,think,"('OPE', 'MOT')",Providence,lil80.xml,39,1,0,MOT,177,401,OPE
3,7,34,328,1.463374104,335,7,is,"('MOT', 'CHI')",Providence,lil80.xml,372,37,3,CHI,5478,1615,MOT
0,3,19,350,1.441300991,353,3,at,"('MOT', 'CHI')",Providence,lil80.xml,372,19,0,CHI,5478,1615,MOT
0,7,9,356,1.422560539,363,7,can,"('MOT', 'CHI')",Providence,lil80.xml,372,9,0,CHI,5478,1615,MOT
1,5,25,341,1.421385681,346,5,was,"('MOT', 'CHI')",Providence,lil80.xml,372,26,1,CHI,5478,1615,MOT
5,9,42,316,1.387314249,325,9,that,"('MOT', 'CHI')",Providence,lil80.xml,372,47,5,CHI,5478,1615,MOT
1,4,1,33,1.360976553,37,4,is,"('OPE', 'MOT')",Providence,lil80.xml,39,2,1,MOT,177,401,OPE
0,3,21,348,1.34467948,351,3,with,"('MOT', 'CHI')",Providence,lil80.xml,372,21,0,CHI,5478,1615,MOT
0,1,3,35,1.335001067,36,1,like,"('MOT', 'OPE')",Providence,lil80.xml,39,3,0,OPE,325,168,MOT
0,1,42,329,1.327798154,330,1,we,"('MOT', 'CHI')",Providence,lil80.xml,372,42,0,CHI,5478,1615,MOT
1,6,25,340,1.267235001,346,6,are,"('MOT', 'CHI')",Providence,lil80.xml,372,26,1,CHI,5478,1615,MOT
0,3,1,35,1.203972804,38,3,did,"('OPE', 'MOT')",Providence,lil80.xml,39,1,0,MOT,177,401,OPE
0,9,9,354,1.199416988,363,9,no,"('MOT', 'CHI')",Providence,lil80.xml,372,9,0,CHI,5478,1615,MOT
1,6,3,60,1.174985267,66,6,and,"('CHI', 'MOT')",Providence,lil80.xml,70,4,1,MOT,315,613,CHI
0,6,15,351,1.104198895,357,6,think,"('MOT', 'CHI')",Providence,lil80.xml,372,15,0,CHI,5478,1615,MOT
0,2,36,334,1.086847447,336,2,on,"('MOT', 'CHI')",Providence,lil80.xml,372,36,0,CHI,5478,1615,MOT
8,11,68,285,1.052702587,296,11,a,"('MOT', 'CHI')",Providence,lil80.xml,372,76,8,CHI,5478,1615,MOT
1,7,3,59,1.041453875,66,7,it,"('CHI', 'MOT')",Providence,lil80.xml,70,4,1,MOT,315,613,CHI
0,3,30,339,0.988611393,342,3,my,"('MOT', 'CHI')",Providence,lil80.xml,372,30,0,CHI,5478,1615,MOT
0,6,17,349,0.987386654,355,6,this,"('MOT', 'CHI')",Providence,lil80.xml,372,17,0,CHI,5478,1615,MOT
0,4,1,34,0.980829253,38,4,there,"('OPE', 'MOT')",Providence,lil80.xml,39,1,0,MOT,177,401,OPE
0,4,1,34,0.980829253,38,4,she,"('OPE', 'MOT')",Providence,lil80.xml,39,1,0,MOT,177,401,OPE
1,3,4,31,0.944461609,34,3,yeah,"('MOT', 'OPE')",Providence,lil80.xml,39,5,1,OPE,325,168,MOT
1,5,2,31,0.929535959,36,5,it,"('OPE', 'MOT')",Providence,lil80.xml,39,3,1,MOT,177,401,OPE
0,6,2,62,0.916290732,68,6,what,"('CHI', 'MOT')",Providence,lil80.xml,70,2,0,MOT,315,613,CHI
1,8,28,335,0.905479816,343,8,oh,"('MOT', 'CHI')",Providence,lil80.xml,372,29,1,CHI,5478,1615,MOT
0,2,1,18,0.893817876,20,2,what,"('OPE', 'CHI')",Providence,lil80.xml,21,1,0,CHI,70,98,OPE
0,3,2,34,0.890972924,37,3,what,"('MOT', 'OPE')",Providence,lil80.xml,39,2,0,OPE,325,168,MOT
3,12,4,51,0.798507696,63,12,you,"('CHI', 'MOT')",Providence,lil80.xml,70,7,3,MOT,315,613,CHI
4,16,3,47,0.753387261,63,16,the,"('CHI', 'MOT')",Providence,lil80.xml,70,7,4,MOT,315,613,CHI
0,6,23,343,0.69600025,349,6,have,"('MOT', 'CHI')",Providence,lil80.xml,372,23,0,CHI,5478,1615,MOT
1,0,0,1,0.693147181,1,0,the,"('MOT', 'TOY')",Providence,lil80.xml,2,1,1,TOY,18,43,MOT
8,14,77,273,0.689692946,287,14,you,"('MOT', 'CHI')",Providence,lil80.xml,372,85,8,CHI,5478,1615,MOT
0,4,2,33,0.667829373,37,4,oh,"('MOT', 'OPE')",Providence,lil80.xml,39,2,0,OPE,325,168,MOT
0,4,2,33,0.667829373,37,4,the,"('OPE', 'MOT')",Providence,lil80.xml,39,2,0,MOT,177,401,OPE
2,18,25,327,0.636202259,345,18,one,"('MOT', 'CHI')",Providence,lil80.xml,372,27,2,CHI,5478,1615,MOT
0,3,1,17,0.606135804,20,3,is,"('OPE', 'CHI')",Providence,lil80.xml,21,1,0,CHI,70,98,OPE
0,2,2,17,0.559615788,19,2,you,"('OPE', 'CHI')",Providence,lil80.xml,21,2,0,CHI,70,98,OPE
3,17,38,314,0.542864978,331,17,it,"('MOT', 'CHI')",Providence,lil80.xml,372,41,3,CHI,5478,1615,MOT
5,16,58,293,0.523951767,309,16,and,"('MOT', 'CHI')",Providence,lil80.xml,372,63,5,CHI,5478,1615,MOT
0,4,39,329,0.491120553,333,4,in,"('MOT', 'CHI')",Providence,lil80.xml,372,39,0,CHI,5478,1615,MOT
1,3,3,14,0.459532329,17,3,yeah,"('OPE', 'CHI')",Providence,lil80.xml,21,4,1,CHI,70,98,OPE
0,1,2,9,0.405465108,10,1,yeah,"('CHI', 'OPE')",Providence,lil80.xml,12,2,0,OPE,50,56,CHI
0,8,27,337,0.284804373,345,8,do,"('MOT', 'CHI')",Providence,lil80.xml,372,27,0,CHI,5478,1615,MOT
0,5,3,31,0.236388778,36,5,that,"('OPE', 'MOT')",Providence,lil80.xml,39,3,0,MOT,177,401,OPE
0,4,4,31,0.209720531,35,4,oh,"('OPE', 'MOT')",Providence,lil80.xml,39,4,0,MOT,177,401,OPE
2,28,26,316,0.176557852,344,28,yeah,"('MOT', 'CHI')",Providence,lil80.xml,372,28,2,CHI,5478,1615,MOT
5,14,88,265,0.168187046,279,14,the,"('MOT', 'CHI')",Providence,lil80.xml,372,93,5,CHI,5478,1615,MOT
0,4,55,313,0.112701923,317,4,to,"('MOT', 'CHI')",Providence,lil80.xml,372,55,0,CHI,5478,1615,MOT
0,1,3,8,0.09531018,9,1,it,"('CHI', 'OPE')",Providence,lil80.xml,12,3,0,OPE,50,56,CHI
0,1,3,8,0.09531018,9,1,a,"('CHI', 'OPE')",Providence,lil80.xml,12,3,0,OPE,50,56,CHI
0,3,6,30,0.089612159,33,3,the,"('MOT', 'OPE')",Providence,lil80.xml,39,6,0,OPE,325,168,MOT
0,4,2,15,0.048790164,19,4,it,"('OPE', 'CHI')",Providence,lil80.xml,21,2,0,CHI,70,98,OPE
0,6,44,322,0.024541109,328,6,of,"('MOT', 'CHI')",Providence,lil80.xml,372,44,0,CHI,5478,1615,MOT
0,9,2,28,-0.025317808,37,9,and,"('OPE', 'MOT')",Providence,lil80.xml,39,2,0,MOT,177,401,OPE
0,10,2,27,-0.120627988,37,10,you,"('OPE', 'MOT')",Providence,lil80.xml,39,2,0,MOT,177,401,OPE
0,4,7,28,-0.280301965,32,4,you,"('MOT', 'OPE')",Providence,lil80.xml,39,7,0,OPE,325,168,MOT
0,5,7,27,-0.462623522,32,5,yeah,"('OPE', 'MOT')",Providence,lil80.xml,39,7,0,MOT,177,401,OPE
0,1,1,0,-0.693147181,1,1,oh,"('MOT', 'TOY')",Providence,lil80.xml,2,1,0,TOY,18,43,MOT
0,1,1,0,-0.693147181,1,1,you,"('MOT', 'TOY')",Providence,lil80.xml,2,1,0,TOY,18,43,MOT
1,0,0,25,2.890371758,25,0,it,"('FAT', 'MOT')",Providence,nai01.xml,26,1,1,MOT,192,211,FAT
1,0,0,25,2.890371758,25,0,up,"('FAT', 'MOT')",Providence,nai01.xml,26,1,1,MOT,192,211,FAT
1,0,3,20,1.992430165,20,0,it,"('MOT', 'FAT')",Providence,nai01.xml,24,4,1,FAT,423,147,MOT
0,1,16,169,1.563975538,170,1,there,"('MOT', 'CHI')",Providence,nai01.xml,186,16,0,CHI,3725,498,MOT
0,1,1,24,1.504077397,25,1,get,"('FAT', 'MOT')",Providence,nai01.xml,26,1,0,MOT,192,211,FAT
0,1,1,24,1.504077397,25,1,can,"('FAT', 'MOT')",Providence,nai01.xml,26,1,0,MOT,192,211,FAT
0,1,1,24,1.504077397,25,1,think,"('FAT', 'MOT')",Providence,nai01.xml,26,1,0,MOT,192,211,FAT
0,1,1,24,1.504077397,25,1,not,"('FAT', 'MOT')",Providence,nai01.xml,26,1,0,MOT,192,211,FAT
1,0,6,17,1.440361582,17,0,a,"('MOT', 'FAT')",Providence,nai01.xml,24,7,1,FAT,423,147,MOT
0,1,1,22,1.427116356,23,1,gonna,"('MOT', 'FAT')",Providence,nai01.xml,24,1,0,FAT,423,147,MOT
0,1,1,22,1.427116356,23,1,in,"('MOT', 'FAT')",Providence,nai01.xml,24,1,0,FAT,423,147,MOT
0,1,1,22,1.427116356,23,1,all,"('MOT', 'FAT')",Providence,nai01.xml,24,1,0,FAT,423,147,MOT
0,1,1,22,1.427116356,23,1,do,"('MOT', 'FAT')",Providence,nai01.xml,24,1,0,FAT,423,147,MOT
1,4,0,21,1.280933845,25,4,oh,"('FAT', 'MOT')",Providence,nai01.xml,26,1,1,MOT,192,211,FAT
0,1,2,23,1.178654996,24,1,do,"('FAT', 'MOT')",Providence,nai01.xml,26,2,0,MOT,192,211,FAT
2,1,5,16,1.15267951,17,1,the,"('MOT', 'FAT')",Providence,nai01.xml,24,7,2,FAT,423,147,MOT
0,2,1,23,1.098612289,25,2,what,"('FAT', 'MOT')",Providence,nai01.xml,26,1,0,MOT,192,211,FAT
0,2,1,23,1.098612289,25,2,this,"('FAT', 'MOT')",Providence,nai01.xml,26,1,0,MOT,192,211,FAT
0,2,1,23,1.098612289,25,2,a,"('FAT', 'MOT')",Providence,nai01.xml,26,1,0,MOT,192,211,FAT
0,2,1,23,1.098612289,25,2,are,"('FAT', 'MOT')",Providence,nai01.xml,26,1,0,MOT,192,211,FAT
0,1,2,21,1.098612289,22,1,was,"('MOT', 'FAT')",Providence,nai01.xml,24,2,0,FAT,423,147,MOT
0,1,2,21,1.098612289,22,1,this,"('MOT', 'FAT')",Providence,nai01.xml,24,2,0,FAT,423,147,MOT
0,2,1,21,1.021651248,23,2,oh,"('MOT', 'FAT')",Providence,nai01.xml,24,1,0,FAT,423,147,MOT
0,1,29,156,0.941769817,157,1,yeah,"('MOT', 'CHI')",Providence,nai01.xml,186,29,0,CHI,3725,498,MOT
0,1,3,20,0.832909123,21,1,yeah,"('MOT', 'FAT')",Providence,nai01.xml,24,3,0,FAT,423,147,MOT
0,1,3,20,0.832909123,21,1,of,"('MOT', 'FAT')",Providence,nai01.xml,24,3,0,FAT,423,147,MOT
0,1,3,20,0.832909123,21,1,she,"('MOT', 'FAT')",Providence,nai01.xml,24,3,0,FAT,423,147,MOT
0,3,1,22,0.810930216,25,3,with,"('FAT', 'MOT')",Providence,nai01.xml,26,1,0,MOT,192,211,FAT
0,2,2,22,0.773189888,24,2,gonna,"('FAT', 'MOT')",Providence,nai01.xml,26,2,0,MOT,192,211,FAT
0,2,2,20,0.693147181,22,2,up,"('MOT', 'FAT')",Providence,nai01.xml,24,2,0,FAT,423,147,MOT
0,2,3,21,0.510825624,23,2,that,"('FAT', 'MOT')",Providence,nai01.xml,26,3,0,MOT,192,211,FAT
0,2,3,19,0.427444015,21,2,what,"('MOT', 'FAT')",Providence,nai01.xml,24,3,0,FAT,423,147,MOT
0,2,3,19,0.427444015,21,2,is,"('MOT', 'FAT')",Providence,nai01.xml,24,3,0,FAT,423,147,MOT
0,2,3,19,0.427444015,21,2,that,"('MOT', 'FAT')",Providence,nai01.xml,24,3,0,FAT,423,147,MOT
0,1,5,18,0.405465108,19,1,to,"('MOT', 'FAT')",Providence,nai01.xml,24,5,0,FAT,423,147,MOT
0,4,2,20,0.262364264,24,4,to,"('FAT', 'MOT')",Providence,nai01.xml,26,2,0,MOT,192,211,FAT
0,3,3,20,0.223143551,23,3,the,"('FAT', 'MOT')",Providence,nai01.xml,26,3,0,MOT,192,211,FAT
1,3,8,12,-0.257829109,15,3,you,"('MOT', 'FAT')",Providence,nai01.xml,24,9,1,FAT,423,147,MOT
0,7,5,14,-0.889857475,21,7,you,"('FAT', 'MOT')",Providence,nai01.xml,26,5,0,MOT,192,211,FAT
0,1,14,136,1.46873803,137,1,yeah,"('MOT', 'CHI')",Providence,nai03.xml,151,14,0,CHI,3602,433,MOT
1,0,0,4,1.386294361,4,0,get,"('MOT', 'FAT')",Providence,nai03.xml,5,1,1,FAT,90,49,MOT
1,9,0,38,1.183770097,47,9,there,"('CHI', 'MOT')",Providence,nai03.xml,48,1,1,MOT,157,1020,CHI
0,1,26,124,0.818835396,125,1,go,"('MOT', 'CHI')",Providence,nai03.xml,151,26,0,CHI,3602,433,MOT
1,1,0,3,0.693147181,4,1,and,"('MOT', 'FAT')",Providence,nai03.xml,5,1,1,FAT,90,49,MOT
1,0,2,2,0.470003629,2,0,the,"('MOT', 'FAT')",Providence,nai03.xml,5,3,1,FAT,90,49,MOT
0,1,1,3,0,4,1,go,"('MOT', 'FAT')",Providence,nai03.xml,5,1,0,FAT,90,49,MOT
0,1,1,3,0,4,1,in,"('MOT', 'FAT')",Providence,nai03.xml,5,1,0,FAT,90,49,MOT
0,1,1,3,0,4,1,a,"('MOT', 'FAT')",Providence,nai03.xml,5,1,0,FAT,90,49,MOT
0,1,1,3,0,4,1,can,"('MOT', 'FAT')",Providence,nai03.xml,5,1,0,FAT,90,49,MOT
0,1,2,2,-0.470003629,3,1,you,"('MOT', 'FAT')",Providence,nai03.xml,5,2,0,FAT,90,49,MOT
0,1,5,140,2.323787301,141,1,did,"('MOT', 'CHI')",Providence,nai04.xml,146,5,0,CHI,2015,514,MOT
0,1,7,138,2.058388132,139,1,where,"('MOT', 'CHI')",Providence,nai04.xml,146,7,0,CHI,2015,514,MOT
0,1,8,137,1.945910149,138,1,go,"('MOT', 'CHI')",Providence,nai04.xml,146,8,0,CHI,2015,514,MOT
5,6,13,122,1.717651497,128,6,there,"('MOT', 'CHI')",Providence,nai04.xml,146,18,5,CHI,2015,514,MOT
0,1,21,124,1.01554569,125,1,it,"('MOT', 'CHI')",Providence,nai04.xml,146,21,0,CHI,2015,514,MOT
1,2,32,111,0.784118959,113,2,the,"('MOT', 'CHI')",Providence,nai04.xml,146,33,1,CHI,2015,514,MOT
0,1,35,110,0.423322726,111,1,a,"('MOT', 'CHI')",Providence,nai04.xml,146,35,0,CHI,2015,514,MOT
0,1,4,124,2.359280437,125,1,get,"('MOT', 'CHI')",Providence,nai05.xml,129,4,0,CHI,2783,448,MOT
1,0,39,89,1.466337069,89,0,a,"('MOT', 'CHI')",Providence,nai05.xml,129,40,1,CHI,2783,448,MOT
1,2,0,22,1.754019141,24,2,was,"('FAT', 'MOT')",Providence,nai06.xml,25,1,1,MOT,174,416,FAT
0,1,1,23,1.466337069,24,1,wanna,"('FAT', 'MOT')",Providence,nai06.xml,25,1,0,MOT,174,416,FAT
0,1,1,23,1.466337069,24,1,do,"('FAT', 'MOT')",Providence,nai06.xml,25,1,0,MOT,174,416,FAT
1,2,1,21,1.427116356,23,2,are,"('FAT', 'MOT')",Providence,nai06.xml,25,2,1,MOT,174,416,FAT
1,0,0,4,1.386294361,4,0,he,"('MOT', 'FAT')",Providence,nai06.xml,5,1,1,FAT,125,78,MOT
2,3,1,19,1.280933845,22,3,we,"('FAT', 'MOT')",Providence,nai06.xml,25,3,2,MOT,174,416,FAT
0,2,1,22,1.060871961,24,2,in,"('FAT', 'MOT')",Providence,nai06.xml,25,1,0,MOT,174,416,FAT
0,2,1,22,1.060871961,24,2,have,"('FAT', 'MOT')",Providence,nai06.xml,25,1,0,MOT,174,416,FAT
0,2,1,22,1.060871961,24,2,on,"('FAT', 'MOT')",Providence,nai06.xml,25,1,0,MOT,174,416,FAT
1,2,3,19,0.938269639,21,2,oh,"('FAT', 'MOT')",Providence,nai06.xml,25,4,1,MOT,174,416,FAT
2,0,1,2,0.875468737,2,0,is,"('MOT', 'FAT')",Providence,nai06.xml,5,3,2,FAT,125,78,MOT
0,3,1,21,0.773189888,24,3,did,"('FAT', 'MOT')",Providence,nai06.xml,25,1,0,MOT,174,416,FAT
0,3,1,21,0.773189888,24,3,my,"('FAT', 'MOT')",Providence,nai06.xml,25,1,0,MOT,174,416,FAT
1,2,4,18,0.739667196,20,2,a,"('FAT', 'MOT')",Providence,nai06.xml,25,5,1,MOT,174,416,FAT
0,2,2,21,0.733969175,23,2,go,"('FAT', 'MOT')",Providence,nai06.xml,25,2,0,MOT,174,416,FAT
3,7,2,13,0.451985124,20,7,the,"('FAT', 'MOT')",Providence,nai06.xml,25,5,3,MOT,174,416,FAT
2,0,2,1,0.405465108,1,0,the,"('MOT', 'FAT')",Providence,nai06.xml,5,4,2,FAT,125,78,MOT
0,5,1,19,0.36772478,24,5,that,"('FAT', 'MOT')",Providence,nai06.xml,25,1,0,MOT,174,416,FAT
1,5,3,16,0.245122458,21,5,to,"('FAT', 'MOT')",Providence,nai06.xml,25,4,1,MOT,174,416,FAT
1,1,1,2,0.223143551,3,1,it,"('MOT', 'FAT')",Providence,nai06.xml,5,2,1,FAT,125,78,MOT
0,3,3,19,0.182321557,22,3,gonna,"('FAT', 'MOT')",Providence,nai06.xml,25,3,0,MOT,174,416,FAT
0,1,1,3,0,4,1,yeah,"('MOT', 'FAT')",Providence,nai06.xml,5,1,0,FAT,125,78,MOT
0,1,1,3,0,4,1,she,"('MOT', 'FAT')",Providence,nai06.xml,5,1,0,FAT,125,78,MOT
0,1,1,3,0,4,1,that,"('MOT', 'FAT')",Providence,nai06.xml,5,1,0,FAT,125,78,MOT
0,1,1,3,0,4,1,not,"('MOT', 'FAT')",Providence,nai06.xml,5,1,0,FAT,125,78,MOT
0,1,1,3,0,4,1,and,"('MOT', 'FAT')",Providence,nai06.xml,5,1,0,FAT,125,78,MOT
0,3,4,18,-0.042559614,21,3,and,"('FAT', 'MOT')",Providence,nai06.xml,25,4,0,MOT,174,416,FAT
1,1,2,1,-0.223143551,2,1,you,"('MOT', 'FAT')",Providence,nai06.xml,5,3,1,FAT,125,78,MOT
0,8,2,15,-0.364643114,23,8,you,"('FAT', 'MOT')",Providence,nai06.xml,25,2,0,MOT,174,416,FAT
1,0,8,153,3.338677025,153,0,see,"('MOT', 'CHI')",Providence,nai07.xml,162,9,1,CHI,2496,642,MOT
1,0,0,34,3.17805383,34,0,up,"('MOT', 'FAT')",Providence,nai07.xml,35,1,1,FAT,494,287,MOT
1,0,13,148,2.931193752,148,0,it,"('MOT', 'CHI')",Providence,nai07.xml,162,14,1,CHI,2496,642,MOT
1,0,2,32,2.610069793,32,0,my,"('MOT', 'FAT')",Providence,nai07.xml,35,3,1,FAT,494,287,MOT
1,0,2,32,2.610069793,32,0,where,"('MOT', 'FAT')",Providence,nai07.xml,35,3,1,FAT,494,287,MOT
0,1,4,157,2.590267165,158,1,up,"('MOT', 'CHI')",Providence,nai07.xml,162,4,0,CHI,2496,642,MOT
1,1,1,32,2.1690537,33,1,like,"('MOT', 'FAT')",Providence,nai07.xml,35,2,1,FAT,494,287,MOT
2,0,6,27,2.163323026,27,0,it,"('MOT', 'FAT')",Providence,nai07.xml,35,8,2,FAT,494,287,MOT
1,1,0,21,2.079441542,22,1,we,"('FAT', 'MOT')",Providence,nai07.xml,23,1,1,MOT,209,170,FAT
2,0,44,116,1.998095902,116,0,the,"('MOT', 'CHI')",Providence,nai07.xml,162,46,2,CHI,2496,642,MOT
0,1,1,33,1.791759469,34,1,go,"('MOT', 'FAT')",Providence,nai07.xml,35,1,0,FAT,494,287,MOT
0,1,1,33,1.791759469,34,1,look,"('MOT', 'FAT')",Providence,nai07.xml,35,1,0,FAT,494,287,MOT
0,1,1,33,1.791759469,34,1,see,"('MOT', 'FAT')",Providence,nai07.xml,35,1,0,FAT,494,287,MOT
0,1,1,33,1.791759469,34,1,she,"('MOT', 'FAT')",Providence,nai07.xml,35,1,0,FAT,494,287,MOT
0,1,1,33,1.791759469,34,1,at,"('MOT', 'FAT')",Providence,nai07.xml,35,1,0,FAT,494,287,MOT
1,3,0,31,1.791759469,34,3,think,"('MOT', 'FAT')",Providence,nai07.xml,35,1,1,FAT,494,287,MOT
2,1,4,28,1.760010771,29,1,they,"('MOT', 'FAT')",Providence,nai07.xml,35,6,2,FAT,494,287,MOT
1,1,3,30,1.704748092,31,1,do,"('MOT', 'FAT')",Providence,nai07.xml,35,4,1,FAT,494,287,MOT
3,1,13,42,1.609437912,43,1,you,"('FAT', 'CHI')",Providence,nai07.xml,59,16,3,CHI,642,290,FAT
0,1,2,32,1.47590652,33,1,no,"('MOT', 'FAT')",Providence,nai07.xml,35,2,0,FAT,494,287,MOT
0,1,2,32,1.47590652,33,1,can,"('MOT', 'FAT')",Providence,nai07.xml,35,2,0,FAT,494,287,MOT
0,1,2,32,1.47590652,33,1,one,"('MOT', 'FAT')",Providence,nai07.xml,35,2,0,FAT,494,287,MOT
0,1,2,32,1.47590652,33,1,on,"('MOT', 'FAT')",Providence,nai07.xml,35,2,0,FAT,494,287,MOT
0,1,1,21,1.386294361,22,1,for,"('FAT', 'MOT')",Providence,nai07.xml,23,1,0,MOT,209,170,FAT
0,1,1,21,1.386294361,22,1,this,"('FAT', 'MOT')",Providence,nai07.xml,23,1,0,MOT,209,170,FAT
0,1,1,21,1.386294361,22,1,up,"('FAT', 'MOT')",Providence,nai07.xml,23,1,0,MOT,209,170,FAT
0,1,1,21,1.386294361,22,1,she,"('FAT', 'MOT')",Providence,nai07.xml,23,1,0,MOT,209,170,FAT
0,1,1,21,1.386294361,22,1,can,"('FAT', 'MOT')",Providence,nai07.xml,23,1,0,MOT,209,170,FAT
0,1,1,21,1.386294361,22,1,where,"('FAT', 'MOT')",Providence,nai07.xml,23,1,0,MOT,209,170,FAT
0,1,1,21,1.386294361,22,1,are,"('FAT', 'MOT')",Providence,nai07.xml,23,1,0,MOT,209,170,FAT
0,1,3,31,1.223775432,32,1,was,"('MOT', 'FAT')",Providence,nai07.xml,35,3,0,FAT,494,287,MOT
0,1,3,31,1.223775432,32,1,but,"('MOT', 'FAT')",Providence,nai07.xml,35,3,0,FAT,494,287,MOT
0,1,3,31,1.223775432,32,1,did,"('MOT', 'FAT')",Providence,nai07.xml,35,3,0,FAT,494,287,MOT
0,1,20,141,1.185623666,142,1,yeah,"('MOT', 'CHI')",Providence,nai07.xml,162,20,0,CHI,2496,642,MOT
0,3,1,31,1.098612289,34,3,are,"('MOT', 'FAT')",Providence,nai07.xml,35,1,0,FAT,494,287,MOT
0,2,2,31,1.070441412,33,2,gonna,"('MOT', 'FAT')",Providence,nai07.xml,35,2,0,FAT,494,287,MOT
0,1,2,20,1.056052674,21,1,there,"('FAT', 'MOT')",Providence,nai07.xml,23,2,0,MOT,209,170,FAT
0,1,2,20,1.056052674,21,1,some,"('FAT', 'MOT')",Providence,nai07.xml,23,2,0,MOT,209,170,FAT
0,1,2,20,1.056052674,21,1,and,"('FAT', 'MOT')",Providence,nai07.xml,23,2,0,MOT,209,170,FAT
0,1,4,30,1.011600912,31,1,of,"('MOT', 'FAT')",Providence,nai07.xml,35,4,0,FAT,494,287,MOT
0,1,24,137,0.990398704,138,1,that,"('MOT', 'CHI')",Providence,nai07.xml,162,24,0,CHI,2496,642,MOT
0,2,1,20,0.980829253,22,2,a,"('FAT', 'MOT')",Providence,nai07.xml,23,1,0,MOT,209,170,FAT
1,2,5,27,0.949080555,29,2,we,"('MOT', 'FAT')",Providence,nai07.xml,35,6,1,FAT,494,287,MOT
2,3,5,25,0.916290732,28,3,have,"('MOT', 'FAT')",Providence,nai07.xml,35,7,2,FAT,494,287,MOT
0,1,5,29,0.826678573,30,1,to,"('MOT', 'FAT')",Providence,nai07.xml,35,5,0,FAT,494,287,MOT
1,2,6,26,0.798507696,28,2,is,"('MOT', 'FAT')",Providence,nai07.xml,35,7,1,FAT,494,287,MOT
0,1,3,19,0.78845736,20,1,have,"('FAT', 'MOT')",Providence,nai07.xml,23,3,0,MOT,209,170,FAT
3,3,4,13,0.693147181,16,3,the,"('FAT', 'MOT')",Providence,nai07.xml,23,7,3,MOT,209,170,FAT
0,3,1,19,0.693147181,22,3,no,"('FAT', 'MOT')",Providence,nai07.xml,23,1,0,MOT,209,170,FAT
2,4,5,24,0.693147181,28,4,the,"('MOT', 'FAT')",Providence,nai07.xml,35,7,2,FAT,494,287,MOT
0,2,2,19,0.650587566,21,2,in,"('FAT', 'MOT')",Providence,nai07.xml,23,2,0,MOT,209,170,FAT
0,2,2,19,0.650587566,21,2,of,"('FAT', 'MOT')",Providence,nai07.xml,23,2,0,MOT,209,170,FAT
0,2,4,29,0.606135804,31,2,what,"('MOT', 'FAT')",Providence,nai07.xml,35,4,0,FAT,494,287,MOT
0,2,4,29,0.606135804,31,2,some,"('MOT', 'FAT')",Providence,nai07.xml,35,4,0,FAT,494,287,MOT
1,5,3,26,0.606135804,31,5,that,"('MOT', 'FAT')",Providence,nai07.xml,35,4,1,FAT,494,287,MOT
0,1,4,18,0.559615788,19,1,oh,"('FAT', 'MOT')",Providence,nai07.xml,23,4,0,MOT,209,170,FAT
0,1,7,27,0.510825624,28,1,yeah,"('MOT', 'FAT')",Providence,nai07.xml,35,7,0,FAT,494,287,MOT
1,4,5,25,0.438254931,29,4,oh,"('MOT', 'FAT')",Providence,nai07.xml,35,6,1,FAT,494,287,MOT
2,6,6,21,0.217412877,27,6,you,"('MOT', 'FAT')",Providence,nai07.xml,35,8,2,FAT,494,287,MOT
0,3,3,17,0.09531018,20,3,you,"('FAT', 'MOT')",Providence,nai07.xml,23,3,0,MOT,209,170,FAT
0,3,37,122,-0.205668921,125,3,a,"('MOT', 'CHI')",Providence,nai07.xml,162,37,0,CHI,2496,642,MOT
0,2,9,270,2.116620545,272,2,up,"('MOT', 'CHI')",Providence,nai08.xml,281,9,0,CHI,4291,1198,MOT
0,1,26,254,1.523724394,255,1,this,"('MOT', 'CHI')",Providence,nai08.xml,281,26,0,CHI,4291,1198,MOT
0,3,14,264,1.435828296,267,3,no,"('MOT', 'CHI')",Providence,nai08.xml,281,14,0,CHI,4291,1198,MOT
0,1,37,243,1.148622709,244,1,to,"('MOT', 'CHI')",Providence,nai08.xml,281,37,0,CHI,4291,1198,MOT
0,3,25,253,0.870828358,256,3,on,"('MOT', 'CHI')",Providence,nai08.xml,281,25,0,CHI,4291,1198,MOT
0,1,49,231,0.830348302,232,1,that,"('MOT', 'CHI')",Providence,nai08.xml,281,49,0,CHI,4291,1198,MOT
0,1,1,3,0,4,1,oh,"('MOT', 'ADU')",Providence,nai08.xml,5,1,0,ADU,49,22,MOT
0,1,1,0,-0.693147181,1,1,you,"('ADU', 'MOT')",Providence,nai08.xml,2,1,0,MOT,20,17,ADU
0,1,1,0,-0.693147181,1,1,she,"('ADU', 'MOT')",Providence,nai08.xml,2,1,0,MOT,20,17,ADU
7,11,3,444,3.234311633,455,11,big,"('CHI', 'MOT')",Providence,nai09.xml,465,10,7,MOT,1745,6166,CHI
1,12,1,451,2.883940868,463,12,go,"('CHI', 'MOT')",Providence,nai09.xml,465,2,1,MOT,1745,6166,CHI
1,28,0,436,2.371424696,464,28,to,"('CHI', 'MOT')",Providence,nai09.xml,465,1,1,MOT,1745,6166,CHI
0,17,1,447,2.155201588,464,17,with,"('CHI', 'MOT')",Providence,nai09.xml,465,1,0,MOT,1745,6166,CHI
2,54,0,409,1.847022148,463,54,oh,"('CHI', 'MOT')",Providence,nai09.xml,465,2,2,MOT,1745,6166,CHI
1,42,1,421,1.687690109,463,42,on,"('CHI', 'MOT')",Providence,nai09.xml,465,2,1,MOT,1745,6166,CHI
1,81,1,382,1.042170978,463,81,a,"('CHI', 'MOT')",Providence,nai09.xml,465,2,1,MOT,1745,6166,CHI
1,119,0,345,0.951228783,464,119,the,"('CHI', 'MOT')",Providence,nai09.xml,465,1,1,MOT,1745,6166,CHI
1,114,1,349,0.703958097,463,114,you,"('CHI', 'MOT')",Providence,nai09.xml,465,2,1,MOT,1745,6166,CHI
3,0,1,94,4.158883083,94,0,one,"('MOT', 'CHI')",Providence,nai10.xml,98,4,3,CHI,1749,356,MOT
6,3,1,309,4.111784197,312,3,one,"('CHI', 'MOT')",Providence,nai10.xml,319,7,6,MOT,1542,3860,CHI
1,0,2,95,3.658420247,95,0,big,"('MOT', 'CHI')",Providence,nai10.xml,98,3,1,CHI,1749,356,MOT
7,9,0,303,3.329024857,312,9,big,"('CHI', 'MOT')",Providence,nai10.xml,319,7,7,MOT,1542,3860,CHI
1,4,2,312,3.236322738,316,4,no,"('CHI', 'MOT')",Providence,nai10.xml,319,3,1,MOT,1542,3860,CHI
5,14,0,300,2.893541333,314,14,was,"('CHI', 'MOT')",Providence,nai10.xml,319,5,5,MOT,1542,3860,CHI
0,1,1,96,2.803360381,97,1,she,"('MOT', 'CHI')",Providence,nai10.xml,98,1,0,CHI,1749,356,MOT
0,1,1,96,2.803360381,97,1,no,"('MOT', 'CHI')",Providence,nai10.xml,98,1,0,CHI,1749,356,MOT
0,1,2,95,2.505525937,96,1,was,"('MOT', 'CHI')",Providence,nai10.xml,98,2,0,CHI,1749,356,MOT
1,24,0,294,2.143980063,318,24,in,"('CHI', 'MOT')",Providence,nai10.xml,319,1,1,MOT,1542,3860,CHI
1,35,0,283,1.779336949,318,35,and,"('CHI', 'MOT')",Providence,nai10.xml,319,1,1,MOT,1542,3860,CHI
1,0,0,6,1.673976434,6,0,did,"('FAT', 'MOT')",Providence,nai10.xml,7,1,1,MOT,46,156,FAT
1,0,1,5,1.252762968,5,0,you,"('FAT', 'MOT')",Providence,nai10.xml,7,2,1,MOT,46,156,FAT
2,73,1,243,0.947160666,316,73,the,"('CHI', 'MOT')",Providence,nai10.xml,319,3,2,MOT,1542,3860,CHI
0,1,1,5,0.287682072,6,1,on,"('FAT', 'MOT')",Providence,nai10.xml,7,1,0,MOT,46,156,FAT
0,2,1,4,-0.117783036,6,2,is,"('FAT', 'MOT')",Providence,nai10.xml,7,1,0,MOT,46,156,FAT
0,1,2,4,-0.133531393,5,1,to,"('FAT', 'MOT')",Providence,nai10.xml,7,2,0,MOT,46,156,FAT
3,6,2,288,3.184833517,294,6,big,"('CHI', 'MOT')",Providence,nai11.xml,299,5,3,MOT,1472,4216,CHI
4,7,2,286,3.137530185,293,7,up,"('CHI', 'MOT')",Providence,nai11.xml,299,6,4,MOT,1472,4216,CHI
1,7,1,290,2.927854851,297,7,all,"('CHI', 'MOT')",Providence,nai11.xml,299,2,1,MOT,1472,4216,CHI
1,11,0,287,2.813410717,298,11,no,"('CHI', 'MOT')",Providence,nai11.xml,299,1,1,MOT,1472,4216,CHI
3,13,1,282,2.649209701,295,13,one,"('CHI', 'MOT')",Providence,nai11.xml,299,4,3,MOT,1472,4216,CHI
1,0,1,17,2.251291799,17,0,see,"('MOT', 'FAT')",Providence,nai11.xml,19,2,1,FAT,138,282,MOT
2,1,1,28,2.2300144,29,1,up,"('CHI', 'FAT')",Providence,nai11.xml,32,3,2,FAT,152,557,CHI
1,16,1,281,2.174083049,297,16,on,"('CHI', 'MOT')",Providence,nai11.xml,299,2,1,MOT,1472,4216,CHI
1,1,1,29,2.079441542,30,1,this,"('CHI', 'FAT')",Providence,nai11.xml,32,2,1,FAT,152,557,CHI
2,1,2,27,2.014903021,28,1,big,"('CHI', 'FAT')",Providence,nai11.xml,32,4,2,FAT,152,557,CHI
1,11,4,283,1.952689836,294,11,this,"('CHI', 'MOT')",Providence,nai11.xml,299,5,1,MOT,1472,4216,CHI
1,1,0,17,1.897119985,18,1,up,"('MOT', 'FAT')",Providence,nai11.xml,19,1,1,FAT,138,282,MOT
2,3,0,27,1.791759469,30,3,is,"('CHI', 'FAT')",Providence,nai11.xml,32,2,2,FAT,152,557,CHI
2,0,20,37,1.584120104,37,0,the,"('FAT', 'CHI')",Providence,nai11.xml,59,22,2,CHI,760,277,FAT
0,1,4,54,1.558144618,55,1,on,"('FAT', 'CHI')",Providence,nai11.xml,59,4,0,CHI,760,277,FAT
1,3,3,52,1.558144618,55,3,big,"('FAT', 'CHI')",Providence,nai11.xml,59,4,1,CHI,760,277,FAT
1,1,2,20,1.526056303,21,1,was,"('FAT', 'MOT')",Providence,nai11.xml,24,3,1,MOT,312,161,FAT
1,1,2,20,1.526056303,21,1,she,"('FAT', 'MOT')",Providence,nai11.xml,24,3,1,MOT,312,161,FAT
0,1,1,22,1.427116356,23,1,they,"('FAT', 'MOT')",Providence,nai11.xml,24,1,0,MOT,312,161,FAT
0,1,1,22,1.427116356,23,1,can,"('FAT', 'MOT')",Providence,nai11.xml,24,1,0,MOT,312,161,FAT
0,1,1,22,1.427116356,23,1,one,"('FAT', 'MOT')",Providence,nai11.xml,24,1,0,MOT,312,161,FAT
0,1,1,17,1.203972804,18,1,what,"('MOT', 'FAT')",Providence,nai11.xml,19,1,0,FAT,138,282,MOT
0,1,1,17,1.203972804,18,1,there,"('MOT', 'FAT')",Providence,nai11.xml,19,1,0,FAT,138,282,MOT
0,1,1,17,1.203972804,18,1,put,"('MOT', 'FAT')",Providence,nai11.xml,19,1,0,FAT,138,282,MOT
0,1,1,17,1.203972804,18,1,at,"('MOT', 'FAT')",Providence,nai11.xml,19,1,0,FAT,138,282,MOT
0,1,1,17,1.203972804,18,1,and,"('MOT', 'FAT')",Providence,nai11.xml,19,1,0,FAT,138,282,MOT
1,2,1,15,1.15267951,17,2,in,"('MOT', 'FAT')",Providence,nai11.xml,19,2,1,FAT,138,282,MOT
1,27,4,267,1.105391976,294,27,is,"('CHI', 'MOT')",Providence,nai11.xml,299,5,1,MOT,1472,4216,CHI
0,1,2,21,1.098612289,22,1,have,"('FAT', 'MOT')",Providence,nai11.xml,24,2,0,MOT,312,161,FAT
0,1,2,21,1.098612289,22,1,at,"('FAT', 'MOT')",Providence,nai11.xml,24,2,0,MOT,312,161,FAT
1,1,4,18,1.098612289,19,1,yeah,"('FAT', 'MOT')",Providence,nai11.xml,24,5,1,MOT,312,161,FAT
1,1,4,18,1.098612289,19,1,big,"('FAT', 'MOT')",Providence,nai11.xml,24,5,1,MOT,312,161,FAT
0,2,1,21,1.021651248,23,2,like,"('FAT', 'MOT')",Providence,nai11.xml,24,1,0,MOT,312,161,FAT
0,2,1,21,1.021651248,23,2,of,"('FAT', 'MOT')",Providence,nai11.xml,24,1,0,MOT,312,161,FAT
0,2,1,21,1.021651248,23,2,there,"('FAT', 'MOT')",Providence,nai11.xml,24,1,0,MOT,312,161,FAT
1,75,0,223,0.967584026,298,75,a,"('CHI', 'MOT')",Providence,nai11.xml,299,1,1,MOT,1472,4216,CHI
1,1,5,17,0.916290732,18,1,a,"('FAT', 'MOT')",Providence,nai11.xml,24,6,1,MOT,312,161,FAT
0,1,2,16,0.864997437,17,1,like,"('MOT', 'FAT')",Providence,nai11.xml,19,2,0,FAT,138,282,MOT
0,1,2,16,0.864997437,17,1,it,"('MOT', 'FAT')",Providence,nai11.xml,19,2,0,FAT,138,282,MOT
0,1,3,20,0.832909123,21,1,put,"('FAT', 'MOT')",Providence,nai11.xml,24,3,0,MOT,312,161,FAT
0,2,1,16,0.798507696,18,2,for,"('MOT', 'FAT')",Providence,nai11.xml,19,1,0,FAT,138,282,MOT
0,2,1,16,0.798507696,18,2,are,"('MOT', 'FAT')",Providence,nai11.xml,19,1,0,FAT,138,282,MOT
0,2,1,16,0.798507696,18,2,on,"('MOT', 'FAT')",Providence,nai11.xml,19,1,0,FAT,138,282,MOT
4,5,1,9,0.644357016,14,5,the,"('MOT', 'FAT')",Providence,nai11.xml,19,5,4,FAT,138,282,MOT
3,88,2,206,0.642107297,294,88,the,"('CHI', 'MOT')",Providence,nai11.xml,299,5,3,MOT,1472,4216,CHI
1,3,2,13,0.587786665,16,3,that,"('MOT', 'FAT')",Providence,nai11.xml,19,3,1,FAT,138,282,MOT
0,2,3,19,0.427444015,21,2,in,"('FAT', 'MOT')",Providence,nai11.xml,24,3,0,MOT,312,161,FAT
0,3,2,19,0.405465108,22,3,it,"('FAT', 'MOT')",Providence,nai11.xml,24,2,0,MOT,312,161,FAT
0,4,1,14,0.287682072,18,4,to,"('MOT', 'FAT')",Providence,nai11.xml,19,1,0,FAT,138,282,MOT
3,8,1,7,0.230523659,15,8,you,"('MOT', 'FAT')",Providence,nai11.xml,19,4,3,FAT,138,282,MOT
0,3,2,14,0.171850257,17,3,oh,"('MOT', 'FAT')",Providence,nai11.xml,19,2,0,FAT,138,282,MOT
0,4,2,13,-0.051293294,17,4,a,"('MOT', 'FAT')",Providence,nai11.xml,19,2,0,FAT,138,282,MOT
0,3,4,17,-0.087011377,20,3,to,"('FAT', 'MOT')",Providence,nai11.xml,24,4,0,MOT,312,161,FAT
2,3,9,10,-0.144581229,13,3,you,"('FAT', 'MOT')",Providence,nai11.xml,24,11,2,MOT,312,161,FAT
1,3,8,12,-0.257829109,15,3,the,"('FAT', 'MOT')",Providence,nai11.xml,24,9,1,MOT,312,161,FAT
0,3,5,16,-0.287682072,19,3,oh,"('FAT', 'MOT')",Providence,nai11.xml,24,5,0,MOT,312,161,FAT
2,1,5,375,4.143134726,376,1,one,"('MOT', 'CHI')",Providence,nai12.xml,383,7,2,CHI,5321,1809,MOT
3,0,37,343,3.49216916,343,0,on,"('MOT', 'CHI')",Providence,nai12.xml,383,40,3,CHI,5321,1809,MOT
1,2,10,370,2.953841332,372,2,big,"('MOT', 'CHI')",Providence,nai12.xml,383,11,1,CHI,5321,1809,MOT
1,0,39,343,2.799021979,343,0,and,"('MOT', 'CHI')",Providence,nai12.xml,383,40,1,CHI,5321,1809,MOT
0,1,12,370,2.589373909,371,1,look,"('MOT', 'CHI')",Providence,nai12.xml,383,12,0,CHI,5321,1809,MOT
0,1,16,366,2.327277706,367,1,at,"('MOT', 'CHI')",Providence,nai12.xml,383,16,0,CHI,5321,1809,MOT
0,1,18,364,2.216482394,365,1,little,"('MOT', 'CHI')",Providence,nai12.xml,383,18,0,CHI,5321,1809,MOT
0,1,20,362,2.11570772,363,1,can,"('MOT', 'CHI')",Providence,nai12.xml,383,20,0,CHI,5321,1809,MOT
0,2,15,366,1.981677373,368,2,no,"('MOT', 'CHI')",Providence,nai12.xml,383,15,0,CHI,5321,1809,MOT
0,4,13,366,1.601405741,370,4,up,"('MOT', 'CHI')",Providence,nai12.xml,383,13,0,CHI,5321,1809,MOT
0,2,24,357,1.532169132,359,2,do,"('MOT', 'CHI')",Providence,nai12.xml,383,24,0,CHI,5321,1809,MOT
1,0,0,3,1.203972804,3,0,you,"('FAT', 'MOT')",Providence,nai12.xml,4,1,1,MOT,24,43,FAT
1,0,0,3,1.203972804,3,0,to,"('FAT', 'MOT')",Providence,nai12.xml,4,1,1,MOT,24,43,FAT
0,2,39,342,1.03425442,344,2,that,"('MOT', 'CHI')",Providence,nai12.xml,383,39,0,CHI,5321,1809,MOT
0,2,40,341,1.00726251,343,2,oh,"('MOT', 'CHI')",Providence,nai12.xml,383,40,0,CHI,5321,1809,MOT
2,6,49,326,0.993551219,332,6,is,"('MOT', 'CHI')",Providence,nai12.xml,383,51,2,CHI,5321,1809,MOT
1,0,0,2,0.980829253,2,0,some,"('MOT', 'FAT')",Providence,nai12.xml,3,1,1,FAT,33,43,MOT
0,5,23,355,0.881008918,360,5,go,"('MOT', 'CHI')",Providence,nai12.xml,383,23,0,CHI,5321,1809,MOT
1,7,37,338,0.774150965,345,7,this,"('MOT', 'CHI')",Providence,nai12.xml,383,38,1,CHI,5321,1809,MOT
0,1,76,306,0.68348527,307,1,a,"('MOT', 'CHI')",Providence,nai12.xml,383,76,0,CHI,5321,1809,MOT
0,2,111,270,-0.212872001,272,2,the,"('MOT', 'CHI')",Providence,nai12.xml,383,111,0,CHI,5321,1809,MOT
0,1,1,1,-0.405465108,2,1,you,"('MOT', 'FAT')",Providence,nai12.xml,3,1,0,FAT,33,43,MOT
0,1,1,1,-0.405465108,2,1,for,"('MOT', 'FAT')",Providence,nai12.xml,3,1,0,FAT,33,43,MOT
0,1,1,1,-0.405465108,2,1,are,"('MOT', 'FAT')",Providence,nai12.xml,3,1,0,FAT,33,43,MOT
0,1,1,1,-0.405465108,2,1,the,"('MOT', 'FAT')",Providence,nai12.xml,3,1,0,FAT,33,43,MOT
0,1,4,445,3.619886583,446,1,my,"('MOT', 'CHI')",Providence,nai13.xml,450,4,0,CHI,6335,2053,MOT
0,1,10,439,2.913256052,440,1,he,"('MOT', 'CHI')",Providence,nai13.xml,450,10,0,CHI,6335,2053,MOT
3,1,42,404,2.851812764,405,1,on,"('MOT', 'CHI')",Providence,nai13.xml,450,45,3,CHI,6335,2053,MOT
0,2,8,440,2.694627181,442,2,make,"('MOT', 'CHI')",Providence,nai13.xml,450,8,0,CHI,6335,2053,MOT
1,7,8,434,2.309380136,441,7,big,"('MOT', 'CHI')",Providence,nai13.xml,450,9,1,CHI,6335,2053,MOT
0,2,15,433,2.148107562,435,2,was,"('MOT', 'CHI')",Providence,nai13.xml,450,15,0,CHI,6335,2053,MOT
2,6,26,416,1.801238213,422,6,one,"('MOT', 'CHI')",Providence,nai13.xml,450,28,2,CHI,6335,2053,MOT
0,11,8,431,1.30833282,442,11,up,"('MOT', 'CHI')",Providence,nai13.xml,450,8,0,CHI,6335,2053,MOT
2,5,73,370,0.895292585,375,5,a,"('MOT', 'CHI')",Providence,nai13.xml,450,75,2,CHI,6335,2053,MOT
2,15,30,403,0.839917753,418,15,this,"('MOT', 'CHI')",Providence,nai13.xml,450,32,2,CHI,6335,2053,MOT
1,1,146,302,0.716365471,303,1,the,"('MOT', 'CHI')",Providence,nai13.xml,450,147,1,CHI,6335,2053,MOT
0,1,1,6,0.405465108,7,1,you,"('MOT', 'AD1')",Providence,nai13.xml,8,1,0,AD1,89,92,MOT
2,15,53,380,0.266908579,395,15,is,"('MOT', 'CHI')",Providence,nai13.xml,450,55,2,CHI,6335,2053,MOT
0,2,1,5,0,7,2,oh,"('MOT', 'AD1')",Providence,nai13.xml,8,1,0,AD1,89,92,MOT
0,1,2,5,0,6,1,see,"('MOT', 'AD1')",Providence,nai13.xml,8,2,0,AD1,89,92,MOT
0,1,2,5,0,6,1,the,"('MOT', 'AD1')",Providence,nai13.xml,8,2,0,AD1,89,92,MOT
0,2,1,5,0,7,2,and,"('MOT', 'AD1')",Providence,nai13.xml,8,1,0,AD1,89,92,MOT
0,1,1,2,-0.182321557,3,1,are,"('MOT', 'AD2')",Providence,nai13.xml,4,1,0,AD2,40,20,MOT
0,1,2,1,-0.693147181,2,1,you,"('MOT', 'AD2')",Providence,nai13.xml,4,2,0,AD2,40,20,MOT
3,9,0,304,3.226843995,313,9,one,"('CHI', 'MOT')",Providence,nai14.xml,316,3,3,MOT,1569,5297,CHI
1,6,1,308,3.116684884,314,6,up,"('CHI', 'MOT')",Providence,nai14.xml,316,2,1,MOT,1569,5297,CHI
1,9,0,306,3.050851573,315,9,no,"('CHI', 'MOT')",Providence,nai14.xml,316,1,1,MOT,1569,5297,CHI
4,11,1,300,2.924824304,311,11,little,"('CHI', 'MOT')",Providence,nai14.xml,316,5,4,MOT,1569,5297,CHI
0,5,1,310,2.868530016,315,5,big,"('CHI', 'MOT')",Providence,nai14.xml,316,1,0,MOT,1569,5297,CHI
1,16,0,299,2.520223322,315,16,like,"('CHI', 'MOT')",Providence,nai14.xml,316,1,1,MOT,1569,5297,CHI
2,16,1,297,2.408533671,313,16,go,"('CHI', 'MOT')",Providence,nai14.xml,316,3,2,MOT,1569,5297,CHI
3,18,2,293,2.242148423,311,18,get,"('CHI', 'MOT')",Providence,nai14.xml,316,5,3,MOT,1569,5297,CHI
1,23,0,292,2.175382835,315,23,see,"('CHI', 'MOT')",Providence,nai14.xml,316,1,1,MOT,1569,5297,CHI
0,8,2,306,2.172223275,314,8,my,"('CHI', 'MOT')",Providence,nai14.xml,316,2,0,MOT,1569,5297,CHI
5,22,3,286,2.090252458,308,22,have,"('CHI', 'MOT')",Providence,nai14.xml,316,8,5,MOT,1569,5297,CHI
5,23,3,285,2.047692843,308,23,can,"('CHI', 'MOT')",Providence,nai14.xml,316,8,5,MOT,1569,5297,CHI
3,33,1,279,1.817567353,312,33,it,"('CHI', 'MOT')",Providence,nai14.xml,316,4,3,MOT,1569,5297,CHI
4,37,1,274,1.772144794,311,37,some,"('CHI', 'MOT')",Providence,nai14.xml,316,5,4,MOT,1569,5297,CHI
1,47,0,268,1.482235655,315,47,in,"('CHI', 'MOT')",Providence,nai14.xml,316,1,1,MOT,1569,5297,CHI
0,24,1,291,1.44141366,315,24,on,"('CHI', 'MOT')",Providence,nai14.xml,316,1,0,MOT,1569,5297,CHI
1,0,0,4,1.386294361,4,0,you,"('FAT', 'MOT')",Providence,nai14.xml,5,1,1,MOT,24,51,FAT
1,0,0,4,1.386294361,4,0,see,"('FAT', 'MOT')",Providence,nai14.xml,5,1,1,MOT,24,51,FAT
3,27,7,279,1.299282984,306,27,this,"('CHI', 'MOT')",Providence,nai14.xml,316,10,3,MOT,1569,5297,CHI
4,69,5,238,0.696388674,307,69,a,"('CHI', 'MOT')",Providence,nai14.xml,316,9,4,MOT,1569,5297,CHI
2,85,3,226,0.444558034,311,85,the,"('CHI', 'MOT')",Providence,nai14.xml,316,5,2,MOT,1569,5297,CHI
0,1,1,0,-0.693147181,1,1,this,"('FAT', 'CHI')",Providence,nai14.xml,2,1,0,CHI,25,17,FAT
0,1,1,0,-0.693147181,1,1,is,"('FAT', 'CHI')",Providence,nai14.xml,2,1,0,CHI,25,17,FAT
0,55,11,250,-0.863453301,305,55,is,"('CHI', 'MOT')",Providence,nai14.xml,316,11,0,MOT,1569,5297,CHI
0,1,2,311,3.669951444,312,1,look,"('MOT', 'CHI')",Providence,nai15.xml,314,2,0,CHI,3559,1485,MOT
0,1,2,311,3.669951444,312,1,up,"('MOT', 'CHI')",Providence,nai15.xml,314,2,0,CHI,3559,1485,MOT
0,1,3,310,3.443618098,311,1,get,"('MOT', 'CHI')",Providence,nai15.xml,314,3,0,CHI,3559,1485,MOT
0,1,4,309,3.258096538,310,1,but,"('MOT', 'CHI')",Providence,nai15.xml,314,4,0,CHI,3559,1485,MOT
1,0,20,293,3.244628321,293,0,on,"('MOT', 'CHI')",Providence,nai15.xml,314,21,1,CHI,3559,1485,MOT
0,1,6,307,2.963983575,308,1,make,"('MOT', 'CHI')",Providence,nai15.xml,314,6,0,CHI,3559,1485,MOT
1,2,8,303,2.923487367,305,2,go,"('MOT', 'CHI')",Providence,nai15.xml,314,9,1,CHI,3559,1485,MOT
0,2,4,308,2.85263143,310,2,little,"('MOT', 'CHI')",Providence,nai15.xml,314,4,0,CHI,3559,1485,MOT
0,1,8,305,2.734367509,306,1,for,"('MOT', 'CHI')",Providence,nai15.xml,314,8,0,CHI,3559,1485,MOT
0,2,5,307,2.695270474,309,2,no,"('MOT', 'CHI')",Providence,nai15.xml,314,5,0,CHI,3559,1485,MOT
0,2,7,305,2.437504411,307,2,have,"('MOT', 'CHI')",Providence,nai15.xml,314,7,0,CHI,3559,1485,MOT
1,1,26,286,2.299130858,287,1,it,"('MOT', 'CHI')",Providence,nai15.xml,314,27,1,CHI,3559,1485,MOT
2,4,15,293,2.24517897,297,4,this,"('MOT', 'CHI')",Providence,nai15.xml,314,17,2,CHI,3559,1485,MOT
0,1,20,293,1.90616982,294,1,in,"('MOT', 'CHI')",Providence,nai15.xml,314,20,0,CHI,3559,1485,MOT
0,1,22,291,1.812378756,292,1,one,"('MOT', 'CHI')",Providence,nai15.xml,314,22,0,CHI,3559,1485,MOT
0,1,1,33,1.791759469,34,1,get,"('CHI', 'FAT')",Providence,nai15.xml,35,1,0,FAT,188,502,CHI
1,0,0,6,1.673976434,6,0,did,"('FAT', 'MOT')",Providence,nai15.xml,7,1,1,MOT,28,61,FAT
0,3,21,290,1.165186779,293,3,with,"('MOT', 'CHI')",Providence,nai15.xml,314,21,0,CHI,3559,1485,MOT
1,4,34,275,1.111146025,279,4,is,"('MOT', 'CHI')",Providence,nai15.xml,314,35,1,CHI,3559,1485,MOT
0,1,6,28,0.661398482,29,1,this,"('CHI', 'FAT')",Providence,nai15.xml,35,6,0,FAT,188,502,CHI
0,1,6,28,0.661398482,29,1,is,"('CHI', 'FAT')",Providence,nai15.xml,35,6,0,FAT,188,502,CHI
0,1,4,20,0.650587566,21,1,the,"('FAT', 'CHI')",Providence,nai15.xml,25,4,0,CHI,271,132,FAT
0,4,2,29,0.559615788,33,4,it,"('CHI', 'FAT')",Providence,nai15.xml,35,2,0,FAT,188,502,CHI
0,1,1,5,0.287682072,6,1,yeah,"('FAT', 'MOT')",Providence,nai15.xml,7,1,0,MOT,28,61,FAT
0,1,1,4,0.15415068,5,1,the,"('MOT', 'FAT')",Providence,nai15.xml,6,1,0,FAT,33,35,MOT
0,2,1,4,-0.117783036,6,2,that,"('FAT', 'MOT')",Providence,nai15.xml,7,1,0,MOT,28,61,FAT
0,1,2,320,3.698210782,321,1,all,"('MOT', 'CHI')",Providence,nai16.xml,323,2,0,CHI,3522,1577,MOT
0,1,3,319,3.471966453,320,1,but,"('MOT', 'CHI')",Providence,nai16.xml,323,3,0,CHI,3522,1577,MOT
4,0,42,277,3.369448683,277,0,and,"('MOT', 'CHI')",Providence,nai16.xml,323,46,4,CHI,3522,1577,MOT
1,0,19,303,3.322416504,303,0,of,"('MOT', 'CHI')",Providence,nai16.xml,323,20,1,CHI,3522,1577,MOT
2,4,3,314,3.311585223,318,4,get,"('MOT', 'CHI')",Providence,nai16.xml,323,5,2,CHI,3522,1577,MOT
0,3,2,318,3.005063601,321,3,big,"('MOT', 'CHI')",Providence,nai16.xml,323,2,0,CHI,3522,1577,MOT
1,1,0,56,2.978925155,57,1,up,"('CHI', 'FAT')",Providence,nai16.xml,58,1,1,FAT,302,639,CHI
1,1,0,56,2.978925155,57,1,to,"('CHI', 'FAT')",Providence,nai16.xml,58,1,1,FAT,302,639,CHI
1,2,0,55,2.573460047,57,2,big,"('CHI', 'FAT')",Providence,nai16.xml,58,1,1,FAT,302,639,CHI
0,1,1,56,2.285777975,57,1,but,"('CHI', 'FAT')",Providence,nai16.xml,58,1,0,FAT,302,639,CHI
0,1,15,307,2.210211773,308,1,see,"('MOT', 'CHI')",Providence,nai16.xml,323,15,0,CHI,3522,1577,MOT
1,1,4,52,2.061423036,53,1,this,"('CHI', 'FAT')",Providence,nai16.xml,58,5,1,FAT,302,639,CHI
1,1,0,20,2.036881927,21,1,for,"('FAT', 'MOT')",Providence,nai16.xml,22,1,1,MOT,158,220,FAT
1,0,1,13,2.014903021,13,0,this,"('MOT', 'FAT')",Providence,nai16.xml,15,2,1,FAT,91,92,MOT
1,0,1,13,2.014903021,13,0,and,"('MOT', 'FAT')",Providence,nai16.xml,15,2,1,FAT,91,92,MOT
0,1,2,47,1.832581464,48,1,this,"('FAT', 'CHI')",Providence,nai16.xml,50,2,0,CHI,457,220,FAT
0,1,23,299,1.798404012,300,1,are,"('MOT', 'CHI')",Providence,nai16.xml,323,23,0,CHI,3522,1577,MOT
5,3,59,256,1.780330773,259,3,the,"('MOT', 'CHI')",Providence,nai16.xml,323,64,5,CHI,3522,1577,MOT
1,0,2,12,1.722766598,12,0,is,"('MOT', 'FAT')",Providence,nai16.xml,15,3,1,FAT,91,92,MOT
1,0,2,12,1.722766598,12,0,the,"('MOT', 'FAT')",Providence,nai16.xml,15,3,1,FAT,91,92,MOT
1,1,1,19,1.704748092,20,1,are,"('FAT', 'MOT')",Providence,nai16.xml,22,2,1,MOT,158,220,FAT
1,2,4,51,1.655957928,53,2,is,"('CHI', 'FAT')",Providence,nai16.xml,58,5,1,FAT,302,639,CHI
0,2,18,303,1.632503185,305,2,in,"('MOT', 'CHI')",Providence,nai16.xml,323,18,0,CHI,3522,1577,MOT
3,8,0,47,1.622683139,55,8,see,"('CHI', 'FAT')",Providence,nai16.xml,58,3,3,FAT,302,639,CHI
0,1,3,46,1.589235205,47,1,wanna,"('FAT', 'CHI')",Providence,nai16.xml,50,3,0,CHI,457,220,FAT
1,2,4,43,1.498772345,45,2,in,"('FAT', 'CHI')",Providence,nai16.xml,50,5,1,CHI,457,220,FAT
1,0,103,219,1.427870788,219,0,you,"('MOT', 'CHI')",Providence,nai16.xml,323,104,1,CHI,3522,1577,MOT
0,1,4,45,1.386294361,46,1,see,"('FAT', 'CHI')",Providence,nai16.xml,50,4,0,CHI,457,220,FAT
0,1,4,45,1.386294361,46,1,is,"('FAT', 'CHI')",Providence,nai16.xml,50,4,0,CHI,457,220,FAT
0,1,1,20,1.343734747,21,1,of,"('FAT', 'MOT')",Providence,nai16.xml,22,1,0,MOT,158,220,FAT
0,1,1,20,1.343734747,21,1,to,"('FAT', 'MOT')",Providence,nai16.xml,22,1,0,MOT,158,220,FAT
1,1,1,12,1.32175584,13,1,you,"('MOT', 'FAT')",Providence,nai16.xml,15,2,1,FAT,91,92,MOT
1,2,1,18,1.299282984,20,2,see,"('FAT', 'MOT')",Providence,nai16.xml,22,2,1,MOT,158,220,FAT
1,2,0,12,1.268511325,14,2,what,"('MOT', 'FAT')",Providence,nai16.xml,15,1,1,FAT,91,92,MOT
0,4,16,303,1.233531607,307,4,have,"('MOT', 'CHI')",Providence,nai16.xml,323,16,0,CHI,3522,1577,MOT
1,12,0,45,1.107122978,57,12,the,"('CHI', 'FAT')",Providence,nai16.xml,58,1,1,FAT,302,639,CHI
0,2,32,289,1.055199796,291,2,oh,"('MOT', 'CHI')",Providence,nai16.xml,323,32,0,CHI,3522,1577,MOT
1,1,4,16,0.99852883,17,1,a,"('FAT', 'MOT')",Providence,nai16.xml,22,5,1,MOT,158,220,FAT
0,1,1,13,0.980829253,14,1,a,"('MOT', 'FAT')",Providence,nai16.xml,15,1,0,FAT,91,92,MOT
0,1,1,13,0.980829253,14,1,see,"('MOT', 'FAT')",Providence,nai16.xml,15,1,0,FAT,91,92,MOT
0,2,1,19,0.938269639,21,2,was,"('FAT', 'MOT')",Providence,nai16.xml,22,1,0,MOT,158,220,FAT
1,7,30,285,0.800777845,292,7,it,"('MOT', 'CHI')",Providence,nai16.xml,323,31,1,CHI,3522,1577,MOT
0,5,21,297,0.789774016,302,5,this,"('MOT', 'CHI')",Providence,nai16.xml,323,21,0,CHI,3522,1577,MOT
0,2,46,275,0.661398482,277,2,a,"('MOT', 'CHI')",Providence,nai16.xml,323,46,0,CHI,3522,1577,MOT
0,3,1,18,0.650587566,21,3,what,"('FAT', 'MOT')",Providence,nai16.xml,22,1,0,MOT,158,220,FAT
0,3,1,18,0.650587566,21,3,and,"('FAT', 'MOT')",Providence,nai16.xml,22,1,0,MOT,158,220,FAT
0,2,2,18,0.606135804,20,2,the,"('FAT', 'MOT')",Providence,nai16.xml,22,2,0,MOT,158,220,FAT
0,2,1,12,0.575364145,14,2,are,"('MOT', 'FAT')",Providence,nai16.xml,15,1,0,FAT,91,92,MOT
0,4,32,287,0.544374172,291,4,on,"('MOT', 'CHI')",Providence,nai16.xml,323,32,0,CHI,3522,1577,MOT
0,1,11,38,0.455475529,39,1,the,"('FAT', 'CHI')",Providence,nai16.xml,50,11,0,CHI,457,220,FAT
0,3,2,17,0.318453731,20,3,yeah,"('FAT', 'MOT')",Providence,nai16.xml,22,2,0,MOT,158,220,FAT
0,2,4,16,0.105360516,18,2,it,"('FAT', 'MOT')",Providence,nai16.xml,22,4,0,MOT,158,220,FAT
0,5,46,272,-0.031748698,277,5,is,"('MOT', 'CHI')",Providence,nai16.xml,323,46,0,CHI,3522,1577,MOT
1,6,3,12,-0.048790164,18,6,you,"('FAT', 'MOT')",Providence,nai16.xml,22,4,1,MOT,158,220,FAT
0,2,12,36,-0.048790164,38,2,a,"('FAT', 'CHI')",Providence,nai16.xml,50,12,0,CHI,457,220,FAT
1,2,0,283,4.155404819,285,2,make,"('CHI', 'MOT')",Providence,nai17.xml,286,1,1,MOT,1118,3854,CHI
1,6,0,279,3.308106959,285,6,not,"('CHI', 'MOT')",Providence,nai17.xml,286,1,1,MOT,1118,3854,CHI
2,7,0,277,3.288868197,284,7,up,"('CHI', 'MOT')",Providence,nai17.xml,286,2,2,MOT,1118,3854,CHI
3,12,1,270,2.678559773,282,12,little,"('CHI', 'MOT')",Providence,nai17.xml,286,4,3,MOT,1118,3854,CHI
0,4,2,280,2.660259537,284,4,get,"('CHI', 'MOT')",Providence,nai17.xml,286,2,0,MOT,1118,3854,CHI
0,3,3,280,2.656756907,283,3,look,"('CHI', 'MOT')",Providence,nai17.xml,286,3,0,MOT,1118,3854,CHI
1,16,0,269,2.420803764,285,16,one,"('CHI', 'MOT')",Providence,nai17.xml,286,1,1,MOT,1118,3854,CHI
3,26,0,257,2.133508763,283,26,it,"('CHI', 'MOT')",Providence,nai17.xml,286,3,3,MOT,1118,3854,CHI
9,23,3,251,2.105874799,274,23,oh,"('CHI', 'MOT')",Providence,nai17.xml,286,12,9,MOT,1118,3854,CHI
1,33,0,252,1.727656583,285,33,in,"('CHI', 'MOT')",Providence,nai17.xml,286,1,1,MOT,1118,3854,CHI
0,13,2,271,1.63064012,284,13,at,"('CHI', 'MOT')",Providence,nai17.xml,286,2,0,MOT,1118,3854,CHI
0,19,1,266,1.565137654,285,19,did,"('CHI', 'MOT')",Providence,nai17.xml,286,1,0,MOT,1118,3854,CHI
2,52,0,232,1.398017825,284,52,a,"('CHI', 'MOT')",Providence,nai17.xml,286,2,2,MOT,1118,3854,CHI
2,40,2,242,1.242254991,282,40,is,"('CHI', 'MOT')",Providence,nai17.xml,286,4,2,MOT,1118,3854,CHI
6,84,1,195,0.944388985,279,84,the,"('CHI', 'MOT')",Providence,nai17.xml,286,7,6,MOT,1118,3854,CHI
1,26,10,249,0.456378463,275,26,this,"('CHI', 'MOT')",Providence,nai17.xml,286,11,1,MOT,1118,3854,CHI
0,2,2,275,3.146305132,277,2,up,"('CHI', 'MOT')",Providence,nai18.xml,279,2,0,MOT,1224,5004,CHI
1,6,1,271,2.992154452,277,6,little,"('CHI', 'MOT')",Providence,nai18.xml,279,2,1,MOT,1224,5004,CHI
1,12,0,266,2.664375138,278,12,not,"('CHI', 'MOT')",Providence,nai18.xml,279,1,1,MOT,1224,5004,CHI
1,14,0,264,2.521274294,278,14,for,"('CHI', 'MOT')",Providence,nai18.xml,279,1,1,MOT,1224,5004,CHI
2,14,1,262,2.408745289,276,14,have,"('CHI', 'MOT')",Providence,nai18.xml,279,3,2,MOT,1224,5004,CHI
2,16,1,260,2.283582146,276,16,go,"('CHI', 'MOT')",Providence,nai18.xml,279,3,2,MOT,1224,5004,CHI
1,20,0,258,2.184802057,278,20,like,"('CHI', 'MOT')",Providence,nai18.xml,279,1,1,MOT,1224,5004,CHI
3,17,2,257,2.17041332,274,17,one,"('CHI', 'MOT')",Providence,nai18.xml,279,5,3,MOT,1224,5004,CHI
1,1,10,107,2.135531008,108,1,go,"('MOT', 'CHI')",Providence,nai18.xml,119,11,1,CHI,2040,564,MOT
6,29,0,244,2.082042323,273,29,on,"('CHI', 'MOT')",Providence,nai18.xml,279,6,6,MOT,1224,5004,CHI
1,0,22,96,2.059238834,96,0,to,"('MOT', 'CHI')",Providence,nai18.xml,119,23,1,CHI,2040,564,MOT
3,28,0,248,2.037181732,276,28,it,"('CHI', 'MOT')",Providence,nai18.xml,279,3,3,MOT,1224,5004,CHI
2,28,0,249,1.976233879,277,28,there,"('CHI', 'MOT')",Providence,nai18.xml,279,2,2,MOT,1224,5004,CHI
0,1,6,112,1.972343406,113,1,up,"('MOT', 'CHI')",Providence,nai18.xml,119,6,0,CHI,2040,564,MOT
3,12,7,257,1.938557175,269,12,no,"('CHI', 'MOT')",Providence,nai18.xml,279,10,3,MOT,1224,5004,CHI
0,1,7,111,1.84582669,112,1,see,"('MOT', 'CHI')",Providence,nai18.xml,119,7,0,CHI,2040,564,MOT
1,0,0,7,1.791759469,7,0,this,"('ADU', 'MOT')",Providence,nai18.xml,8,1,1,MOT,52,41,ADU
1,0,1,10,1.791759469,10,0,it,"('MOT', 'ADU')",Providence,nai18.xml,12,2,1,ADU,100,63,MOT
1,0,1,10,1.791759469,10,0,a,"('MOT', 'ADU')",Providence,nai18.xml,12,2,1,ADU,100,63,MOT
0,1,8,110,1.731655545,111,1,want,"('MOT', 'CHI')",Providence,nai18.xml,119,8,0,CHI,2040,564,MOT
0,1,9,109,1.627456418,110,1,have,"('MOT', 'CHI')",Providence,nai18.xml,119,9,0,CHI,2040,564,MOT
0,1,9,109,1.627456418,110,1,was,"('MOT', 'CHI')",Providence,nai18.xml,119,9,0,CHI,2040,564,MOT
2,0,2,8,1.609437912,8,0,that,"('MOT', 'ADU')",Providence,nai18.xml,12,4,2,ADU,100,63,MOT
1,27,1,250,1.605860091,277,27,do,"('CHI', 'MOT')",Providence,nai18.xml,279,2,1,MOT,1224,5004,CHI
5,49,0,225,1.55422718,274,49,to,"('CHI', 'MOT')",Providence,nai18.xml,279,5,5,MOT,1224,5004,CHI
4,33,3,239,1.498980917,272,33,in,"('CHI', 'MOT')",Providence,nai18.xml,279,7,4,MOT,1224,5004,CHI
1,46,0,232,1.379176893,278,46,we,"('CHI', 'MOT')",Providence,nai18.xml,279,1,1,MOT,1224,5004,CHI
2,54,0,223,1.336196524,277,54,what,"('CHI', 'MOT')",Providence,nai18.xml,279,2,2,MOT,1224,5004,CHI
2,21,6,250,1.314456538,271,21,this,"('CHI', 'MOT')",Providence,nai18.xml,279,8,2,MOT,1224,5004,CHI
0,1,13,105,1.280933845,106,1,there,"('MOT', 'CHI')",Providence,nai18.xml,119,13,0,CHI,2040,564,MOT
0,1,14,104,1.207092932,105,1,in,"('MOT', 'CHI')",Providence,nai18.xml,119,14,0,CHI,2040,564,MOT
1,2,18,98,1.174985267,100,2,it,"('MOT', 'CHI')",Providence,nai18.xml,119,19,1,CHI,2040,564,MOT
0,1,17,101,1.006804739,102,1,on,"('MOT', 'CHI')",Providence,nai18.xml,119,17,0,CHI,2040,564,MOT
5,60,3,211,0.987772307,271,60,is,"('CHI', 'MOT')",Providence,nai18.xml,279,8,5,MOT,1224,5004,CHI
1,51,1,226,0.986820883,277,51,that,"('CHI', 'MOT')",Providence,nai18.xml,279,2,1,MOT,1224,5004,CHI
1,55,1,222,0.912712911,277,55,and,"('CHI', 'MOT')",Providence,nai18.xml,279,2,1,MOT,1224,5004,CHI
2,84,0,193,0.900878453,277,84,you,"('CHI', 'MOT')",Providence,nai18.xml,279,2,2,MOT,1224,5004,CHI
3,9,14,93,0.783661188,102,9,this,"('MOT', 'CHI')",Providence,nai18.xml,119,17,3,CHI,2040,564,MOT
0,1,1,10,0.773189888,11,1,of,"('MOT', 'ADU')",Providence,nai18.xml,12,1,0,ADU,100,63,MOT
0,1,1,10,0.773189888,11,1,are,"('MOT', 'ADU')",Providence,nai18.xml,12,1,0,ADU,100,63,MOT
0,1,1,10,0.773189888,11,1,to,"('MOT', 'ADU')",Providence,nai18.xml,12,1,0,ADU,100,63,MOT
6,74,4,195,0.745634207,269,74,a,"('CHI', 'MOT')",Providence,nai18.xml,279,10,6,MOT,1224,5004,CHI
2,43,5,229,0.730326184,272,43,oh,"('CHI', 'MOT')",Providence,nai18.xml,279,7,2,MOT,1224,5004,CHI
3,8,18,90,0.658745754,98,8,is,"('MOT', 'CHI')",Providence,nai18.xml,119,21,3,CHI,2040,564,MOT
8,96,3,172,0.6559862,268,96,the,"('CHI', 'MOT')",Providence,nai18.xml,279,11,8,MOT,1224,5004,CHI
0,29,3,247,0.61698582,276,29,yeah,"('CHI', 'MOT')",Providence,nai18.xml,279,3,0,MOT,1224,5004,CHI
0,2,1,9,0.36772478,11,2,oh,"('MOT', 'ADU')",Providence,nai18.xml,12,1,0,ADU,100,63,MOT
0,2,1,9,0.36772478,11,2,you,"('MOT', 'ADU')",Providence,nai18.xml,12,1,0,ADU,100,63,MOT
0,1,3,8,0.09531018,9,1,yeah,"('MOT', 'ADU')",Providence,nai18.xml,12,3,0,ADU,100,63,MOT
0,2,1,5,0,7,2,oh,"('ADU', 'MOT')",Providence,nai18.xml,8,1,0,MOT,52,41,ADU
0,2,36,81,-0.293547192,83,2,the,"('MOT', 'CHI')",Providence,nai18.xml,119,36,0,CHI,2040,564,MOT
0,3,2,3,-0.693147181,6,3,in,"('ADU', 'MOT')",Providence,nai18.xml,8,2,0,MOT,52,41,ADU
0,1,1,0,-0.693147181,1,1,the,"('MOT', 'FAT')",Providence,nai18.xml,2,1,0,FAT,10,15,MOT
1,5,0,409,3.833460683,414,5,make,"('CHI', 'MOT')",Providence,nai19.xml,415,1,1,MOT,1971,5437,CHI
3,6,2,404,3.515497412,410,6,big,"('CHI', 'MOT')",Providence,nai19.xml,415,5,3,MOT,1971,5437,CHI
2,10,0,403,3.342701175,413,10,get,"('CHI', 'MOT')",Providence,nai19.xml,415,2,2,MOT,1971,5437,CHI
0,4,1,410,3.322635059,414,4,but,"('CHI', 'MOT')",Providence,nai19.xml,415,1,0,MOT,1971,5437,CHI
2,15,0,398,2.968007726,413,15,some,"('CHI', 'MOT')",Providence,nai19.xml,415,2,2,MOT,1971,5437,CHI
2,15,1,397,2.742451628,412,15,my,"('CHI', 'MOT')",Providence,nai19.xml,415,3,2,MOT,1971,5437,CHI
2,9,5,399,2.614959778,408,9,one,"('CHI', 'MOT')",Providence,nai19.xml,415,7,2,MOT,1971,5437,CHI
0,7,2,406,2.562542617,413,7,look,"('CHI', 'MOT')",Providence,nai19.xml,415,2,0,MOT,1971,5437,CHI
2,15,2,396,2.55771169,411,15,up,"('CHI', 'MOT')",Providence,nai19.xml,415,4,2,MOT,1971,5437,CHI
1,21,0,393,2.534177699,414,21,have,"('CHI', 'MOT')",Providence,nai19.xml,415,1,1,MOT,1971,5437,CHI
0,11,1,403,2.447166322,414,11,little,"('CHI', 'MOT')",Providence,nai19.xml,415,1,0,MOT,1971,5437,CHI
1,15,2,397,2.33698652,412,15,where,"('CHI', 'MOT')",Providence,nai19.xml,415,3,1,MOT,1971,5437,CHI
1,8,6,400,2.314855186,408,8,no,"('CHI', 'MOT')",Providence,nai19.xml,415,7,1,MOT,1971,5437,CHI
0,16,1,398,2.098859628,414,16,did,"('CHI', 'MOT')",Providence,nai19.xml,415,1,0,MOT,1971,5437,CHI
0,10,3,402,2.018532789,412,10,at,"('CHI', 'MOT')",Providence,nai19.xml,415,3,0,MOT,1971,5437,CHI
0,18,1,396,1.987633992,414,18,gonna,"('CHI', 'MOT')",Providence,nai19.xml,415,1,0,MOT,1971,5437,CHI
1,38,0,376,1.961658506,414,38,what,"('CHI', 'MOT')",Providence,nai19.xml,415,1,1,MOT,1971,5437,CHI
2,30,2,381,1.896313208,411,30,oh,"('CHI', 'MOT')",Providence,nai19.xml,415,4,2,MOT,1971,5437,CHI
0,20,1,394,1.887550534,414,20,was,"('CHI', 'MOT')",Providence,nai19.xml,415,1,0,MOT,1971,5437,CHI
1,20,3,391,1.880312867,411,20,for,"('CHI', 'MOT')",Providence,nai19.xml,415,4,1,MOT,1971,5437,CHI
1,45,0,369,1.796578756,414,45,are,"('CHI', 'MOT')",Providence,nai19.xml,415,1,1,MOT,1971,5437,CHI
1,46,0,368,1.77507255,414,46,yeah,"('CHI', 'MOT')",Providence,nai19.xml,415,1,1,MOT,1971,5437,CHI
3,38,3,371,1.661884388,409,38,on,"('CHI', 'MOT')",Providence,nai19.xml,415,6,3,MOT,1971,5437,CHI
2,21,7,385,1.620941737,406,21,this,"('CHI', 'MOT')",Providence,nai19.xml,415,9,2,MOT,1971,5437,CHI
0,20,2,393,1.597461721,413,20,see,"('CHI', 'MOT')",Providence,nai19.xml,415,2,0,MOT,1971,5437,CHI
0,34,1,380,1.37672491,414,34,with,"('CHI', 'MOT')",Providence,nai19.xml,415,1,0,MOT,1971,5437,CHI
4,50,5,356,1.290984181,406,50,a,"('CHI', 'MOT')",Providence,nai19.xml,415,9,4,MOT,1971,5437,CHI
1,32,4,378,1.271752819,410,32,there,"('CHI', 'MOT')",Providence,nai19.xml,415,5,1,MOT,1971,5437,CHI
1,46,2,366,1.25942764,412,46,in,"('CHI', 'MOT')",Providence,nai19.xml,415,3,1,MOT,1971,5437,CHI
1,47,2,365,1.238374231,412,47,that,"('CHI', 'MOT')",Providence,nai19.xml,415,3,1,MOT,1971,5437,CHI
0,46,1,368,1.08192537,414,46,we,"('CHI', 'MOT')",Providence,nai19.xml,415,1,0,MOT,1971,5437,CHI
2,114,0,299,0.995664319,413,114,you,"('CHI', 'MOT')",Providence,nai19.xml,415,2,2,MOT,1971,5437,CHI
3,43,9,360,0.966934465,403,43,it,"('CHI', 'MOT')",Providence,nai19.xml,415,12,3,MOT,1971,5437,CHI
10,111,7,287,0.726421969,398,111,the,"('CHI', 'MOT')",Providence,nai19.xml,415,17,10,MOT,1971,5437,CHI
5,66,13,331,0.580295993,397,66,is,"('CHI', 'MOT')",Providence,nai19.xml,415,18,5,MOT,1971,5437,CHI
1,1,4,358,3.942967809,359,1,put,"('MOT', 'CHI')",Providence,nai20.xml,364,5,1,CHI,3864,1664,MOT
3,4,4,353,3.46295426,357,4,one,"('MOT', 'CHI')",Providence,nai20.xml,364,7,3,CHI,3864,1664,MOT
0,1,5,358,3.249820629,359,1,go,"('MOT', 'CHI')",Providence,nai20.xml,364,5,0,CHI,3864,1664,MOT
0,1,5,358,3.249820629,359,1,my,"('MOT', 'CHI')",Providence,nai20.xml,364,5,0,CHI,3864,1664,MOT
0,1,5,358,3.249820629,359,1,where,"('MOT', 'CHI')",Providence,nai20.xml,364,5,0,CHI,3864,1664,MOT
1,3,6,354,2.992950631,357,3,up,"('MOT', 'CHI')",Providence,nai20.xml,364,7,1,CHI,3864,1664,MOT
0,1,7,356,2.992950631,357,1,get,"('MOT', 'CHI')",Providence,nai20.xml,364,7,0,CHI,3864,1664,MOT
0,1,7,356,2.992950631,357,1,make,"('MOT', 'CHI')",Providence,nai20.xml,364,7,0,CHI,3864,1664,MOT
1,0,0,24,2.85263143,24,0,we,"('MOT', 'FAT')",Providence,nai20.xml,25,1,1,FAT,195,181,MOT
0,1,9,354,2.786693328,355,1,not,"('MOT', 'CHI')",Providence,nai20.xml,364,9,0,CHI,3864,1664,MOT
2,3,16,343,2.568788134,346,3,see,"('MOT', 'CHI')",Providence,nai20.xml,364,18,2,CHI,3864,1664,MOT
2,3,19,340,2.420368129,343,3,oh,"('MOT', 'CHI')",Providence,nai20.xml,364,21,2,CHI,3864,1664,MOT
0,1,14,349,2.397895273,350,1,there,"('MOT', 'CHI')",Providence,nai20.xml,364,14,0,CHI,3864,1664,MOT
1,0,0,12,2.233592222,12,0,in,"('CHI', 'FAT')",Providence,nai20.xml,13,1,1,FAT,55,115,CHI
0,1,17,346,2.217485762,347,1,want,"('MOT', 'CHI')",Providence,nai20.xml,364,17,0,CHI,3864,1664,MOT
0,1,17,346,2.217485762,347,1,like,"('MOT', 'CHI')",Providence,nai20.xml,364,17,0,CHI,3864,1664,MOT
1,3,18,342,2.111655162,345,3,in,"('MOT', 'CHI')",Providence,nai20.xml,364,19,1,CHI,3864,1664,MOT
0,2,13,349,2.059805567,351,2,at,"('MOT', 'CHI')",Providence,nai20.xml,364,13,0,CHI,3864,1664,MOT
0,3,10,351,2.00372972,354,3,have,"('MOT', 'CHI')",Providence,nai20.xml,364,10,0,CHI,3864,1664,MOT
1,0,2,16,1.974081026,16,0,on,"('CHI', 'MOT')",Providence,nai20.xml,19,3,1,MOT,71,133,CHI
0,1,22,341,1.969440646,342,1,with,"('MOT', 'CHI')",Providence,nai20.xml,364,22,0,CHI,3864,1664,MOT
1,2,29,332,1.945910149,334,2,that,"('MOT', 'CHI')",Providence,nai20.xml,364,30,1,CHI,3864,1664,MOT
1,1,1,24,1.909542505,25,1,you,"('FAT', 'MOT')",Providence,nai20.xml,27,2,1,MOT,235,185,FAT
3,6,25,330,1.862232726,336,6,on,"('MOT', 'CHI')",Providence,nai20.xml,364,28,3,CHI,3864,1664,MOT
1,1,2,23,1.648658626,24,1,in,"('FAT', 'MOT')",Providence,nai20.xml,27,3,1,MOT,235,185,FAT
0,3,15,346,1.641278518,349,3,for,"('MOT', 'CHI')",Providence,nai20.xml,364,15,0,CHI,3864,1664,MOT
1,1,2,21,1.568615918,22,1,did,"('MOT', 'FAT')",Providence,nai20.xml,25,3,1,FAT,195,181,MOT
0,2,22,340,1.563975538,342,2,do,"('MOT', 'CHI')",Providence,nai20.xml,364,22,0,CHI,3864,1664,MOT
0,1,1,25,1.540445041,26,1,go,"('FAT', 'MOT')",Providence,nai20.xml,27,1,0,MOT,235,185,FAT
0,1,1,25,1.540445041,26,1,like,"('FAT', 'MOT')",Providence,nai20.xml,27,1,0,MOT,235,185,FAT
0,1,1,25,1.540445041,26,1,we,"('FAT', 'MOT')",Providence,nai20.xml,27,1,0,MOT,235,185,FAT
0,1,1,25,1.540445041,26,1,was,"('FAT', 'MOT')",Providence,nai20.xml,27,1,0,MOT,235,185,FAT
0,1,1,23,1.466337069,24,1,gonna,"('MOT', 'FAT')",Providence,nai20.xml,25,1,0,FAT,195,181,MOT
0,1,1,23,1.466337069,24,1,yeah,"('MOT', 'FAT')",Providence,nai20.xml,25,1,0,FAT,195,181,MOT
0,1,1,23,1.466337069,24,1,they,"('MOT', 'FAT')",Providence,nai20.xml,25,1,0,FAT,195,181,MOT
0,1,1,23,1.466337069,24,1,she,"('MOT', 'FAT')",Providence,nai20.xml,25,1,0,FAT,195,181,MOT
1,1,3,22,1.427116356,23,1,is,"('FAT', 'MOT')",Providence,nai20.xml,27,4,1,MOT,235,185,FAT
4,1,6,16,1.375823061,17,1,the,"('FAT', 'MOT')",Providence,nai20.xml,27,10,4,MOT,235,185,FAT
1,1,2,15,1.280933845,16,1,it,"('CHI', 'MOT')",Providence,nai20.xml,19,3,1,MOT,71,133,CHI
0,1,1,17,1.203972804,18,1,he,"('CHI', 'MOT')",Providence,nai20.xml,19,1,0,MOT,71,133,CHI
0,10,8,346,1.180052621,356,10,no,"('MOT', 'CHI')",Providence,nai20.xml,364,8,0,CHI,3864,1664,MOT
1,1,1,10,1.178654996,11,1,the,"('CHI', 'FAT')",Providence,nai20.xml,13,2,1,FAT,55,115,CHI
1,2,2,20,1.16315081,22,2,to,"('MOT', 'FAT')",Providence,nai20.xml,25,3,1,FAT,195,181,MOT
0,1,2,22,1.139434283,23,1,it,"('MOT', 'FAT')",Providence,nai20.xml,25,2,0,FAT,195,181,MOT
0,1,2,22,1.139434283,23,1,that,"('MOT', 'FAT')",Providence,nai20.xml,25,2,0,FAT,195,181,MOT
0,2,1,24,1.134979933,26,2,there,"('FAT', 'MOT')",Providence,nai20.xml,27,1,0,MOT,235,185,FAT
0,2,1,24,1.134979933,26,2,not,"('FAT', 'MOT')",Providence,nai20.xml,27,1,0,MOT,235,185,FAT
0,2,1,22,1.060871961,24,2,see,"('MOT', 'FAT')",Providence,nai20.xml,25,1,0,FAT,195,181,MOT
0,2,1,22,1.060871961,24,2,are,"('MOT', 'FAT')",Providence,nai20.xml,25,1,0,FAT,195,181,MOT
0,2,1,22,1.060871961,24,2,not,"('MOT', 'FAT')",Providence,nai20.xml,25,1,0,FAT,195,181,MOT
1,3,2,21,0.955511445,24,3,it,"('FAT', 'MOT')",Providence,nai20.xml,27,3,1,MOT,235,185,FAT
0,1,1,11,0.84729786,12,1,this,"('CHI', 'FAT')",Providence,nai20.xml,13,1,0,FAT,55,115,CHI
5,8,75,276,0.843807455,284,8,the,"('MOT', 'CHI')",Providence,nai20.xml,364,80,5,CHI,3864,1664,MOT
0,2,2,23,0.810930216,25,2,see,"('FAT', 'MOT')",Providence,nai20.xml,27,2,0,MOT,235,185,FAT
0,2,2,23,0.810930216,25,2,he,"('FAT', 'MOT')",Providence,nai20.xml,27,2,0,MOT,235,185,FAT
0,2,2,23,0.810930216,25,2,that,"('FAT', 'MOT')",Providence,nai20.xml,27,2,0,MOT,235,185,FAT
0,2,2,23,0.810930216,25,2,and,"('FAT', 'MOT')",Providence,nai20.xml,27,2,0,MOT,235,185,FAT
1,2,4,18,0.739667196,20,2,the,"('MOT', 'FAT')",Providence,nai20.xml,25,5,1,FAT,195,181,MOT
0,2,2,21,0.733969175,23,2,a,"('MOT', 'FAT')",Providence,nai20.xml,25,2,0,FAT,195,181,MOT
0,4,33,327,0.643356516,331,4,to,"('MOT', 'CHI')",Providence,nai20.xml,364,33,0,CHI,3864,1664,MOT
2,30,15,317,0.575258027,347,30,this,"('MOT', 'CHI')",Providence,nai20.xml,364,17,2,CHI,3864,1664,MOT
0,2,3,20,0.470003629,22,2,in,"('MOT', 'FAT')",Providence,nai20.xml,25,3,0,FAT,195,181,MOT
0,3,2,20,0.446287103,23,3,and,"('MOT', 'FAT')",Providence,nai20.xml,25,2,0,FAT,195,181,MOT
0,2,1,10,0.441832752,12,2,is,"('CHI', 'FAT')",Providence,nai20.xml,13,1,0,FAT,55,115,CHI
1,10,41,312,0.29180579,322,10,it,"('MOT', 'CHI')",Providence,nai20.xml,364,42,1,CHI,3864,1664,MOT
0,3,3,21,0.262364264,24,3,oh,"('FAT', 'MOT')",Providence,nai20.xml,27,3,0,MOT,235,185,FAT
1,7,67,289,0.062303883,296,7,a,"('MOT', 'CHI')",Providence,nai20.xml,364,68,1,CHI,3864,1664,MOT
0,3,4,20,0.040821995,23,3,to,"('FAT', 'MOT')",Providence,nai20.xml,27,4,0,MOT,235,185,FAT
0,4,3,20,0.039220713,24,4,yeah,"('FAT', 'MOT')",Providence,nai20.xml,27,3,0,MOT,235,185,FAT
0,2,6,19,-0.042559614,21,2,a,"('FAT', 'MOT')",Providence,nai20.xml,27,6,0,MOT,235,185,FAT
0,4,6,15,-0.644357016,19,4,you,"('MOT', 'FAT')",Providence,nai20.xml,25,6,0,FAT,195,181,MOT
0,1,4,3,-0.693147181,4,1,a,"('FAT', 'CHI')",Providence,nai20.xml,8,4,0,CHI,81,25,FAT
0,31,32,301,-1.180955434,332,31,is,"('MOT', 'CHI')",Providence,nai20.xml,364,32,0,CHI,3864,1664,MOT
2,1,1,342,4.639571613,343,1,no,"('CHI', 'MOT')",Providence,nai21.xml,346,3,2,MOT,1661,3780,CHI
1,2,0,343,4.345247383,345,2,little,"('CHI', 'MOT')",Providence,nai21.xml,346,1,1,MOT,1661,3780,CHI
0,1,2,343,3.766997233,344,1,big,"('CHI', 'MOT')",Providence,nai21.xml,346,2,0,MOT,1661,3780,CHI
0,2,1,343,3.652100203,345,2,some,"('CHI', 'MOT')",Providence,nai21.xml,346,1,0,MOT,1661,3780,CHI
0,2,1,343,3.652100203,345,2,at,"('CHI', 'MOT')",Providence,nai21.xml,346,1,0,MOT,1661,3780,CHI
0,3,1,342,3.36441813,345,3,my,"('CHI', 'MOT')",Providence,nai21.xml,346,1,0,MOT,1661,3780,CHI
1,0,2,53,3.091042453,53,0,in,"('MOT', 'CHI')",Providence,nai21.xml,56,3,1,CHI,761,269,MOT
0,5,1,340,2.958953022,345,5,look,"('CHI', 'MOT')",Providence,nai21.xml,346,1,0,MOT,1661,3780,CHI
1,8,1,336,2.956067017,344,8,have,"('CHI', 'MOT')",Providence,nai21.xml,346,2,1,MOT,1661,3780,CHI
3,5,7,331,2.932674138,336,5,get,"('CHI', 'MOT')",Providence,nai21.xml,346,10,3,MOT,1661,3780,CHI
0,6,1,339,2.804802342,345,6,want,"('CHI', 'MOT')",Providence,nai21.xml,346,1,0,MOT,1661,3780,CHI
17,10,18,301,2.627761763,311,10,where,"('CHI', 'MOT')",Providence,nai21.xml,346,35,17,MOT,1661,3780,CHI
1,16,0,329,2.610646328,345,16,all,"('CHI', 'MOT')",Providence,nai21.xml,346,1,1,MOT,1661,3780,CHI
1,19,0,326,2.448127398,345,19,gonna,"('CHI', 'MOT')",Providence,nai21.xml,346,1,1,MOT,1661,3780,CHI
0,9,1,336,2.448127398,345,9,was,"('CHI', 'MOT')",Providence,nai21.xml,346,1,0,MOT,1661,3780,CHI
2,24,0,320,2.339880878,344,24,on,"('CHI', 'MOT')",Providence,nai21.xml,346,2,2,MOT,1661,3780,CHI
1,16,1,328,2.32007825,344,16,put,"('CHI', 'MOT')",Providence,nai21.xml,346,2,1,MOT,1661,3780,CHI
1,17,1,327,2.262919837,344,17,up,"('CHI', 'MOT')",Providence,nai21.xml,346,2,1,MOT,1661,3780,CHI
0,1,1,54,2.251291799,55,1,have,"('MOT', 'CHI')",Providence,nai21.xml,56,1,0,CHI,761,269,MOT
11,16,12,307,2.216642663,323,16,did,"('CHI', 'MOT')",Providence,nai21.xml,346,23,11,MOT,1661,3780,CHI
1,12,3,330,2.177080011,342,12,one,"('CHI', 'MOT')",Providence,nai21.xml,346,4,1,MOT,1661,3780,CHI
2,1,5,48,2.140066163,49,1,he,"('MOT', 'CHI')",Providence,nai21.xml,56,7,2,CHI,761,269,MOT
3,27,1,315,2.102972039,342,27,yeah,"('CHI', 'MOT')",Providence,nai21.xml,346,4,3,MOT,1661,3780,CHI
12,12,27,295,2.01976921,307,12,go,"('CHI', 'MOT')",Providence,nai21.xml,346,39,12,MOT,1661,3780,CHI
0,11,2,333,1.975237764,344,11,wanna,"('CHI', 'MOT')",Providence,nai21.xml,346,2,0,MOT,1661,3780,CHI
1,13,4,328,1.945910149,341,13,with,"('CHI', 'MOT')",Providence,nai21.xml,346,5,1,MOT,1661,3780,CHI
0,1,2,53,1.945910149,54,1,get,"('MOT', 'CHI')",Providence,nai21.xml,56,2,0,CHI,761,269,MOT
0,1,2,53,1.945910149,54,1,one,"('MOT', 'CHI')",Providence,nai21.xml,56,2,0,CHI,761,269,MOT
0,16,1,329,1.917499147,345,16,she,"('CHI', 'MOT')",Providence,nai21.xml,346,1,0,MOT,1661,3780,CHI
1,36,0,309,1.832941759,345,36,are,"('CHI', 'MOT')",Providence,nai21.xml,346,1,1,MOT,1661,3780,CHI
1,27,1,317,1.821087084,344,27,we,"('CHI', 'MOT')",Providence,nai21.xml,346,2,1,MOT,1661,3780,CHI
0,14,2,330,1.752094213,344,14,see,"('CHI', 'MOT')",Providence,nai21.xml,346,2,0,MOT,1661,3780,CHI
0,12,3,331,1.669157147,343,12,for,"('CHI', 'MOT')",Providence,nai21.xml,346,3,0,MOT,1661,3780,CHI
1,32,1,312,1.656784033,344,32,to,"('CHI', 'MOT')",Providence,nai21.xml,346,2,1,MOT,1661,3780,CHI
1,0,0,5,1.540445041,5,0,have,"('AD1', 'MOT')",Providence,nai21.xml,6,1,1,MOT,66,44,AD1
1,0,0,5,1.540445041,5,0,they,"('AD1', 'MOT')",Providence,nai21.xml,6,1,1,MOT,66,44,AD1
0,1,4,51,1.504077397,52,1,did,"('MOT', 'CHI')",Providence,nai21.xml,56,4,0,CHI,761,269,MOT
7,44,5,290,1.450832882,334,44,there,"('CHI', 'MOT')",Providence,nai21.xml,346,12,7,MOT,1661,3780,CHI
0,29,1,316,1.34951511,345,29,oh,"('CHI', 'MOT')",Providence,nai21.xml,346,1,0,MOT,1661,3780,CHI
0,1,5,50,1.331234584,51,1,do,"('MOT', 'CHI')",Providence,nai21.xml,56,5,0,CHI,761,269,MOT
1,0,18,37,1.312186389,37,0,you,"('MOT', 'CHI')",Providence,nai21.xml,56,19,1,CHI,761,269,MOT
3,43,4,296,1.236762627,339,43,in,"('CHI', 'MOT')",Providence,nai21.xml,346,7,3,MOT,1661,3780,CHI
0,20,3,323,1.189584067,343,20,this,"('CHI', 'MOT')",Providence,nai21.xml,346,3,0,MOT,1661,3780,CHI
6,61,4,275,1.15691501,336,61,you,"('CHI', 'MOT')",Providence,nai21.xml,346,10,6,MOT,1661,3780,CHI
0,18,4,324,1.104443209,342,18,do,"('CHI', 'MOT')",Providence,nai21.xml,346,4,0,MOT,1661,3780,CHI
10,38,18,280,1.101457241,318,38,it,"('CHI', 'MOT')",Providence,nai21.xml,346,28,10,MOT,1661,3780,CHI
1,5,3,47,1.098612289,52,5,go,"('MOT', 'CHI')",Providence,nai21.xml,56,4,1,CHI,761,269,MOT
15,49,17,265,1.089947406,314,49,that,"('CHI', 'MOT')",Providence,nai21.xml,346,32,15,MOT,1661,3780,CHI
0,3,3,50,1.011600912,53,3,she,"('MOT', 'CHI')",Providence,nai21.xml,56,3,0,CHI,761,269,MOT
1,1,0,4,0.84729786,5,1,go,"('AD1', 'MOT')",Providence,nai21.xml,6,1,1,MOT,66,44,AD1
39,88,18,201,0.796028908,289,88,the,"('CHI', 'MOT')",Providence,nai21.xml,346,57,39,MOT,1661,3780,CHI
1,0,0,1,0.693147181,1,0,no,"('AD2', 'MOT')",Providence,nai21.xml,2,1,1,MOT,4,13,AD2
1,0,0,1,0.693147181,1,0,see,"('TOY', 'MOT')",Providence,nai21.xml,2,1,1,MOT,33,19,TOY
1,0,0,1,0.693147181,1,0,little,"('TOY', 'MOT')",Providence,nai21.xml,2,1,1,MOT,33,19,TOY
1,0,0,1,0.693147181,1,0,to,"('TOY', 'MOT')",Providence,nai21.xml,2,1,1,MOT,33,19,TOY
3,2,21,30,0.555946059,32,2,the,"('MOT', 'CHI')",Providence,nai21.xml,56,24,3,CHI,761,269,MOT
0,3,6,47,0.485507816,50,3,where,"('MOT', 'CHI')",Providence,nai21.xml,56,6,0,CHI,761,269,MOT
0,30,6,310,0.321381991,340,30,what,"('CHI', 'MOT')",Providence,nai21.xml,346,6,0,MOT,1661,3780,CHI
1,80,4,261,0.190518324,341,80,is,"('CHI', 'MOT')",Providence,nai21.xml,346,5,1,MOT,1661,3780,CHI
1,5,10,40,0.186585956,45,5,there,"('MOT', 'CHI')",Providence,nai21.xml,56,11,1,CHI,761,269,MOT
0,1,1,4,0.15415068,5,1,you,"('AD1', 'MOT')",Providence,nai21.xml,6,1,0,MOT,66,44,AD1
0,1,1,4,0.15415068,5,1,this,"('AD1', 'MOT')",Providence,nai21.xml,6,1,0,MOT,66,44,AD1
1,59,8,278,0.026907453,337,59,a,"('CHI', 'MOT')",Providence,nai21.xml,346,9,1,MOT,1661,3780,CHI
0,3,11,42,-0.101096117,45,3,it,"('MOT', 'CHI')",Providence,nai21.xml,56,11,0,CHI,761,269,MOT
0,4,10,42,-0.223143551,46,4,a,"('MOT', 'CHI')",Providence,nai21.xml,56,10,0,CHI,761,269,MOT
0,1,2,3,-0.287682072,4,1,in,"('AD1', 'MOT')",Providence,nai21.xml,6,2,0,MOT,66,44,AD1
0,1,2,3,-0.287682072,4,1,and,"('AD1', 'MOT')",Providence,nai21.xml,6,2,0,MOT,66,44,AD1
0,1,3,2,-0.693147181,3,1,no,"('AD1', 'MOT')",Providence,nai21.xml,6,3,0,MOT,66,44,AD1
1,0,11,402,4.055504729,402,0,was,"('MOT', 'CHI')",Providence,nai22.xml,414,12,1,CHI,4862,1941,MOT
0,2,1,411,3.831053943,413,2,make,"('MOT', 'CHI')",Providence,nai22.xml,414,1,0,CHI,4862,1941,MOT
0,1,5,408,3.379535885,409,1,get,"('MOT', 'CHI')",Providence,nai22.xml,414,5,0,CHI,4862,1941,MOT
0,1,5,408,3.379535885,409,1,my,"('MOT', 'CHI')",Providence,nai22.xml,414,5,0,CHI,4862,1941,MOT
2,0,39,373,3.264338199,373,0,she,"('MOT', 'CHI')",Providence,nai22.xml,414,41,2,CHI,4862,1941,MOT
0,3,4,407,2.842969519,410,3,no,"('MOT', 'CHI')",Providence,nai22.xml,414,4,0,CHI,4862,1941,MOT
15,11,19,369,2.649583743,380,11,did,"('MOT', 'CHI')",Providence,nai22.xml,414,34,15,CHI,4862,1941,MOT
0,1,13,400,2.59773918,401,1,he,"('MOT', 'CHI')",Providence,nai22.xml,414,13,0,CHI,4862,1941,MOT
1,3,13,397,2.530716186,400,3,one,"('MOT', 'CHI')",Providence,nai22.xml,414,14,1,CHI,4862,1941,MOT
0,2,9,403,2.512305624,405,2,put,"('MOT', 'CHI')",Providence,nai22.xml,414,9,0,CHI,4862,1941,MOT
0,2,9,403,2.512305624,405,2,wanna,"('MOT', 'CHI')",Providence,nai22.xml,414,9,0,CHI,4862,1941,MOT
12,13,16,373,2.485699986,386,13,where,"('MOT', 'CHI')",Providence,nai22.xml,414,28,12,CHI,4862,1941,MOT
2,1,48,363,2.356854723,364,1,what,"('MOT', 'CHI')",Providence,nai22.xml,414,50,2,CHI,4862,1941,MOT
1,2,22,389,2.349468679,391,2,they,"('MOT', 'CHI')",Providence,nai22.xml,414,23,1,CHI,4862,1941,MOT
15,22,12,365,2.23337802,387,22,go,"('MOT', 'CHI')",Providence,nai22.xml,414,27,15,CHI,4862,1941,MOT
1,0,2,17,2.028148247,17,0,have,"('CHI', 'MOT')",Providence,nai22.xml,20,3,1,MOT,78,214,CHI
4,6,32,372,1.966112856,378,6,have,"('MOT', 'CHI')",Providence,nai22.xml,414,36,4,CHI,4862,1941,MOT
0,1,26,387,1.940795048,388,1,of,"('MOT', 'CHI')",Providence,nai22.xml,414,26,0,CHI,4862,1941,MOT
1,6,14,393,1.907985115,399,6,with,"('MOT', 'CHI')",Providence,nai22.xml,414,15,1,CHI,4862,1941,MOT
1,2,35,376,1.897119985,378,2,do,"('MOT', 'CHI')",Providence,nai22.xml,414,36,1,CHI,4862,1941,MOT
0,2,22,390,1.69968479,392,2,we,"('MOT', 'CHI')",Providence,nai22.xml,414,22,0,CHI,4862,1941,MOT
3,8,27,376,1.67917125,384,8,on,"('MOT', 'CHI')",Providence,nai22.xml,414,30,3,CHI,4862,1941,MOT
1,1,1,17,1.609437912,18,1,the,"('CHI', 'MOT')",Providence,nai22.xml,20,2,1,MOT,78,214,CHI
1,6,20,387,1.59062858,393,6,this,"('MOT', 'CHI')",Providence,nai22.xml,414,21,1,CHI,4862,1941,MOT
5,9,42,358,1.508150722,367,9,in,"('MOT', 'CHI')",Providence,nai22.xml,414,47,5,CHI,4862,1941,MOT
1,0,1,7,1.504077397,7,0,a,"('FAT', 'CHI')",Providence,nai22.xml,9,2,1,CHI,88,45,FAT
0,3,20,391,1.504077397,394,3,at,"('MOT', 'CHI')",Providence,nai22.xml,414,20,0,CHI,4862,1941,MOT
1,0,1,7,1.504077397,7,0,in,"('MOT', 'FAT')",Providence,nai22.xml,9,2,1,FAT,77,36,MOT
0,1,40,373,1.498772345,374,1,oh,"('MOT', 'CHI')",Providence,nai22.xml,414,40,0,CHI,4862,1941,MOT
4,4,73,333,1.456552255,337,4,is,"('MOT', 'CHI')",Providence,nai22.xml,414,77,4,CHI,4862,1941,MOT
0,1,45,368,1.37290728,369,1,and,"('MOT', 'CHI')",Providence,nai22.xml,414,45,0,CHI,4862,1941,MOT
2,9,29,374,1.252762968,383,9,like,"('MOT', 'CHI')",Providence,nai22.xml,414,31,2,CHI,4862,1941,MOT
0,2,36,376,1.203972804,378,2,see,"('MOT', 'CHI')",Providence,nai22.xml,414,36,0,CHI,4862,1941,MOT
6,22,27,359,1.203102861,381,22,it,"('MOT', 'CHI')",Providence,nai22.xml,414,33,6,CHI,4862,1941,MOT
0,4,23,387,1.145495875,391,4,up,"('MOT', 'CHI')",Providence,nai22.xml,414,23,0,CHI,4862,1941,MOT
3,5,75,331,1.035554153,336,5,that,"('MOT', 'CHI')",Providence,nai22.xml,414,78,3,CHI,4862,1941,MOT
1,12,20,381,0.971589372,393,12,for,"('MOT', 'CHI')",Providence,nai22.xml,414,21,1,CHI,4862,1941,MOT
1,0,3,5,0.84729786,5,0,the,"('MOT', 'FAT')",Providence,nai22.xml,9,4,1,FAT,77,36,MOT
1,1,1,6,0.810930216,7,1,it,"('FAT', 'CHI')",Providence,nai22.xml,9,2,1,CHI,88,45,FAT
1,6,0,13,0.693147181,19,6,is,"('CHI', 'MOT')",Providence,nai22.xml,20,1,1,MOT,78,214,CHI
5,5,1,9,0.693147181,14,5,a,"('CHI', 'MOT')",Providence,nai22.xml,20,6,5,MOT,78,214,CHI
26,44,80,264,0.543615447,308,44,a,"('MOT', 'CHI')",Providence,nai22.xml,414,106,26,CHI,4862,1941,MOT
13,26,98,277,0.336144422,303,26,the,"('MOT', 'CHI')",Providence,nai22.xml,414,111,13,CHI,4862,1941,MOT
1,10,48,355,0.268788123,365,10,there,"('MOT', 'CHI')",Providence,nai22.xml,414,49,1,CHI,4862,1941,MOT
0,1,2,6,0.117783036,7,1,at,"('FAT', 'CHI')",Providence,nai22.xml,9,2,0,CHI,88,45,FAT
0,9,46,359,-0.260283098,368,9,to,"('MOT', 'CHI')",Providence,nai22.xml,414,46,0,CHI,4862,1941,MOT
0,5,85,324,-0.455549213,329,5,you,"('MOT', 'CHI')",Providence,nai22.xml,414,85,0,CHI,4862,1941,MOT
0,3,3,3,-0.916290732,6,3,the,"('FAT', 'CHI')",Providence,nai22.xml,9,3,0,CHI,88,45,FAT
1,2,0,365,4.406719247,367,2,want,"('CHI', 'MOT')",Providence,nai23.xml,368,1,1,MOT,1596,5108,CHI
2,8,0,358,3.423176288,366,8,little,"('CHI', 'MOT')",Providence,nai23.xml,368,2,2,MOT,1596,5108,CHI
1,8,0,359,3.308106959,367,8,no,"('CHI', 'MOT')",Providence,nai23.xml,368,1,1,MOT,1596,5108,CHI
1,6,1,360,3.269025609,366,6,big,"('CHI', 'MOT')",Providence,nai23.xml,368,2,1,MOT,1596,5108,CHI
1,12,1,354,2.6499864,366,12,make,"('CHI', 'MOT')",Providence,nai23.xml,368,2,1,MOT,1596,5108,CHI
1,10,2,355,2.591175843,365,10,up,"('CHI', 'MOT')",Providence,nai23.xml,368,3,1,MOT,1596,5108,CHI
1,17,1,349,2.324564,366,17,wanna,"('CHI', 'MOT')",Providence,nai23.xml,368,2,1,MOT,1596,5108,CHI
7,17,8,336,2.227974229,353,17,do,"('CHI', 'MOT')",Providence,nai23.xml,368,15,7,MOT,1596,5108,CHI
1,26,0,341,2.20949467,367,26,are,"('CHI', 'MOT')",Providence,nai23.xml,368,1,1,MOT,1596,5108,CHI
17,19,15,317,2.191324855,336,19,where,"('CHI', 'MOT')",Providence,nai23.xml,368,32,17,MOT,1596,5108,CHI
1,27,0,340,2.173127026,367,27,see,"('CHI', 'MOT')",Providence,nai23.xml,368,1,1,MOT,1596,5108,CHI
0,15,1,352,2.039595633,367,15,at,"('CHI', 'MOT')",Providence,nai23.xml,368,1,0,MOT,1596,5108,CHI
3,18,5,342,2.030914501,360,18,some,"('CHI', 'MOT')",Providence,nai23.xml,368,8,3,MOT,1596,5108,CHI
2,24,2,340,1.990610328,364,24,for,"('CHI', 'MOT')",Providence,nai23.xml,368,4,2,MOT,1596,5108,CHI
18,21,20,309,1.969652041,330,21,go,"('CHI', 'MOT')",Providence,nai23.xml,368,38,18,MOT,1596,5108,CHI
2,16,5,345,1.962577202,361,16,one,"('CHI', 'MOT')",Providence,nai23.xml,368,7,2,MOT,1596,5108,CHI
0,17,1,350,1.921812597,367,17,get,"('CHI', 'MOT')",Providence,nai23.xml,368,1,0,MOT,1596,5108,CHI
5,31,3,329,1.915082685,360,31,on,"('CHI', 'MOT')",Providence,nai23.xml,368,8,5,MOT,1596,5108,CHI
6,22,8,332,1.912757942,354,22,did,"('CHI', 'MOT')",Providence,nai23.xml,368,14,6,MOT,1596,5108,CHI
1,21,2,344,1.898028663,365,21,put,"('CHI', 'MOT')",Providence,nai23.xml,368,3,1,MOT,1596,5108,CHI
14,32,8,314,1.885691289,346,32,there,"('CHI', 'MOT')",Providence,nai23.xml,368,22,14,MOT,1596,5108,CHI
0,20,1,347,1.767661918,367,20,like,"('CHI', 'MOT')",Providence,nai23.xml,368,1,0,MOT,1596,5108,CHI
11,39,6,312,1.718056273,351,39,she,"('CHI', 'MOT')",Providence,nai23.xml,368,17,11,MOT,1596,5108,CHI
1,46,0,321,1.655183934,367,46,oh,"('CHI', 'MOT')",Providence,nai23.xml,368,1,1,MOT,1596,5108,CHI
1,35,2,330,1.405552178,365,35,what,"('CHI', 'MOT')",Providence,nai23.xml,368,3,1,MOT,1596,5108,CHI
1,60,0,307,1.394457672,367,60,to,"('CHI', 'MOT')",Providence,nai23.xml,368,1,1,MOT,1596,5108,CHI
1,18,7,342,1.33776732,360,18,this,"('CHI', 'MOT')",Providence,nai23.xml,368,8,1,MOT,1596,5108,CHI
6,61,3,298,1.30975845,359,61,in,"('CHI', 'MOT')",Providence,nai23.xml,368,9,6,MOT,1596,5108,CHI
9,53,7,299,1.292526202,352,53,is,"('CHI', 'MOT')",Providence,nai23.xml,368,16,9,MOT,1596,5108,CHI
0,20,3,345,1.251401498,365,20,with,"('CHI', 'MOT')",Providence,nai23.xml,368,3,0,MOT,1596,5108,CHI
9,38,16,305,1.186730998,343,38,it,"('CHI', 'MOT')",Providence,nai23.xml,368,25,9,MOT,1596,5108,CHI
5,60,6,297,0.999258636,357,60,that,"('CHI', 'MOT')",Providence,nai23.xml,368,11,5,MOT,1596,5108,CHI
2,61,3,302,0.925465108,363,61,a,"('CHI', 'MOT')",Providence,nai23.xml,368,5,2,MOT,1596,5108,CHI
14,101,6,247,0.849968089,348,101,the,"('CHI', 'MOT')",Providence,nai23.xml,368,20,14,MOT,1596,5108,CHI
1,93,2,272,0.445776334,365,93,you,"('CHI', 'MOT')",Providence,nai23.xml,368,3,1,MOT,1596,5108,CHI
1,3,0,217,3.610917913,220,3,at,"('CHI', 'MOT')",Providence,nai24.xml,221,1,1,MOT,919,2215,CHI
2,3,1,215,3.496507561,218,3,big,"('CHI', 'MOT')",Providence,nai24.xml,221,3,2,MOT,919,2215,CHI
1,0,0,45,3.444682494,45,0,can,"('CHI', 'GRA')",Providence,nai24.xml,46,1,1,GRA,197,336,CHI
1,4,0,216,3.387774361,220,4,he,"('CHI', 'MOT')",Providence,nai24.xml,221,1,1,MOT,919,2215,CHI
1,1,5,214,3.300455812,215,1,where,"('CHI', 'MOT')",Providence,nai24.xml,221,6,1,MOT,919,2215,CHI
0,1,1,149,3.232121052,150,1,where,"('MOT', 'CHI')",Providence,nai24.xml,151,1,0,CHI,1412,590,MOT
0,2,1,218,3.205452805,220,2,one,"('CHI', 'MOT')",Providence,nai24.xml,221,1,0,MOT,919,2215,CHI
1,0,3,61,3.044522438,61,0,there,"('MOT', 'GRA')",Providence,nai24.xml,65,4,1,GRA,484,335,MOT
0,1,2,148,2.937838295,149,1,there,"('MOT', 'CHI')",Providence,nai24.xml,151,2,0,CHI,1412,590,MOT
0,1,2,148,2.937838295,149,1,did,"('MOT', 'CHI')",Providence,nai24.xml,151,2,0,CHI,1412,590,MOT
0,1,2,148,2.937838295,149,1,he,"('MOT', 'CHI')",Providence,nai24.xml,151,2,0,CHI,1412,590,MOT
1,0,12,138,2.926739402,138,0,to,"('MOT', 'CHI')",Providence,nai24.xml,151,13,1,CHI,1412,590,MOT
0,3,1,217,2.917770732,220,3,my,"('CHI', 'MOT')",Providence,nai24.xml,221,1,0,MOT,919,2215,CHI
2,8,0,211,2.913256052,219,8,see,"('CHI', 'MOT')",Providence,nai24.xml,221,2,2,MOT,919,2215,CHI
2,8,0,211,2.913256052,219,8,are,"('CHI', 'MOT')",Providence,nai24.xml,221,2,2,MOT,919,2215,CHI
1,1,1,62,2.788092909,63,1,want,"('MOT', 'GRA')",Providence,nai24.xml,65,2,1,GRA,484,335,MOT
0,1,1,91,2.751535313,92,1,gonna,"('GRA', 'CHI')",Providence,nai24.xml,93,1,0,CHI,508,367,GRA
0,1,1,91,2.751535313,92,1,there,"('GRA', 'CHI')",Providence,nai24.xml,93,1,0,CHI,508,367,GRA
1,1,1,57,2.708050201,58,1,have,"('GRA', 'MOT')",Providence,nai24.xml,60,2,1,MOT,399,484,GRA
2,0,0,18,2.708050201,18,0,are,"('MOT', 'FAT')",Providence,nai24.xml,20,2,2,FAT,109,148,MOT
0,4,1,216,2.694627181,220,4,no,"('CHI', 'MOT')",Providence,nai24.xml,221,1,0,MOT,919,2215,CHI
1,5,2,213,2.685577345,218,5,they,"('CHI', 'MOT')",Providence,nai24.xml,221,3,1,MOT,919,2215,CHI
1,0,0,19,2.63905733,19,0,no,"('CHI', 'FAT')",Providence,nai24.xml,20,1,1,FAT,54,145,CHI
1,0,0,19,2.63905733,19,0,like,"('MOT', 'FAT')",Providence,nai24.xml,20,1,1,FAT,109,148,MOT
2,11,0,208,2.625573979,219,11,not,"('CHI', 'MOT')",Providence,nai24.xml,221,2,2,MOT,919,2215,CHI
4,9,2,206,2.607308631,215,9,in,"('CHI', 'MOT')",Providence,nai24.xml,221,6,4,MOT,919,2215,CHI
5,2,13,131,2.602689685,133,2,are,"('MOT', 'CHI')",Providence,nai24.xml,151,18,5,CHI,1412,590,MOT
0,1,4,146,2.519039656,147,1,yeah,"('MOT', 'CHI')",Providence,nai24.xml,151,4,0,CHI,1412,590,MOT
2,7,3,209,2.457755661,216,7,there,"('CHI', 'MOT')",Providence,nai24.xml,221,5,2,MOT,919,2215,CHI
0,1,2,90,2.453157951,91,1,some,"('GRA', 'CHI')",Providence,nai24.xml,93,2,0,CHI,508,367,GRA
0,1,1,63,2.397895273,64,1,they,"('MOT', 'GRA')",Providence,nai24.xml,65,1,0,GRA,484,335,MOT
0,1,1,63,2.397895273,64,1,this,"('MOT', 'GRA')",Providence,nai24.xml,65,1,0,GRA,484,335,MOT
0,1,1,63,2.397895273,64,1,all,"('MOT', 'GRA')",Providence,nai24.xml,65,1,0,GRA,484,335,MOT
0,1,1,63,2.397895273,64,1,my,"('MOT', 'GRA')",Providence,nai24.xml,65,1,0,GRA,484,335,MOT
0,1,1,63,2.397895273,64,1,where,"('MOT', 'GRA')",Providence,nai24.xml,65,1,0,GRA,484,335,MOT
0,1,1,63,2.397895273,64,1,think,"('MOT', 'GRA')",Providence,nai24.xml,65,1,0,GRA,484,335,MOT
0,1,1,63,2.397895273,64,1,not,"('MOT', 'GRA')",Providence,nai24.xml,65,1,0,GRA,484,335,MOT
1,6,1,143,2.378222507,149,6,no,"('MOT', 'CHI')",Providence,nai24.xml,151,2,1,CHI,1412,590,MOT
0,2,1,90,2.346070205,92,2,did,"('GRA', 'CHI')",Providence,nai24.xml,93,1,0,CHI,508,367,GRA
0,2,1,90,2.346070205,92,2,no,"('GRA', 'CHI')",Providence,nai24.xml,93,1,0,CHI,508,367,GRA
0,2,1,90,2.346070205,92,2,where,"('GRA', 'CHI')",Providence,nai24.xml,93,1,0,CHI,508,367,GRA
2,7,4,208,2.319626559,215,7,she,"('CHI', 'MOT')",Providence,nai24.xml,221,6,2,MOT,919,2215,CHI
0,1,1,58,2.319114395,59,1,no,"('GRA', 'MOT')",Providence,nai24.xml,60,1,0,MOT,399,484,GRA
0,1,1,58,2.319114395,59,1,one,"('GRA', 'MOT')",Providence,nai24.xml,60,1,0,MOT,399,484,GRA
0,1,1,58,2.319114395,59,1,do,"('GRA', 'MOT')",Providence,nai24.xml,60,1,0,MOT,399,484,GRA
3,9,4,205,2.261763098,214,9,some,"('CHI', 'MOT')",Providence,nai24.xml,221,7,3,MOT,919,2215,CHI
0,1,3,89,2.219203484,90,1,at,"('GRA', 'CHI')",Providence,nai24.xml,93,3,0,CHI,508,367,GRA
1,1,2,42,2.197224577,43,1,no,"('CHI', 'GRA')",Providence,nai24.xml,46,3,1,GRA,197,336,CHI
0,8,1,212,2.106840516,220,8,we,"('CHI', 'MOT')",Providence,nai24.xml,221,1,0,MOT,919,2215,CHI
1,17,0,203,2.106840516,220,17,of,"('CHI', 'MOT')",Providence,nai24.xml,221,1,1,MOT,919,2215,CHI
1,17,0,203,2.106840516,220,17,on,"('CHI', 'MOT')",Providence,nai24.xml,221,1,1,MOT,919,2215,CHI
0,1,2,62,2.094945728,63,1,for,"('MOT', 'GRA')",Providence,nai24.xml,65,2,0,GRA,484,335,MOT
0,1,2,62,2.094945728,63,1,look,"('MOT', 'GRA')",Providence,nai24.xml,65,2,0,GRA,484,335,MOT
0,1,1,44,2.058388132,45,1,gonna,"('CHI', 'GRA')",Providence,nai24.xml,46,1,0,GRA,197,336,CHI
0,1,1,44,2.058388132,45,1,there,"('CHI', 'GRA')",Providence,nai24.xml,46,1,0,GRA,197,336,CHI
0,1,1,44,2.058388132,45,1,that,"('CHI', 'GRA')",Providence,nai24.xml,46,1,0,GRA,197,336,CHI
0,3,1,89,2.058388132,92,3,he,"('GRA', 'CHI')",Providence,nai24.xml,93,1,0,CHI,508,367,GRA
0,1,2,57,2.014903021,58,1,gonna,"('GRA', 'MOT')",Providence,nai24.xml,60,2,0,MOT,399,484,GRA
0,1,2,57,2.014903021,58,1,want,"('GRA', 'MOT')",Providence,nai24.xml,60,2,0,MOT,399,484,GRA
0,1,2,57,2.014903021,58,1,put,"('GRA', 'MOT')",Providence,nai24.xml,60,2,0,MOT,399,484,GRA
0,1,2,57,2.014903021,58,1,where,"('GRA', 'MOT')",Providence,nai24.xml,60,2,0,MOT,399,484,GRA
0,2,1,62,1.992430165,64,2,one,"('MOT', 'GRA')",Providence,nai24.xml,65,1,0,GRA,484,335,MOT
3,19,1,198,1.987874348,217,19,is,"('CHI', 'MOT')",Providence,nai24.xml,221,4,3,MOT,919,2215,CHI
0,1,8,142,1.981001469,143,1,get,"('MOT', 'CHI')",Providence,nai24.xml,151,8,0,CHI,1412,590,MOT
0,2,8,211,1.969440646,213,2,go,"('CHI', 'MOT')",Providence,nai24.xml,221,8,0,MOT,919,2215,CHI
0,2,1,57,1.913649287,59,2,go,"('GRA', 'MOT')",Providence,nai24.xml,60,1,0,MOT,399,484,GRA
0,2,1,57,1.913649287,59,2,of,"('GRA', 'MOT')",Providence,nai24.xml,60,1,0,MOT,399,484,GRA
0,2,1,57,1.913649287,59,2,was,"('GRA', 'MOT')",Providence,nai24.xml,60,1,0,MOT,399,484,GRA
0,2,1,57,1.913649287,59,2,little,"('GRA', 'MOT')",Providence,nai24.xml,60,1,0,MOT,399,484,GRA
0,2,1,57,1.913649287,59,2,on,"('GRA', 'MOT')",Providence,nai24.xml,60,1,0,MOT,399,484,GRA
0,1,9,141,1.878770846,142,1,in,"('MOT', 'CHI')",Providence,nai24.xml,151,9,0,CHI,1412,590,MOT
0,1,9,141,1.878770846,142,1,have,"('MOT', 'CHI')",Providence,nai24.xml,151,9,0,CHI,1412,590,MOT
0,1,5,87,1.860752341,88,1,was,"('GRA', 'CHI')",Providence,nai24.xml,93,5,0,CHI,508,367,GRA
0,1,3,61,1.85629799,62,1,in,"('MOT', 'GRA')",Providence,nai24.xml,65,3,0,GRA,484,335,MOT
0,1,3,61,1.85629799,62,1,she,"('MOT', 'GRA')",Providence,nai24.xml,65,3,0,GRA,484,335,MOT
0,4,1,88,1.835244581,92,4,go,"('GRA', 'CHI')",Providence,nai24.xml,93,1,0,CHI,508,367,GRA
1,4,1,54,1.791759469,58,4,there,"('GRA', 'MOT')",Providence,nai24.xml,60,2,1,MOT,399,484,GRA
1,3,2,54,1.774952351,57,3,like,"('GRA', 'MOT')",Providence,nai24.xml,60,3,1,MOT,399,484,GRA
0,1,2,43,1.749199855,44,1,some,"('CHI', 'GRA')",Providence,nai24.xml,46,2,0,GRA,197,336,CHI
0,12,1,208,1.739115736,220,12,gonna,"('CHI', 'MOT')",Providence,nai24.xml,221,1,0,MOT,919,2215,CHI
0,12,1,208,1.739115736,220,12,yeah,"('CHI', 'MOT')",Providence,nai24.xml,221,1,0,MOT,919,2215,CHI
0,12,1,208,1.739115736,220,12,was,"('CHI', 'MOT')",Providence,nai24.xml,221,1,0,MOT,919,2215,CHI
0,12,1,208,1.739115736,220,12,what,"('CHI', 'MOT')",Providence,nai24.xml,221,1,0,MOT,919,2215,CHI
0,1,6,86,1.716047647,87,1,do,"('GRA', 'CHI')",Providence,nai24.xml,93,6,0,CHI,508,367,GRA
0,1,6,86,1.716047647,87,1,and,"('GRA', 'CHI')",Providence,nai24.xml,93,6,0,CHI,508,367,GRA
0,1,11,139,1.69773052,140,1,like,"('MOT', 'CHI')",Providence,nai24.xml,151,11,0,CHI,1412,590,MOT
0,2,2,61,1.68948062,63,2,have,"('MOT', 'GRA')",Providence,nai24.xml,65,2,0,GRA,484,335,MOT
0,2,2,61,1.68948062,63,2,was,"('MOT', 'GRA')",Providence,nai24.xml,65,2,0,GRA,484,335,MOT
0,2,7,142,1.687769756,144,2,for,"('MOT', 'CHI')",Providence,nai24.xml,151,7,0,CHI,1412,590,MOT
0,1,4,60,1.658228077,61,1,and,"('MOT', 'GRA')",Providence,nai24.xml,65,4,0,GRA,484,335,MOT
0,3,1,56,1.625967214,59,3,did,"('GRA', 'MOT')",Providence,nai24.xml,60,1,0,MOT,399,484,GRA
0,3,1,56,1.625967214,59,3,some,"('GRA', 'MOT')",Providence,nai24.xml,60,1,0,MOT,399,484,GRA
0,8,3,210,1.586965057,218,8,do,"('CHI', 'MOT')",Providence,nai24.xml,221,3,0,MOT,919,2215,CHI
1,4,2,53,1.5518088,57,4,think,"('GRA', 'MOT')",Providence,nai24.xml,60,3,1,MOT,399,484,GRA
0,1,13,137,1.540445041,138,1,of,"('MOT', 'CHI')",Providence,nai24.xml,151,13,0,CHI,1412,590,MOT
0,1,13,137,1.540445041,138,1,is,"('MOT', 'CHI')",Providence,nai24.xml,151,13,0,CHI,1412,590,MOT
1,2,0,17,1.540445041,19,2,what,"('MOT', 'FAT')",Providence,nai24.xml,20,1,1,FAT,109,148,MOT
0,4,2,87,1.53686722,91,4,it,"('GRA', 'CHI')",Providence,nai24.xml,93,2,0,CHI,508,367,GRA
0,11,2,208,1.526961691,219,11,like,"('CHI', 'MOT')",Providence,nai24.xml,221,2,0,MOT,919,2215,CHI
1,2,17,131,1.504077397,133,2,some,"('MOT', 'CHI')",Providence,nai24.xml,151,18,1,CHI,1412,590,MOT
1,2,6,56,1.491654877,58,2,of,"('MOT', 'GRA')",Providence,nai24.xml,65,7,1,GRA,484,335,MOT
0,1,5,59,1.488077055,60,1,some,"('MOT', 'GRA')",Providence,nai24.xml,65,5,0,GRA,484,335,MOT
1,6,1,52,1.455287233,58,6,is,"('GRA', 'MOT')",Providence,nai24.xml,60,2,1,MOT,399,484,GRA
1,2,6,51,1.4046435,53,2,a,"('GRA', 'MOT')",Providence,nai24.xml,60,7,1,MOT,399,484,GRA
0,1,5,54,1.403993938,55,1,they,"('GRA', 'MOT')",Providence,nai24.xml,60,5,0,MOT,399,484,GRA
0,3,2,60,1.401798548,63,3,on,"('MOT', 'GRA')",Providence,nai24.xml,65,2,0,GRA,484,335,MOT
3,35,1,182,1.400087683,217,35,a,"('CHI', 'MOT')",Providence,nai24.xml,221,4,3,MOT,919,2215,CHI
7,38,2,174,1.383960638,212,38,the,"('CHI', 'MOT')",Providence,nai24.xml,221,9,7,MOT,919,2215,CHI
0,3,1,42,1.365240952,45,3,what,"('CHI', 'GRA')",Providence,nai24.xml,46,1,0,GRA,197,336,CHI
0,3,2,55,1.32175584,58,3,to,"('GRA', 'MOT')",Providence,nai24.xml,60,2,0,MOT,399,484,GRA
3,18,7,193,1.318240898,211,18,it,"('CHI', 'MOT')",Providence,nai24.xml,221,10,3,MOT,919,2215,CHI
0,2,11,138,1.292265411,140,2,do,"('MOT', 'CHI')",Providence,nai24.xml,151,11,0,CHI,1412,590,MOT
4,6,20,121,1.26524363,127,6,the,"('MOT', 'CHI')",Providence,nai24.xml,151,24,4,CHI,1412,590,MOT
0,1,10,82,1.264597426,83,1,a,"('GRA', 'CHI')",Providence,nai24.xml,93,10,0,CHI,508,367,GRA
0,20,1,200,1.259542655,220,20,oh,"('CHI', 'MOT')",Providence,nai24.xml,221,1,0,MOT,919,2215,CHI
0,2,4,59,1.252762968,61,2,it,"('MOT', 'GRA')",Providence,nai24.xml,65,4,0,GRA,484,335,MOT
0,1,1,18,1.252762968,19,1,get,"('MOT', 'FAT')",Providence,nai24.xml,20,1,0,FAT,109,148,MOT
0,1,1,18,1.252762968,19,1,we,"('MOT', 'FAT')",Providence,nai24.xml,20,1,0,FAT,109,148,MOT
0,1,1,18,1.252762968,19,1,was,"('MOT', 'FAT')",Providence,nai24.xml,20,1,0,FAT,109,148,MOT
0,1,1,18,1.252762968,19,1,is,"('MOT', 'FAT')",Providence,nai24.xml,20,1,0,FAT,109,148,MOT
0,1,1,18,1.252762968,19,1,that,"('MOT', 'FAT')",Providence,nai24.xml,20,1,0,FAT,109,148,MOT
0,1,1,18,1.252762968,19,1,do,"('MOT', 'FAT')",Providence,nai24.xml,20,1,0,FAT,109,148,MOT
0,1,1,18,1.252762968,19,1,not,"('MOT', 'FAT')",Providence,nai24.xml,20,1,0,FAT,109,148,MOT
0,1,1,18,1.252762968,19,1,on,"('MOT', 'FAT')",Providence,nai24.xml,20,1,0,FAT,109,148,MOT
1,32,1,187,1.208507959,219,32,that,"('CHI', 'MOT')",Providence,nai24.xml,221,2,1,MOT,919,2215,CHI
0,1,1,17,1.203972804,18,1,oh,"('FAT', 'MOT')",Providence,nai24.xml,19,1,0,MOT,108,166,FAT
0,1,1,17,1.203972804,18,1,was,"('FAT', 'MOT')",Providence,nai24.xml,19,1,0,MOT,108,166,FAT
0,1,1,17,1.203972804,18,1,are,"('FAT', 'MOT')",Providence,nai24.xml,19,1,0,MOT,108,166,FAT
0,1,1,17,1.203972804,18,1,not,"('FAT', 'MOT')",Providence,nai24.xml,19,1,0,MOT,108,166,FAT
0,2,4,54,1.170071253,56,2,are,"('GRA', 'MOT')",Providence,nai24.xml,60,4,0,MOT,399,484,GRA
2,7,3,48,1.116311866,55,7,it,"('GRA', 'MOT')",Providence,nai24.xml,60,5,2,MOT,399,484,GRA
0,11,4,206,1.112405611,217,11,did,"('CHI', 'MOT')",Providence,nai24.xml,221,4,0,MOT,919,2215,CHI
1,23,3,194,1.112405611,217,23,to,"('CHI', 'MOT')",Providence,nai24.xml,221,4,1,MOT,919,2215,CHI
0,4,2,54,1.098612289,58,4,we,"('GRA', 'MOT')",Providence,nai24.xml,60,2,0,MOT,399,484,GRA
0,2,5,58,1.082611947,60,2,can,"('MOT', 'GRA')",Providence,nai24.xml,65,5,0,GRA,484,335,MOT
0,2,5,58,1.082611947,60,2,to,"('MOT', 'GRA')",Providence,nai24.xml,65,5,0,GRA,484,335,MOT
2,45,1,173,1.054160526,218,45,you,"('CHI', 'MOT')",Providence,nai24.xml,221,3,2,MOT,919,2215,CHI
2,4,8,51,1.047318994,55,4,a,"('MOT', 'GRA')",Providence,nai24.xml,65,10,2,GRA,484,335,MOT
4,5,16,68,1.044124103,73,5,the,"('GRA', 'CHI')",Providence,nai24.xml,93,20,4,CHI,508,367,GRA
4,10,3,43,1.021651248,53,10,you,"('GRA', 'MOT')",Providence,nai24.xml,60,7,4,MOT,399,484,GRA
1,5,4,50,0.99852883,55,5,oh,"('GRA', 'MOT')",Providence,nai24.xml,60,5,1,MOT,399,484,GRA
0,4,3,58,0.940007258,62,4,are,"('MOT', 'GRA')",Providence,nai24.xml,65,3,0,GRA,484,335,MOT
0,4,3,58,0.940007258,62,4,do,"('MOT', 'GRA')",Providence,nai24.xml,65,3,0,GRA,484,335,MOT
0,1,2,17,0.916290732,18,1,in,"('MOT', 'FAT')",Providence,nai24.xml,20,2,0,FAT,109,148,MOT
0,1,2,17,0.916290732,18,1,to,"('MOT', 'FAT')",Providence,nai24.xml,20,2,0,FAT,109,148,MOT
1,2,2,14,0.875468737,16,2,the,"('FAT', 'MOT')",Providence,nai24.xml,19,3,1,MOT,108,166,FAT
1,5,16,129,0.869603618,134,5,a,"('MOT', 'CHI')",Providence,nai24.xml,151,17,1,CHI,1412,590,MOT
0,4,3,53,0.858661619,57,4,what,"('GRA', 'MOT')",Providence,nai24.xml,60,3,0,MOT,399,484,GRA
1,5,17,128,0.810930216,133,5,it,"('MOT', 'CHI')",Providence,nai24.xml,151,18,1,CHI,1412,590,MOT
0,3,5,57,0.794929875,60,3,that,"('MOT', 'GRA')",Providence,nai24.xml,65,5,0,GRA,484,335,MOT
1,6,5,53,0.778669354,59,6,is,"('MOT', 'GRA')",Providence,nai24.xml,65,6,1,GRA,484,335,MOT
0,6,2,52,0.762140052,58,6,that,"('GRA', 'MOT')",Providence,nai24.xml,60,2,0,MOT,399,484,GRA
0,5,3,52,0.676340062,57,5,yeah,"('GRA', 'MOT')",Providence,nai24.xml,60,3,0,MOT,399,484,GRA
0,1,3,16,0.641853886,17,1,it,"('MOT', 'FAT')",Providence,nai24.xml,20,3,0,FAT,109,148,MOT
1,4,9,51,0.641853886,55,4,oh,"('MOT', 'GRA')",Providence,nai24.xml,65,10,1,GRA,484,335,MOT
0,6,3,56,0.603535022,62,6,yeah,"('MOT', 'GRA')",Providence,nai24.xml,65,3,0,GRA,484,335,MOT
0,6,3,51,0.522189382,57,6,in,"('GRA', 'MOT')",Providence,nai24.xml,60,3,0,MOT,399,484,GRA
0,6,3,51,0.522189382,57,6,and,"('GRA', 'MOT')",Providence,nai24.xml,60,3,0,MOT,399,484,GRA
0,3,1,15,0.510825624,18,3,is,"('FAT', 'MOT')",Providence,nai24.xml,19,1,0,MOT,108,166,FAT
0,3,1,15,0.510825624,18,3,to,"('FAT', 'MOT')",Providence,nai24.xml,19,1,0,MOT,108,166,FAT
2,5,12,46,0.504556011,51,5,you,"('MOT', 'GRA')",Providence,nai24.xml,65,14,2,GRA,484,335,MOT
0,2,2,15,0.459532329,17,2,that,"('FAT', 'MOT')",Providence,nai24.xml,19,2,0,MOT,108,166,FAT
1,5,9,50,0.459532329,55,5,the,"('MOT', 'GRA')",Providence,nai24.xml,65,10,1,GRA,484,335,MOT
0,9,1,36,0.44895022,45,9,a,"('CHI', 'GRA')",Providence,nai24.xml,46,1,0,GRA,197,336,CHI
0,4,1,15,0.336472237,19,4,did,"('MOT', 'FAT')",Providence,nai24.xml,20,1,0,FAT,109,148,MOT
0,2,29,120,0.287682072,122,2,what,"('MOT', 'CHI')",Providence,nai24.xml,151,29,0,CHI,1412,590,MOT
0,2,34,115,0.096992266,117,2,you,"('MOT', 'CHI')",Providence,nai24.xml,151,34,0,CHI,1412,590,MOT
0,8,3,35,0,43,8,the,"('CHI', 'GRA')",Providence,nai24.xml,46,3,0,GRA,197,336,CHI
0,6,1,12,-0.048790164,18,6,you,"('FAT', 'MOT')",Providence,nai24.xml,19,1,0,MOT,108,166,FAT
0,3,3,14,-0.051293294,17,3,the,"('MOT', 'FAT')",Providence,nai24.xml,20,3,0,FAT,109,148,MOT
1,5,4,10,-0.211309094,15,5,you,"('MOT', 'FAT')",Providence,nai24.xml,20,5,1,FAT,109,148,MOT
0,7,8,50,-0.304489191,57,7,what,"('MOT', 'GRA')",Providence,nai24.xml,65,8,0,GRA,484,335,MOT
0,6,3,10,-0.664976304,16,6,a,"('FAT', 'MOT')",Providence,nai24.xml,19,3,0,MOT,108,166,FAT
0,11,7,42,-0.674798042,53,11,the,"('GRA', 'MOT')",Providence,nai24.xml,60,7,0,MOT,399,484,GRA
2,1,9,363,3.743149084,364,1,make,"('MOT', 'CHI')",Providence,nai25.xml,375,11,2,CHI,4584,1752,MOT
1,1,14,359,3.058430868,360,1,all,"('MOT', 'CHI')",Providence,nai25.xml,375,15,1,CHI,4584,1752,MOT
0,1,7,367,3.023131248,368,1,little,"('MOT', 'CHI')",Providence,nai25.xml,375,7,0,CHI,4584,1752,MOT
0,1,9,365,2.817040485,366,1,want,"('MOT', 'CHI')",Providence,nai25.xml,375,9,0,CHI,4584,1752,MOT
0,4,3,368,2.705379973,372,4,he,"('MOT', 'CHI')",Providence,nai25.xml,375,3,0,CHI,4584,1752,MOT
0,2,7,366,2.61766614,368,2,up,"('MOT', 'CHI')",Providence,nai25.xml,375,7,0,CHI,4584,1752,MOT
1,3,11,360,2.567692843,363,3,with,"('MOT', 'CHI')",Providence,nai25.xml,375,12,1,CHI,4584,1752,MOT
3,4,17,351,2.563549777,355,4,they,"('MOT', 'CHI')",Providence,nai25.xml,375,20,3,CHI,4584,1752,MOT
0,1,13,361,2.495956486,362,1,look,"('MOT', 'CHI')",Providence,nai25.xml,375,13,0,CHI,4584,1752,MOT
0,1,14,360,2.428666931,361,1,have,"('MOT', 'CHI')",Providence,nai25.xml,375,14,0,CHI,4584,1752,MOT
1,5,8,361,2.411575377,366,5,get,"('MOT', 'CHI')",Providence,nai25.xml,375,9,1,CHI,4584,1752,MOT
1,12,3,359,2.258016774,371,12,no,"('MOT', 'CHI')",Providence,nai25.xml,375,4,1,CHI,4584,1752,MOT
1,1,39,334,2.082413312,335,1,to,"('MOT', 'CHI')",Providence,nai25.xml,375,40,1,CHI,4584,1752,MOT
0,2,14,359,2.023201823,361,2,some,"('MOT', 'CHI')",Providence,nai25.xml,375,14,0,CHI,4584,1752,MOT
0,1,22,352,2.000916779,353,1,see,"('MOT', 'CHI')",Providence,nai25.xml,375,22,0,CHI,4584,1752,MOT
0,1,22,352,2.000916779,353,1,did,"('MOT', 'CHI')",Providence,nai25.xml,375,22,0,CHI,4584,1752,MOT
0,1,23,351,1.957273908,352,1,of,"('MOT', 'CHI')",Providence,nai25.xml,375,23,0,CHI,4584,1752,MOT
2,6,19,348,1.892138655,354,6,one,"('MOT', 'CHI')",Providence,nai25.xml,375,21,2,CHI,4584,1752,MOT
0,1,25,349,1.874647129,350,1,put,"('MOT', 'CHI')",Providence,nai25.xml,375,25,0,CHI,4584,1752,MOT
5,4,55,311,1.814088946,315,4,are,"('MOT', 'CHI')",Providence,nai25.xml,375,60,5,CHI,4584,1752,MOT
2,2,50,321,1.794841136,323,2,that,"('MOT', 'CHI')",Providence,nai25.xml,375,52,2,CHI,4584,1752,MOT
0,2,18,355,1.788977826,357,2,she,"('MOT', 'CHI')",Providence,nai25.xml,375,18,0,CHI,4584,1752,MOT
0,1,28,346,1.76072736,347,1,like,"('MOT', 'CHI')",Providence,nai25.xml,375,28,0,CHI,4584,1752,MOT
0,1,30,344,1.690441697,345,1,do,"('MOT', 'CHI')",Providence,nai25.xml,375,30,0,CHI,4584,1752,MOT
0,2,24,349,1.50975923,351,2,this,"('MOT', 'CHI')",Providence,nai25.xml,375,24,0,CHI,4584,1752,MOT
8,16,31,320,1.473485062,336,16,where,"('MOT', 'CHI')",Providence,nai25.xml,375,39,8,CHI,4584,1752,MOT
2,5,39,329,1.362763864,334,5,on,"('MOT', 'CHI')",Providence,nai25.xml,375,41,2,CHI,4584,1752,MOT
0,1,50,324,1.145569272,325,1,oh,"('MOT', 'CHI')",Providence,nai25.xml,375,50,0,CHI,4584,1752,MOT
0,1,50,324,1.145569272,325,1,and,"('MOT', 'CHI')",Providence,nai25.xml,375,50,0,CHI,4584,1752,MOT
0,3,30,342,0.997294516,345,3,what,"('MOT', 'CHI')",Providence,nai25.xml,375,30,0,CHI,4584,1752,MOT
2,6,49,318,0.969307607,324,6,in,"('MOT', 'CHI')",Providence,nai25.xml,375,51,2,CHI,4584,1752,MOT
3,20,23,329,0.870353637,349,20,go,"('MOT', 'CHI')",Providence,nai25.xml,375,26,3,CHI,4584,1752,MOT
5,20,34,316,0.85671086,336,20,there,"('MOT', 'CHI')",Providence,nai25.xml,375,39,5,CHI,4584,1752,MOT
1,10,26,338,0.785889232,348,10,yeah,"('MOT', 'CHI')",Providence,nai25.xml,375,27,1,CHI,4584,1752,MOT
3,4,111,257,0.59542029,261,4,you,"('MOT', 'CHI')",Providence,nai25.xml,375,114,3,CHI,4584,1752,MOT
5,20,46,304,0.563842499,324,20,it,"('MOT', 'CHI')",Providence,nai25.xml,375,51,5,CHI,4584,1752,MOT
1,7,49,318,0.452422091,325,7,a,"('MOT', 'CHI')",Providence,nai25.xml,375,50,1,CHI,4584,1752,MOT
0,3,58,314,0.284552179,317,3,is,"('MOT', 'CHI')",Providence,nai25.xml,375,58,0,CHI,4584,1752,MOT
2,8,108,257,-0.229862502,265,8,the,"('MOT', 'CHI')",Providence,nai25.xml,375,110,2,CHI,4584,1752,MOT
1,1,5,412,3.948836979,413,1,she,"('MOT', 'CHI')",Providence,nai26.xml,419,6,1,CHI,4893,2363,MOT
0,1,4,414,3.548179572,415,1,big,"('MOT', 'CHI')",Providence,nai26.xml,419,4,0,CHI,4893,2363,MOT
1,1,11,406,3.374657826,407,1,my,"('MOT', 'CHI')",Providence,nai26.xml,419,12,1,CHI,4893,2363,MOT
3,3,11,402,3.236224463,405,3,get,"('MOT', 'CHI')",Providence,nai26.xml,419,14,3,CHI,4893,2363,MOT
0,1,7,411,3.135494216,412,1,want,"('MOT', 'CHI')",Providence,nai26.xml,419,7,0,CHI,4893,2363,MOT
1,2,9,407,3.128221457,409,2,at,"('MOT', 'CHI')",Providence,nai26.xml,419,10,1,CHI,4893,2363,MOT
0,1,11,407,2.758060622,408,1,look,"('MOT', 'CHI')",Providence,nai26.xml,419,11,0,CHI,4893,2363,MOT
0,1,12,406,2.681510646,407,1,like,"('MOT', 'CHI')",Providence,nai26.xml,419,12,0,CHI,4893,2363,MOT
1,2,16,400,2.651510791,402,2,one,"('MOT', 'CHI')",Providence,nai26.xml,419,17,1,CHI,4893,2363,MOT
0,3,7,409,2.442347035,412,3,not,"('MOT', 'CHI')",Providence,nai26.xml,419,7,0,CHI,4893,2363,MOT
0,3,8,408,2.334568139,411,3,up,"('MOT', 'CHI')",Providence,nai26.xml,419,8,0,CHI,4893,2363,MOT
0,4,7,408,2.219203484,412,4,he,"('MOT', 'CHI')",Providence,nai26.xml,419,7,0,CHI,4893,2363,MOT
0,3,10,406,2.147392204,409,3,they,"('MOT', 'CHI')",Providence,nai26.xml,419,10,0,CHI,4893,2363,MOT
1,4,16,398,2.140685167,402,4,put,"('MOT', 'CHI')",Providence,nai26.xml,419,17,1,CHI,4893,2363,MOT
1,4,17,397,2.086913557,401,4,little,"('MOT', 'CHI')",Providence,nai26.xml,419,18,1,CHI,4893,2363,MOT
2,2,46,369,2.009555414,371,2,and,"('MOT', 'CHI')",Providence,nai26.xml,419,48,2,CHI,4893,2363,MOT
4,1,107,307,1.925475211,308,1,you,"('MOT', 'CHI')",Providence,nai26.xml,419,111,4,CHI,4893,2363,MOT
0,2,19,398,1.853317362,400,2,of,"('MOT', 'CHI')",Providence,nai26.xml,419,19,0,CHI,4893,2363,MOT
1,5,19,394,1.804306685,399,5,with,"('MOT', 'CHI')",Providence,nai26.xml,419,20,1,CHI,4893,2363,MOT
2,26,5,386,1.631416819,412,26,no,"('MOT', 'CHI')",Providence,nai26.xml,419,7,2,CHI,4893,2363,MOT
21,22,53,323,1.474139677,345,22,it,"('MOT', 'CHI')",Providence,nai26.xml,419,74,21,CHI,4893,2363,MOT
2,5,40,372,1.460199391,377,5,are,"('MOT', 'CHI')",Providence,nai26.xml,419,42,2,CHI,4893,2363,MOT
0,1,44,374,1.41045661,375,1,oh,"('MOT', 'CHI')",Providence,nai26.xml,419,44,0,CHI,4893,2363,MOT
2,5,43,369,1.386294361,374,5,what,"('MOT', 'CHI')",Providence,nai26.xml,419,45,2,CHI,4893,2363,MOT
2,10,24,383,1.347398271,393,10,some,"('MOT', 'CHI')",Providence,nai26.xml,419,26,2,CHI,4893,2363,MOT
0,4,20,395,1.293481062,399,4,this,"('MOT', 'CHI')",Providence,nai26.xml,419,20,0,CHI,4893,2363,MOT
0,3,26,390,1.260386894,393,3,do,"('MOT', 'CHI')",Providence,nai26.xml,419,26,0,CHI,4893,2363,MOT
6,12,54,347,1.142704365,359,12,a,"('MOT', 'CHI')",Providence,nai26.xml,419,60,6,CHI,4893,2363,MOT
4,23,24,368,1.003996312,391,23,go,"('MOT', 'CHI')",Providence,nai26.xml,419,28,4,CHI,4893,2363,MOT
6,33,23,357,0.95682426,390,33,where,"('MOT', 'CHI')",Providence,nai26.xml,419,29,6,CHI,4893,2363,MOT
0,7,18,394,0.923762747,401,7,for,"('MOT', 'CHI')",Providence,nai26.xml,419,18,0,CHI,4893,2363,MOT
1,6,46,366,0.779672531,372,6,in,"('MOT', 'CHI')",Providence,nai26.xml,419,47,1,CHI,4893,2363,MOT
11,32,48,328,0.769169436,360,32,there,"('MOT', 'CHI')",Providence,nai26.xml,419,59,11,CHI,4893,2363,MOT
0,9,17,393,0.754390806,402,9,on,"('MOT', 'CHI')",Providence,nai26.xml,419,17,0,CHI,4893,2363,MOT
0,5,34,380,0.583146285,385,5,to,"('MOT', 'CHI')",Providence,nai26.xml,419,34,0,CHI,4893,2363,MOT
1,26,15,377,0.510825624,403,26,did,"('MOT', 'CHI')",Providence,nai26.xml,419,16,1,CHI,4893,2363,MOT
16,25,117,261,0.332802508,286,25,the,"('MOT', 'CHI')",Providence,nai26.xml,419,133,16,CHI,4893,2363,MOT
1,23,24,371,0.200670695,394,23,yeah,"('MOT', 'CHI')",Providence,nai26.xml,419,25,1,CHI,4893,2363,MOT
5,27,59,328,0.147635999,355,27,that,"('MOT', 'CHI')",Providence,nai26.xml,419,64,5,CHI,4893,2363,MOT
3,18,66,332,0.042806681,350,18,is,"('MOT', 'CHI')",Providence,nai26.xml,419,69,3,CHI,4893,2363,MOT
2,0,24,375,3.698652966,375,0,one,"('MOT', 'CHI')",Providence,nai27.xml,401,26,2,CHI,5206,1912,MOT
2,1,15,383,3.416863498,384,1,look,"('MOT', 'CHI')",Providence,nai27.xml,401,17,2,CHI,5206,1912,MOT
4,1,27,369,3.338677025,370,1,at,"('MOT', 'CHI')",Providence,nai27.xml,401,31,4,CHI,5206,1912,MOT
0,1,6,394,3.211347558,395,1,some,"('MOT', 'CHI')",Providence,nai27.xml,401,6,0,CHI,5206,1912,MOT
0,1,7,393,3.091042453,394,1,want,"('MOT', 'CHI')",Providence,nai27.xml,401,7,0,CHI,5206,1912,MOT
1,2,9,389,3.083437854,391,2,he,"('MOT', 'CHI')",Providence,nai27.xml,401,10,1,CHI,5206,1912,MOT
2,3,10,386,3.041968158,389,3,she,"('MOT', 'CHI')",Providence,nai27.xml,401,12,2,CHI,5206,1912,MOT
4,8,8,381,2.741863565,389,8,they,"('MOT', 'CHI')",Providence,nai27.xml,401,12,4,CHI,5206,1912,MOT
0,1,14,386,2.497843441,387,1,up,"('MOT', 'CHI')",Providence,nai27.xml,401,14,0,CHI,5206,1912,MOT
0,1,14,386,2.497843441,387,1,put,"('MOT', 'CHI')",Providence,nai27.xml,401,14,0,CHI,5206,1912,MOT
2,3,26,370,2.238046572,373,3,on,"('MOT', 'CHI')",Providence,nai27.xml,401,28,2,CHI,5206,1912,MOT
0,3,9,389,2.192161275,392,3,where,"('MOT', 'CHI')",Providence,nai27.xml,401,9,0,CHI,5206,1912,MOT
4,3,55,339,1.952911345,342,3,are,"('MOT', 'CHI')",Providence,nai27.xml,401,59,4,CHI,5206,1912,MOT
1,3,26,371,1.869146133,374,3,with,"('MOT', 'CHI')",Providence,nai27.xml,401,27,1,CHI,5206,1912,MOT
0,1,28,372,1.832581464,373,1,do,"('MOT', 'CHI')",Providence,nai27.xml,401,28,0,CHI,5206,1912,MOT
3,4,42,352,1.807241833,356,4,to,"('MOT', 'CHI')",Providence,nai27.xml,401,45,3,CHI,5206,1912,MOT
0,2,22,377,1.666133256,379,2,for,"('MOT', 'CHI')",Providence,nai27.xml,401,22,0,CHI,5206,1912,MOT
1,16,6,378,1.64412347,394,16,no,"('MOT', 'CHI')",Providence,nai27.xml,401,7,1,CHI,5206,1912,MOT
0,1,34,366,1.634130525,367,1,oh,"('MOT', 'CHI')",Providence,nai27.xml,401,34,0,CHI,5206,1912,MOT
1,4,27,369,1.609437912,373,4,there,"('MOT', 'CHI')",Providence,nai27.xml,401,28,1,CHI,5206,1912,MOT
0,1,35,365,1.604017845,366,1,of,"('MOT', 'CHI')",Providence,nai27.xml,401,35,0,CHI,5206,1912,MOT
0,3,21,377,1.423632032,380,3,have,"('MOT', 'CHI')",Providence,nai27.xml,401,21,0,CHI,5206,1912,MOT
11,11,68,311,1.386294361,322,11,that,"('MOT', 'CHI')",Providence,nai27.xml,401,79,11,CHI,5206,1912,MOT
1,12,13,375,1.319188444,387,12,go,"('MOT', 'CHI')",Providence,nai27.xml,401,14,1,CHI,5206,1912,MOT
5,13,43,340,1.112796924,353,13,it,"('MOT', 'CHI')",Providence,nai27.xml,401,48,5,CHI,5206,1912,MOT
5,7,82,307,0.979423771,314,7,a,"('MOT', 'CHI')",Providence,nai27.xml,401,87,5,CHI,5206,1912,MOT
6,14,53,328,0.967627741,342,14,what,"('MOT', 'CHI')",Providence,nai27.xml,401,59,6,CHI,5206,1912,MOT
4,11,55,331,0.854299056,342,11,in,"('MOT', 'CHI')",Providence,nai27.xml,401,59,4,CHI,5206,1912,MOT
0,1,70,330,0.83832919,331,1,and,"('MOT', 'CHI')",Providence,nai27.xml,401,70,0,CHI,5206,1912,MOT
10,53,28,310,0.619929126,363,53,yeah,"('MOT', 'CHI')",Providence,nai27.xml,401,38,10,CHI,5206,1912,MOT
1,5,70,325,0.416063239,330,5,is,"('MOT', 'CHI')",Providence,nai27.xml,401,71,1,CHI,5206,1912,MOT
0,1,128,272,0.056089467,273,1,you,"('MOT', 'CHI')",Providence,nai27.xml,401,128,0,CHI,5206,1912,MOT
6,13,129,253,-0.022141126,266,13,the,"('MOT', 'CHI')",Providence,nai27.xml,401,135,6,CHI,5206,1912,MOT
1,0,1,527,5.577841251,527,0,big,"('CHI', 'MOT')",Providence,nai28.xml,529,2,1,MOT,3181,5452,CHI
1,6,1,521,3.631931102,527,6,they,"('CHI', 'MOT')",Providence,nai28.xml,529,2,1,MOT,3181,5452,CHI
1,9,0,519,3.564826805,528,9,all,"('CHI', 'MOT')",Providence,nai28.xml,529,1,1,MOT,3181,5452,CHI
1,5,3,520,3.376828791,525,5,one,"('CHI', 'MOT')",Providence,nai28.xml,529,4,1,MOT,3181,5452,CHI
4,11,2,512,3.308487984,523,11,look,"('CHI', 'MOT')",Providence,nai28.xml,529,6,4,MOT,3181,5452,CHI
1,9,1,518,3.275256158,527,9,put,"('CHI', 'MOT')",Providence,nai28.xml,529,2,1,MOT,3181,5452,CHI
1,9,1,518,3.275256158,527,9,not,"('CHI', 'MOT')",Providence,nai28.xml,529,2,1,MOT,3181,5452,CHI
4,12,2,511,3.228445276,523,12,with,"('CHI', 'MOT')",Providence,nai28.xml,529,6,4,MOT,3181,5452,CHI
1,14,0,514,3.159361697,528,14,was,"('CHI', 'MOT')",Providence,nai28.xml,529,1,1,MOT,3181,5452,CHI
3,15,1,510,3.089146718,525,15,little,"('CHI', 'MOT')",Providence,nai28.xml,529,4,3,MOT,3181,5452,CHI
4,15,3,507,2.901116297,522,15,get,"('CHI', 'MOT')",Providence,nai28.xml,529,7,4,MOT,3181,5452,CHI
5,16,4,504,2.81831844,520,16,at,"('CHI', 'MOT')",Providence,nai28.xml,529,9,5,MOT,3181,5452,CHI
0,7,2,520,2.805252529,527,7,make,"('CHI', 'MOT')",Providence,nai28.xml,529,2,0,MOT,3181,5452,CHI
3,16,3,507,2.737037738,523,16,up,"('CHI', 'MOT')",Providence,nai28.xml,529,6,3,MOT,3181,5452,CHI
2,5,13,509,2.719746241,514,5,no,"('CHI', 'MOT')",Providence,nai28.xml,529,15,2,MOT,3181,5452,CHI
2,3,23,501,2.643017731,504,3,did,"('CHI', 'MOT')",Providence,nai28.xml,529,25,2,MOT,3181,5452,CHI
0,4,6,519,2.574518808,523,4,my,"('CHI', 'MOT')",Providence,nai28.xml,529,6,0,MOT,3181,5452,CHI
4,34,1,490,2.373480915,524,34,of,"('CHI', 'MOT')",Providence,nai28.xml,529,5,4,MOT,3181,5452,CHI
6,24,6,493,2.339880878,517,24,on,"('CHI', 'MOT')",Providence,nai28.xml,529,12,6,MOT,3181,5452,CHI
3,13,10,503,2.289162073,516,13,she,"('CHI', 'MOT')",Providence,nai28.xml,529,13,3,MOT,3181,5452,CHI
2,22,3,502,2.282509136,524,22,gonna,"('CHI', 'MOT')",Providence,nai28.xml,529,5,2,MOT,3181,5452,CHI
5,7,31,486,2.27928953,493,7,go,"('CHI', 'MOT')",Providence,nai28.xml,529,36,5,MOT,3181,5452,CHI
4,27,4,494,2.234229773,521,27,some,"('CHI', 'MOT')",Providence,nai28.xml,529,8,4,MOT,3181,5452,CHI
9,24,11,485,2.229036405,509,24,for,"('CHI', 'MOT')",Providence,nai28.xml,529,20,9,MOT,3181,5452,CHI
4,25,5,495,2.211113689,520,25,have,"('CHI', 'MOT')",Providence,nai28.xml,529,9,4,MOT,3181,5452,CHI
5,32,4,488,2.155024223,520,32,are,"('CHI', 'MOT')",Providence,nai28.xml,529,9,5,MOT,3181,5452,CHI
0,21,1,507,2.083222265,528,21,see,"('CHI', 'MOT')",Providence,nai28.xml,529,1,0,MOT,3181,5452,CHI
0,23,1,505,1.996210888,528,23,like,"('CHI', 'MOT')",Providence,nai28.xml,529,1,0,MOT,3181,5452,CHI
1,35,1,492,1.994322313,527,35,think,"('CHI', 'MOT')",Providence,nai28.xml,529,2,1,MOT,3181,5452,CHI
1,27,4,497,1.680333734,524,27,do,"('CHI', 'MOT')",Providence,nai28.xml,529,5,1,MOT,3181,5452,CHI
2,12,20,495,1.588057117,507,12,where,"('CHI', 'MOT')",Providence,nai28.xml,529,22,2,MOT,3181,5452,CHI
14,56,12,447,1.557352852,503,56,in,"('CHI', 'MOT')",Providence,nai28.xml,529,26,14,MOT,3181,5452,CHI
8,54,8,459,1.543686535,513,54,to,"('CHI', 'MOT')",Providence,nai28.xml,529,16,8,MOT,3181,5452,CHI
10,45,16,458,1.461607795,503,45,it,"('CHI', 'MOT')",Providence,nai28.xml,529,26,10,MOT,3181,5452,CHI
2,19,14,494,1.456675158,513,19,he,"('CHI', 'MOT')",Providence,nai28.xml,529,16,2,MOT,3181,5452,CHI
3,44,6,476,1.439404186,520,44,oh,"('CHI', 'MOT')",Providence,nai28.xml,529,9,3,MOT,3181,5452,CHI
2,52,4,471,1.312277096,523,52,and,"('CHI', 'MOT')",Providence,nai28.xml,529,6,2,MOT,3181,5452,CHI
8,38,22,461,1.284533129,499,38,there,"('CHI', 'MOT')",Providence,nai28.xml,529,30,8,MOT,3181,5452,CHI
1,25,10,493,1.123930097,518,25,this,"('CHI', 'MOT')",Providence,nai28.xml,529,11,1,MOT,3181,5452,CHI
6,47,18,458,1.045123604,505,47,what,"('CHI', 'MOT')",Providence,nai28.xml,529,24,6,MOT,3181,5452,CHI
15,69,27,418,0.932266336,487,69,is,"('CHI', 'MOT')",Providence,nai28.xml,529,42,15,MOT,3181,5452,CHI
58,103,40,328,0.898714087,431,103,the,"('CHI', 'MOT')",Providence,nai28.xml,529,98,58,MOT,3181,5452,CHI
10,68,21,430,0.881889305,498,68,that,"('CHI', 'MOT')",Providence,nai28.xml,529,31,10,MOT,3181,5452,CHI
7,107,7,408,0.872764467,515,107,you,"('CHI', 'MOT')",Providence,nai28.xml,529,14,7,MOT,3181,5452,CHI
10,73,21,425,0.811930717,498,73,a,"('CHI', 'MOT')",Providence,nai28.xml,529,31,10,MOT,3181,5452,CHI
14,40,83,392,0.472402818,432,40,yeah,"('CHI', 'MOT')",Providence,nai28.xml,529,97,14,MOT,3181,5452,CHI
1,5,0,207,3.168751438,212,5,look,"('CHI', 'MOT')",Providence,nai29.xml,213,1,1,MOT,1197,2572,CHI
0,2,1,210,3.168751438,212,2,one,"('CHI', 'MOT')",Providence,nai29.xml,213,1,0,MOT,1197,2572,CHI
1,4,1,207,3.058707073,211,4,wanna,"('CHI', 'MOT')",Providence,nai29.xml,213,2,1,MOT,1197,2572,CHI
1,6,0,206,3.014600758,212,6,not,"('CHI', 'MOT')",Providence,nai29.xml,213,1,1,MOT,1197,2572,CHI
1,0,5,78,2.995732274,78,0,there,"('MOT', 'CHI')",Providence,nai29.xml,84,6,1,CHI,931,428,MOT
3,1,16,193,2.926739402,194,1,no,"('CHI', 'MOT')",Providence,nai29.xml,213,19,3,MOT,1197,2572,CHI
1,0,6,77,2.865370456,77,0,some,"('MOT', 'CHI')",Providence,nai29.xml,84,7,1,CHI,931,428,MOT
2,0,10,72,2.763620052,72,0,that,"('MOT', 'CHI')",Providence,nai29.xml,84,12,2,CHI,931,428,MOT
1,0,7,76,2.747270914,76,0,what,"('MOT', 'CHI')",Providence,nai29.xml,84,8,1,CHI,931,428,MOT
0,4,1,208,2.657925814,212,4,up,"('CHI', 'MOT')",Providence,nai29.xml,213,1,0,MOT,1197,2572,CHI
0,1,1,82,2.650891787,83,1,one,"('MOT', 'CHI')",Providence,nai29.xml,84,1,0,CHI,931,428,MOT
1,7,1,204,2.588703443,211,7,get,"('CHI', 'MOT')",Providence,nai29.xml,213,2,1,MOT,1197,2572,CHI
1,7,1,204,2.588703443,211,7,see,"('CHI', 'MOT')",Providence,nai29.xml,213,2,1,MOT,1197,2572,CHI
0,3,2,208,2.588703443,211,3,little,"('CHI', 'MOT')",Providence,nai29.xml,213,2,0,MOT,1197,2572,CHI
5,9,3,196,2.519308077,205,9,there,"('CHI', 'MOT')",Providence,nai29.xml,213,8,5,MOT,1197,2572,CHI
4,7,5,197,2.459977267,204,7,go,"('CHI', 'MOT')",Providence,nai29.xml,213,9,4,MOT,1197,2572,CHI
0,4,2,207,2.365559892,211,4,where,"('CHI', 'MOT')",Providence,nai29.xml,213,2,0,MOT,1197,2572,CHI
2,11,1,199,2.360854001,210,11,at,"('CHI', 'MOT')",Providence,nai29.xml,213,3,2,MOT,1197,2572,CHI
0,2,1,81,2.245426679,83,2,this,"('MOT', 'CHI')",Providence,nai29.xml,84,1,0,CHI,931,428,MOT
7,17,1,188,2.219203484,205,17,on,"('CHI', 'MOT')",Providence,nai29.xml,213,8,7,MOT,1197,2572,CHI
2,18,0,193,2.129171114,211,18,we,"('CHI', 'MOT')",Providence,nai29.xml,213,2,2,MOT,1197,2572,CHI
0,8,1,204,2.070139149,212,8,with,"('CHI', 'MOT')",Providence,nai29.xml,213,1,0,MOT,1197,2572,CHI
1,2,4,77,2.043073898,79,2,put,"('MOT', 'CHI')",Providence,nai29.xml,84,5,1,CHI,931,428,MOT
1,13,1,198,2.029087656,211,13,like,"('CHI', 'MOT')",Providence,nai29.xml,213,2,1,MOT,1197,2572,CHI
0,3,5,205,2.014903021,208,3,make,"('CHI', 'MOT')",Providence,nai29.xml,213,5,0,MOT,1197,2572,CHI
0,2,2,80,1.945910149,82,2,no,"('MOT', 'CHI')",Providence,nai29.xml,84,2,0,CHI,931,428,MOT
1,1,8,74,1.945910149,75,1,is,"('MOT', 'CHI')",Providence,nai29.xml,84,9,1,CHI,931,428,MOT
0,1,4,79,1.921812597,80,1,go,"('MOT', 'CHI')",Providence,nai29.xml,84,4,0,CHI,931,428,MOT
0,1,4,79,1.921812597,80,1,at,"('MOT', 'CHI')",Providence,nai29.xml,84,4,0,CHI,931,428,MOT
1,3,3,77,1.921812597,80,3,with,"('MOT', 'CHI')",Providence,nai29.xml,84,4,1,CHI,931,428,MOT
1,15,1,196,1.895556263,211,15,are,"('CHI', 'MOT')",Providence,nai29.xml,213,2,1,MOT,1197,2572,CHI
0,10,1,202,1.869468454,212,10,they,"('CHI', 'MOT')",Providence,nai29.xml,213,1,0,MOT,1197,2572,CHI
4,15,4,190,1.86698289,205,15,have,"('CHI', 'MOT')",Providence,nai29.xml,213,8,4,MOT,1197,2572,CHI
2,16,2,193,1.825497609,209,16,for,"('CHI', 'MOT')",Providence,nai29.xml,213,4,2,MOT,1197,2572,CHI
1,0,0,7,1.791759469,7,0,little,"('GRA', 'MOT')",Providence,nai29.xml,8,1,1,MOT,37,43,GRA
1,0,0,7,1.791759469,7,0,are,"('GRA', 'MOT')",Providence,nai29.xml,8,1,1,MOT,37,43,GRA
2,6,2,74,1.767661918,80,6,do,"('MOT', 'CHI')",Providence,nai29.xml,84,4,2,CHI,931,428,MOT
5,17,5,186,1.739491041,203,17,in,"('CHI', 'MOT')",Providence,nai29.xml,213,10,5,MOT,1197,2572,CHI
5,19,4,185,1.726008092,204,19,it,"('CHI', 'MOT')",Providence,nai29.xml,213,9,5,MOT,1197,2572,CHI
3,21,3,186,1.558144618,207,21,and,"('CHI', 'MOT')",Providence,nai29.xml,213,6,3,MOT,1197,2572,CHI
1,12,5,195,1.391090533,207,12,this,"('CHI', 'MOT')",Providence,nai29.xml,213,6,1,MOT,1197,2572,CHI
5,27,4,177,1.389535855,204,27,that,"('CHI', 'MOT')",Providence,nai29.xml,213,9,5,MOT,1197,2572,CHI
1,0,0,4,1.386294361,4,0,is,"('GRA', 'CHI')",Providence,nai29.xml,5,1,1,CHI,34,22,GRA
1,0,1,6,1.386294361,6,0,yeah,"('CHI', 'GRA')",Providence,nai29.xml,8,2,1,GRA,26,45,CHI
1,0,1,6,1.386294361,6,0,in,"('GRA', 'MOT')",Providence,nai29.xml,8,2,1,MOT,37,43,GRA
1,0,1,6,1.386294361,6,0,a,"('GRA', 'MOT')",Providence,nai29.xml,8,2,1,MOT,37,43,GRA
6,12,19,176,1.332147998,188,12,yeah,"('CHI', 'MOT')",Providence,nai29.xml,213,25,6,MOT,1197,2572,CHI
5,7,9,63,1.216395324,70,7,it,"('MOT', 'CHI')",Providence,nai29.xml,84,14,5,CHI,931,428,MOT
0,2,6,76,1.203972804,78,2,in,"('MOT', 'CHI')",Providence,nai29.xml,84,6,0,CHI,931,428,MOT
1,1,0,7,1.203972804,8,1,no,"('MOT', 'GRA')",Providence,nai29.xml,9,1,1,GRA,69,70,MOT
1,1,0,6,1.098612289,7,1,you,"('GRA', 'MOT')",Providence,nai29.xml,8,1,1,MOT,37,43,GRA
1,1,0,6,1.098612289,7,1,what,"('GRA', 'MOT')",Providence,nai29.xml,8,1,1,MOT,37,43,GRA
3,5,12,64,1.024001425,69,5,on,"('MOT', 'CHI')",Providence,nai29.xml,84,15,3,CHI,931,428,MOT
1,21,4,187,1.003302109,208,21,gonna,"('CHI', 'MOT')",Providence,nai29.xml,213,5,1,MOT,1197,2572,CHI
11,30,14,158,1.002106651,188,30,the,"('CHI', 'MOT')",Providence,nai29.xml,213,25,11,MOT,1197,2572,CHI
0,9,6,198,0.960307617,207,9,some,"('CHI', 'MOT')",Providence,nai29.xml,213,6,0,MOT,1197,2572,CHI
4,25,9,175,0.951558871,200,25,is,"('CHI', 'MOT')",Providence,nai29.xml,213,13,4,MOT,1197,2572,CHI
3,28,6,176,0.948979427,204,28,to,"('CHI', 'MOT')",Providence,nai29.xml,213,9,3,MOT,1197,2572,CHI
1,0,1,3,0.916290732,3,0,a,"('GRA', 'CHI')",Providence,nai29.xml,5,2,1,CHI,34,22,GRA
1,0,1,3,0.916290732,3,0,on,"('GRA', 'CHI')",Providence,nai29.xml,5,2,1,CHI,34,22,GRA
0,2,9,73,0.84729786,75,2,get,"('MOT', 'CHI')",Providence,nai29.xml,84,9,0,CHI,931,428,MOT
1,2,0,6,0.798507696,8,2,what,"('MOT', 'GRA')",Providence,nai29.xml,9,1,1,GRA,69,70,MOT
1,2,0,6,0.798507696,8,2,on,"('MOT', 'GRA')",Providence,nai29.xml,9,1,1,GRA,69,70,MOT
1,69,0,143,0.712015665,212,69,you,"('CHI', 'MOT')",Providence,nai29.xml,213,1,1,MOT,1197,2572,CHI
2,25,8,178,0.67861908,203,25,what,"('CHI', 'MOT')",Providence,nai29.xml,213,10,2,MOT,1197,2572,CHI
3,38,6,166,0.652713611,204,38,a,"('CHI', 'MOT')",Providence,nai29.xml,213,9,3,MOT,1197,2572,CHI
0,2,12,70,0.566395475,72,2,yeah,"('MOT', 'CHI')",Providence,nai29.xml,84,12,0,CHI,931,428,MOT
0,1,1,7,0.510825624,8,1,are,"('MOT', 'GRA')",Providence,nai29.xml,9,1,0,GRA,69,70,MOT
0,1,1,6,0.405465108,7,1,what,"('CHI', 'GRA')",Providence,nai29.xml,8,1,0,GRA,26,45,CHI
0,1,1,6,0.405465108,7,1,do,"('CHI', 'GRA')",Providence,nai29.xml,8,1,0,GRA,26,45,CHI
1,2,0,1,0.105360516,3,2,a,"('MOT', 'ENV')",Providence,nai29.xml,4,1,1,ENV,25,128,MOT
0,5,10,69,0.054067221,74,5,a,"('MOT', 'CHI')",Providence,nai29.xml,84,10,0,CHI,931,428,MOT
0,1,1,3,0,4,1,what,"('GRA', 'CHI')",Providence,nai29.xml,5,1,0,CHI,34,22,GRA
0,1,1,3,0,4,1,the,"('GRA', 'CHI')",Providence,nai29.xml,5,1,0,CHI,34,22,GRA
0,1,1,2,-0.182321557,3,1,to,"('MOT', 'ENV')",Providence,nai29.xml,4,1,0,ENV,25,128,MOT
1,7,20,56,-0.347401307,63,7,the,"('MOT', 'CHI')",Providence,nai29.xml,84,21,1,CHI,931,428,MOT
0,3,2,4,-0.575364145,7,3,you,"('MOT', 'GRA')",Providence,nai29.xml,9,2,0,GRA,69,70,MOT
1,0,4,246,4.260665778,246,0,he,"('MOT', 'CHI')",Providence,nai30.xml,251,5,1,CHI,2669,1319,MOT
1,0,4,246,4.260665778,246,0,big,"('MOT', 'CHI')",Providence,nai30.xml,251,5,1,CHI,2669,1319,MOT
1,0,5,245,4.123093976,245,0,like,"('MOT', 'CHI')",Providence,nai30.xml,251,6,1,CHI,2669,1319,MOT
1,0,7,243,3.891820298,243,0,get,"('MOT', 'CHI')",Providence,nai30.xml,251,8,1,CHI,2669,1319,MOT
0,1,5,245,2.874371417,246,1,for,"('MOT', 'CHI')",Providence,nai30.xml,251,5,0,CHI,2669,1319,MOT
3,1,22,225,2.826655944,226,1,to,"('MOT', 'CHI')",Providence,nai30.xml,251,25,3,CHI,2669,1319,MOT
0,2,3,246,2.813410717,248,2,they,"('MOT', 'CHI')",Providence,nai30.xml,251,3,0,CHI,2669,1319,MOT
1,3,5,242,2.736799614,245,3,put,"('MOT', 'CHI')",Providence,nai30.xml,251,6,1,CHI,2669,1319,MOT
5,7,5,234,2.720472721,241,7,where,"('MOT', 'CHI')",Providence,nai30.xml,251,10,5,CHI,2669,1319,MOT
1,2,8,240,2.693807844,242,2,she,"('MOT', 'CHI')",Providence,nai30.xml,251,9,1,CHI,2669,1319,MOT
0,1,7,243,2.614959778,244,1,this,"('MOT', 'CHI')",Providence,nai30.xml,251,7,0,CHI,2669,1319,MOT
1,3,6,241,2.614959778,244,3,one,"('MOT', 'CHI')",Providence,nai30.xml,251,7,1,CHI,2669,1319,MOT
1,1,15,234,2.577688383,235,1,on,"('MOT', 'CHI')",Providence,nai30.xml,251,16,1,CHI,2669,1319,MOT
1,0,32,218,2.531426665,218,0,we,"('MOT', 'CHI')",Providence,nai30.xml,251,33,1,CHI,2669,1319,MOT
0,2,5,244,2.468906308,246,2,with,"('MOT', 'CHI')",Providence,nai30.xml,251,5,0,CHI,2669,1319,MOT
0,2,5,244,2.468906308,246,2,wanna,"('MOT', 'CHI')",Providence,nai30.xml,251,5,0,CHI,2669,1319,MOT
0,7,1,243,2.351375257,250,7,no,"('MOT', 'CHI')",Providence,nai30.xml,251,1,0,CHI,2669,1319,MOT
8,8,14,221,2.26436388,229,8,what,"('MOT', 'CHI')",Providence,nai30.xml,251,22,8,CHI,2669,1319,MOT
0,1,15,235,1.945910149,236,1,do,"('MOT', 'CHI')",Providence,nai30.xml,251,15,0,CHI,2669,1319,MOT
1,3,16,231,1.826245645,234,3,oh,"('MOT', 'CHI')",Providence,nai30.xml,251,17,1,CHI,2669,1319,MOT
5,8,21,217,1.687280399,225,8,in,"('MOT', 'CHI')",Providence,nai30.xml,251,26,5,CHI,2669,1319,MOT
0,2,13,236,1.673976434,238,2,did,"('MOT', 'CHI')",Providence,nai30.xml,251,13,0,CHI,2669,1319,MOT
0,3,12,236,1.459445243,239,3,up,"('MOT', 'CHI')",Providence,nai30.xml,251,12,0,CHI,2669,1319,MOT
0,1,27,223,1.360091989,224,1,and,"('MOT', 'CHI')",Providence,nai30.xml,251,27,0,CHI,2669,1319,MOT
1,5,20,225,1.212630867,230,5,is,"('MOT', 'CHI')",Providence,nai30.xml,251,21,1,CHI,2669,1319,MOT
1,6,27,217,0.762140052,223,6,of,"('MOT', 'CHI')",Providence,nai30.xml,251,28,1,CHI,2669,1319,MOT
2,10,25,214,0.753956185,224,10,there,"('MOT', 'CHI')",Providence,nai30.xml,251,27,2,CHI,2669,1319,MOT
0,5,17,229,0.727633357,234,5,at,"('MOT', 'CHI')",Providence,nai30.xml,251,17,0,CHI,2669,1319,MOT
4,13,35,199,0.622784531,212,13,that,"('MOT', 'CHI')",Providence,nai30.xml,251,39,4,CHI,2669,1319,MOT
5,14,46,186,0.421685052,200,14,a,"('MOT', 'CHI')",Providence,nai30.xml,251,51,5,CHI,2669,1319,MOT
0,9,14,228,0.401289737,237,9,go,"('MOT', 'CHI')",Providence,nai30.xml,251,14,0,CHI,2669,1319,MOT
0,7,21,223,0.231801614,230,7,it,"('MOT', 'CHI')",Providence,nai30.xml,251,21,0,CHI,2669,1319,MOT
7,43,28,173,0.068829058,216,43,yeah,"('MOT', 'CHI')",Providence,nai30.xml,251,35,7,CHI,2669,1319,MOT
13,33,61,144,-0.030650729,177,33,the,"('MOT', 'CHI')",Providence,nai30.xml,251,74,13,CHI,2669,1319,MOT
0,1,2,278,3.558913128,279,1,my,"('MOT', 'CHI')",Providence,nai31.xml,281,2,0,CHI,3305,1703,MOT
0,1,2,278,3.558913128,279,1,at,"('MOT', 'CHI')",Providence,nai31.xml,281,2,0,CHI,3305,1703,MOT
2,1,8,270,3.530030254,271,1,one,"('MOT', 'CHI')",Providence,nai31.xml,281,10,2,CHI,3305,1703,MOT
1,0,2,65,3.288401888,65,0,and,"('FAT', 'CHI')",Providence,nai31.xml,68,3,1,CHI,788,339,FAT
1,2,5,273,3.139110856,275,2,they,"('MOT', 'CHI')",Providence,nai31.xml,281,6,1,CHI,3305,1703,MOT
0,1,5,275,2.988563784,276,1,he,"('MOT', 'CHI')",Providence,nai31.xml,281,5,0,CHI,3305,1703,MOT
0,2,3,276,2.926739402,278,2,look,"('MOT', 'CHI')",Providence,nai31.xml,281,3,0,CHI,3305,1703,MOT
0,1,6,274,2.851428784,275,1,all,"('MOT', 'CHI')",Providence,nai31.xml,281,6,0,CHI,3305,1703,MOT
1,4,4,272,2.765420233,276,4,she,"('MOT', 'CHI')",Providence,nai31.xml,281,5,1,CHI,3305,1703,MOT
1,1,14,265,2.757773636,266,1,we,"('MOT', 'CHI')",Providence,nai31.xml,281,15,1,CHI,3305,1703,MOT
1,4,5,271,2.628285233,275,4,big,"('MOT', 'CHI')",Providence,nai31.xml,281,6,1,CHI,3305,1703,MOT
0,1,8,272,2.621038824,273,1,but,"('MOT', 'CHI')",Providence,nai31.xml,281,8,0,CHI,3305,1703,MOT
1,1,2,64,2.595254707,65,1,where,"('FAT', 'CHI')",Providence,nai31.xml,68,3,1,CHI,788,339,FAT
3,3,15,260,2.583997552,263,3,gonna,"('MOT', 'CHI')",Providence,nai31.xml,281,18,3,CHI,3305,1703,MOT
1,0,0,15,2.427748236,15,0,do,"('MOT', 'FAT')",Providence,nai31.xml,16,1,1,FAT,171,181,MOT
0,1,11,269,2.347705528,270,1,think,"('MOT', 'CHI')",Providence,nai31.xml,281,11,0,CHI,3305,1703,MOT
2,4,12,263,2.311297034,267,4,little,"('MOT', 'CHI')",Providence,nai31.xml,281,14,2,CHI,3305,1703,MOT
1,0,9,58,2.302585093,58,0,it,"('FAT', 'CHI')",Providence,nai31.xml,68,10,1,CHI,788,339,FAT
0,1,12,268,2.269914311,269,1,get,"('MOT', 'CHI')",Providence,nai31.xml,281,12,0,CHI,3305,1703,MOT
2,0,1,13,2.197224577,13,0,on,"('MOT', 'FAT')",Providence,nai31.xml,16,3,2,FAT,171,181,MOT
0,1,2,65,2.140066163,66,1,not,"('FAT', 'CHI')",Providence,nai31.xml,68,2,0,CHI,788,339,FAT
1,0,0,10,2.079441542,10,0,gonna,"('CHI', 'FAT')",Providence,nai31.xml,11,1,1,FAT,55,140,CHI
1,0,0,10,2.079441542,10,0,a,"('CHI', 'FAT')",Providence,nai31.xml,11,1,1,FAT,55,140,CHI
2,3,21,255,2.054123734,258,3,want,"('MOT', 'CHI')",Providence,nai31.xml,281,23,2,CHI,3305,1703,MOT
1,4,11,265,2.046770759,269,4,of,"('MOT', 'CHI')",Providence,nai31.xml,281,12,1,CHI,3305,1703,MOT
6,7,21,247,2.044350222,254,7,and,"('MOT', 'CHI')",Providence,nai31.xml,281,27,6,CHI,3305,1703,MOT
0,9,2,270,1.949475215,279,9,no,"('MOT', 'CHI')",Providence,nai31.xml,281,2,0,CHI,3305,1703,MOT
0,2,11,268,1.94224042,270,2,this,"('MOT', 'CHI')",Providence,nai31.xml,281,11,0,CHI,3305,1703,MOT
0,1,3,64,1.902107526,65,1,was,"('FAT', 'CHI')",Providence,nai31.xml,68,3,0,CHI,788,339,FAT
1,3,2,62,1.902107526,65,3,in,"('FAT', 'CHI')",Providence,nai31.xml,68,3,1,CHI,788,339,FAT
3,7,15,256,1.890850372,263,7,like,"('MOT', 'CHI')",Providence,nai31.xml,281,18,3,CHI,3305,1703,MOT
0,2,12,267,1.864449203,269,2,with,"('MOT', 'CHI')",Providence,nai31.xml,281,12,0,CHI,3305,1703,MOT
5,8,20,248,1.851657611,256,8,was,"('MOT', 'CHI')",Providence,nai31.xml,281,25,5,CHI,3305,1703,MOT
1,2,4,61,1.823012013,63,2,a,"('FAT', 'CHI')",Providence,nai31.xml,68,5,1,CHI,788,339,FAT
2,3,27,249,1.81566499,252,3,oh,"('MOT', 'CHI')",Providence,nai31.xml,281,29,2,CHI,3305,1703,MOT
1,5,12,263,1.791759469,268,5,have,"('MOT', 'CHI')",Providence,nai31.xml,281,13,1,CHI,3305,1703,MOT
5,5,38,233,1.673976434,238,5,is,"('MOT', 'CHI')",Providence,nai31.xml,281,43,5,CHI,3305,1703,MOT
1,2,30,248,1.627456418,250,2,some,"('MOT', 'CHI')",Providence,nai31.xml,281,31,1,CHI,3305,1703,MOT
0,2,3,63,1.496642418,65,2,with,"('FAT', 'CHI')",Providence,nai31.xml,68,3,0,CHI,788,339,FAT
0,1,6,61,1.386294361,62,1,do,"('FAT', 'CHI')",Providence,nai31.xml,68,6,0,CHI,788,339,FAT
1,1,1,13,1.386294361,14,1,to,"('MOT', 'FAT')",Providence,nai31.xml,16,2,1,FAT,171,181,MOT
2,0,27,39,1.378197151,39,0,you,"('FAT', 'CHI')",Providence,nai31.xml,68,29,2,CHI,788,339,FAT
1,7,14,259,1.371479275,266,7,for,"('MOT', 'CHI')",Providence,nai31.xml,281,15,1,CHI,3305,1703,MOT
0,6,8,267,1.368275856,273,6,where,"('MOT', 'CHI')",Providence,nai31.xml,281,8,0,CHI,3305,1703,MOT
0,3,16,262,1.310582539,265,3,yeah,"('MOT', 'CHI')",Providence,nai31.xml,281,16,0,CHI,3305,1703,MOT
0,2,4,62,1.299282984,64,2,on,"('FAT', 'CHI')",Providence,nai31.xml,68,4,0,CHI,788,339,FAT
2,8,20,251,1.287854288,259,8,in,"('MOT', 'CHI')",Providence,nai31.xml,281,22,2,CHI,3305,1703,MOT
2,4,37,238,1.272770535,242,4,it,"('MOT', 'CHI')",Providence,nai31.xml,281,39,2,CHI,3305,1703,MOT
3,2,73,203,1.263692039,205,2,you,"('MOT', 'CHI')",Providence,nai31.xml,281,76,3,CHI,3305,1703,MOT
0,1,1,14,1.041453875,15,1,and,"('MOT', 'FAT')",Providence,nai31.xml,16,1,0,FAT,171,181,MOT
1,1,1,8,1.011600912,9,1,the,"('CHI', 'FAT')",Providence,nai31.xml,11,2,1,FAT,55,140,CHI
1,2,0,8,0.980829253,10,2,what,"('CHI', 'FAT')",Providence,nai31.xml,11,1,1,FAT,55,140,CHI
0,3,25,253,0.870828358,256,3,do,"('MOT', 'CHI')",Providence,nai31.xml,281,25,0,CHI,3305,1703,MOT
4,11,38,228,0.825138562,239,11,a,"('MOT', 'CHI')",Providence,nai31.xml,281,42,4,CHI,3305,1703,MOT
1,5,34,241,0.803898545,246,5,to,"('MOT', 'CHI')",Providence,nai31.xml,281,35,1,CHI,3305,1703,MOT
0,2,8,58,0.725937003,60,2,to,"('FAT', 'CHI')",Providence,nai31.xml,68,8,0,CHI,788,339,FAT
1,0,0,1,0.693147181,1,0,the,"('CHI', 'MOT')",Providence,nai31.xml,2,1,1,MOT,12,17,CHI
0,3,6,59,0.693147181,62,3,there,"('FAT', 'CHI')",Providence,nai31.xml,68,6,0,CHI,788,339,FAT
0,1,2,13,0.693147181,14,1,we,"('MOT', 'FAT')",Providence,nai31.xml,16,2,0,FAT,171,181,MOT
0,1,2,13,0.693147181,14,1,are,"('MOT', 'FAT')",Providence,nai31.xml,16,2,0,FAT,171,181,MOT
0,6,17,258,0.693147181,264,6,are,"('MOT', 'CHI')",Providence,nai31.xml,281,17,0,CHI,3305,1703,MOT
0,2,1,13,0.635988767,15,2,but,"('MOT', 'FAT')",Providence,nai31.xml,16,1,0,FAT,171,181,MOT
0,2,1,13,0.635988767,15,2,that,"('MOT', 'FAT')",Providence,nai31.xml,16,1,0,FAT,171,181,MOT
0,2,1,13,0.635988767,15,2,not,"('MOT', 'FAT')",Providence,nai31.xml,16,1,0,FAT,171,181,MOT
0,14,8,259,0.606135804,273,14,go,"('MOT', 'CHI')",Providence,nai31.xml,281,8,0,CHI,3305,1703,MOT
1,9,26,245,0.568443702,254,9,there,"('MOT', 'CHI')",Providence,nai31.xml,281,27,1,CHI,3305,1703,MOT
0,3,7,58,0.559615788,61,3,that,"('FAT', 'CHI')",Providence,nai31.xml,68,7,0,CHI,788,339,FAT
0,9,2,57,0.530628251,66,9,no,"('FAT', 'CHI')",Providence,nai31.xml,68,2,0,CHI,788,339,FAT
4,7,14,43,0.485507816,50,7,the,"('FAT', 'CHI')",Providence,nai31.xml,68,18,4,CHI,788,339,FAT
3,19,27,232,0.458215673,251,19,what,"('MOT', 'CHI')",Providence,nai31.xml,281,30,3,CHI,3305,1703,MOT
1,2,3,10,0.441832752,12,2,oh,"('MOT', 'FAT')",Providence,nai31.xml,16,4,1,FAT,171,181,MOT
5,21,36,219,0.428454626,240,21,that,"('MOT', 'CHI')",Providence,nai31.xml,281,41,5,CHI,3305,1703,MOT
0,1,3,12,0.405465108,13,1,it,"('MOT', 'FAT')",Providence,nai31.xml,16,3,0,FAT,171,181,MOT
14,36,47,184,0.356674944,220,36,the,"('MOT', 'CHI')",Providence,nai31.xml,281,61,14,CHI,3305,1703,MOT
0,7,4,57,0.318453731,64,7,go,"('FAT', 'CHI')",Providence,nai31.xml,68,4,0,CHI,788,339,FAT
0,2,2,12,0.287682072,14,2,what,"('MOT', 'FAT')",Providence,nai31.xml,16,2,0,FAT,171,181,MOT
0,2,2,12,0.287682072,14,2,is,"('MOT', 'FAT')",Providence,nai31.xml,16,2,0,FAT,171,181,MOT
0,2,2,12,0.287682072,14,2,the,"('MOT', 'FAT')",Providence,nai31.xml,16,2,0,FAT,171,181,MOT
0,3,2,11,0,14,3,a,"('MOT', 'FAT')",Providence,nai31.xml,16,2,0,FAT,171,181,MOT
1,3,4,8,-0.074107972,11,3,you,"('MOT', 'FAT')",Providence,nai31.xml,16,5,1,FAT,171,181,MOT
0,4,1,6,-0.223143551,10,4,you,"('CHI', 'FAT')",Providence,nai31.xml,11,1,0,FAT,55,140,CHI
1,0,6,381,4.443957592,381,0,some,"('MOT', 'CHI')",Providence,nai32.xml,388,7,1,CHI,4922,2499,MOT
1,0,7,380,4.335982696,380,0,but,"('MOT', 'CHI')",Providence,nai32.xml,388,8,1,CHI,4922,2499,MOT
3,3,5,377,3.642835516,380,3,one,"('MOT', 'CHI')",Providence,nai32.xml,388,8,3,CHI,4922,2499,MOT
0,2,2,384,3.47609869,386,2,big,"('MOT', 'CHI')",Providence,nai32.xml,388,2,0,CHI,4922,2499,MOT
1,4,3,380,3.247787168,384,4,he,"('MOT', 'CHI')",Providence,nai32.xml,388,4,1,CHI,4922,2499,MOT
1,3,5,379,3.17805383,382,3,get,"('MOT', 'CHI')",Providence,nai32.xml,388,6,1,CHI,4922,2499,MOT
0,1,7,380,3.057663231,381,1,not,"('MOT', 'CHI')",Providence,nai32.xml,388,7,0,CHI,4922,2499,MOT
1,0,35,352,2.924857934,352,0,we,"('MOT', 'CHI')",Providence,nai32.xml,388,36,1,CHI,4922,2499,MOT
1,2,12,373,2.818729878,375,2,have,"('MOT', 'CHI')",Providence,nai32.xml,388,13,1,CHI,4922,2499,MOT
1,3,9,375,2.762117422,378,3,put,"('MOT', 'CHI')",Providence,nai32.xml,388,10,1,CHI,4922,2499,MOT
1,4,9,374,2.538973871,378,4,up,"('MOT', 'CHI')",Providence,nai32.xml,388,10,1,CHI,4922,2499,MOT
0,3,6,379,2.48490665,382,3,little,"('MOT', 'CHI')",Providence,nai32.xml,388,6,0,CHI,4922,2499,MOT
3,5,16,364,2.466214517,369,5,they,"('MOT', 'CHI')",Providence,nai32.xml,388,19,3,CHI,4922,2499,MOT
1,2,19,366,2.416995444,368,2,can,"('MOT', 'CHI')",Providence,nai32.xml,388,20,1,CHI,4922,2499,MOT
0,4,5,379,2.397895273,383,4,look,"('MOT', 'CHI')",Providence,nai32.xml,388,5,0,CHI,4922,2499,MOT
3,4,22,359,2.380916936,363,4,gonna,"('MOT', 'CHI')",Providence,nai32.xml,388,25,3,CHI,4922,2499,MOT
2,17,2,367,2.372318431,384,17,no,"('MOT', 'CHI')",Providence,nai32.xml,388,4,2,CHI,4922,2499,MOT
1,2,24,361,2.198595379,363,2,this,"('MOT', 'CHI')",Providence,nai32.xml,388,25,1,CHI,4922,2499,MOT
2,6,15,365,2.12984158,371,6,make,"('MOT', 'CHI')",Providence,nai32.xml,388,17,2,CHI,4922,2499,MOT
3,6,23,356,2.00533357,362,6,was,"('MOT', 'CHI')",Providence,nai32.xml,388,26,3,CHI,4922,2499,MOT
0,2,15,371,1.995100393,373,2,with,"('MOT', 'CHI')",Providence,nai32.xml,388,15,0,CHI,4922,2499,MOT
1,5,15,367,1.935271751,372,5,for,"('MOT', 'CHI')",Providence,nai32.xml,388,16,1,CHI,4922,2499,MOT
6,24,10,348,1.760918364,372,24,go,"('MOT', 'CHI')",Providence,nai32.xml,388,16,6,CHI,4922,2499,MOT
0,2,23,363,1.587873735,365,2,see,"('MOT', 'CHI')",Providence,nai32.xml,388,23,0,CHI,4922,2499,MOT
5,16,23,344,1.448992955,360,16,she,"('MOT', 'CHI')",Providence,nai32.xml,388,28,5,CHI,4922,2499,MOT
4,10,34,340,1.386294361,350,10,it,"('MOT', 'CHI')",Providence,nai32.xml,388,38,4,CHI,4922,2499,MOT
3,6,45,334,1.363171944,340,6,to,"('MOT', 'CHI')",Providence,nai32.xml,388,48,3,CHI,4922,2499,MOT
1,5,28,354,1.356278465,359,5,do,"('MOT', 'CHI')",Providence,nai32.xml,388,29,1,CHI,4922,2499,MOT
1,6,26,355,1.274344036,361,6,like,"('MOT', 'CHI')",Providence,nai32.xml,388,27,1,CHI,4922,2499,MOT
2,7,35,344,1.222077158,351,7,yeah,"('MOT', 'CHI')",Providence,nai32.xml,388,37,2,CHI,4922,2499,MOT
0,10,9,369,1.14700883,379,10,where,"('MOT', 'CHI')",Providence,nai32.xml,388,9,0,CHI,4922,2499,MOT
2,11,26,349,1.104152469,360,11,are,"('MOT', 'CHI')",Providence,nai32.xml,388,28,2,CHI,4922,2499,MOT
2,9,32,345,1.087438988,354,9,on,"('MOT', 'CHI')",Providence,nai32.xml,388,34,2,CHI,4922,2499,MOT
0,8,13,367,1.026970409,375,8,at,"('MOT', 'CHI')",Providence,nai32.xml,388,13,0,CHI,4922,2499,MOT
2,3,79,304,1.026818597,307,3,you,"('MOT', 'CHI')",Providence,nai32.xml,388,81,2,CHI,4922,2499,MOT
19,29,67,273,0.834225779,302,29,a,"('MOT', 'CHI')",Providence,nai32.xml,388,86,19,CHI,4922,2499,MOT
3,10,50,325,0.801148833,335,10,and,"('MOT', 'CHI')",Providence,nai32.xml,388,53,3,CHI,4922,2499,MOT
12,26,57,293,0.777873738,319,26,that,"('MOT', 'CHI')",Providence,nai32.xml,388,69,12,CHI,4922,2499,MOT
0,9,16,363,0.731298947,372,9,did,"('MOT', 'CHI')",Providence,nai32.xml,388,16,0,CHI,4922,2499,MOT
7,24,49,308,0.611263699,332,24,in,"('MOT', 'CHI')",Providence,nai32.xml,388,56,7,CHI,4922,2499,MOT
0,8,23,357,0.489261446,365,8,of,"('MOT', 'CHI')",Providence,nai32.xml,388,23,0,CHI,4922,2499,MOT
9,33,61,285,0.267879445,318,33,is,"('MOT', 'CHI')",Providence,nai32.xml,388,70,9,CHI,4922,2499,MOT
28,48,95,217,0.234410453,265,48,the,"('MOT', 'CHI')",Providence,nai32.xml,388,123,28,CHI,4922,2499,MOT
1,4,92,291,0.223564515,295,4,oh,"('MOT', 'CHI')",Providence,nai32.xml,388,93,1,CHI,4922,2499,MOT
0,5,46,337,0.177681177,342,5,what,"('MOT', 'CHI')",Providence,nai32.xml,388,46,0,CHI,4922,2499,MOT
4,32,40,312,0.13072773,344,32,there,"('MOT', 'CHI')",Providence,nai32.xml,388,44,4,CHI,4922,2499,MOT
0,1,1,303,3.931825633,304,1,my,"('MOT', 'CHI')",Providence,nai33.xml,305,1,0,CHI,3053,1783,MOT
0,1,3,301,3.414442608,302,1,one,"('MOT', 'CHI')",Providence,nai33.xml,305,3,0,CHI,3053,1783,MOT
0,2,2,301,3.235405127,303,2,put,"('MOT', 'CHI')",Providence,nai33.xml,305,2,0,CHI,3053,1783,MOT
0,1,4,300,3.228826156,301,1,but,"('MOT', 'CHI')",Providence,nai33.xml,305,4,0,CHI,3053,1783,MOT
1,0,0,31,3.091042453,31,0,little,"('CHI', 'MOT')",Providence,nai33.xml,32,1,1,MOT,176,359,CHI
0,1,5,299,3.071369688,300,1,wanna,"('MOT', 'CHI')",Providence,nai33.xml,305,5,0,CHI,3053,1783,MOT
0,2,3,300,3.0089775,302,2,look,"('MOT', 'CHI')",Providence,nai33.xml,305,3,0,CHI,3053,1783,MOT
2,2,13,288,2.843540458,290,2,see,"('MOT', 'CHI')",Providence,nai33.xml,305,15,2,CHI,3053,1783,MOT
0,2,4,299,2.823361048,301,2,make,"('MOT', 'CHI')",Providence,nai33.xml,305,4,0,CHI,3053,1783,MOT
1,2,9,293,2.803360381,295,2,with,"('MOT', 'CHI')",Providence,nai33.xml,305,10,1,CHI,3053,1783,MOT
1,0,1,30,2.772588722,30,0,she,"('CHI', 'MOT')",Providence,nai33.xml,32,2,1,MOT,176,359,CHI
4,3,18,280,2.697578901,283,3,and,"('MOT', 'CHI')",Providence,nai33.xml,305,22,4,CHI,3053,1783,MOT
1,2,11,291,2.642452919,293,2,for,"('MOT', 'CHI')",Providence,nai33.xml,305,12,1,CHI,3053,1783,MOT
0,1,11,293,2.432262916,294,1,want,"('MOT', 'CHI')",Providence,nai33.xml,305,11,0,CHI,3053,1783,MOT
1,1,22,281,2.430098413,282,1,do,"('MOT', 'CHI')",Providence,nai33.xml,305,23,1,CHI,3053,1783,MOT
1,1,0,30,2.397895273,31,1,in,"('CHI', 'MOT')",Providence,nai33.xml,32,1,1,MOT,176,359,CHI
1,1,0,30,2.397895273,31,1,was,"('CHI', 'MOT')",Providence,nai33.xml,32,1,1,MOT,176,359,CHI
0,1,12,292,2.354770846,293,1,can,"('MOT', 'CHI')",Providence,nai33.xml,305,12,0,CHI,3053,1783,MOT
1,3,14,287,2.150393278,290,3,have,"('MOT', 'CHI')",Providence,nai33.xml,305,15,1,CHI,3053,1783,MOT
3,8,11,283,2.096653671,291,8,was,"('MOT', 'CHI')",Providence,nai33.xml,305,14,3,CHI,3053,1783,MOT
2,2,0,28,2.079441542,30,2,on,"('CHI', 'MOT')",Providence,nai33.xml,32,2,2,MOT,176,359,CHI
1,1,1,29,2.079441542,30,1,for,"('CHI', 'MOT')",Providence,nai33.xml,32,2,1,MOT,176,359,CHI
1,1,1,29,2.079441542,30,1,this,"('CHI', 'MOT')",Providence,nai33.xml,32,2,1,MOT,176,359,CHI
0,1,17,287,2.032294763,288,1,did,"('MOT', 'CHI')",Providence,nai33.xml,305,17,0,CHI,3053,1783,MOT
1,2,0,29,1.992430165,31,2,of,"('CHI', 'MOT')",Providence,nai33.xml,32,1,1,MOT,176,359,CHI
1,0,0,8,1.897119985,8,0,was,"('CHI', 'FAT')",Providence,nai33.xml,9,1,1,FAT,35,65,CHI
1,0,0,8,1.897119985,8,0,to,"('CHI', 'FAT')",Providence,nai33.xml,9,1,1,FAT,35,65,CHI
1,4,15,285,1.866660777,289,4,of,"('MOT', 'CHI')",Providence,nai33.xml,305,16,1,CHI,3053,1783,MOT
0,1,23,281,1.736951233,282,1,are,"('MOT', 'CHI')",Providence,nai33.xml,305,23,0,CHI,3053,1783,MOT
0,1,1,30,1.704748092,31,1,want,"('CHI', 'MOT')",Providence,nai33.xml,32,1,0,MOT,176,359,CHI
0,1,1,30,1.704748092,31,1,my,"('CHI', 'MOT')",Providence,nai33.xml,32,1,0,MOT,176,359,CHI
6,12,20,267,1.687110951,279,12,she,"('MOT', 'CHI')",Providence,nai33.xml,305,26,6,CHI,3053,1783,MOT
1,2,1,28,1.673976434,30,2,yeah,"('CHI', 'MOT')",Providence,nai33.xml,32,2,1,MOT,176,359,CHI
1,0,0,6,1.673976434,6,0,yeah,"('FAT', 'MOT')",Providence,nai33.xml,7,1,1,MOT,52,58,FAT
1,0,1,7,1.504077397,7,0,on,"('CHI', 'FAT')",Providence,nai33.xml,9,2,1,FAT,35,65,CHI
1,6,16,282,1.472678975,288,6,get,"('MOT', 'CHI')",Providence,nai33.xml,305,17,1,CHI,3053,1783,MOT
1,8,14,282,1.339463061,290,8,like,"('MOT', 'CHI')",Providence,nai33.xml,305,15,1,CHI,3053,1783,MOT
0,2,1,29,1.299282984,31,2,like,"('CHI', 'MOT')",Providence,nai33.xml,32,1,0,MOT,176,359,CHI
0,2,1,29,1.299282984,31,2,some,"('CHI', 'MOT')",Providence,nai33.xml,32,1,0,MOT,176,359,CHI
1,9,13,282,1.298145974,291,9,there,"('MOT', 'CHI')",Providence,nai33.xml,305,14,1,CHI,3053,1783,MOT
1,3,35,266,1.271385481,269,3,oh,"('MOT', 'CHI')",Providence,nai33.xml,305,36,1,CHI,3053,1783,MOT
1,1,0,7,1.203972804,8,1,the,"('CHI', 'FAT')",Providence,nai33.xml,9,1,1,FAT,35,65,CHI
4,9,35,257,1.184267733,266,9,this,"('MOT', 'CHI')",Providence,nai33.xml,305,39,4,CHI,3053,1783,MOT
1,16,9,279,1.068759326,295,16,go,"('MOT', 'CHI')",Providence,nai33.xml,305,10,1,CHI,3053,1783,MOT
0,5,15,285,1.051780989,290,5,little,"('MOT', 'CHI')",Providence,nai33.xml,305,15,0,CHI,3053,1783,MOT
0,3,1,28,1.011600912,31,3,are,"('CHI', 'MOT')",Providence,nai33.xml,32,1,0,MOT,176,359,CHI
0,3,1,28,1.011600912,31,3,to,"('CHI', 'MOT')",Providence,nai33.xml,32,1,0,MOT,176,359,CHI
0,3,24,278,1.001055999,281,3,to,"('MOT', 'CHI')",Providence,nai33.xml,305,24,0,CHI,3053,1783,MOT
1,1,0,5,0.980829253,6,1,a,"('FAT', 'MOT')",Providence,nai33.xml,7,1,1,MOT,52,58,FAT
0,6,14,285,0.961673738,291,6,some,"('MOT', 'CHI')",Providence,nai33.xml,305,14,0,CHI,3053,1783,MOT
1,4,2,25,0.90825856,29,4,what,"('CHI', 'MOT')",Providence,nai33.xml,32,3,1,MOT,176,359,CHI
0,6,15,284,0.897630309,290,6,on,"('MOT', 'CHI')",Providence,nai33.xml,305,15,0,CHI,3053,1783,MOT
7,21,32,245,0.865814002,266,21,what,"('MOT', 'CHI')",Providence,nai33.xml,305,39,7,CHI,3053,1783,MOT
5,12,44,244,0.847944064,256,12,a,"('MOT', 'CHI')",Providence,nai33.xml,305,49,5,CHI,3053,1783,MOT
0,22,4,279,0.78647912,301,22,no,"('MOT', 'CHI')",Providence,nai33.xml,305,4,0,CHI,3053,1783,MOT
0,8,13,284,0.778304989,292,8,where,"('MOT', 'CHI')",Providence,nai33.xml,305,13,0,CHI,3053,1783,MOT
3,20,21,261,0.729122283,281,20,in,"('MOT', 'CHI')",Providence,nai33.xml,305,24,3,CHI,3053,1783,MOT
1,5,2,24,0.725937003,29,5,it,"('CHI', 'MOT')",Providence,nai33.xml,32,3,1,MOT,176,359,CHI
1,4,3,24,0.693147181,28,4,the,"('CHI', 'MOT')",Providence,nai33.xml,32,4,1,MOT,176,359,CHI
0,5,1,26,0.606135804,31,5,and,"('CHI', 'MOT')",Providence,nai33.xml,32,1,0,MOT,176,359,CHI
1,9,30,265,0.514455392,274,9,that,"('MOT', 'CHI')",Providence,nai33.xml,305,31,1,CHI,3053,1783,MOT
10,28,51,216,0.392796252,244,28,the,"('MOT', 'CHI')",Providence,nai33.xml,305,61,10,CHI,3053,1783,MOT
2,10,47,246,0.321850968,256,10,is,"('MOT', 'CHI')",Providence,nai33.xml,305,49,2,CHI,3053,1783,MOT
0,1,1,5,0.287682072,6,1,oh,"('FAT', 'MOT')",Providence,nai33.xml,7,1,0,MOT,52,58,FAT
0,1,1,5,0.287682072,6,1,the,"('FAT', 'MOT')",Providence,nai33.xml,7,1,0,MOT,52,58,FAT
0,6,28,271,0.284104251,277,6,it,"('MOT', 'CHI')",Providence,nai33.xml,305,28,0,CHI,3053,1783,MOT
1,15,25,264,0.226708617,279,15,yeah,"('MOT', 'CHI')",Providence,nai33.xml,305,26,1,CHI,3053,1783,MOT
0,1,1,4,0.15415068,5,1,oh,"('MOT', 'FAT')",Providence,nai33.xml,6,1,0,FAT,46,27,MOT
0,1,1,4,0.15415068,5,1,a,"('MOT', 'FAT')",Providence,nai33.xml,6,1,0,FAT,46,27,MOT
0,5,3,24,0.032789823,29,5,a,"('CHI', 'MOT')",Providence,nai33.xml,32,3,0,MOT,176,359,CHI
1,1,1,1,0,2,1,the,"('FAT', 'CHI')",Providence,nai33.xml,4,2,1,CHI,23,20,FAT
0,6,3,23,-0.121360857,29,6,is,"('CHI', 'MOT')",Providence,nai33.xml,32,3,0,MOT,176,359,CHI
0,4,87,214,-0.704446736,218,4,you,"('MOT', 'CHI')",Providence,nai33.xml,305,87,0,CHI,3053,1783,MOT
1,0,12,514,4.231203745,514,0,wanna,"('MOT', 'CHI')",Providence,nai34.xml,527,13,1,CHI,7047,2639,MOT
2,1,21,503,3.413125953,504,1,they,"('MOT', 'CHI')",Providence,nai34.xml,527,23,2,CHI,7047,2639,MOT
0,1,7,519,3.36729583,520,1,she,"('MOT', 'CHI')",Providence,nai34.xml,527,7,0,CHI,7047,2639,MOT
0,1,10,516,3.073850053,517,1,want,"('MOT', 'CHI')",Providence,nai34.xml,527,10,0,CHI,7047,2639,MOT
1,1,21,504,3.050457173,505,1,for,"('MOT', 'CHI')",Providence,nai34.xml,527,22,1,CHI,7047,2639,MOT
1,1,21,504,3.050457173,505,1,was,"('MOT', 'CHI')",Providence,nai34.xml,527,22,1,CHI,7047,2639,MOT
2,2,21,502,3.007660844,504,2,some,"('MOT', 'CHI')",Providence,nai34.xml,527,23,2,CHI,7047,2639,MOT
0,1,11,515,2.991878704,516,1,little,"('MOT', 'CHI')",Providence,nai34.xml,527,11,0,CHI,7047,2639,MOT
1,1,23,502,2.966461891,503,1,one,"('MOT', 'CHI')",Providence,nai34.xml,527,24,1,CHI,7047,2639,MOT
1,1,25,500,2.88838566,501,1,up,"('MOT', 'CHI')",Providence,nai34.xml,527,26,1,CHI,7047,2639,MOT
1,2,22,502,2.602195736,504,2,like,"('MOT', 'CHI')",Providence,nai34.xml,527,23,1,CHI,7047,2639,MOT
0,2,14,511,2.37296589,513,2,gonna,"('MOT', 'CHI')",Providence,nai34.xml,527,14,0,CHI,7047,2639,MOT
0,2,14,511,2.37296589,513,2,but,"('MOT', 'CHI')",Providence,nai34.xml,527,14,0,CHI,7047,2639,MOT
0,2,17,508,2.195273357,510,2,get,"('MOT', 'CHI')",Providence,nai34.xml,527,17,0,CHI,7047,2639,MOT
0,1,27,499,2.158157109,500,1,see,"('MOT', 'CHI')",Providence,nai34.xml,527,27,0,CHI,7047,2639,MOT
1,3,31,492,1.989082321,495,3,do,"('MOT', 'CHI')",Providence,nai34.xml,527,32,1,CHI,7047,2639,MOT
0,1,33,493,1.958080685,494,1,can,"('MOT', 'CHI')",Providence,nai34.xml,527,33,0,CHI,7047,2639,MOT
2,3,49,473,1.911636746,476,3,to,"('MOT', 'CHI')",Providence,nai34.xml,527,51,2,CHI,7047,2639,MOT
0,3,17,507,1.907591285,510,3,put,"('MOT', 'CHI')",Providence,nai34.xml,527,17,0,CHI,7047,2639,MOT
1,2,49,475,1.814991771,477,2,this,"('MOT', 'CHI')",Providence,nai34.xml,527,50,1,CHI,7047,2639,MOT
0,7,9,511,1.776491997,518,7,no,"('MOT', 'CHI')",Providence,nai34.xml,527,9,0,CHI,7047,2639,MOT
0,4,18,505,1.631199404,509,4,have,"('MOT', 'CHI')",Providence,nai34.xml,527,18,0,CHI,7047,2639,MOT
0,2,31,494,1.615480227,496,2,on,"('MOT', 'CHI')",Providence,nai34.xml,527,31,0,CHI,7047,2639,MOT
0,2,38,487,1.408952385,489,2,we,"('MOT', 'CHI')",Providence,nai34.xml,527,38,0,CHI,7047,2639,MOT
1,4,46,476,1.369833084,480,4,of,"('MOT', 'CHI')",Providence,nai34.xml,527,47,1,CHI,7047,2639,MOT
6,16,48,457,1.250659918,473,16,what,"('MOT', 'CHI')",Providence,nai34.xml,527,54,6,CHI,7047,2639,MOT
0,4,27,496,1.241866377,500,4,with,"('MOT', 'CHI')",Providence,nai34.xml,527,27,0,CHI,7047,2639,MOT
1,2,84,440,1.224451336,442,2,and,"('MOT', 'CHI')",Providence,nai34.xml,527,85,1,CHI,7047,2639,MOT
0,3,37,487,1.148622709,490,3,are,"('MOT', 'CHI')",Providence,nai34.xml,527,37,0,CHI,7047,2639,MOT
1,1,125,400,1.146906298,401,1,you,"('MOT', 'CHI')",Providence,nai34.xml,527,126,1,CHI,7047,2639,MOT
6,9,90,422,1.129095305,431,9,is,"('MOT', 'CHI')",Providence,nai34.xml,527,96,6,CHI,7047,2639,MOT
0,2,54,471,1.039350825,473,2,oh,"('MOT', 'CHI')",Providence,nai34.xml,527,54,0,CHI,7047,2639,MOT
3,22,27,475,0.997670338,497,22,he,"('MOT', 'CHI')",Providence,nai34.xml,527,30,3,CHI,7047,2639,MOT
5,16,59,447,0.910928789,463,16,in,"('MOT', 'CHI')",Providence,nai34.xml,527,64,5,CHI,7047,2639,MOT
5,12,87,423,0.763448525,435,12,a,"('MOT', 'CHI')",Providence,nai34.xml,527,92,5,CHI,7047,2639,MOT
26,33,138,330,0.557385907,363,33,the,"('MOT', 'CHI')",Providence,nai34.xml,527,164,26,CHI,7047,2639,MOT
1,23,22,481,0.522754195,504,23,where,"('MOT', 'CHI')",Providence,nai34.xml,527,23,1,CHI,7047,2639,MOT
2,47,23,455,0.15415068,502,47,yeah,"('MOT', 'CHI')",Providence,nai34.xml,527,25,2,CHI,7047,2639,MOT
0,19,22,486,0.0547249,505,19,did,"('MOT', 'CHI')",Providence,nai34.xml,527,22,0,CHI,7047,2639,MOT
0,27,17,483,-0.038318864,510,27,go,"('MOT', 'CHI')",Providence,nai34.xml,527,17,0,CHI,7047,2639,MOT
5,29,90,403,-0.111104357,432,29,that,"('MOT', 'CHI')",Providence,nai34.xml,527,95,5,CHI,7047,2639,MOT
3,51,42,431,-0.233012052,482,51,there,"('MOT', 'CHI')",Providence,nai34.xml,527,45,3,CHI,7047,2639,MOT
0,20,55,452,-0.926366384,472,20,it,"('MOT', 'CHI')",Providence,nai34.xml,527,55,0,CHI,7047,2639,MOT
1,0,2,181,4.293195421,181,0,where,"('FAT', 'CHI')",Providence,nai35.xml,184,3,1,CHI,2004,1521,FAT
1,0,5,142,3.583518938,142,0,but,"('MOT', 'CHI')",Providence,nai35.xml,148,6,1,CHI,2167,726,MOT
4,1,8,171,3.436288701,172,1,he,"('FAT', 'CHI')",Providence,nai35.xml,184,12,4,CHI,2004,1521,FAT
0,1,1,182,3.428596356,183,1,all,"('FAT', 'CHI')",Providence,nai35.xml,184,1,0,CHI,2004,1521,FAT
1,3,1,179,3.135494216,182,3,this,"('FAT', 'CHI')",Providence,nai35.xml,184,2,1,CHI,2004,1521,FAT
3,2,6,173,3.065936532,175,2,put,"('FAT', 'CHI')",Providence,nai35.xml,184,9,3,CHI,2004,1521,FAT
0,1,2,145,2.917770732,146,1,big,"('MOT', 'CHI')",Providence,nai35.xml,148,2,0,CHI,2167,726,MOT
0,1,3,180,2.90690106,181,1,for,"('FAT', 'CHI')",Providence,nai35.xml,184,3,0,CHI,2004,1521,FAT
0,1,3,180,2.90690106,181,1,some,"('FAT', 'CHI')",Providence,nai35.xml,184,3,0,CHI,2004,1521,FAT
0,1,3,180,2.90690106,181,1,one,"('FAT', 'CHI')",Providence,nai35.xml,184,3,0,CHI,2004,1521,FAT
1,2,4,177,2.847121774,179,2,wanna,"('FAT', 'CHI')",Providence,nai35.xml,184,5,1,CHI,2004,1521,FAT
0,2,2,180,2.730029108,182,2,was,"('FAT', 'CHI')",Providence,nai35.xml,184,2,0,CHI,2004,1521,FAT
0,2,2,180,2.730029108,182,2,look,"('FAT', 'CHI')",Providence,nai35.xml,184,2,0,CHI,2004,1521,FAT
0,1,4,179,2.719100037,180,1,we,"('FAT', 'CHI')",Providence,nai35.xml,184,4,0,CHI,2004,1521,FAT
1,1,0,38,2.614959778,39,1,of,"('CHI', 'MOT')",Providence,nai35.xml,40,1,1,MOT,184,491,CHI
1,1,0,38,2.614959778,39,1,see,"('CHI', 'MOT')",Providence,nai35.xml,40,1,1,MOT,184,491,CHI
1,1,0,38,2.614959778,39,1,wanna,"('CHI', 'MOT')",Providence,nai35.xml,40,1,1,MOT,184,491,CHI
0,3,1,144,2.519039656,147,3,no,"('MOT', 'CHI')",Providence,nai35.xml,148,1,0,CHI,2167,726,MOT
0,1,4,143,2.498699972,144,1,think,"('MOT', 'CHI')",Providence,nai35.xml,148,4,0,CHI,2167,726,MOT
0,3,2,179,2.442347035,182,3,get,"('FAT', 'CHI')",Providence,nai35.xml,184,2,0,CHI,2004,1521,FAT
6,5,11,162,2.339610416,167,5,she,"('FAT', 'CHI')",Providence,nai35.xml,184,17,6,CHI,2004,1521,FAT
0,1,5,142,2.337676413,143,1,where,"('MOT', 'CHI')",Providence,nai35.xml,148,5,0,CHI,2167,726,MOT
1,1,1,37,2.302585093,38,1,there,"('CHI', 'MOT')",Providence,nai35.xml,40,2,1,MOT,184,491,CHI
1,1,11,135,2.288196356,136,1,oh,"('MOT', 'CHI')",Providence,nai35.xml,148,12,1,CHI,2167,726,MOT
0,3,2,143,2.224623552,146,3,did,"('MOT', 'CHI')",Providence,nai35.xml,148,2,0,CHI,2167,726,MOT
0,1,6,141,2.197224577,142,1,some,"('MOT', 'CHI')",Providence,nai35.xml,148,6,0,CHI,2167,726,MOT
0,1,6,141,2.197224577,142,1,at,"('MOT', 'CHI')",Providence,nai35.xml,148,6,0,CHI,2167,726,MOT
0,2,5,177,2.153974594,179,2,with,"('FAT', 'CHI')",Providence,nai35.xml,184,5,0,CHI,2004,1521,FAT
1,0,26,121,2.138035706,121,0,you,"('MOT', 'CHI')",Providence,nai35.xml,148,27,1,CHI,2167,726,MOT
0,1,9,174,2.085107279,175,1,not,"('FAT', 'CHI')",Providence,nai35.xml,184,9,0,CHI,2004,1521,FAT
0,2,6,176,2.014903021,178,2,see,"('FAT', 'CHI')",Providence,nai35.xml,184,6,0,CHI,2004,1521,FAT
0,2,6,176,2.014903021,178,2,no,"('FAT', 'CHI')",Providence,nai35.xml,184,6,0,CHI,2004,1521,FAT
1,2,10,135,1.964059468,137,2,with,"('MOT', 'CHI')",Providence,nai35.xml,148,11,1,CHI,2167,726,MOT
1,2,10,135,1.964059468,137,2,are,"('MOT', 'CHI')",Providence,nai35.xml,148,11,1,CHI,2167,726,MOT
0,1,1,38,1.921812597,39,1,want,"('CHI', 'MOT')",Providence,nai35.xml,40,1,0,MOT,184,491,CHI
1,3,0,36,1.921812597,39,3,they,"('CHI', 'MOT')",Providence,nai35.xml,40,1,1,MOT,184,491,CHI
0,1,1,38,1.921812597,39,1,did,"('CHI', 'MOT')",Providence,nai35.xml,40,1,0,MOT,184,491,CHI
1,3,0,36,1.921812597,39,3,no,"('CHI', 'MOT')",Providence,nai35.xml,40,1,1,MOT,184,491,CHI
1,2,1,36,1.897119985,38,2,we,"('CHI', 'MOT')",Providence,nai35.xml,40,2,1,MOT,184,491,CHI
1,2,1,36,1.897119985,38,2,put,"('CHI', 'MOT')",Providence,nai35.xml,40,2,1,MOT,184,491,CHI
1,5,6,172,1.89154894,177,5,go,"('FAT', 'CHI')",Providence,nai35.xml,184,7,1,CHI,2004,1521,FAT
1,1,17,129,1.887069649,130,1,in,"('MOT', 'CHI')",Providence,nai35.xml,148,18,1,CHI,2167,726,MOT
1,3,11,169,1.826850789,172,3,do,"('FAT', 'CHI')",Providence,nai35.xml,184,12,1,CHI,2004,1521,FAT
0,4,4,176,1.802809305,180,4,have,"('FAT', 'CHI')",Providence,nai35.xml,184,4,0,CHI,2004,1521,FAT
1,2,18,163,1.668006267,165,2,gonna,"('FAT', 'CHI')",Providence,nai35.xml,184,19,1,CHI,2004,1521,FAT
6,9,16,153,1.565137654,162,9,are,"('FAT', 'CHI')",Providence,nai35.xml,184,22,6,CHI,2004,1521,FAT
0,1,13,134,1.518783544,135,1,this,"('MOT', 'CHI')",Providence,nai35.xml,148,13,0,CHI,2167,726,MOT
0,2,11,171,1.501224328,173,2,think,"('FAT', 'CHI')",Providence,nai35.xml,184,11,0,CHI,2004,1521,FAT
3,8,12,161,1.497519996,169,8,on,"('FAT', 'CHI')",Providence,nai35.xml,184,15,3,CHI,2004,1521,FAT
0,5,5,174,1.460827413,179,5,up,"('FAT', 'CHI')",Providence,nai35.xml,184,5,0,CHI,2004,1521,FAT
0,2,9,137,1.452252329,139,2,do,"('MOT', 'CHI')",Providence,nai35.xml,148,9,0,CHI,2167,726,MOT
3,5,1,31,1.440361582,36,5,in,"('CHI', 'MOT')",Providence,nai35.xml,40,4,3,MOT,184,491,CHI
0,5,4,139,1.400087683,144,5,go,"('MOT', 'CHI')",Providence,nai35.xml,148,4,0,CHI,2167,726,MOT
4,10,13,157,1.397002375,167,10,they,"('FAT', 'CHI')",Providence,nai35.xml,184,17,4,CHI,2004,1521,FAT
1,4,14,165,1.392159481,169,4,that,"('FAT', 'CHI')",Providence,nai35.xml,184,15,1,CHI,2004,1521,FAT
1,8,7,168,1.375121061,176,8,want,"('FAT', 'CHI')",Providence,nai35.xml,184,8,1,CHI,2004,1521,FAT
0,3,8,137,1.266947603,140,3,for,"('MOT', 'CHI')",Providence,nai35.xml,148,8,0,CHI,2167,726,MOT
0,6,4,138,1.245937003,144,6,one,"('MOT', 'CHI')",Providence,nai35.xml,148,4,0,CHI,2167,726,MOT
1,7,0,32,1.228665417,39,7,and,"('CHI', 'MOT')",Providence,nai35.xml,40,1,1,MOT,184,491,CHI
0,2,2,36,1.203972804,38,2,go,"('CHI', 'MOT')",Providence,nai35.xml,40,2,0,MOT,184,491,CHI
0,2,2,36,1.203972804,38,2,a,"('CHI', 'MOT')",Providence,nai35.xml,40,2,0,MOT,184,491,CHI
0,4,9,171,1.168816547,175,4,what,"('FAT', 'CHI')",Providence,nai35.xml,184,9,0,CHI,2004,1521,FAT
0,4,7,137,1.15618214,141,4,they,"('MOT', 'CHI')",Providence,nai35.xml,148,7,0,CHI,2167,726,MOT
10,10,35,129,1.098612289,139,10,there,"('FAT', 'CHI')",Providence,nai35.xml,184,45,10,CHI,2004,1521,FAT
0,5,9,170,0.986494991,175,5,of,"('FAT', 'CHI')",Providence,nai35.xml,184,9,0,CHI,2004,1521,FAT
4,7,31,142,0.936358295,149,7,a,"('FAT', 'CHI')",Providence,nai35.xml,184,35,4,CHI,2004,1521,FAT
1,6,16,161,0.932696767,167,6,it,"('FAT', 'CHI')",Providence,nai35.xml,184,17,1,CHI,2004,1521,FAT
1,7,1,31,0.916290732,38,7,to,"('CHI', 'MOT')",Providence,nai35.xml,40,2,1,MOT,184,491,CHI
0,5,10,169,0.893817876,174,5,can,"('FAT', 'CHI')",Providence,nai35.xml,184,10,0,CHI,2004,1521,FAT
0,9,4,135,0.889262059,144,9,want,"('MOT', 'CHI')",Providence,nai35.xml,148,4,0,CHI,2167,726,MOT
4,16,11,117,0.848286003,133,16,what,"('MOT', 'CHI')",Providence,nai35.xml,148,15,4,CHI,2167,726,MOT
4,9,2,25,0.810930216,34,9,the,"('CHI', 'MOT')",Providence,nai35.xml,40,6,4,MOT,184,491,CHI
3,5,31,109,0.764606145,114,5,he,"('MOT', 'CHI')",Providence,nai35.xml,148,34,3,CHI,2167,726,MOT
0,5,9,134,0.759105148,139,5,there,"('MOT', 'CHI')",Providence,nai35.xml,148,9,0,CHI,2167,726,MOT
2,11,16,155,0.741937345,166,11,to,"('FAT', 'CHI')",Providence,nai35.xml,184,18,2,CHI,2004,1521,FAT
7,18,23,136,0.719122667,154,18,in,"('FAT', 'CHI')",Providence,nai35.xml,184,30,7,CHI,2004,1521,FAT
0,3,3,34,0.667829373,37,3,yeah,"('CHI', 'MOT')",Providence,nai35.xml,40,3,0,MOT,184,491,CHI
1,11,12,160,0.653481924,171,11,and,"('FAT', 'CHI')",Providence,nai35.xml,184,13,1,CHI,2004,1521,FAT
2,3,40,103,0.610259521,106,3,and,"('MOT', 'CHI')",Providence,nai35.xml,148,42,2,CHI,2167,726,MOT
2,8,3,27,0.566395475,35,8,he,"('CHI', 'MOT')",Providence,nai35.xml,40,5,2,MOT,184,491,CHI
3,13,23,145,0.490206337,158,13,is,"('FAT', 'CHI')",Providence,nai35.xml,184,26,3,CHI,2004,1521,FAT
2,7,25,114,0.464059272,121,7,it,"('MOT', 'CHI')",Providence,nai35.xml,148,27,2,CHI,2167,726,MOT
18,32,31,103,0.436086711,135,32,the,"('FAT', 'CHI')",Providence,nai35.xml,184,49,18,CHI,2004,1521,FAT
1,13,13,157,0.428995606,170,13,yeah,"('FAT', 'CHI')",Providence,nai35.xml,184,14,1,CHI,2004,1521,FAT
0,6,2,32,0.356674944,38,6,do,"('CHI', 'MOT')",Providence,nai35.xml,40,2,0,MOT,184,491,CHI
0,3,22,123,0.287682072,126,3,a,"('MOT', 'CHI')",Providence,nai35.xml,148,22,0,CHI,2167,726,MOT
2,11,22,113,0.191891008,124,11,that,"('MOT', 'CHI')",Providence,nai35.xml,148,24,2,CHI,2167,726,MOT
3,46,5,94,0.189388724,140,46,yeah,"('MOT', 'CHI')",Providence,nai35.xml,148,8,3,CHI,2167,726,MOT
2,10,24,112,0.188794071,122,10,to,"('MOT', 'CHI')",Providence,nai35.xml,148,26,2,CHI,2167,726,MOT
1,7,30,110,-0.103678429,117,7,is,"('MOT', 'CHI')",Providence,nai35.xml,148,31,1,CHI,2167,726,MOT
0,3,40,141,-0.140357358,144,3,you,"('FAT', 'CHI')",Providence,nai35.xml,184,40,0,CHI,2004,1521,FAT
0,1,1,2,-0.182321557,3,1,did,"('MOT', 'FAT')",Providence,nai35.xml,4,1,0,FAT,88,14,MOT
5,12,60,71,-0.535231251,83,12,the,"('MOT', 'CHI')",Providence,nai35.xml,148,65,5,CHI,2167,726,MOT
0,2,1,1,-0.587786665,3,2,oh,"('MOT', 'FAT')",Providence,nai35.xml,4,1,0,FAT,88,14,MOT
0,1,2,1,-0.693147181,2,1,you,"('MOT', 'FAT')",Providence,nai35.xml,4,2,0,FAT,88,14,MOT
2,1,9,465,3.988984047,466,1,they,"('MOT', 'CHI')",Providence,nai36.xml,477,11,2,CHI,6011,2289,MOT
2,4,3,468,3.704471549,472,4,where,"('MOT', 'CHI')",Providence,nai36.xml,477,5,2,CHI,6011,2289,MOT
2,1,16,458,3.543130878,459,1,she,"('MOT', 'CHI')",Providence,nai36.xml,477,18,2,CHI,6011,2289,MOT
2,2,19,454,2.991374968,456,2,was,"('MOT', 'CHI')",Providence,nai36.xml,477,21,2,CHI,6011,2289,MOT
0,1,10,466,2.972548938,467,1,but,"('MOT', 'CHI')",Providence,nai36.xml,477,10,0,CHI,6011,2289,MOT
2,4,13,458,2.795845584,462,4,big,"('MOT', 'CHI')",Providence,nai36.xml,477,15,2,CHI,6011,2289,MOT
0,1,13,463,2.742988252,464,1,look,"('MOT', 'CHI')",Providence,nai36.xml,477,13,0,CHI,6011,2289,MOT
9,15,9,444,2.66766214,459,15,no,"('MOT', 'CHI')",Providence,nai36.xml,477,18,9,CHI,6011,2289,MOT
2,3,20,452,2.658947488,455,3,little,"('MOT', 'CHI')",Providence,nai36.xml,477,22,2,CHI,6011,2289,MOT
2,4,18,453,2.527182133,457,4,my,"('MOT', 'CHI')",Providence,nai36.xml,477,20,2,CHI,6011,2289,MOT
2,3,29,443,2.320603598,446,3,are,"('MOT', 'CHI')",Providence,nai36.xml,477,31,2,CHI,6011,2289,MOT
0,1,21,455,2.298227788,456,1,have,"('MOT', 'CHI')",Providence,nai36.xml,477,21,0,CHI,6011,2289,MOT
0,2,18,457,2.039053481,459,2,gonna,"('MOT', 'CHI')",Providence,nai36.xml,477,18,0,CHI,6011,2289,MOT
0,3,14,460,1.983154322,463,3,get,"('MOT', 'CHI')",Providence,nai36.xml,477,14,0,CHI,6011,2289,MOT
0,1,32,444,1.883050889,445,1,of,"('MOT', 'CHI')",Providence,nai36.xml,477,32,0,CHI,6011,2289,MOT
0,1,32,444,1.883050889,445,1,this,"('MOT', 'CHI')",Providence,nai36.xml,477,32,0,CHI,6011,2289,MOT
0,2,24,451,1.763588592,453,2,at,"('MOT', 'CHI')",Providence,nai36.xml,477,24,0,CHI,6011,2289,MOT
9,16,34,418,1.740351503,434,16,it,"('MOT', 'CHI')",Providence,nai36.xml,477,43,9,CHI,6011,2289,MOT
0,1,39,437,1.68005548,438,1,do,"('MOT', 'CHI')",Providence,nai36.xml,477,39,0,CHI,6011,2289,MOT
3,8,32,434,1.673976434,442,8,like,"('MOT', 'CHI')",Providence,nai36.xml,477,35,3,CHI,6011,2289,MOT
0,9,7,461,1.657169315,470,9,go,"('MOT', 'CHI')",Providence,nai36.xml,477,7,0,CHI,6011,2289,MOT
0,3,20,454,1.651713396,457,3,see,"('MOT', 'CHI')",Providence,nai36.xml,477,20,0,CHI,6011,2289,MOT
0,4,17,456,1.581687999,460,4,did,"('MOT', 'CHI')",Providence,nai36.xml,477,17,0,CHI,6011,2289,MOT
0,5,15,457,1.514911739,462,5,put,"('MOT', 'CHI')",Providence,nai36.xml,477,15,0,CHI,6011,2289,MOT
0,2,33,442,1.446358602,444,2,we,"('MOT', 'CHI')",Providence,nai36.xml,477,33,0,CHI,6011,2289,MOT
2,9,28,438,1.437314181,447,9,one,"('MOT', 'CHI')",Providence,nai36.xml,477,30,2,CHI,6011,2289,MOT
0,4,21,452,1.381937056,456,4,make,"('MOT', 'CHI')",Providence,nai36.xml,477,21,0,CHI,6011,2289,MOT
2,8,35,432,1.329135947,440,8,for,"('MOT', 'CHI')",Providence,nai36.xml,477,37,2,CHI,6011,2289,MOT
2,8,36,431,1.301553133,439,8,there,"('MOT', 'CHI')",Providence,nai36.xml,477,38,2,CHI,6011,2289,MOT
0,1,56,420,1.293781988,421,1,oh,"('MOT', 'CHI')",Providence,nai36.xml,477,56,0,CHI,6011,2289,MOT
0,4,24,449,1.252762968,453,4,with,"('MOT', 'CHI')",Providence,nai36.xml,477,24,0,CHI,6011,2289,MOT
12,12,93,360,1.251426963,372,12,a,"('MOT', 'CHI')",Providence,nai36.xml,477,105,12,CHI,6011,2289,MOT
19,41,38,379,1.225530525,420,41,what,"('MOT', 'CHI')",Providence,nai36.xml,477,57,19,CHI,6011,2289,MOT
2,7,48,420,1.129383947,427,7,in,"('MOT', 'CHI')",Providence,nai36.xml,477,50,2,CHI,6011,2289,MOT
0,5,24,448,1.070441412,453,5,want,"('MOT', 'CHI')",Providence,nai36.xml,477,24,0,CHI,6011,2289,MOT
4,14,52,407,0.88831688,421,14,to,"('MOT', 'CHI')",Providence,nai36.xml,477,56,4,CHI,6011,2289,MOT
7,20,61,389,0.805017076,409,20,is,"('MOT', 'CHI')",Providence,nai36.xml,477,68,7,CHI,6011,2289,MOT
9,16,90,362,0.794422485,378,16,that,"('MOT', 'CHI')",Providence,nai36.xml,477,99,9,CHI,6011,2289,MOT
0,9,23,445,0.601031892,454,9,on,"('MOT', 'CHI')",Providence,nai36.xml,477,23,0,CHI,6011,2289,MOT
0,6,37,434,0.481838087,440,6,he,"('MOT', 'CHI')",Providence,nai36.xml,477,37,0,CHI,6011,2289,MOT
1,49,12,415,0.217259608,464,49,yeah,"('MOT', 'CHI')",Providence,nai36.xml,477,13,1,CHI,6011,2289,MOT
11,36,102,328,0.031689942,364,36,the,"('MOT', 'CHI')",Providence,nai36.xml,477,113,11,CHI,6011,2289,MOT
1,11,64,401,0.029413885,412,11,and,"('MOT', 'CHI')",Providence,nai36.xml,477,65,1,CHI,6011,2289,MOT
0,11,127,339,-1.481087879,350,11,you,"('MOT', 'CHI')",Providence,nai36.xml,477,127,0,CHI,6011,2289,MOT
1,1,8,374,3.534349915,375,1,my,"('MOT', 'CHI')",Providence,nai37.xml,384,9,1,CHI,5250,2316,MOT
1,2,5,376,3.455264603,378,2,big,"('MOT', 'CHI')",Providence,nai37.xml,384,6,1,CHI,5250,2316,MOT
2,1,16,365,3.317815773,366,1,up,"('MOT', 'CHI')",Providence,nai37.xml,384,18,2,CHI,5250,2316,MOT
0,2,4,378,3.055048851,380,2,make,"('MOT', 'CHI')",Providence,nai37.xml,384,4,0,CHI,5250,2316,MOT
0,1,7,376,3.047164447,377,1,was,"('MOT', 'CHI')",Providence,nai37.xml,384,7,0,CHI,5250,2316,MOT
3,3,17,361,2.81159088,364,3,for,"('MOT', 'CHI')",Providence,nai37.xml,384,20,3,CHI,5250,2316,MOT
0,1,10,373,2.751535313,374,1,they,"('MOT', 'CHI')",Providence,nai37.xml,384,10,0,CHI,5250,2316,MOT
1,9,2,372,2.729159164,381,9,no,"('MOT', 'CHI')",Providence,nai37.xml,384,3,1,CHI,5250,2316,MOT
1,2,14,367,2.67752361,369,2,at,"('MOT', 'CHI')",Providence,nai37.xml,384,15,1,CHI,5250,2316,MOT
2,3,18,361,2.523908808,364,3,get,"('MOT', 'CHI')",Providence,nai37.xml,384,20,2,CHI,5250,2316,MOT
0,1,14,369,2.453157951,370,1,look,"('MOT', 'CHI')",Providence,nai37.xml,384,14,0,CHI,5250,2316,MOT
0,2,9,373,2.435737626,375,2,but,"('MOT', 'CHI')",Providence,nai37.xml,384,9,0,CHI,5250,2316,MOT
0,3,7,374,2.354017267,377,3,where,"('MOT', 'CHI')",Providence,nai37.xml,384,7,0,CHI,5250,2316,MOT
0,1,18,365,2.219203484,366,1,did,"('MOT', 'CHI')",Providence,nai37.xml,384,18,0,CHI,5250,2316,MOT
0,4,7,373,2.130873715,377,4,put,"('MOT', 'CHI')",Providence,nai37.xml,384,7,0,CHI,5250,2316,MOT
1,3,19,361,2.118443699,364,3,we,"('MOT', 'CHI')",Providence,nai37.xml,384,20,1,CHI,5250,2316,MOT
5,2,77,300,1.979358083,302,2,you,"('MOT', 'CHI')",Providence,nai37.xml,384,82,5,CHI,5250,2316,MOT
0,1,24,359,1.940400493,360,1,with,"('MOT', 'CHI')",Providence,nai37.xml,384,24,0,CHI,5250,2316,MOT
0,6,6,372,1.914819562,378,6,he,"('MOT', 'CHI')",Providence,nai37.xml,384,6,0,CHI,5250,2316,MOT
3,11,15,355,1.813738376,366,11,little,"('MOT', 'CHI')",Providence,nai37.xml,384,18,3,CHI,5250,2316,MOT
0,2,19,363,1.762227122,365,2,like,"('MOT', 'CHI')",Providence,nai37.xml,384,19,0,CHI,5250,2316,MOT
2,11,14,357,1.636836887,368,11,go,"('MOT', 'CHI')",Providence,nai37.xml,384,16,2,CHI,5250,2316,MOT
0,2,23,359,1.576914721,361,2,are,"('MOT', 'CHI')",Providence,nai37.xml,384,23,0,CHI,5250,2316,MOT
1,5,22,356,1.576914721,361,5,gonna,"('MOT', 'CHI')",Providence,nai37.xml,384,23,1,CHI,5250,2316,MOT
0,5,11,368,1.570217199,373,5,one,"('MOT', 'CHI')",Providence,nai37.xml,384,11,0,CHI,5250,2316,MOT
1,7,18,358,1.474545049,365,7,see,"('MOT', 'CHI')",Providence,nai37.xml,384,19,1,CHI,5250,2316,MOT
0,3,20,361,1.425296519,364,3,can,"('MOT', 'CHI')",Providence,nai37.xml,384,20,0,CHI,5250,2316,MOT
6,11,41,326,1.395183309,337,11,she,"('MOT', 'CHI')",Providence,nai37.xml,384,47,6,CHI,5250,2316,MOT
1,7,21,355,1.332805676,362,7,want,"('MOT', 'CHI')",Providence,nai37.xml,384,22,1,CHI,5250,2316,MOT
3,10,39,332,1.044851112,342,10,on,"('MOT', 'CHI')",Providence,nai37.xml,384,42,3,CHI,5250,2316,MOT
4,10,51,319,0.970609747,329,10,in,"('MOT', 'CHI')",Providence,nai37.xml,384,55,4,CHI,5250,2316,MOT
6,11,66,301,0.906331392,312,11,and,"('MOT', 'CHI')",Providence,nai37.xml,384,72,6,CHI,5250,2316,MOT
0,10,12,362,0.887303195,372,10,do,"('MOT', 'CHI')",Providence,nai37.xml,384,12,0,CHI,5250,2316,MOT
2,10,36,336,0.864040042,346,10,it,"('MOT', 'CHI')",Providence,nai37.xml,384,38,2,CHI,5250,2316,MOT
3,20,26,335,0.785520501,355,20,think,"('MOT', 'CHI')",Providence,nai37.xml,384,29,3,CHI,5250,2316,MOT
0,6,23,355,0.72961686,361,6,have,"('MOT', 'CHI')",Providence,nai37.xml,384,23,0,CHI,5250,2316,MOT
9,22,57,296,0.715904168,318,22,to,"('MOT', 'CHI')",Providence,nai37.xml,384,66,9,CHI,5250,2316,MOT
0,5,29,350,0.651989108,355,5,of,"('MOT', 'CHI')",Providence,nai37.xml,384,29,0,CHI,5250,2316,MOT
4,24,32,324,0.610909082,348,24,there,"('MOT', 'CHI')",Providence,nai37.xml,384,36,4,CHI,5250,2316,MOT
0,6,27,351,0.570116409,357,6,this,"('MOT', 'CHI')",Providence,nai37.xml,384,27,0,CHI,5250,2316,MOT
1,6,55,322,0.485886675,328,6,oh,"('MOT', 'CHI')",Providence,nai37.xml,384,56,1,CHI,5250,2316,MOT
6,28,63,287,0.074836216,315,28,that,"('MOT', 'CHI')",Providence,nai37.xml,384,69,6,CHI,5250,2316,MOT
36,53,113,182,0.07271417,235,53,the,"('MOT', 'CHI')",Providence,nai37.xml,384,149,36,CHI,5250,2316,MOT
12,33,88,251,0.06960783,284,33,a,"('MOT', 'CHI')",Providence,nai37.xml,384,100,12,CHI,5250,2316,MOT
3,41,28,312,0.024234971,353,41,yeah,"('MOT', 'CHI')",Providence,nai37.xml,384,31,3,CHI,5250,2316,MOT
3,15,74,292,-0.022400937,307,15,is,"('MOT', 'CHI')",Providence,nai37.xml,384,77,3,CHI,5250,2316,MOT
1,14,48,321,-0.126645723,335,14,what,"('MOT', 'CHI')",Providence,nai37.xml,384,49,1,CHI,5250,2316,MOT
0,1,1,100,2.842969519,101,1,where,"('MOT', 'CHI')",Providence,nai38.xml,102,1,0,CHI,1940,564,MOT
1,2,2,97,2.600217496,99,2,make,"('MOT', 'CHI')",Providence,nai38.xml,102,3,1,CHI,1940,564,MOT
0,1,3,98,2.312535424,99,1,was,"('MOT', 'CHI')",Providence,nai38.xml,102,3,0,CHI,1940,564,MOT
0,1,3,98,2.312535424,99,1,did,"('MOT', 'CHI')",Providence,nai38.xml,102,3,0,CHI,1940,564,MOT
0,1,3,98,2.312535424,99,1,up,"('MOT', 'CHI')",Providence,nai38.xml,102,3,0,CHI,1940,564,MOT
1,2,4,95,2.243744593,97,2,there,"('MOT', 'CHI')",Providence,nai38.xml,102,5,1,CHI,1940,564,MOT
0,1,4,97,2.120263536,98,1,he,"('MOT', 'CHI')",Providence,nai38.xml,102,4,0,CHI,1940,564,MOT
0,1,4,97,2.120263536,98,1,big,"('MOT', 'CHI')",Providence,nai38.xml,102,4,0,CHI,1940,564,MOT
0,1,5,96,1.956062521,97,1,want,"('MOT', 'CHI')",Providence,nai38.xml,102,5,0,CHI,1940,564,MOT
3,2,12,85,1.943105098,87,2,and,"('MOT', 'CHI')",Providence,nai38.xml,102,15,3,CHI,1940,564,MOT
1,1,12,88,1.802809305,89,1,on,"('MOT', 'CHI')",Providence,nai38.xml,102,13,1,CHI,1940,564,MOT
0,1,8,93,1.568615918,94,1,gonna,"('MOT', 'CHI')",Providence,nai38.xml,102,8,0,CHI,1940,564,MOT
1,2,10,89,1.562185028,91,2,is,"('MOT', 'CHI')",Providence,nai38.xml,102,11,1,CHI,1940,564,MOT
2,3,11,86,1.515127233,89,3,it,"('MOT', 'CHI')",Providence,nai38.xml,102,13,2,CHI,1940,564,MOT
0,1,9,92,1.462834438,93,1,go,"('MOT', 'CHI')",Providence,nai38.xml,102,9,0,CHI,1940,564,MOT
0,2,6,94,1.406913648,96,2,little,"('MOT', 'CHI')",Providence,nai38.xml,102,6,0,CHI,1940,564,MOT
1,2,12,87,1.397344197,89,2,she,"('MOT', 'CHI')",Providence,nai38.xml,102,13,1,CHI,1940,564,MOT
0,1,10,91,1.365240952,92,1,do,"('MOT', 'CHI')",Providence,nai38.xml,102,10,0,CHI,1940,564,MOT
1,4,8,89,1.239690887,93,4,put,"('MOT', 'CHI')",Providence,nai38.xml,102,9,1,CHI,1940,564,MOT
0,4,4,94,1.203972804,98,4,no,"('MOT', 'CHI')",Providence,nai38.xml,102,4,0,CHI,1940,564,MOT
0,2,8,92,1.16315081,94,2,with,"('MOT', 'CHI')",Providence,nai38.xml,102,8,0,CHI,1940,564,MOT
0,3,6,93,1.119231576,96,3,one,"('MOT', 'CHI')",Providence,nai38.xml,102,6,0,CHI,1940,564,MOT
4,5,19,74,0.993251773,79,5,a,"('MOT', 'CHI')",Providence,nai38.xml,102,23,4,CHI,1940,564,MOT
1,3,16,82,0.828321959,85,3,to,"('MOT', 'CHI')",Providence,nai38.xml,102,17,1,CHI,1940,564,MOT
0,3,13,86,0.416514944,89,3,for,"('MOT', 'CHI')",Providence,nai38.xml,102,13,0,CHI,1940,564,MOT
0,2,18,82,0.360002734,84,2,yeah,"('MOT', 'CHI')",Providence,nai38.xml,102,18,0,CHI,1940,564,MOT
0,1,1,5,0.287682072,6,1,oh,"('MOT', 'FAT')",Providence,nai38.xml,7,1,0,FAT,93,40,MOT
0,1,1,5,0.287682072,6,1,a,"('MOT', 'FAT')",Providence,nai38.xml,7,1,0,FAT,93,40,MOT
0,1,1,5,0.287682072,6,1,no,"('MOT', 'FAT')",Providence,nai38.xml,7,1,0,FAT,93,40,MOT
0,1,1,5,0.287682072,6,1,some,"('MOT', 'FAT')",Providence,nai38.xml,7,1,0,FAT,93,40,MOT
0,2,21,79,0.184734103,81,2,that,"('MOT', 'CHI')",Providence,nai38.xml,102,21,0,CHI,1940,564,MOT
5,10,29,58,0.0588405,68,10,the,"('MOT', 'CHI')",Providence,nai38.xml,102,34,5,CHI,1940,564,MOT
0,8,13,81,-0.394415272,89,8,in,"('MOT', 'CHI')",Providence,nai38.xml,102,13,0,CHI,1940,564,MOT
1,0,17,252,3.234749174,252,0,of,"('MOT', 'CHI')",Providence,nai39.xml,270,18,1,CHI,4416,1278,MOT
2,1,12,255,3.185835971,256,1,go,"('MOT', 'CHI')",Providence,nai39.xml,270,14,2,CHI,4416,1278,MOT
2,0,1,34,3.072693315,34,0,of,"('MOT', 'FAT')",Providence,nai39.xml,37,3,2,FAT,397,224,MOT
2,1,14,253,3.060270795,254,1,was,"('MOT', 'CHI')",Providence,nai39.xml,270,16,2,CHI,4416,1278,MOT
1,0,0,23,2.813410717,23,0,make,"('CHI', 'MOT')",Providence,nai39.xml,24,1,1,MOT,128,256,CHI
0,1,6,263,2.810907587,264,1,look,"('MOT', 'CHI')",Providence,nai39.xml,270,6,0,CHI,4416,1278,MOT
0,1,6,263,2.810907587,264,1,some,"('MOT', 'CHI')",Providence,nai39.xml,270,6,0,CHI,4416,1278,MOT
0,2,4,264,2.700615223,266,2,want,"('MOT', 'CHI')",Providence,nai39.xml,270,4,0,CHI,4416,1278,MOT
1,0,2,34,2.667228207,34,0,get,"('MOT', 'FAT')",Providence,nai39.xml,37,3,1,FAT,397,224,MOT
1,2,10,257,2.594105942,259,2,they,"('MOT', 'CHI')",Providence,nai39.xml,270,11,1,CHI,4416,1278,MOT
1,0,33,236,2.581898916,236,0,oh,"('MOT', 'CHI')",Providence,nai39.xml,270,34,1,CHI,4416,1278,MOT
0,1,8,261,2.58021683,262,1,all,"('MOT', 'CHI')",Providence,nai39.xml,270,8,0,CHI,4416,1278,MOT
0,2,5,263,2.542726221,265,2,my,"('MOT', 'CHI')",Providence,nai39.xml,270,5,0,CHI,4416,1278,MOT
1,1,0,35,2.538973871,36,1,up,"('MOT', 'FAT')",Providence,nai39.xml,37,1,1,FAT,397,224,MOT
0,2,7,261,2.28389296,263,2,at,"('MOT', 'CHI')",Providence,nai39.xml,270,7,0,CHI,4416,1278,MOT
1,0,4,32,2.273597556,32,0,oh,"('MOT', 'FAT')",Providence,nai39.xml,37,5,1,FAT,397,224,MOT
1,0,0,12,2.233592222,12,0,do,"('FAT', 'MOT')",Providence,nai39.xml,13,1,1,MOT,40,113,FAT
5,1,60,204,2.226638463,205,1,to,"('MOT', 'CHI')",Providence,nai39.xml,270,65,5,CHI,4416,1278,MOT
2,2,23,243,2.213551471,245,2,on,"('MOT', 'CHI')",Providence,nai39.xml,270,25,2,CHI,4416,1278,MOT
1,1,0,22,2.120263536,23,1,have,"('CHI', 'MOT')",Providence,nai39.xml,24,1,1,MOT,128,256,CHI
1,1,0,22,2.120263536,23,1,of,"('CHI', 'MOT')",Providence,nai39.xml,24,1,1,MOT,128,256,CHI
1,1,27,241,2.095970844,242,1,we,"('MOT', 'CHI')",Providence,nai39.xml,270,28,1,CHI,4416,1278,MOT
1,2,18,249,2.083401943,251,2,gonna,"('MOT', 'CHI')",Providence,nai39.xml,270,19,1,CHI,4416,1278,MOT
3,5,17,245,2.032921526,250,5,did,"('MOT', 'CHI')",Providence,nai39.xml,270,20,3,CHI,4416,1278,MOT
0,4,5,261,2.031900597,265,4,where,"('MOT', 'CHI')",Providence,nai39.xml,270,5,0,CHI,4416,1278,MOT
2,2,28,238,2.023201823,240,2,think,"('MOT', 'CHI')",Providence,nai39.xml,270,30,2,CHI,4416,1278,MOT
0,2,10,258,1.984825565,260,2,put,"('MOT', 'CHI')",Providence,nai39.xml,270,10,0,CHI,4416,1278,MOT
0,2,10,258,1.984825565,260,2,one,"('MOT', 'CHI')",Providence,nai39.xml,270,10,0,CHI,4416,1278,MOT
0,1,17,252,1.903677385,253,1,see,"('MOT', 'CHI')",Providence,nai39.xml,270,17,0,CHI,4416,1278,MOT
0,2,11,257,1.900958761,259,2,can,"('MOT', 'CHI')",Providence,nai39.xml,270,11,0,CHI,4416,1278,MOT
0,1,1,35,1.84582669,36,1,have,"('MOT', 'FAT')",Providence,nai39.xml,37,1,0,FAT,397,224,MOT
0,1,1,35,1.84582669,36,1,is,"('MOT', 'FAT')",Providence,nai39.xml,37,1,0,FAT,397,224,MOT
0,1,19,250,1.79571987,251,1,with,"('MOT', 'CHI')",Providence,nai39.xml,270,19,0,CHI,4416,1278,MOT
1,2,0,21,1.714798428,23,2,was,"('CHI', 'MOT')",Providence,nai39.xml,24,1,1,MOT,128,256,CHI
2,1,5,29,1.673976434,30,1,to,"('MOT', 'FAT')",Providence,nai39.xml,37,7,2,FAT,397,224,MOT
1,0,0,5,1.540445041,5,0,is,"('CHI', 'FAT')",Providence,nai39.xml,6,1,1,FAT,36,36,CHI
1,1,0,11,1.540445041,12,1,up,"('FAT', 'MOT')",Providence,nai39.xml,13,1,1,MOT,40,113,FAT
0,1,2,34,1.531476371,35,1,did,"('MOT', 'FAT')",Providence,nai39.xml,37,2,0,FAT,397,224,MOT
0,1,2,34,1.531476371,35,1,can,"('MOT', 'FAT')",Providence,nai39.xml,37,2,0,FAT,397,224,MOT
0,1,2,34,1.531476371,35,1,wanna,"('MOT', 'FAT')",Providence,nai39.xml,37,2,0,FAT,397,224,MOT
0,1,2,34,1.531476371,35,1,think,"('MOT', 'FAT')",Providence,nai39.xml,37,2,0,FAT,397,224,MOT
0,1,1,22,1.427116356,23,1,did,"('CHI', 'MOT')",Providence,nai39.xml,24,1,0,MOT,128,256,CHI
1,4,21,244,1.427116356,248,4,for,"('MOT', 'CHI')",Providence,nai39.xml,270,22,1,CHI,4416,1278,MOT
1,1,51,217,1.4046435,218,1,and,"('MOT', 'CHI')",Providence,nai39.xml,270,52,1,CHI,4416,1278,MOT
0,2,19,249,1.390254762,251,2,this,"('MOT', 'CHI')",Providence,nai39.xml,270,19,0,CHI,4416,1278,MOT
1,2,1,20,1.386294361,22,2,what,"('CHI', 'MOT')",Providence,nai39.xml,24,2,1,MOT,128,256,CHI
1,2,3,31,1.358123484,33,2,a,"('MOT', 'FAT')",Providence,nai39.xml,37,4,1,FAT,397,224,MOT
8,12,32,218,1.341342973,230,12,he,"('MOT', 'CHI')",Providence,nai39.xml,270,40,8,CHI,4416,1278,MOT
0,1,3,33,1.280933845,34,1,for,"('MOT', 'FAT')",Providence,nai39.xml,37,3,0,FAT,397,224,MOT
2,5,30,233,1.261131218,238,5,there,"('MOT', 'CHI')",Providence,nai39.xml,270,32,2,CHI,4416,1278,MOT
12,23,23,212,1.244037756,235,23,what,"('MOT', 'CHI')",Providence,nai39.xml,270,35,12,CHI,4416,1278,MOT
2,3,1,18,1.238374231,21,3,a,"('CHI', 'MOT')",Providence,nai39.xml,24,3,2,MOT,128,256,CHI
2,5,31,232,1.22796831,237,5,it,"('MOT', 'CHI')",Providence,nai39.xml,270,33,2,CHI,4416,1278,MOT
1,4,0,19,1.203972804,23,4,oh,"('CHI', 'MOT')",Providence,nai39.xml,24,1,1,MOT,128,256,CHI
5,8,40,217,1.169337308,225,8,is,"('MOT', 'CHI')",Providence,nai39.xml,270,45,5,CHI,4416,1278,MOT
1,4,28,237,1.142783507,241,4,she,"('MOT', 'CHI')",Providence,nai39.xml,270,29,1,CHI,4416,1278,MOT
4,6,45,215,1.138873902,221,6,in,"('MOT', 'CHI')",Providence,nai39.xml,270,49,4,CHI,4416,1278,MOT
0,2,2,33,1.126011263,35,2,make,"('MOT', 'FAT')",Providence,nai39.xml,37,2,0,FAT,397,224,MOT
0,2,2,33,1.126011263,35,2,and,"('MOT', 'FAT')",Providence,nai39.xml,37,2,0,FAT,397,224,MOT
1,0,1,4,1.098612289,4,0,the,"('CHI', 'FAT')",Providence,nai39.xml,6,2,1,FAT,36,36,CHI
0,1,4,32,1.070441412,33,1,was,"('MOT', 'FAT')",Providence,nai39.xml,37,4,0,FAT,397,224,MOT
0,1,4,32,1.070441412,33,1,put,"('MOT', 'FAT')",Providence,nai39.xml,37,4,0,FAT,397,224,MOT
0,2,1,21,1.021651248,23,2,we,"('CHI', 'MOT')",Providence,nai39.xml,24,1,0,MOT,128,256,CHI
0,2,1,21,1.021651248,23,2,up,"('CHI', 'MOT')",Providence,nai39.xml,24,1,0,MOT,128,256,CHI
0,1,5,31,0.887303195,32,1,this,"('MOT', 'FAT')",Providence,nai39.xml,37,5,0,FAT,397,224,MOT
0,1,1,11,0.84729786,12,1,yeah,"('FAT', 'MOT')",Providence,nai39.xml,13,1,0,MOT,40,113,FAT
2,3,64,201,0.820686391,204,3,you,"('MOT', 'CHI')",Providence,nai39.xml,270,66,2,CHI,4416,1278,MOT
0,3,1,20,0.733969175,23,3,on,"('CHI', 'MOT')",Providence,nai39.xml,24,1,0,MOT,128,256,CHI
1,2,8,26,0.597837001,28,2,in,"('MOT', 'FAT')",Providence,nai39.xml,37,9,1,FAT,397,224,MOT
0,4,1,19,0.510825624,23,4,that,"('CHI', 'MOT')",Providence,nai39.xml,24,1,0,MOT,128,256,CHI
0,4,1,19,0.510825624,23,4,to,"('CHI', 'MOT')",Providence,nai39.xml,24,1,0,MOT,128,256,CHI
2,10,0,12,0.492476485,22,10,you,"('CHI', 'MOT')",Providence,nai39.xml,24,2,2,MOT,128,256,CHI
14,16,83,157,0.444502981,173,16,the,"('MOT', 'CHI')",Providence,nai39.xml,270,97,14,CHI,4416,1278,MOT
0,6,21,243,0.444048574,249,6,are,"('MOT', 'CHI')",Providence,nai39.xml,270,21,0,CHI,4416,1278,MOT
4,11,52,203,0.43936666,214,11,that,"('MOT', 'CHI')",Providence,nai39.xml,270,56,4,CHI,4416,1278,MOT
0,3,4,30,0.377294231,33,3,yeah,"('MOT', 'FAT')",Providence,nai39.xml,37,4,0,FAT,397,224,MOT
3,4,10,20,0.326902786,24,4,you,"('MOT', 'FAT')",Providence,nai39.xml,37,13,3,FAT,397,224,MOT
0,2,6,29,0.318453731,31,2,it,"('MOT', 'FAT')",Providence,nai39.xml,37,6,0,FAT,397,224,MOT
0,1,9,27,0.310154928,28,1,that,"('MOT', 'FAT')",Providence,nai39.xml,37,9,0,FAT,397,224,MOT
8,21,54,187,0.294406571,208,21,a,"('MOT', 'CHI')",Providence,nai39.xml,270,62,8,CHI,4416,1278,MOT
0,1,1,5,0.287682072,6,1,do,"('FAT', 'CHI')",Providence,nai39.xml,7,1,0,CHI,32,34,FAT
0,6,1,17,0.174353387,23,6,it,"('CHI', 'MOT')",Providence,nai39.xml,24,1,0,MOT,128,256,CHI
0,1,1,4,0.15415068,5,1,you,"('CHI', 'FAT')",Providence,nai39.xml,6,1,0,FAT,36,36,CHI
0,3,3,18,0.139761942,21,3,yeah,"('CHI', 'MOT')",Providence,nai39.xml,24,3,0,MOT,128,256,CHI
0,3,3,18,0.139761942,21,3,the,"('CHI', 'MOT')",Providence,nai39.xml,24,3,0,MOT,128,256,CHI
0,5,33,232,0.129356021,237,5,do,"('MOT', 'CHI')",Providence,nai39.xml,270,33,0,CHI,4416,1278,MOT
0,4,8,25,-0.478035801,29,4,the,"('MOT', 'FAT')",Providence,nai39.xml,37,8,0,FAT,397,224,MOT
1,30,24,215,-0.527288553,245,30,yeah,"('MOT', 'CHI')",Providence,nai39.xml,270,25,1,CHI,4416,1278,MOT
1,0,10,333,3.942328355,333,0,some,"('MOT', 'CHI')",Providence,nai40.xml,344,11,1,CHI,4921,2218,MOT
2,2,3,337,3.885972328,339,2,she,"('MOT', 'CHI')",Providence,nai40.xml,344,5,2,CHI,4921,2218,MOT
0,1,2,341,3.761200116,342,1,make,"('MOT', 'CHI')",Providence,nai40.xml,344,2,0,CHI,4921,2218,MOT
2,0,26,316,3.45946629,316,0,see,"('MOT', 'CHI')",Providence,nai40.xml,344,28,2,CHI,4921,2218,MOT
0,1,4,339,3.349904087,340,1,little,"('MOT', 'CHI')",Providence,nai40.xml,344,4,0,CHI,4921,2218,MOT
2,1,19,322,3.053796075,323,1,like,"('MOT', 'CHI')",Providence,nai40.xml,344,21,2,CHI,4921,2218,MOT
1,1,14,328,2.968905031,329,1,one,"('MOT', 'CHI')",Providence,nai40.xml,344,15,1,CHI,4921,2218,MOT
0,1,7,336,2.935628349,337,1,they,"('MOT', 'CHI')",Providence,nai40.xml,344,7,0,CHI,4921,2218,MOT
0,1,8,335,2.827313622,336,1,all,"('MOT', 'CHI')",Providence,nai40.xml,344,8,0,CHI,4921,2218,MOT
0,3,4,337,2.656756907,340,3,at,"('MOT', 'CHI')",Providence,nai40.xml,344,4,0,CHI,4921,2218,MOT
2,2,20,320,2.602689685,322,2,for,"('MOT', 'CHI')",Providence,nai40.xml,344,22,2,CHI,4921,2218,MOT
2,2,21,319,2.558776498,321,2,of,"('MOT', 'CHI')",Providence,nai40.xml,344,23,2,CHI,4921,2218,MOT
0,1,13,330,2.406945108,331,1,up,"('MOT', 'CHI')",Providence,nai40.xml,344,13,0,CHI,4921,2218,MOT
1,2,17,324,2.391816227,326,2,gonna,"('MOT', 'CHI')",Providence,nai40.xml,344,18,1,CHI,4921,2218,MOT
1,3,13,327,2.339399066,330,3,look,"('MOT', 'CHI')",Providence,nai40.xml,344,14,1,CHI,4921,2218,MOT
0,2,10,332,2.233592222,334,2,want,"('MOT', 'CHI')",Providence,nai40.xml,344,10,0,CHI,4921,2218,MOT
3,2,39,300,2.22052014,302,2,think,"('MOT', 'CHI')",Providence,nai40.xml,344,42,3,CHI,4921,2218,MOT
0,2,11,331,2.150568886,333,2,no,"('MOT', 'CHI')",Providence,nai40.xml,344,11,0,CHI,4921,2218,MOT
0,1,19,324,2.052290553,325,1,with,"('MOT', 'CHI')",Providence,nai40.xml,344,19,0,CHI,4921,2218,MOT
2,7,12,323,2.051716994,330,7,put,"('MOT', 'CHI')",Providence,nai40.xml,344,14,2,CHI,4921,2218,MOT
0,4,7,333,2.019337618,337,4,get,"('MOT', 'CHI')",Providence,nai40.xml,344,7,0,CHI,4921,2218,MOT
1,1,39,303,1.985915484,304,1,do,"('MOT', 'CHI')",Providence,nai40.xml,344,40,1,CHI,4921,2218,MOT
0,3,12,329,1.785789302,332,3,my,"('MOT', 'CHI')",Providence,nai40.xml,344,12,0,CHI,4921,2218,MOT
1,4,20,319,1.732040235,323,4,have,"('MOT', 'CHI')",Providence,nai40.xml,344,21,1,CHI,4921,2218,MOT
0,1,27,316,1.704748092,317,1,are,"('MOT', 'CHI')",Providence,nai40.xml,344,27,0,CHI,4921,2218,MOT
4,27,9,304,1.377325691,331,27,did,"('MOT', 'CHI')",Providence,nai40.xml,344,13,4,CHI,4921,2218,MOT
4,25,12,303,1.260062271,328,25,where,"('MOT', 'CHI')",Providence,nai40.xml,344,16,4,CHI,4921,2218,MOT
9,14,45,276,1.245937003,290,14,is,"('MOT', 'CHI')",Providence,nai40.xml,344,54,9,CHI,4921,2218,MOT
8,26,21,289,1.226302281,315,26,he,"('MOT', 'CHI')",Providence,nai40.xml,344,29,8,CHI,4921,2218,MOT
8,11,53,272,1.221672381,283,11,it,"('MOT', 'CHI')",Providence,nai40.xml,344,61,8,CHI,4921,2218,MOT
1,5,29,309,1.191394022,314,5,on,"('MOT', 'CHI')",Providence,nai40.xml,344,30,1,CHI,4921,2218,MOT
2,1,108,233,1.150798042,234,1,you,"('MOT', 'CHI')",Providence,nai40.xml,344,110,2,CHI,4921,2218,MOT
5,15,34,290,1.032446428,305,15,what,"('MOT', 'CHI')",Providence,nai40.xml,344,39,5,CHI,4921,2218,MOT
9,14,60,261,0.955872521,275,14,a,"('MOT', 'CHI')",Providence,nai40.xml,344,69,9,CHI,4921,2218,MOT
1,11,19,313,0.904095459,324,11,there,"('MOT', 'CHI')",Providence,nai40.xml,344,20,1,CHI,4921,2218,MOT
0,5,21,318,0.856571497,323,5,this,"('MOT', 'CHI')",Providence,nai40.xml,344,21,0,CHI,4921,2218,MOT
0,8,14,322,0.835321669,330,8,yeah,"('MOT', 'CHI')",Providence,nai40.xml,344,14,0,CHI,4921,2218,MOT
6,14,62,262,0.61698582,276,14,that,"('MOT', 'CHI')",Providence,nai40.xml,344,68,6,CHI,4921,2218,MOT
2,11,46,285,0.39877612,296,11,in,"('MOT', 'CHI')",Providence,nai40.xml,344,48,2,CHI,4921,2218,MOT
24,35,100,185,0.201752361,220,35,the,"('MOT', 'CHI')",Providence,nai40.xml,344,124,24,CHI,4921,2218,MOT
1,10,48,285,0.057158414,295,10,and,"('MOT', 'CHI')",Providence,nai40.xml,344,49,1,CHI,4921,2218,MOT
1,33,16,294,0.018405428,327,33,go,"('MOT', 'CHI')",Providence,nai40.xml,344,17,1,CHI,4921,2218,MOT
1,16,51,276,-0.445470443,292,16,to,"('MOT', 'CHI')",Providence,nai40.xml,344,52,1,CHI,4921,2218,MOT
1,0,15,286,3.465735903,286,0,we,"('MOT', 'CHI')",Providence,nai41.xml,302,16,1,CHI,5830,1706,MOT
1,0,18,283,3.301113923,283,0,up,"('MOT', 'CHI')",Providence,nai41.xml,302,19,1,CHI,5830,1706,MOT
0,1,4,297,3.218875825,298,1,make,"('MOT', 'CHI')",Providence,nai41.xml,302,4,0,CHI,5830,1706,MOT
0,1,7,294,2.803360381,295,1,no,"('MOT', 'CHI')",Providence,nai41.xml,302,7,0,CHI,5830,1706,MOT
1,2,14,285,2.427748236,287,2,with,"('MOT', 'CHI')",Providence,nai41.xml,302,15,1,CHI,5830,1706,MOT
0,1,11,290,2.422076071,291,1,look,"('MOT', 'CHI')",Providence,nai41.xml,302,11,0,CHI,5830,1706,MOT
0,1,11,290,2.422076071,291,1,wanna,"('MOT', 'CHI')",Providence,nai41.xml,302,11,0,CHI,5830,1706,MOT
1,3,11,287,2.344549292,290,3,get,"('MOT', 'CHI')",Providence,nai41.xml,302,12,1,CHI,5830,1706,MOT
0,1,12,289,2.344549292,290,1,one,"('MOT', 'CHI')",Providence,nai41.xml,302,12,0,CHI,5830,1706,MOT
4,3,27,268,2.336107785,271,3,on,"('MOT', 'CHI')",Providence,nai41.xml,302,31,4,CHI,5830,1706,MOT
1,0,0,12,2.233592222,12,0,they,"('CHI', 'MOT')",Providence,nai41.xml,13,1,1,MOT,89,182,CHI
1,0,0,12,2.233592222,12,0,on,"('CHI', 'MOT')",Providence,nai41.xml,13,1,1,MOT,89,182,CHI
1,0,0,12,2.233592222,12,0,and,"('CHI', 'MOT')",Providence,nai41.xml,13,1,1,MOT,89,182,CHI
3,5,17,277,2.152466677,282,5,they,"('MOT', 'CHI')",Providence,nai41.xml,302,20,3,CHI,5830,1706,MOT
0,1,15,286,2.140066163,287,1,my,"('MOT', 'CHI')",Providence,nai41.xml,302,15,0,CHI,5830,1706,MOT
0,4,6,292,2.008214032,296,4,put,"('MOT', 'CHI')",Providence,nai41.xml,302,6,0,CHI,5830,1706,MOT
3,0,1,9,1.992430165,9,0,it,"('CHI', 'MOT')",Providence,nai41.xml,13,4,3,MOT,89,182,CHI
1,5,11,285,1.939084184,290,5,want,"('MOT', 'CHI')",Providence,nai41.xml,302,12,1,CHI,5830,1706,MOT
2,9,9,282,1.911250447,291,9,where,"('MOT', 'CHI')",Providence,nai41.xml,302,11,2,CHI,5830,1706,MOT
0,3,9,290,1.902785722,293,3,but,"('MOT', 'CHI')",Providence,nai41.xml,302,9,0,CHI,5830,1706,MOT
1,0,1,11,1.871802177,11,0,like,"('CHI', 'MOT')",Providence,nai41.xml,13,2,1,MOT,89,182,CHI
1,0,1,11,1.871802177,11,0,have,"('CHI', 'MOT')",Providence,nai41.xml,13,2,1,MOT,89,182,CHI
5,11,16,270,1.816805501,281,11,he,"('MOT', 'CHI')",Providence,nai41.xml,302,21,5,CHI,5830,1706,MOT
0,2,14,286,1.798679912,288,2,all,"('MOT', 'CHI')",Providence,nai41.xml,302,14,0,CHI,5830,1706,MOT
0,1,22,279,1.77070606,280,1,are,"('MOT', 'CHI')",Providence,nai41.xml,302,22,0,CHI,5830,1706,MOT
10,10,35,247,1.70668046,257,10,she,"('MOT', 'CHI')",Providence,nai41.xml,302,45,10,CHI,5830,1706,MOT
0,4,9,289,1.679642171,293,4,big,"('MOT', 'CHI')",Providence,nai41.xml,302,9,0,CHI,5830,1706,MOT
1,4,19,278,1.641641053,282,4,see,"('MOT', 'CHI')",Providence,nai41.xml,302,20,1,CHI,5830,1706,MOT
0,2,17,283,1.616430948,285,2,have,"('MOT', 'CHI')",Providence,nai41.xml,302,17,0,CHI,5830,1706,MOT
2,1,0,10,1.584120104,11,1,to,"('CHI', 'MOT')",Providence,nai41.xml,13,2,2,MOT,89,182,CHI
1,1,0,11,1.540445041,12,1,do,"('CHI', 'MOT')",Providence,nai41.xml,13,1,1,MOT,89,182,CHI
1,1,0,9,1.386294361,10,1,is,"('MOT', 'FAT')",Providence,nai41.xml,11,1,1,FAT,74,83,MOT
3,6,35,258,1.335001067,264,6,this,"('MOT', 'CHI')",Providence,nai41.xml,302,38,3,CHI,5830,1706,MOT
2,13,13,274,1.292768303,287,13,go,"('MOT', 'CHI')",Providence,nai41.xml,302,15,2,CHI,5830,1706,MOT
1,3,34,264,1.290646286,267,3,was,"('MOT', 'CHI')",Providence,nai41.xml,302,35,1,CHI,5830,1706,MOT
0,2,24,276,1.278080776,278,2,at,"('MOT', 'CHI')",Providence,nai41.xml,302,24,0,CHI,5830,1706,MOT
2,13,15,272,1.174598196,285,13,did,"('MOT', 'CHI')",Providence,nai41.xml,302,17,2,CHI,5830,1706,MOT
0,4,16,282,1.16315081,286,4,little,"('MOT', 'CHI')",Providence,nai41.xml,302,16,0,CHI,5830,1706,MOT
1,2,0,10,1.134979933,12,2,is,"('CHI', 'MOT')",Providence,nai41.xml,13,1,1,MOT,89,182,CHI
0,4,17,281,1.105605324,285,4,can,"('MOT', 'CHI')",Providence,nai41.xml,302,17,0,CHI,5830,1706,MOT
14,26,42,220,0.865199071,246,26,what,"('MOT', 'CHI')",Providence,nai41.xml,302,56,14,CHI,5830,1706,MOT
1,4,44,253,0.790389728,257,4,of,"('MOT', 'CHI')",Providence,nai41.xml,302,45,1,CHI,5830,1706,MOT
3,8,47,244,0.775160332,252,8,in,"('MOT', 'CHI')",Providence,nai41.xml,302,50,3,CHI,5830,1706,MOT
5,10,57,230,0.723918839,240,10,it,"('MOT', 'CHI')",Providence,nai41.xml,302,62,5,CHI,5830,1706,MOT
1,0,0,1,0.693147181,1,0,it,"('FAT', 'CHI')",Providence,nai41.xml,2,1,1,CHI,19,13,FAT
0,1,1,9,0.693147181,10,1,for,"('MOT', 'FAT')",Providence,nai41.xml,11,1,0,FAT,74,83,MOT
0,1,1,9,0.693147181,10,1,do,"('MOT', 'FAT')",Providence,nai41.xml,11,1,0,FAT,74,83,MOT
0,4,27,271,0.647283764,275,4,for,"('MOT', 'CHI')",Providence,nai41.xml,302,27,0,CHI,5830,1706,MOT
4,7,71,220,0.619912952,227,7,and,"('MOT', 'CHI')",Providence,nai41.xml,302,75,4,CHI,5830,1706,MOT
1,2,1,7,0.606135804,9,2,you,"('MOT', 'FAT')",Providence,nai41.xml,11,2,1,FAT,74,83,MOT
1,2,1,7,0.606135804,9,2,it,"('MOT', 'FAT')",Providence,nai41.xml,11,2,1,FAT,74,83,MOT
0,4,30,268,0.537954291,272,4,like,"('MOT', 'CHI')",Providence,nai41.xml,302,30,0,CHI,5830,1706,MOT
0,2,1,10,0.441832752,12,2,what,"('CHI', 'MOT')",Providence,nai41.xml,13,1,0,MOT,89,182,CHI
0,5,30,267,0.355632734,272,5,there,"('MOT', 'CHI')",Providence,nai41.xml,302,30,0,CHI,5830,1706,MOT
0,1,2,8,0.318453731,9,1,in,"('MOT', 'FAT')",Providence,nai41.xml,11,2,0,FAT,74,83,MOT
0,1,2,8,0.318453731,9,1,what,"('MOT', 'FAT')",Providence,nai41.xml,11,2,0,FAT,74,83,MOT
5,15,59,223,0.310154928,238,15,to,"('MOT', 'CHI')",Providence,nai41.xml,302,64,5,CHI,5830,1706,MOT
30,36,85,151,0.302642372,187,36,the,"('MOT', 'CHI')",Providence,nai41.xml,302,115,30,CHI,5830,1706,MOT
0,7,24,271,0.297251523,278,7,do,"('MOT', 'CHI')",Providence,nai41.xml,302,24,0,CHI,5830,1706,MOT
7,14,79,202,0.278549589,216,14,a,"('MOT', 'CHI')",Providence,nai41.xml,302,86,7,CHI,5830,1706,MOT
1,4,1,7,0.262364264,11,4,you,"('CHI', 'MOT')",Providence,nai41.xml,13,2,1,MOT,89,182,CHI
2,33,16,251,0.232511301,284,33,yeah,"('MOT', 'CHI')",Providence,nai41.xml,302,18,2,CHI,5830,1706,MOT
2,17,34,249,0.161641352,266,17,think,"('MOT', 'CHI')",Providence,nai41.xml,302,36,2,CHI,5830,1706,MOT
0,3,1,9,0.15415068,12,3,some,"('CHI', 'MOT')",Providence,nai41.xml,13,1,0,MOT,89,182,CHI
4,15,66,217,0.015504187,232,15,that,"('MOT', 'CHI')",Providence,nai41.xml,302,70,4,CHI,5830,1706,MOT
0,3,1,7,0,10,3,yeah,"('MOT', 'FAT')",Providence,nai41.xml,11,1,0,FAT,74,83,MOT
0,3,1,7,0,10,3,the,"('MOT', 'FAT')",Providence,nai41.xml,11,1,0,FAT,74,83,MOT
0,3,84,215,-0.447014111,218,3,you,"('MOT', 'CHI')",Providence,nai41.xml,302,84,0,CHI,5830,1706,MOT
0,1,1,0,-0.693147181,1,1,the,"('FAT', 'CHI')",Providence,nai41.xml,2,1,0,CHI,19,13,FAT
1,12,70,219,-0.711223164,231,12,is,"('MOT', 'CHI')",Providence,nai41.xml,302,71,1,CHI,5830,1706,MOT
0,1,1,179,3.412247218,180,1,my,"('CHI', 'MOT')",Providence,nai42.xml,181,1,0,MOT,1189,2052,CHI
1,0,4,87,3.235873401,87,0,of,"('MOT', 'CHI')",Providence,nai42.xml,92,5,1,CHI,1045,564,MOT
0,1,2,178,3.11905549,179,1,no,"('CHI', 'MOT')",Providence,nai42.xml,181,2,0,MOT,1189,2052,CHI
0,2,1,178,3.00678211,180,2,make,"('CHI', 'MOT')",Providence,nai42.xml,181,1,0,MOT,1189,2052,CHI
0,2,1,178,3.00678211,180,2,he,"('CHI', 'MOT')",Providence,nai42.xml,181,1,0,MOT,1189,2052,CHI
0,1,1,90,2.740840024,91,1,gonna,"('MOT', 'CHI')",Providence,nai42.xml,92,1,0,CHI,1045,564,MOT
0,1,1,90,2.740840024,91,1,no,"('MOT', 'CHI')",Providence,nai42.xml,92,1,0,CHI,1045,564,MOT
0,1,1,90,2.740840024,91,1,where,"('MOT', 'CHI')",Providence,nai42.xml,92,1,0,CHI,1045,564,MOT
0,1,2,89,2.442347035,90,1,see,"('MOT', 'CHI')",Providence,nai42.xml,92,2,0,CHI,1045,564,MOT
2,9,1,169,2.379546134,178,9,we,"('CHI', 'MOT')",Providence,nai42.xml,181,3,2,MOT,1189,2052,CHI
2,3,10,166,2.214924154,169,3,where,"('CHI', 'MOT')",Providence,nai42.xml,181,12,2,MOT,1189,2052,CHI
0,1,3,88,2.208274414,89,1,this,"('MOT', 'CHI')",Providence,nai42.xml,92,3,0,CHI,1045,564,MOT
0,1,3,88,2.208274414,89,1,on,"('MOT', 'CHI')",Providence,nai42.xml,92,3,0,CHI,1045,564,MOT
1,9,1,170,2.202764758,179,9,up,"('CHI', 'MOT')",Providence,nai42.xml,181,2,1,MOT,1189,2052,CHI
0,3,3,175,2.197224577,178,3,wanna,"('CHI', 'MOT')",Providence,nai42.xml,181,3,0,MOT,1189,2052,CHI
1,14,0,166,2.090491378,180,14,of,"('CHI', 'MOT')",Providence,nai42.xml,181,1,1,MOT,1189,2052,CHI
1,8,2,170,2.079441542,178,8,for,"('CHI', 'MOT')",Providence,nai42.xml,181,3,1,MOT,1189,2052,CHI
0,2,2,88,2.036881927,90,2,look,"('MOT', 'CHI')",Providence,nai42.xml,92,2,0,CHI,1045,564,MOT
2,9,3,167,2.031900597,176,9,have,"('CHI', 'MOT')",Providence,nai42.xml,181,5,2,MOT,1189,2052,CHI
0,7,1,173,2.025952857,180,7,with,"('CHI', 'MOT')",Providence,nai42.xml,181,1,0,MOT,1189,2052,CHI
0,7,1,173,2.025952857,180,7,see,"('CHI', 'MOT')",Providence,nai42.xml,181,1,0,MOT,1189,2052,CHI
1,15,0,165,2.025952857,180,15,do,"('CHI', 'MOT')",Providence,nai42.xml,181,1,1,MOT,1189,2052,CHI
3,5,10,163,2.022283128,168,5,go,"('CHI', 'MOT')",Providence,nai42.xml,181,13,3,MOT,1189,2052,CHI
0,1,4,87,2.014903021,88,1,want,"('MOT', 'CHI')",Providence,nai42.xml,92,4,0,CHI,1045,564,MOT
1,2,5,84,1.992430165,86,2,little,"('MOT', 'CHI')",Providence,nai42.xml,92,6,1,CHI,1045,564,MOT
1,1,9,81,1.945910149,82,1,like,"('MOT', 'CHI')",Providence,nai42.xml,92,10,1,CHI,1045,564,MOT
0,8,1,172,1.908169821,180,8,can,"('CHI', 'MOT')",Providence,nai42.xml,181,1,0,MOT,1189,2052,CHI
1,10,2,168,1.878770846,178,10,little,"('CHI', 'MOT')",Providence,nai42.xml,181,3,1,MOT,1189,2052,CHI
1,2,6,83,1.863218433,85,2,go,"('MOT', 'CHI')",Providence,nai42.xml,92,7,1,CHI,1045,564,MOT
0,2,3,87,1.802809305,89,2,think,"('MOT', 'CHI')",Providence,nai42.xml,92,3,0,CHI,1045,564,MOT
1,0,0,7,1.791759469,7,0,not,"('FAT', 'MOT')",Providence,nai42.xml,8,1,1,MOT,48,84,FAT
1,9,3,168,1.786188424,177,9,think,"('CHI', 'MOT')",Providence,nai42.xml,181,4,1,MOT,1189,2052,CHI
1,9,3,168,1.786188424,177,9,on,"('CHI', 'MOT')",Providence,nai42.xml,181,4,1,MOT,1189,2052,CHI
1,2,7,82,1.746297095,84,2,it,"('MOT', 'CHI')",Providence,nai42.xml,92,8,1,CHI,1045,564,MOT
0,10,1,170,1.707499126,180,10,like,"('CHI', 'MOT')",Providence,nai42.xml,181,1,0,MOT,1189,2052,CHI
1,10,3,167,1.690878244,177,10,some,"('CHI', 'MOT')",Providence,nai42.xml,181,4,1,MOT,1189,2052,CHI
2,7,8,164,1.687555692,171,7,did,"('CHI', 'MOT')",Providence,nai42.xml,181,10,2,MOT,1189,2052,CHI
4,12,7,158,1.627033674,170,12,it,"('CHI', 'MOT')",Providence,nai42.xml,181,11,4,MOT,1189,2052,CHI
0,8,2,171,1.614978093,179,8,was,"('CHI', 'MOT')",Providence,nai42.xml,181,2,0,MOT,1189,2052,CHI
0,2,4,86,1.609437912,88,2,with,"('MOT', 'CHI')",Providence,nai42.xml,92,4,0,CHI,1045,564,MOT
0,2,4,86,1.609437912,88,2,at,"('MOT', 'CHI')",Providence,nai42.xml,92,4,0,CHI,1045,564,MOT
0,3,7,171,1.586965057,174,3,put,"('CHI', 'MOT')",Providence,nai42.xml,181,7,0,MOT,1189,2052,CHI
0,1,7,84,1.575536361,85,1,for,"('MOT', 'CHI')",Providence,nai42.xml,92,7,0,CHI,1045,564,MOT
3,11,8,159,1.483932831,170,11,in,"('CHI', 'MOT')",Providence,nai42.xml,181,11,3,MOT,1189,2052,CHI
2,14,5,160,1.363821505,174,14,she,"('CHI', 'MOT')",Providence,nai42.xml,181,7,2,MOT,1189,2052,CHI
1,3,8,80,1.351608803,83,3,that,"('MOT', 'CHI')",Providence,nai42.xml,92,9,1,CHI,1045,564,MOT
0,11,2,168,1.32729602,179,11,this,"('CHI', 'MOT')",Providence,nai42.xml,181,2,0,MOT,1189,2052,CHI
0,7,4,170,1.316184795,177,7,want,"('CHI', 'MOT')",Providence,nai42.xml,181,4,0,MOT,1189,2052,CHI
5,5,14,68,1.272965676,73,5,to,"('MOT', 'CHI')",Providence,nai42.xml,92,19,5,CHI,1045,564,MOT
0,1,10,81,1.252762968,82,1,are,"('MOT', 'CHI')",Providence,nai42.xml,92,10,0,CHI,1045,564,MOT
0,17,1,163,1.215022641,180,17,are,"('CHI', 'MOT')",Providence,nai42.xml,181,1,0,MOT,1189,2052,CHI
0,10,3,168,1.185623666,178,10,get,"('CHI', 'MOT')",Providence,nai42.xml,181,3,0,MOT,1189,2052,CHI
1,15,4,161,1.15643186,176,15,and,"('CHI', 'MOT')",Providence,nai42.xml,181,5,1,MOT,1189,2052,CHI
0,4,4,84,1.098612289,88,4,yeah,"('MOT', 'CHI')",Providence,nai42.xml,92,4,0,CHI,1045,564,MOT
2,10,12,157,1.058027009,167,10,yeah,"('CHI', 'MOT')",Providence,nai42.xml,181,14,2,MOT,1189,2052,CHI
0,2,8,82,1.053149915,84,2,there,"('MOT', 'CHI')",Providence,nai42.xml,92,8,0,CHI,1045,564,MOT
0,3,6,83,1.011600912,86,3,some,"('MOT', 'CHI')",Providence,nai42.xml,92,6,0,CHI,1045,564,MOT
5,13,7,67,0.920364057,80,13,what,"('MOT', 'CHI')",Providence,nai42.xml,92,12,5,CHI,1045,564,MOT
1,3,13,75,0.916290732,78,3,do,"('MOT', 'CHI')",Providence,nai42.xml,92,14,1,CHI,1045,564,MOT
2,18,7,154,0.915333336,172,18,there,"('CHI', 'MOT')",Providence,nai42.xml,181,9,2,MOT,1189,2052,CHI
0,14,3,164,0.875468737,178,14,gonna,"('CHI', 'MOT')",Providence,nai42.xml,181,3,0,MOT,1189,2052,CHI
3,33,4,141,0.833193254,174,33,a,"('CHI', 'MOT')",Providence,nai42.xml,181,7,3,MOT,1189,2052,CHI
2,43,2,134,0.710048991,177,43,you,"('CHI', 'MOT')",Providence,nai42.xml,181,4,2,MOT,1189,2052,CHI
0,8,3,81,0.704197017,89,8,is,"('MOT', 'CHI')",Providence,nai42.xml,92,3,0,CHI,1045,564,MOT
0,4,7,81,0.659245629,85,4,up,"('MOT', 'CHI')",Providence,nai42.xml,92,7,0,CHI,1045,564,MOT
4,29,9,139,0.635988767,168,29,the,"('CHI', 'MOT')",Providence,nai42.xml,181,13,4,MOT,1189,2052,CHI
4,23,13,141,0.598932891,164,23,is,"('CHI', 'MOT')",Providence,nai42.xml,181,17,4,MOT,1189,2052,CHI
2,4,20,66,0.587786665,70,4,a,"('MOT', 'CHI')",Providence,nai42.xml,92,22,2,CHI,1045,564,MOT
0,2,13,77,0.587786665,79,2,and,"('MOT', 'CHI')",Providence,nai42.xml,92,13,0,CHI,1045,564,MOT
0,4,8,80,0.542324291,84,4,he,"('MOT', 'CHI')",Providence,nai42.xml,92,8,0,CHI,1045,564,MOT
1,16,11,153,0.362540063,169,16,that,"('CHI', 'MOT')",Providence,nai42.xml,181,12,1,MOT,1189,2052,CHI
1,19,10,151,0.279960026,170,19,what,"('CHI', 'MOT')",Providence,nai42.xml,181,11,1,MOT,1189,2052,CHI
3,4,37,48,0.028170877,52,4,you,"('MOT', 'CHI')",Providence,nai42.xml,92,40,3,CHI,1045,564,MOT
0,2,1,5,0,7,2,oh,"('FAT', 'MOT')",Providence,nai42.xml,8,1,0,MOT,48,84,FAT
0,2,1,5,0,7,2,you,"('FAT', 'MOT')",Providence,nai42.xml,8,1,0,MOT,48,84,FAT
0,2,1,5,0,7,2,the,"('FAT', 'MOT')",Providence,nai42.xml,8,1,0,MOT,48,84,FAT
4,17,15,56,-0.00796817,73,17,the,"('MOT', 'CHI')",Providence,nai42.xml,92,19,4,CHI,1045,564,MOT
0,24,6,151,-0.122167634,175,24,to,"('CHI', 'MOT')",Providence,nai42.xml,181,6,0,MOT,1189,2052,CHI
5,1,2,277,4.536177315,278,1,he,"('MOT', 'CHI')",Providence,nai43.xml,285,7,5,CHI,4662,1641,MOT
1,0,11,273,3.670860949,273,0,big,"('MOT', 'CHI')",Providence,nai43.xml,285,12,1,CHI,4662,1641,MOT
0,1,2,282,3.573047639,283,1,my,"('MOT', 'CHI')",Providence,nai43.xml,285,2,0,CHI,4662,1641,MOT
2,2,6,275,3.328626689,277,2,make,"('MOT', 'CHI')",Providence,nai43.xml,285,8,2,CHI,4662,1641,MOT
1,3,10,271,2.362304328,274,3,little,"('MOT', 'CHI')",Providence,nai43.xml,285,11,1,CHI,4662,1641,MOT
3,6,11,265,2.277267285,271,6,up,"('MOT', 'CHI')",Providence,nai43.xml,285,14,3,CHI,4662,1641,MOT
1,1,24,259,2.272507638,260,1,have,"('MOT', 'CHI')",Providence,nai43.xml,285,25,1,CHI,4662,1641,MOT
2,4,13,266,2.261763098,270,4,want,"('MOT', 'CHI')",Providence,nai43.xml,285,15,2,CHI,4662,1641,MOT
0,1,13,271,2.211930725,272,1,are,"('MOT', 'CHI')",Providence,nai43.xml,285,13,0,CHI,4662,1641,MOT
2,3,18,262,2.208524133,265,3,some,"('MOT', 'CHI')",Providence,nai43.xml,285,20,2,CHI,4662,1641,MOT
4,10,11,260,1.984131362,270,10,she,"('MOT', 'CHI')",Providence,nai43.xml,285,15,4,CHI,4662,1641,MOT
0,2,11,272,1.95683922,274,2,at,"('MOT', 'CHI')",Providence,nai43.xml,285,11,0,CHI,4662,1641,MOT
3,8,13,261,1.900816847,269,8,did,"('MOT', 'CHI')",Providence,nai43.xml,285,16,3,CHI,4662,1641,MOT
0,2,13,270,1.806465617,272,2,not,"('MOT', 'CHI')",Providence,nai43.xml,285,13,0,CHI,4662,1641,MOT
1,3,19,262,1.803059024,265,3,for,"('MOT', 'CHI')",Providence,nai43.xml,285,20,1,CHI,4662,1641,MOT
1,6,11,267,1.7249508,273,6,put,"('MOT', 'CHI')",Providence,nai43.xml,285,12,1,CHI,4662,1641,MOT
1,3,22,259,1.663926098,262,3,with,"('MOT', 'CHI')",Providence,nai43.xml,285,23,1,CHI,4662,1641,MOT
6,9,26,244,1.658228077,253,9,there,"('MOT', 'CHI')",Providence,nai43.xml,285,32,6,CHI,4662,1641,MOT
0,1,24,260,1.620910314,261,1,see,"('MOT', 'CHI')",Providence,nai43.xml,285,24,0,CHI,4662,1641,MOT
3,5,31,246,1.544405442,251,5,in,"('MOT', 'CHI')",Providence,nai43.xml,285,34,3,CHI,4662,1641,MOT
0,5,8,272,1.53686722,277,5,look,"('MOT', 'CHI')",Providence,nai43.xml,285,8,0,CHI,4662,1641,MOT
1,11,7,266,1.53686722,277,11,go,"('MOT', 'CHI')",Providence,nai43.xml,285,8,1,CHI,4662,1641,MOT
3,6,27,249,1.523724394,255,6,we,"('MOT', 'CHI')",Providence,nai43.xml,285,30,3,CHI,4662,1641,MOT
0,2,18,265,1.500366817,267,2,can,"('MOT', 'CHI')",Providence,nai43.xml,285,18,0,CHI,4662,1641,MOT
1,4,22,258,1.440782546,262,4,like,"('MOT', 'CHI')",Providence,nai43.xml,285,23,1,CHI,4662,1641,MOT
12,12,43,218,1.403686104,230,12,it,"('MOT', 'CHI')",Providence,nai43.xml,285,55,12,CHI,4662,1641,MOT
0,3,16,266,1.325452702,269,3,get,"('MOT', 'CHI')",Providence,nai43.xml,285,16,0,CHI,4662,1641,MOT
7,10,39,229,1.295142191,239,10,is,"('MOT', 'CHI')",Providence,nai43.xml,285,46,7,CHI,4662,1641,MOT
1,2,48,234,1.134979933,236,2,oh,"('MOT', 'CHI')",Providence,nai43.xml,285,49,1,CHI,4662,1641,MOT
2,6,31,246,1.134688345,252,6,on,"('MOT', 'CHI')",Providence,nai43.xml,285,33,2,CHI,4662,1641,MOT
0,4,16,265,1.102309151,269,4,this,"('MOT', 'CHI')",Providence,nai43.xml,285,16,0,CHI,4662,1641,MOT
0,7,10,268,1.059669315,275,7,where,"('MOT', 'CHI')",Providence,nai43.xml,285,10,0,CHI,4662,1641,MOT
20,18,61,186,1.00911902,204,18,a,"('MOT', 'CHI')",Providence,nai43.xml,285,81,20,CHI,4662,1641,MOT
3,11,27,244,0.984727893,255,11,think,"('MOT', 'CHI')",Providence,nai43.xml,285,30,3,CHI,4662,1641,MOT
3,14,27,241,0.761584342,255,14,what,"('MOT', 'CHI')",Providence,nai43.xml,285,30,3,CHI,4662,1641,MOT
10,12,75,188,0.675305494,200,12,the,"('MOT', 'CHI')",Providence,nai43.xml,285,85,10,CHI,4662,1641,MOT
0,5,22,258,0.609916526,263,5,was,"('MOT', 'CHI')",Providence,nai43.xml,285,22,0,CHI,4662,1641,MOT
4,12,46,223,0.561304978,235,12,that,"('MOT', 'CHI')",Providence,nai43.xml,285,50,4,CHI,4662,1641,MOT
0,18,8,259,0.38418771,277,18,no,"('MOT', 'CHI')",Providence,nai43.xml,285,8,0,CHI,4662,1641,MOT
5,19,45,216,0.312843618,235,19,to,"('MOT', 'CHI')",Providence,nai43.xml,285,50,5,CHI,4662,1641,MOT
2,3,112,168,0.112019331,171,3,you,"('MOT', 'CHI')",Providence,nai43.xml,285,114,2,CHI,4662,1641,MOT
0,9,27,249,-0.109199292,258,9,and,"('MOT', 'CHI')",Providence,nai43.xml,285,27,0,CHI,4662,1641,MOT
1,23,25,236,-0.252590753,259,23,yeah,"('MOT', 'CHI')",Providence,nai43.xml,285,26,1,CHI,4662,1641,MOT
0,11,34,240,-0.5350361,251,11,do,"('MOT', 'CHI')",Providence,nai43.xml,285,34,0,CHI,4662,1641,MOT
1,0,0,100,4.219507705,100,0,on,"('CHI', 'FAT')",Providence,nai44.xml,101,1,1,FAT,603,1315,CHI
1,0,1,99,3.921973336,99,0,some,"('CHI', 'FAT')",Providence,nai44.xml,101,2,1,FAT,603,1315,CHI
1,2,2,244,3.498525726,246,2,he,"('CHI', 'MOT')",Providence,nai44.xml,249,3,1,MOT,1505,3467,CHI
1,2,3,243,3.312163759,245,2,they,"('CHI', 'MOT')",Providence,nai44.xml,249,4,1,MOT,1505,3467,CHI
6,8,0,235,3.170502241,243,8,was,"('CHI', 'MOT')",Providence,nai44.xml,249,6,6,MOT,1505,3467,CHI
2,7,0,240,3.150329282,247,7,make,"('CHI', 'MOT')",Providence,nai44.xml,249,2,2,MOT,1505,3467,CHI
1,2,0,98,3.120895417,100,2,was,"('CHI', 'FAT')",Providence,nai44.xml,101,1,1,FAT,603,1315,CHI
2,6,1,240,3.056692973,246,6,at,"('CHI', 'MOT')",Providence,nai44.xml,249,3,2,MOT,1505,3467,CHI
1,4,2,242,2.987700102,246,4,where,"('CHI', 'MOT')",Providence,nai44.xml,249,3,1,MOT,1505,3467,CHI
2,3,0,96,2.941144083,99,3,go,"('CHI', 'FAT')",Providence,nai44.xml,101,2,2,FAT,603,1315,CHI
1,0,0,26,2.926739402,26,0,with,"('MOT', 'FAT')",Providence,nai44.xml,27,1,1,FAT,234,193,MOT
1,0,0,26,2.926739402,26,0,all,"('MOT', 'FAT')",Providence,nai44.xml,27,1,1,FAT,234,193,MOT
1,3,0,97,2.833213344,100,3,no,"('CHI', 'FAT')",Providence,nai44.xml,101,1,1,FAT,603,1315,CHI
0,4,1,244,2.813410717,248,4,big,"('CHI', 'MOT')",Providence,nai44.xml,249,1,0,MOT,1505,3467,CHI
0,3,2,244,2.744864174,247,3,my,"('CHI', 'MOT')",Providence,nai44.xml,249,2,0,MOT,1505,3467,CHI
1,7,1,240,2.744864174,247,7,with,"('CHI', 'MOT')",Providence,nai44.xml,249,2,1,MOT,1505,3467,CHI
1,0,0,21,2.730029108,21,0,did,"('FAT', 'MOT')",Providence,nai44.xml,22,1,1,MOT,252,159,FAT
2,2,3,94,2.63905733,96,2,he,"('CHI', 'FAT')",Providence,nai44.xml,101,5,2,FAT,603,1315,CHI
0,5,1,243,2.63108916,248,5,not,"('CHI', 'MOT')",Providence,nai44.xml,249,1,0,MOT,1505,3467,CHI
1,4,0,96,2.610069793,100,4,of,"('CHI', 'FAT')",Providence,nai44.xml,101,1,1,FAT,603,1315,CHI
1,0,1,25,2.602689685,25,0,oh,"('MOT', 'FAT')",Providence,nai44.xml,27,2,1,FAT,234,193,MOT
1,0,1,25,2.602689685,25,0,is,"('MOT', 'FAT')",Providence,nai44.xml,27,2,1,FAT,234,193,MOT
1,0,0,18,2.590267165,18,0,was,"('MOT', 'CHI')",Providence,nai44.xml,19,1,1,CHI,304,72,MOT
2,9,2,236,2.513656063,245,9,one,"('CHI', 'MOT')",Providence,nai44.xml,249,4,2,MOT,1505,3467,CHI
0,6,1,242,2.47693848,248,6,wanna,"('CHI', 'MOT')",Providence,nai44.xml,249,1,0,MOT,1505,3467,CHI
0,2,1,98,2.427748236,100,2,up,"('CHI', 'FAT')",Providence,nai44.xml,101,1,0,FAT,603,1315,CHI
1,0,1,20,2.397895273,20,0,what,"('FAT', 'MOT')",Providence,nai44.xml,22,2,1,MOT,252,159,FAT
1,0,1,20,2.397895273,20,0,at,"('FAT', 'MOT')",Providence,nai44.xml,22,2,1,MOT,252,159,FAT
0,5,2,242,2.339399066,247,5,go,"('CHI', 'MOT')",Providence,nai44.xml,249,2,0,MOT,1505,3467,CHI
2,11,2,234,2.331334506,245,11,see,"('CHI', 'MOT')",Providence,nai44.xml,249,4,2,MOT,1505,3467,CHI
1,4,1,95,2.312535424,99,4,with,"('CHI', 'FAT')",Providence,nai44.xml,101,2,1,FAT,603,1315,CHI
1,10,2,236,2.199242741,246,10,up,"('CHI', 'MOT')",Providence,nai44.xml,249,3,1,MOT,1505,3467,CHI
1,13,1,234,2.185248386,247,13,this,"('CHI', 'MOT')",Providence,nai44.xml,249,2,1,MOT,1505,3467,CHI
0,2,2,97,2.130213867,99,2,yeah,"('CHI', 'FAT')",Providence,nai44.xml,101,2,0,FAT,603,1315,CHI
1,0,2,19,2.128231706,19,0,do,"('FAT', 'MOT')",Providence,nai44.xml,22,3,1,MOT,252,159,FAT
0,4,4,241,2.108190955,245,4,look,"('CHI', 'MOT')",Providence,nai44.xml,249,4,0,MOT,1505,3467,CHI
2,12,3,232,2.093084318,244,12,little,"('CHI', 'MOT')",Providence,nai44.xml,249,5,2,MOT,1505,3467,CHI
3,17,2,227,2.05534399,244,17,we,"('CHI', 'MOT')",Providence,nai44.xml,249,5,3,MOT,1505,3467,CHI
10,20,4,215,2.048844254,235,20,it,"('CHI', 'MOT')",Providence,nai44.xml,249,14,10,MOT,1505,3467,CHI
3,13,4,229,2.047180679,242,13,there,"('CHI', 'MOT')",Providence,nai44.xml,249,7,3,MOT,1505,3467,CHI
2,15,2,230,2.043652434,245,15,have,"('CHI', 'MOT')",Providence,nai44.xml,249,4,2,MOT,1505,3467,CHI
0,10,1,238,2.024953356,248,10,on,"('CHI', 'MOT')",Providence,nai44.xml,249,1,0,MOT,1505,3467,CHI
1,22,0,226,1.980501594,248,22,can,"('CHI', 'MOT')",Providence,nai44.xml,249,1,1,MOT,1505,3467,CHI
3,16,3,227,1.974897686,243,16,want,"('CHI', 'MOT')",Providence,nai44.xml,249,6,3,MOT,1505,3467,CHI
1,0,2,16,1.974081026,16,0,to,"('MOT', 'CHI')",Providence,nai44.xml,19,3,1,CHI,304,72,MOT
9,13,12,215,1.966112856,228,13,she,"('CHI', 'MOT')",Providence,nai44.xml,249,21,9,MOT,1505,3467,CHI
0,6,3,240,1.958080685,246,6,put,"('CHI', 'MOT')",Providence,nai44.xml,249,3,0,MOT,1505,3467,CHI
1,1,0,18,1.945910149,19,1,up,"('FAT', 'CHI')",Providence,nai44.xml,20,1,1,CHI,306,99,FAT
0,4,1,96,1.916922612,100,4,in,"('CHI', 'FAT')",Providence,nai44.xml,101,1,0,FAT,603,1315,CHI
0,12,1,236,1.857899272,248,12,like,"('CHI', 'MOT')",Providence,nai44.xml,249,1,0,MOT,1505,3467,CHI
1,2,0,24,1.828127113,26,2,up,"('MOT', 'FAT')",Providence,nai44.xml,27,1,1,FAT,234,193,MOT
0,5,1,95,1.734601055,100,5,did,"('CHI', 'FAT')",Providence,nai44.xml,101,1,0,FAT,603,1315,CHI
0,10,2,237,1.733263263,247,10,get,"('CHI', 'MOT')",Providence,nai44.xml,249,2,0,MOT,1505,3467,CHI
2,21,2,224,1.725198703,245,21,are,"('CHI', 'MOT')",Providence,nai44.xml,249,4,2,MOT,1505,3467,CHI
1,1,1,19,1.704748092,20,1,like,"('FAT', 'MOT')",Providence,nai44.xml,22,2,1,MOT,252,159,FAT
1,1,2,23,1.648658626,24,1,that,"('MOT', 'FAT')",Providence,nai44.xml,27,3,1,FAT,234,193,MOT
0,4,2,95,1.619388243,99,4,want,"('CHI', 'FAT')",Providence,nai44.xml,101,2,0,FAT,603,1315,CHI
5,28,3,213,1.61493999,241,28,to,"('CHI', 'MOT')",Providence,nai44.xml,249,8,5,MOT,1505,3467,CHI
0,3,3,95,1.609437912,98,3,this,"('CHI', 'FAT')",Providence,nai44.xml,101,3,0,FAT,603,1315,CHI
2,1,2,17,1.609437912,18,1,oh,"('FAT', 'MOT')",Providence,nai44.xml,22,4,2,MOT,252,159,FAT
1,13,0,87,1.580450376,100,13,are,"('CHI', 'FAT')",Providence,nai44.xml,101,1,1,FAT,603,1315,CHI
1,2,0,17,1.540445041,19,2,it,"('FAT', 'CHI')",Providence,nai44.xml,20,1,1,CHI,306,99,FAT
0,13,2,234,1.492101206,247,13,did,"('CHI', 'MOT')",Providence,nai44.xml,249,2,0,MOT,1505,3467,CHI
1,15,0,85,1.446918983,100,15,gonna,"('CHI', 'FAT')",Providence,nai44.xml,101,1,1,FAT,603,1315,CHI
4,27,5,213,1.368275856,240,27,of,"('CHI', 'MOT')",Providence,nai44.xml,249,9,4,MOT,1505,3467,CHI
0,1,1,20,1.343734747,21,1,gonna,"('FAT', 'MOT')",Providence,nai44.xml,22,1,0,MOT,252,159,FAT
0,1,1,20,1.343734747,21,1,yeah,"('FAT', 'MOT')",Providence,nai44.xml,22,1,0,MOT,252,159,FAT
0,1,1,20,1.343734747,21,1,where,"('FAT', 'MOT')",Providence,nai44.xml,22,1,0,MOT,252,159,FAT
11,38,6,194,1.33222714,232,38,a,"('CHI', 'MOT')",Providence,nai44.xml,249,17,11,MOT,1505,3467,CHI
0,1,1,18,1.252762968,19,1,yeah,"('FAT', 'CHI')",Providence,nai44.xml,20,1,0,CHI,306,99,FAT
0,1,1,18,1.252762968,19,1,get,"('FAT', 'CHI')",Providence,nai44.xml,20,1,0,CHI,306,99,FAT
0,1,1,18,1.252762968,19,1,we,"('FAT', 'CHI')",Providence,nai44.xml,20,1,0,CHI,306,99,FAT
0,1,1,18,1.252762968,19,1,put,"('FAT', 'CHI')",Providence,nai44.xml,20,1,0,CHI,306,99,FAT
0,1,1,18,1.252762968,19,1,do,"('FAT', 'CHI')",Providence,nai44.xml,20,1,0,CHI,306,99,FAT
0,17,2,230,1.240786777,247,17,for,"('CHI', 'MOT')",Providence,nai44.xml,249,2,0,MOT,1505,3467,CHI
0,1,2,24,1.216395324,25,1,are,"('MOT', 'FAT')",Providence,nai44.xml,27,2,0,FAT,234,193,MOT
0,1,1,17,1.203972804,18,1,no,"('MOT', 'CHI')",Providence,nai44.xml,19,1,0,CHI,304,72,MOT
0,1,1,17,1.203972804,18,1,one,"('MOT', 'CHI')",Providence,nai44.xml,19,1,0,CHI,304,72,MOT
5,13,5,78,1.200394983,91,13,that,"('CHI', 'FAT')",Providence,nai44.xml,101,10,5,FAT,603,1315,CHI
6,35,6,202,1.199797433,237,35,that,"('CHI', 'MOT')",Providence,nai44.xml,249,12,6,MOT,1505,3467,CHI
1,24,3,221,1.191900223,245,24,some,"('CHI', 'MOT')",Providence,nai44.xml,249,4,1,MOT,1505,3467,CHI
12,36,11,190,1.164501249,226,36,the,"('CHI', 'MOT')",Providence,nai44.xml,249,23,12,MOT,1505,3467,CHI
5,34,6,204,1.152100974,238,34,what,"('CHI', 'MOT')",Providence,nai44.xml,249,11,5,MOT,1505,3467,CHI
0,2,1,24,1.134979933,26,2,see,"('MOT', 'FAT')",Providence,nai44.xml,27,1,0,FAT,234,193,MOT
0,2,1,24,1.134979933,26,2,no,"('MOT', 'FAT')",Providence,nai44.xml,27,1,0,FAT,234,193,MOT
0,2,1,24,1.134979933,26,2,and,"('MOT', 'FAT')",Providence,nai44.xml,27,1,0,FAT,234,193,MOT
4,13,5,79,1.115780092,92,13,it,"('CHI', 'FAT')",Providence,nai44.xml,101,9,4,FAT,603,1315,CHI
4,36,5,204,1.089562453,240,36,and,"('CHI', 'MOT')",Providence,nai44.xml,249,9,4,MOT,1505,3467,CHI
2,18,9,220,1.069862875,238,18,in,"('CHI', 'MOT')",Providence,nai44.xml,249,11,2,MOT,1505,3467,CHI
3,16,3,79,1.048350454,95,16,to,"('CHI', 'FAT')",Providence,nai44.xml,101,6,3,FAT,603,1315,CHI
2,12,4,83,1.028932368,95,12,what,"('CHI', 'FAT')",Providence,nai44.xml,101,6,2,FAT,603,1315,CHI
4,16,4,77,1.027516367,93,16,is,"('CHI', 'FAT')",Providence,nai44.xml,101,8,4,FAT,603,1315,CHI
1,0,8,13,1.003302109,13,0,the,"('FAT', 'MOT')",Providence,nai44.xml,22,9,1,MOT,252,159,FAT
5,18,4,74,0.99272,92,18,a,"('CHI', 'FAT')",Providence,nai44.xml,101,9,5,FAT,603,1315,CHI
5,19,4,73,0.941426705,92,19,the,"('CHI', 'FAT')",Providence,nai44.xml,101,9,5,FAT,603,1315,CHI
0,1,2,16,0.864997437,17,1,make,"('MOT', 'CHI')",Providence,nai44.xml,19,2,0,CHI,304,72,MOT
2,17,13,217,0.838858992,234,17,think,"('CHI', 'MOT')",Providence,nai44.xml,249,15,2,MOT,1505,3467,CHI
0,2,2,23,0.810930216,25,2,there,"('MOT', 'FAT')",Providence,nai44.xml,27,2,0,FAT,234,193,MOT
0,2,2,23,0.810930216,25,2,on,"('MOT', 'FAT')",Providence,nai44.xml,27,2,0,FAT,234,193,MOT
0,2,31,216,0.798507696,218,2,no,"('CHI', 'MOT')",Providence,nai44.xml,249,31,0,MOT,1505,3467,CHI
1,2,3,16,0.798507696,18,2,a,"('FAT', 'MOT')",Providence,nai44.xml,22,4,1,MOT,252,159,FAT
2,4,3,18,0.721318058,22,4,the,"('MOT', 'FAT')",Providence,nai44.xml,27,5,2,FAT,234,193,MOT
1,2,3,14,0.693147181,16,2,a,"('FAT', 'CHI')",Providence,nai44.xml,20,4,1,CHI,306,99,FAT
0,3,1,18,0.650587566,21,3,there,"('FAT', 'MOT')",Providence,nai44.xml,22,1,0,MOT,252,159,FAT
0,3,1,18,0.650587566,21,3,she,"('FAT', 'MOT')",Providence,nai44.xml,22,1,0,MOT,252,159,FAT
0,15,6,228,0.649227947,243,15,gonna,"('CHI', 'MOT')",Providence,nai44.xml,249,6,0,MOT,1505,3467,CHI
0,1,3,16,0.641853886,17,1,on,"('FAT', 'CHI')",Providence,nai44.xml,20,3,0,CHI,306,99,FAT
0,2,2,18,0.606135804,20,2,was,"('FAT', 'MOT')",Providence,nai44.xml,22,2,0,MOT,252,159,FAT
0,2,2,18,0.606135804,20,2,think,"('FAT', 'MOT')",Providence,nai44.xml,22,2,0,MOT,252,159,FAT
0,13,2,86,0.589768826,99,13,and,"('CHI', 'FAT')",Providence,nai44.xml,101,2,0,FAT,603,1315,CHI
0,1,3,15,0.587786665,16,1,this,"('MOT', 'CHI')",Providence,nai44.xml,19,3,0,CHI,304,72,MOT
1,3,2,13,0.587786665,16,3,a,"('MOT', 'CHI')",Providence,nai44.xml,19,3,1,CHI,304,72,MOT
0,2,3,22,0.550046337,24,2,we,"('MOT', 'FAT')",Providence,nai44.xml,27,3,0,FAT,234,193,MOT
2,4,4,17,0.54522705,21,4,you,"('MOT', 'FAT')",Providence,nai44.xml,27,6,2,FAT,234,193,MOT
2,34,1,64,0.538996501,98,34,you,"('CHI', 'FAT')",Providence,nai44.xml,101,3,2,FAT,603,1315,CHI
9,86,5,149,0.532148393,235,86,you,"('CHI', 'MOT')",Providence,nai44.xml,249,14,9,MOT,1505,3467,CHI
4,40,13,192,0.406747982,232,40,is,"('CHI', 'MOT')",Providence,nai44.xml,249,17,4,MOT,1505,3467,CHI
0,1,4,15,0.405465108,16,1,that,"('FAT', 'CHI')",Providence,nai44.xml,20,4,0,CHI,306,99,FAT
0,2,4,21,0.328504067,23,2,yeah,"('MOT', 'FAT')",Providence,nai44.xml,27,4,0,FAT,234,193,MOT
0,25,5,219,0.301324849,244,25,do,"('CHI', 'MOT')",Providence,nai44.xml,249,5,0,MOT,1505,3467,CHI
0,4,2,21,0.300104592,25,4,a,"('MOT', 'FAT')",Providence,nai44.xml,27,2,0,FAT,234,193,MOT
0,5,1,16,0.245122458,21,5,and,"('FAT', 'MOT')",Providence,nai44.xml,22,1,0,MOT,252,159,FAT
0,2,3,15,0.236388778,17,2,the,"('FAT', 'CHI')",Providence,nai44.xml,20,3,0,CHI,306,99,FAT
0,1,5,13,0.133531393,14,1,is,"('MOT', 'CHI')",Providence,nai44.xml,19,5,0,CHI,304,72,MOT
0,3,3,16,0.048790164,19,3,it,"('FAT', 'MOT')",Providence,nai44.xml,22,3,0,MOT,252,159,FAT
0,3,4,20,0.040821995,23,3,to,"('MOT', 'FAT')",Providence,nai44.xml,27,4,0,FAT,234,193,MOT
0,4,2,14,0,18,4,to,"('FAT', 'CHI')",Providence,nai44.xml,20,2,0,CHI,306,99,FAT
1,3,6,12,-0.057158414,15,3,you,"('FAT', 'MOT')",Providence,nai44.xml,22,7,1,MOT,252,159,FAT
1,16,30,202,-0.242946179,218,16,yeah,"('CHI', 'MOT')",Providence,nai44.xml,249,31,1,MOT,1505,3467,CHI
0,1,7,11,-0.251314428,12,1,the,"('MOT', 'CHI')",Providence,nai44.xml,19,7,0,CHI,304,72,MOT
0,1,8,10,-0.430782916,11,1,up,"('MOT', 'CHI')",Providence,nai44.xml,19,8,0,CHI,304,72,MOT
0,4,1,439,3.390024081,443,4,make,"('CHI', 'MOT')",Providence,nai45.xml,444,1,0,MOT,2671,6168,CHI
0,4,1,439,3.390024081,443,4,my,"('CHI', 'MOT')",Providence,nai45.xml,444,1,0,MOT,2671,6168,CHI
2,11,1,430,3.097837496,441,11,was,"('CHI', 'MOT')",Providence,nai45.xml,444,3,2,MOT,2671,6168,CHI
0,6,1,437,3.053551844,443,6,did,"('CHI', 'MOT')",Providence,nai45.xml,444,1,0,MOT,2671,6168,CHI
3,10,3,428,2.995732274,438,10,she,"('CHI', 'MOT')",Providence,nai45.xml,444,6,3,MOT,2671,6168,CHI
1,20,0,423,2.648086736,443,20,have,"('CHI', 'MOT')",Providence,nai45.xml,444,1,1,MOT,2671,6168,CHI
1,7,5,431,2.621038824,438,7,he,"('CHI', 'MOT')",Providence,nai45.xml,444,6,1,MOT,2671,6168,CHI
2,14,3,425,2.533696814,439,14,big,"('CHI', 'MOT')",Providence,nai45.xml,444,5,2,MOT,2671,6168,CHI
4,13,7,420,2.480777256,433,13,one,"('CHI', 'MOT')",Providence,nai45.xml,444,11,4,MOT,2671,6168,CHI
1,20,1,422,2.358154944,442,20,not,"('CHI', 'MOT')",Providence,nai45.xml,444,2,1,MOT,2671,6168,CHI
1,13,3,427,2.353640264,440,13,they,"('CHI', 'MOT')",Providence,nai45.xml,444,4,1,MOT,2671,6168,CHI
2,18,3,421,2.297308036,439,18,for,"('CHI', 'MOT')",Providence,nai45.xml,444,5,2,MOT,2671,6168,CHI
0,14,1,429,2.291411792,443,14,want,"('CHI', 'MOT')",Providence,nai45.xml,444,1,0,MOT,2671,6168,CHI
0,8,4,432,2.102325836,440,8,where,"('CHI', 'MOT')",Providence,nai45.xml,444,4,0,MOT,2671,6168,CHI
0,13,2,429,2.070472872,442,13,look,"('CHI', 'MOT')",Providence,nai45.xml,444,2,0,MOT,2671,6168,CHI
0,18,1,425,2.055023014,443,18,get,"('CHI', 'MOT')",Providence,nai45.xml,444,1,0,MOT,2671,6168,CHI
5,20,9,410,2.043073898,430,20,with,"('CHI', 'MOT')",Providence,nai45.xml,444,14,5,MOT,2671,6168,CHI
0,12,3,429,1.9191825,441,12,at,"('CHI', 'MOT')",Providence,nai45.xml,444,3,0,MOT,2671,6168,CHI
1,12,7,424,1.90783164,436,12,some,"('CHI', 'MOT')",Providence,nai45.xml,444,8,1,MOT,2671,6168,CHI
1,27,2,414,1.845074528,441,27,gonna,"('CHI', 'MOT')",Providence,nai45.xml,444,3,1,MOT,2671,6168,CHI
0,23,1,420,1.821408163,443,23,see,"('CHI', 'MOT')",Providence,nai45.xml,444,1,0,MOT,2671,6168,CHI
0,23,1,420,1.821408163,443,23,wanna,"('CHI', 'MOT')",Providence,nai45.xml,444,1,0,MOT,2671,6168,CHI
0,15,3,426,1.711543135,441,15,but,"('CHI', 'MOT')",Providence,nai45.xml,444,3,0,MOT,2671,6168,CHI
1,26,3,414,1.696860727,440,26,up,"('CHI', 'MOT')",Providence,nai45.xml,444,4,1,MOT,2671,6168,CHI
5,37,6,396,1.664569983,433,37,are,"('CHI', 'MOT')",Providence,nai45.xml,444,11,5,MOT,2671,6168,CHI
1,27,3,413,1.660493083,440,27,put,"('CHI', 'MOT')",Providence,nai45.xml,444,4,1,MOT,2671,6168,CHI
1,33,2,408,1.650918514,441,33,we,"('CHI', 'MOT')",Providence,nai45.xml,444,3,1,MOT,2671,6168,CHI
2,38,3,401,1.578185369,439,38,can,"('CHI', 'MOT')",Providence,nai45.xml,444,5,2,MOT,2671,6168,CHI
3,32,6,403,1.571824722,435,32,on,"('CHI', 'MOT')",Providence,nai45.xml,444,9,3,MOT,2671,6168,CHI
0,7,10,427,1.513294052,434,7,no,"('CHI', 'MOT')",Providence,nai45.xml,444,10,0,MOT,2671,6168,CHI
3,42,4,395,1.512369081,437,42,of,"('CHI', 'MOT')",Providence,nai45.xml,444,7,3,MOT,2671,6168,CHI
3,28,9,404,1.452985736,432,28,go,"('CHI', 'MOT')",Providence,nai45.xml,444,12,3,MOT,2671,6168,CHI
0,39,1,404,1.310582539,443,39,like,"('CHI', 'MOT')",Providence,nai45.xml,444,1,0,MOT,2671,6168,CHI
10,46,15,373,1.294543639,419,46,in,"('CHI', 'MOT')",Providence,nai45.xml,444,25,10,MOT,2671,6168,CHI
16,73,10,345,1.237198452,418,73,it,"('CHI', 'MOT')",Providence,nai45.xml,444,26,16,MOT,2671,6168,CHI
26,68,21,329,1.15887148,397,68,a,"('CHI', 'MOT')",Providence,nai45.xml,444,47,26,MOT,2671,6168,CHI
2,23,13,406,1.153453204,429,23,there,"('CHI', 'MOT')",Providence,nai45.xml,444,15,2,MOT,2671,6168,CHI
9,72,8,355,1.129143592,427,72,to,"('CHI', 'MOT')",Providence,nai45.xml,444,17,9,MOT,2671,6168,CHI
8,39,22,375,1.073294481,414,39,think,"('CHI', 'MOT')",Providence,nai45.xml,444,30,8,MOT,2671,6168,CHI
0,33,3,408,0.957771333,441,33,this,"('CHI', 'MOT')",Providence,nai45.xml,444,3,0,MOT,2671,6168,CHI
0,20,7,417,0.842752398,437,20,little,"('CHI', 'MOT')",Providence,nai45.xml,444,7,0,MOT,2671,6168,CHI
2,48,8,386,0.799527584,434,48,and,"('CHI', 'MOT')",Providence,nai45.xml,444,10,2,MOT,2671,6168,CHI
0,41,3,400,0.746462239,441,41,do,"('CHI', 'MOT')",Providence,nai45.xml,444,3,0,MOT,2671,6168,CHI
33,103,28,280,0.692078233,383,103,the,"('CHI', 'MOT')",Providence,nai45.xml,444,61,33,MOT,2671,6168,CHI
3,46,15,380,0.599537681,426,46,what,"('CHI', 'MOT')",Providence,nai45.xml,444,18,3,MOT,2671,6168,CHI
5,64,16,359,0.533967152,423,64,is,"('CHI', 'MOT')",Providence,nai45.xml,444,21,5,MOT,2671,6168,CHI
13,149,9,273,0.50010166,422,149,you,"('CHI', 'MOT')",Providence,nai45.xml,444,22,13,MOT,2671,6168,CHI
0,35,9,400,0.098518984,435,35,yeah,"('CHI', 'MOT')",Providence,nai45.xml,444,9,0,MOT,2671,6168,CHI
7,76,35,326,-0.047138636,402,76,that,"('CHI', 'MOT')",Providence,nai45.xml,444,42,7,MOT,2671,6168,CHI
3,3,3,446,4.032025798,449,3,where,"('CHI', 'MOT')",Providence,nai46.xml,455,6,3,MOT,2823,5835,CHI
3,3,4,445,3.912023005,448,3,they,"('CHI', 'MOT')",Providence,nai46.xml,455,7,3,MOT,2823,5835,CHI
4,6,6,439,3.281179708,445,6,he,"('CHI', 'MOT')",Providence,nai46.xml,455,10,4,MOT,2823,5835,CHI
0,5,1,449,3.232121052,454,5,make,"('CHI', 'MOT')",Providence,nai46.xml,455,1,0,MOT,2823,5835,CHI
5,10,5,435,3.011516141,445,10,she,"('CHI', 'MOT')",Providence,nai46.xml,455,10,5,MOT,2823,5835,CHI
0,7,1,447,2.944438979,454,7,up,"('CHI', 'MOT')",Providence,nai46.xml,455,1,0,MOT,2823,5835,CHI
1,11,1,442,2.942243589,453,11,big,"('CHI', 'MOT')",Providence,nai46.xml,455,2,1,MOT,2823,5835,CHI
0,6,2,447,2.788092909,453,6,my,"('CHI', 'MOT')",Providence,nai46.xml,455,2,0,MOT,2823,5835,CHI
3,22,1,429,2.574932801,451,22,can,"('CHI', 'MOT')",Providence,nai46.xml,455,4,3,MOT,2823,5835,CHI
0,11,1,443,2.538973871,454,11,but,"('CHI', 'MOT')",Providence,nai46.xml,455,1,0,MOT,2823,5835,CHI
1,17,1,436,2.53677848,453,17,little,"('CHI', 'MOT')",Providence,nai46.xml,455,2,1,MOT,2823,5835,CHI
10,17,10,418,2.496414257,435,17,was,"('CHI', 'MOT')",Providence,nai46.xml,455,20,10,MOT,2823,5835,CHI
2,12,5,436,2.445685937,448,12,at,"('CHI', 'MOT')",Providence,nai46.xml,455,7,2,MOT,2823,5835,CHI
0,9,2,444,2.431417965,453,9,one,"('CHI', 'MOT')",Providence,nai46.xml,455,2,0,MOT,2823,5835,CHI
1,11,4,439,2.376012562,450,11,not,"('CHI', 'MOT')",Providence,nai46.xml,455,5,1,MOT,2823,5835,CHI
1,16,2,436,2.368593122,452,16,we,"('CHI', 'MOT')",Providence,nai46.xml,455,3,1,MOT,2823,5835,CHI
4,6,24,421,2.323787301,427,6,no,"('CHI', 'MOT')",Providence,nai46.xml,455,28,4,MOT,2823,5835,CHI
0,16,1,438,2.190667177,454,16,see,"('CHI', 'MOT')",Providence,nai46.xml,455,1,0,MOT,2823,5835,CHI
4,22,6,423,2.091595641,445,22,there,"('CHI', 'MOT')",Providence,nai46.xml,455,10,4,MOT,2823,5835,CHI
3,24,4,424,2.079441542,448,24,get,"('CHI', 'MOT')",Providence,nai46.xml,455,7,3,MOT,2823,5835,CHI
3,15,9,428,2.072722591,443,15,put,"('CHI', 'MOT')",Providence,nai46.xml,455,12,3,MOT,2823,5835,CHI
0,12,3,440,1.943709928,452,12,go,"('CHI', 'MOT')",Providence,nai46.xml,455,3,0,MOT,2823,5835,CHI
0,17,2,436,1.8436313,453,17,are,"('CHI', 'MOT')",Providence,nai46.xml,455,2,0,MOT,2823,5835,CHI
1,30,2,422,1.767819262,452,30,of,"('CHI', 'MOT')",Providence,nai46.xml,455,3,1,MOT,2823,5835,CHI
2,22,6,425,1.767555867,447,22,have,"('CHI', 'MOT')",Providence,nai46.xml,455,8,2,MOT,2823,5835,CHI
0,16,3,436,1.675445942,452,16,with,"('CHI', 'MOT')",Providence,nai46.xml,455,3,0,MOT,2823,5835,CHI
11,33,17,394,1.618805662,427,33,in,"('CHI', 'MOT')",Providence,nai46.xml,455,28,11,MOT,2823,5835,CHI
7,38,9,401,1.614553013,439,38,on,"('CHI', 'MOT')",Providence,nai46.xml,455,16,7,MOT,2823,5835,CHI
1,31,3,420,1.551543934,451,31,yeah,"('CHI', 'MOT')",Providence,nai46.xml,455,4,1,MOT,2823,5835,CHI
1,29,4,421,1.45972183,450,29,for,"('CHI', 'MOT')",Providence,nai46.xml,455,5,1,MOT,2823,5835,CHI
1,20,7,427,1.453062538,447,20,wanna,"('CHI', 'MOT')",Providence,nai46.xml,455,8,1,MOT,2823,5835,CHI
6,29,18,402,1.357353957,431,29,some,"('CHI', 'MOT')",Providence,nai46.xml,455,24,6,MOT,2823,5835,CHI
2,38,5,410,1.347073648,448,38,gonna,"('CHI', 'MOT')",Providence,nai46.xml,455,7,2,MOT,2823,5835,CHI
4,22,20,409,1.286584886,431,22,want,"('CHI', 'MOT')",Providence,nai46.xml,455,24,4,MOT,2823,5835,CHI
0,17,5,433,1.277400273,450,17,did,"('CHI', 'MOT')",Providence,nai46.xml,455,5,0,MOT,2823,5835,CHI
7,48,14,386,1.129769271,434,48,and,"('CHI', 'MOT')",Providence,nai46.xml,455,21,7,MOT,2823,5835,CHI
16,59,23,357,1.060778148,416,59,it,"('CHI', 'MOT')",Providence,nai46.xml,455,39,16,MOT,2823,5835,CHI
0,22,5,428,1.032277815,450,22,this,"('CHI', 'MOT')",Providence,nai46.xml,455,5,0,MOT,2823,5835,CHI
6,28,30,391,0.983660993,419,28,think,"('CHI', 'MOT')",Providence,nai46.xml,455,36,6,MOT,2823,5835,CHI
7,54,17,377,0.884749546,431,54,to,"('CHI', 'MOT')",Providence,nai46.xml,455,24,7,MOT,2823,5835,CHI
5,41,19,390,0.866731041,431,41,what,"('CHI', 'MOT')",Providence,nai46.xml,455,24,5,MOT,2823,5835,CHI
28,78,39,310,0.729888212,388,78,the,"('CHI', 'MOT')",Providence,nai46.xml,455,67,28,MOT,2823,5835,CHI
19,86,26,324,0.700699903,410,86,a,"('CHI', 'MOT')",Providence,nai46.xml,455,45,19,MOT,2823,5835,CHI
4,48,20,383,0.530258804,431,48,is,"('CHI', 'MOT')",Providence,nai46.xml,455,24,4,MOT,2823,5835,CHI
2,58,11,384,0.408849206,442,58,that,"('CHI', 'MOT')",Providence,nai46.xml,455,13,2,MOT,2823,5835,CHI
17,155,21,262,0.189507216,417,155,you,"('CHI', 'MOT')",Providence,nai46.xml,455,38,17,MOT,2823,5835,CHI
0,41,8,406,0.066768176,447,41,do,"('CHI', 'MOT')",Providence,nai46.xml,455,8,0,MOT,2823,5835,CHI
1,2,2,214,3.369592042,216,2,one,"('MOT', 'CHI')",Providence,nai47.xml,219,3,1,CHI,2871,1664,MOT
0,1,3,215,3.08190997,216,1,put,"('MOT', 'CHI')",Providence,nai47.xml,219,3,0,CHI,2871,1664,MOT
2,2,6,209,3.058707073,211,2,he,"('MOT', 'CHI')",Providence,nai47.xml,219,8,2,CHI,2871,1664,MOT
1,1,7,210,3.058707073,211,1,big,"('MOT', 'CHI')",Providence,nai47.xml,219,8,1,CHI,2871,1664,MOT
1,1,9,208,2.866951484,209,1,gonna,"('MOT', 'CHI')",Providence,nai47.xml,219,10,1,CHI,2871,1664,MOT
10,4,14,191,2.813564551,195,4,was,"('MOT', 'CHI')",Providence,nai47.xml,219,24,10,CHI,2871,1664,MOT
0,1,6,212,2.598049306,213,1,little,"('MOT', 'CHI')",Providence,nai47.xml,219,6,0,CHI,2871,1664,MOT
1,3,6,209,2.475604257,212,3,have,"('MOT', 'CHI')",Providence,nai47.xml,219,7,1,CHI,2871,1664,MOT
1,2,9,207,2.461486376,209,2,get,"('MOT', 'CHI')",Providence,nai47.xml,219,10,1,CHI,2871,1664,MOT
3,4,10,202,2.406344327,206,4,she,"('MOT', 'CHI')",Providence,nai47.xml,219,13,3,CHI,2871,1664,MOT
5,5,13,196,2.317473705,201,5,we,"('MOT', 'CHI')",Providence,nai47.xml,219,18,5,CHI,2871,1664,MOT
1,3,8,207,2.265543821,210,3,up,"('MOT', 'CHI')",Providence,nai47.xml,219,9,1,CHI,2871,1664,MOT
2,5,7,205,2.265543821,210,5,they,"('MOT', 'CHI')",Providence,nai47.xml,219,9,2,CHI,2871,1664,MOT
0,1,10,208,2.173804303,209,1,all,"('MOT', 'CHI')",Providence,nai47.xml,219,10,0,CHI,2871,1664,MOT
1,4,7,207,2.142416341,211,4,where,"('MOT', 'CHI')",Providence,nai47.xml,219,8,1,CHI,2871,1664,MOT
0,6,2,211,2.05686722,217,6,want,"('MOT', 'CHI')",Providence,nai47.xml,219,2,0,CHI,2871,1664,MOT
0,1,15,203,1.801515644,204,1,yeah,"('MOT', 'CHI')",Providence,nai47.xml,219,15,0,CHI,2871,1664,MOT
0,2,10,207,1.768339195,209,2,with,"('MOT', 'CHI')",Providence,nai47.xml,219,10,0,CHI,2871,1664,MOT
2,7,10,200,1.722447669,207,7,at,"('MOT', 'CHI')",Providence,nai47.xml,219,12,2,CHI,2871,1664,MOT
2,5,15,197,1.680533834,202,5,are,"('MOT', 'CHI')",Providence,nai47.xml,219,17,2,CHI,2871,1664,MOT
2,4,20,193,1.604425371,197,4,in,"('MOT', 'CHI')",Providence,nai47.xml,219,22,2,CHI,2871,1664,MOT
0,7,4,208,1.508696343,215,7,look,"('MOT', 'CHI')",Providence,nai47.xml,219,4,0,CHI,2871,1664,MOT
1,10,6,202,1.464003345,212,10,some,"('MOT', 'CHI')",Providence,nai47.xml,219,7,1,CHI,2871,1664,MOT
1,8,10,200,1.278080776,208,8,this,"('MOT', 'CHI')",Providence,nai47.xml,219,11,1,CHI,2871,1664,MOT
0,3,13,203,1.243193517,206,3,do,"('MOT', 'CHI')",Providence,nai47.xml,219,13,0,CHI,2871,1664,MOT
2,3,38,176,1.173145341,179,3,oh,"('MOT', 'CHI')",Providence,nai47.xml,219,40,2,CHI,2871,1664,MOT
0,5,9,205,1.166931533,210,5,can,"('MOT', 'CHI')",Providence,nai47.xml,219,9,0,CHI,2871,1664,MOT
7,13,26,173,1.121478113,186,13,to,"('MOT', 'CHI')",Providence,nai47.xml,219,33,7,CHI,2871,1664,MOT
1,10,10,198,1.077410081,208,10,go,"('MOT', 'CHI')",Providence,nai47.xml,219,11,1,CHI,2871,1664,MOT
4,11,22,182,1.065326311,193,11,what,"('MOT', 'CHI')",Providence,nai47.xml,219,26,4,CHI,2871,1664,MOT
1,5,20,193,1.064210862,198,5,think,"('MOT', 'CHI')",Providence,nai47.xml,219,21,1,CHI,2871,1664,MOT
6,13,26,174,1.02223931,187,13,it,"('MOT', 'CHI')",Providence,nai47.xml,219,32,6,CHI,2871,1664,MOT
3,12,19,185,0.936595998,197,12,there,"('MOT', 'CHI')",Providence,nai47.xml,219,22,3,CHI,2871,1664,MOT
0,3,18,198,0.931179344,201,3,see,"('MOT', 'CHI')",Providence,nai47.xml,219,18,0,CHI,2871,1664,MOT
5,10,33,171,0.914470895,181,10,you,"('MOT', 'CHI')",Providence,nai47.xml,219,38,5,CHI,2871,1664,MOT
2,10,21,186,0.770108222,196,10,of,"('MOT', 'CHI')",Providence,nai47.xml,219,23,2,CHI,2871,1664,MOT
6,14,32,167,0.758466647,181,14,that,"('MOT', 'CHI')",Providence,nai47.xml,219,38,6,CHI,2871,1664,MOT
0,6,12,201,0.757366773,207,6,on,"('MOT', 'CHI')",Providence,nai47.xml,219,12,0,CHI,2871,1664,MOT
0,5,15,199,0.702903356,204,5,did,"('MOT', 'CHI')",Providence,nai47.xml,219,15,0,CHI,2871,1664,MOT
3,14,26,176,0.501752328,190,14,and,"('MOT', 'CHI')",Providence,nai47.xml,219,29,3,CHI,2871,1664,MOT
0,7,15,197,0.415221283,204,7,for,"('MOT', 'CHI')",Providence,nai47.xml,219,15,0,CHI,2871,1664,MOT
23,34,48,114,0.342881622,148,34,the,"('MOT', 'CHI')",Providence,nai47.xml,219,71,23,CHI,2871,1664,MOT
11,26,45,137,0.234572247,163,26,a,"('MOT', 'CHI')",Providence,nai47.xml,219,56,11,CHI,2871,1664,MOT
0,34,4,181,0.032789823,215,34,no,"('MOT', 'CHI')",Providence,nai47.xml,219,4,0,CHI,2871,1664,MOT
3,22,29,165,-0.033813364,187,22,is,"('MOT', 'CHI')",Providence,nai47.xml,219,32,3,CHI,2871,1664,MOT
2,0,3,222,4.564348191,222,0,he,"('CHI', 'MOT')",Providence,nai48.xml,227,5,2,MOT,1737,3300,CHI
1,1,1,224,4.038655656,225,1,big,"('CHI', 'MOT')",Providence,nai48.xml,227,2,1,MOT,1737,3300,CHI
1,0,2,95,3.658420247,95,0,did,"('FAT', 'CHI')",Providence,nai48.xml,98,3,1,CHI,976,694,FAT
1,0,2,95,3.658420247,95,0,one,"('FAT', 'CHI')",Providence,nai48.xml,98,3,1,CHI,976,694,FAT
3,3,1,220,3.624340933,223,3,at,"('CHI', 'MOT')",Providence,nai48.xml,227,4,3,MOT,1737,3300,CHI
2,3,1,221,3.523415014,224,3,all,"('CHI', 'MOT')",Providence,nai48.xml,227,3,2,MOT,1737,3300,CHI
0,2,1,224,3.232121052,226,2,where,"('CHI', 'MOT')",Providence,nai48.xml,227,1,0,MOT,1737,3300,CHI
1,6,0,220,3.077970372,226,6,they,"('CHI', 'MOT')",Providence,nai48.xml,227,1,1,MOT,1737,3300,CHI
0,2,2,223,2.940043368,225,2,one,"('CHI', 'MOT')",Providence,nai48.xml,227,2,0,MOT,1737,3300,CHI
0,1,1,96,2.803360381,97,1,she,"('FAT', 'CHI')",Providence,nai48.xml,98,1,0,CHI,976,694,FAT
0,1,1,96,2.803360381,97,1,he,"('FAT', 'CHI')",Providence,nai48.xml,98,1,0,CHI,976,694,FAT
2,6,2,217,2.777043073,223,6,she,"('CHI', 'MOT')",Providence,nai48.xml,227,4,2,MOT,1737,3300,CHI
1,1,3,93,2.772588722,94,1,like,"('FAT', 'CHI')",Providence,nai48.xml,98,4,1,CHI,976,694,FAT
1,3,0,91,2.772588722,94,3,want,"('MOT', 'CHI')",Providence,nai48.xml,95,1,1,CHI,867,714,MOT
0,4,1,222,2.721295428,226,4,did,"('CHI', 'MOT')",Providence,nai48.xml,227,1,0,MOT,1737,3300,CHI
1,1,4,89,2.575878428,90,1,are,"('MOT', 'CHI')",Providence,nai48.xml,95,5,1,CHI,867,714,MOT
1,1,14,211,2.532762671,212,1,no,"('CHI', 'MOT')",Providence,nai48.xml,227,15,1,MOT,1737,3300,CHI
0,1,2,95,2.505525937,96,1,want,"('FAT', 'CHI')",Providence,nai48.xml,98,2,0,CHI,976,694,FAT
0,1,2,92,2.47443535,93,1,in,"('MOT', 'CHI')",Providence,nai48.xml,95,2,0,CHI,867,714,MOT
1,0,0,15,2.427748236,15,0,get,"('CHI', 'FAT')",Providence,nai48.xml,16,1,1,FAT,130,94,CHI
1,0,0,15,2.427748236,15,0,for,"('CHI', 'FAT')",Providence,nai48.xml,16,1,1,FAT,130,94,CHI
1,0,0,15,2.427748236,15,0,make,"('CHI', 'FAT')",Providence,nai48.xml,16,1,1,FAT,130,94,CHI
2,4,1,88,2.423031246,92,4,did,"('MOT', 'CHI')",Providence,nai48.xml,95,3,2,CHI,867,714,MOT
2,10,2,213,2.325057949,223,10,are,"('CHI', 'MOT')",Providence,nai48.xml,227,4,2,MOT,1737,3300,CHI
1,8,2,216,2.30701969,224,8,not,"('CHI', 'MOT')",Providence,nai48.xml,227,3,1,MOT,1737,3300,CHI
2,2,5,86,2.302585093,88,2,gonna,"('MOT', 'CHI')",Providence,nai48.xml,95,7,2,CHI,867,714,MOT
1,0,1,18,2.302585093,18,0,put,"('MOT', 'FAT')",Providence,nai48.xml,20,2,1,FAT,250,138,MOT
0,1,3,94,2.272125886,95,1,but,"('FAT', 'CHI')",Providence,nai48.xml,98,3,0,CHI,976,694,FAT
0,1,3,91,2.240709689,92,1,get,"('MOT', 'CHI')",Providence,nai48.xml,95,3,0,CHI,867,714,MOT
1,2,4,91,2.202501634,93,2,up,"('FAT', 'CHI')",Providence,nai48.xml,98,5,1,CHI,976,694,FAT
2,12,2,211,2.158003864,223,12,of,"('CHI', 'MOT')",Providence,nai48.xml,227,4,2,MOT,1737,3300,CHI
0,2,2,94,2.100060829,96,2,put,"('FAT', 'CHI')",Providence,nai48.xml,98,2,0,CHI,976,694,FAT
0,1,4,93,2.079441542,94,1,at,"('FAT', 'CHI')",Providence,nai48.xml,98,4,0,CHI,976,694,FAT
0,1,4,93,2.079441542,94,1,not,"('FAT', 'CHI')",Providence,nai48.xml,98,4,0,CHI,976,694,FAT
1,0,1,14,2.079441542,14,0,you,"('CHI', 'FAT')",Providence,nai48.xml,16,2,1,FAT,130,94,CHI
1,0,1,14,2.079441542,14,0,with,"('CHI', 'FAT')",Providence,nai48.xml,16,2,1,FAT,130,94,CHI
1,0,1,14,2.079441542,14,0,a,"('CHI', 'FAT')",Providence,nai48.xml,16,2,1,FAT,130,94,CHI
0,2,2,91,2.068970242,93,2,look,"('MOT', 'CHI')",Providence,nai48.xml,95,2,0,CHI,867,714,MOT
2,12,3,210,1.999398834,222,12,little,"('CHI', 'MOT')",Providence,nai48.xml,227,5,2,MOT,1737,3300,CHI
1,1,0,18,1.945910149,19,1,was,"('MOT', 'FAT')",Providence,nai48.xml,20,1,1,FAT,250,138,MOT
5,8,2,83,1.929909808,91,8,was,"('FAT', 'CHI')",Providence,nai48.xml,98,7,5,CHI,976,694,FAT
0,1,5,92,1.914819562,93,1,little,"('FAT', 'CHI')",Providence,nai48.xml,98,5,0,CHI,976,694,FAT
0,1,5,92,1.914819562,93,1,do,"('FAT', 'CHI')",Providence,nai48.xml,98,5,0,CHI,976,694,FAT
1,0,1,11,1.871802177,11,0,on,"('FAT', 'MOT')",Providence,nai48.xml,13,2,1,MOT,120,74,FAT
0,2,3,93,1.866660777,95,2,some,"('FAT', 'CHI')",Providence,nai48.xml,98,3,0,CHI,976,694,FAT
0,2,3,90,1.835244581,92,2,little,"('MOT', 'CHI')",Providence,nai48.xml,95,3,0,CHI,867,714,MOT
0,2,3,90,1.835244581,92,2,at,"('MOT', 'CHI')",Providence,nai48.xml,95,3,0,CHI,867,714,MOT
2,17,2,206,1.832581464,223,17,like,"('CHI', 'MOT')",Providence,nai48.xml,227,4,2,MOT,1737,3300,CHI
2,21,1,203,1.818666922,224,21,for,"('CHI', 'MOT')",Providence,nai48.xml,227,3,2,MOT,1737,3300,CHI
8,14,11,194,1.791759469,208,14,some,"('CHI', 'MOT')",Providence,nai48.xml,227,19,8,MOT,1737,3300,CHI
2,1,0,13,1.791759469,14,1,to,"('CHI', 'FAT')",Providence,nai48.xml,16,2,2,FAT,130,94,CHI
1,0,2,13,1.791759469,13,0,and,"('CHI', 'FAT')",Providence,nai48.xml,16,3,1,FAT,130,94,CHI
0,3,2,90,1.781288169,93,3,where,"('MOT', 'CHI')",Providence,nai48.xml,95,2,0,CHI,867,714,MOT
2,5,4,87,1.77070606,92,5,in,"('FAT', 'CHI')",Providence,nai48.xml,98,6,2,CHI,976,694,FAT
0,1,6,91,1.77070606,92,1,are,"('FAT', 'CHI')",Providence,nai48.xml,98,6,0,CHI,976,694,FAT
0,1,6,91,1.77070606,92,1,big,"('FAT', 'CHI')",Providence,nai48.xml,98,6,0,CHI,976,694,FAT
6,23,3,195,1.763588592,218,23,there,"('CHI', 'MOT')",Providence,nai48.xml,227,9,6,MOT,1737,3300,CHI
1,9,5,212,1.718292317,221,9,wanna,"('CHI', 'MOT')",Providence,nai48.xml,227,6,1,MOT,1737,3300,CHI
0,2,4,92,1.673976434,94,2,get,"('FAT', 'CHI')",Providence,nai48.xml,98,4,0,CHI,976,694,FAT
5,1,2,12,1.609437912,13,1,a,"('MOT', 'FAT')",Providence,nai48.xml,20,7,5,FAT,250,138,MOT
1,3,6,85,1.609437912,88,3,with,"('MOT', 'CHI')",Providence,nai48.xml,95,7,1,CHI,867,714,MOT
0,1,7,87,1.609437912,88,1,there,"('MOT', 'CHI')",Providence,nai48.xml,95,7,0,CHI,867,714,MOT
1,1,1,17,1.609437912,18,1,yeah,"('MOT', 'FAT')",Providence,nai48.xml,20,2,1,FAT,250,138,MOT
1,12,4,210,1.593933726,222,12,was,"('CHI', 'MOT')",Providence,nai48.xml,227,5,1,MOT,1737,3300,CHI
0,4,2,89,1.558144618,93,4,some,"('MOT', 'CHI')",Providence,nai48.xml,95,2,0,CHI,867,714,MOT
0,15,1,211,1.558144618,226,15,yeah,"('CHI', 'MOT')",Providence,nai48.xml,227,1,0,MOT,1737,3300,CHI
1,2,0,17,1.540445041,19,2,is,"('MOT', 'FAT')",Providence,nai48.xml,20,1,1,FAT,250,138,MOT
1,10,1,86,1.493925025,96,10,no,"('FAT', 'CHI')",Providence,nai48.xml,98,2,1,CHI,976,694,FAT
1,16,3,207,1.484274769,223,16,gonna,"('CHI', 'MOT')",Providence,nai48.xml,227,4,1,MOT,1737,3300,CHI
0,2,5,88,1.477266139,90,2,have,"('MOT', 'CHI')",Providence,nai48.xml,95,5,0,CHI,867,714,MOT
0,1,9,88,1.419817053,89,1,is,"('FAT', 'CHI')",Providence,nai48.xml,98,9,0,CHI,976,694,FAT
1,1,1,13,1.386294361,14,1,he,"('CHI', 'FAT')",Providence,nai48.xml,16,2,1,FAT,130,94,CHI
4,22,6,195,1.378108777,217,22,in,"('CHI', 'MOT')",Providence,nai48.xml,227,10,4,MOT,1737,3300,CHI
8,28,7,184,1.362691418,212,28,and,"('CHI', 'MOT')",Providence,nai48.xml,227,15,8,MOT,1737,3300,CHI
3,2,21,72,1.360318875,74,2,you,"('FAT', 'CHI')",Providence,nai48.xml,98,24,3,CHI,976,694,FAT
1,12,1,84,1.326870941,96,12,think,"('FAT', 'CHI')",Providence,nai48.xml,98,2,1,CHI,976,694,FAT
0,1,1,18,1.252762968,19,1,oh,"('MOT', 'FAT')",Providence,nai48.xml,20,1,0,FAT,250,138,MOT
0,1,1,18,1.252762968,19,1,want,"('MOT', 'FAT')",Providence,nai48.xml,20,1,0,FAT,250,138,MOT
0,1,1,18,1.252762968,19,1,in,"('MOT', 'FAT')",Providence,nai48.xml,20,1,0,FAT,250,138,MOT
0,1,1,18,1.252762968,19,1,what,"('MOT', 'FAT')",Providence,nai48.xml,20,1,0,FAT,250,138,MOT
0,1,1,18,1.252762968,19,1,this,"('MOT', 'FAT')",Providence,nai48.xml,20,1,0,FAT,250,138,MOT
0,1,1,18,1.252762968,19,1,did,"('MOT', 'FAT')",Providence,nai48.xml,20,1,0,FAT,250,138,MOT
0,1,1,18,1.252762968,19,1,do,"('MOT', 'FAT')",Providence,nai48.xml,20,1,0,FAT,250,138,MOT
7,32,6,182,1.250162187,214,32,it,"('CHI', 'MOT')",Providence,nai48.xml,227,13,7,MOT,1737,3300,CHI
2,27,3,195,1.232143681,222,27,is,"('CHI', 'MOT')",Providence,nai48.xml,227,5,2,MOT,1737,3300,CHI
1,2,1,16,1.203972804,18,2,it,"('MOT', 'FAT')",Providence,nai48.xml,20,2,1,FAT,250,138,MOT
1,4,8,85,1.196673502,89,4,to,"('FAT', 'CHI')",Providence,nai48.xml,98,9,1,CHI,976,694,FAT
7,32,7,181,1.180983286,213,32,to,"('CHI', 'MOT')",Providence,nai48.xml,227,14,7,MOT,1737,3300,CHI
0,9,5,213,1.16315081,222,9,go,"('CHI', 'MOT')",Providence,nai48.xml,227,5,0,MOT,1737,3300,CHI
1,4,8,82,1.16315081,86,4,on,"('MOT', 'CHI')",Providence,nai48.xml,95,9,1,CHI,867,714,MOT
0,4,4,87,1.131402111,91,4,go,"('MOT', 'CHI')",Providence,nai48.xml,95,4,0,CHI,867,714,MOT
3,18,10,196,1.109083589,214,18,on,"('CHI', 'MOT')",Providence,nai48.xml,227,13,3,MOT,1737,3300,CHI
1,1,3,15,1.098612289,16,1,the,"('MOT', 'FAT')",Providence,nai48.xml,20,4,1,FAT,250,138,MOT
0,3,6,86,1.045123604,89,3,yeah,"('MOT', 'CHI')",Providence,nai48.xml,95,6,0,CHI,867,714,MOT
0,1,1,14,1.041453875,15,1,in,"('CHI', 'FAT')",Providence,nai48.xml,16,1,0,FAT,130,94,CHI
0,1,1,14,1.041453875,15,1,it,"('CHI', 'FAT')",Providence,nai48.xml,16,1,0,FAT,130,94,CHI
0,1,1,14,1.041453875,15,1,what,"('CHI', 'FAT')",Providence,nai48.xml,16,1,0,FAT,130,94,CHI
8,33,10,176,1.026989913,209,33,that,"('CHI', 'MOT')",Providence,nai48.xml,227,18,8,MOT,1737,3300,CHI
4,10,8,73,1.015136567,83,10,to,"('MOT', 'CHI')",Providence,nai48.xml,95,12,4,CHI,867,714,MOT
2,7,8,78,1.000172216,85,7,it,"('MOT', 'CHI')",Providence,nai48.xml,95,10,2,CHI,867,714,MOT
1,2,1,12,0.980829253,14,2,is,"('CHI', 'FAT')",Providence,nai48.xml,16,2,1,FAT,130,94,CHI
0,5,4,89,0.980829253,94,5,there,"('FAT', 'CHI')",Providence,nai48.xml,98,4,0,CHI,976,694,FAT
2,0,5,6,0.980829253,6,0,the,"('FAT', 'MOT')",Providence,nai48.xml,13,7,2,MOT,120,74,FAT
1,9,4,81,0.966440516,90,9,he,"('MOT', 'CHI')",Providence,nai48.xml,95,5,1,CHI,867,714,MOT
0,3,7,88,0.949080555,91,3,that,"('FAT', 'CHI')",Providence,nai48.xml,98,7,0,CHI,976,694,FAT
0,21,2,204,0.947613203,225,21,what,"('CHI', 'MOT')",Providence,nai48.xml,227,2,0,MOT,1737,3300,CHI
5,42,5,175,0.934724434,217,42,a,"('CHI', 'MOT')",Providence,nai48.xml,227,10,5,MOT,1737,3300,CHI
0,1,2,17,0.916290732,18,1,have,"('MOT', 'FAT')",Providence,nai48.xml,20,2,0,FAT,250,138,MOT
0,1,2,17,0.916290732,18,1,for,"('MOT', 'FAT')",Providence,nai48.xml,20,2,0,FAT,250,138,MOT
0,1,2,17,0.916290732,18,1,all,"('MOT', 'FAT')",Providence,nai48.xml,20,2,0,FAT,250,138,MOT
0,1,2,17,0.916290732,18,1,some,"('MOT', 'FAT')",Providence,nai48.xml,20,2,0,FAT,250,138,MOT
0,12,5,210,0.900786545,222,12,with,"('CHI', 'MOT')",Providence,nai48.xml,227,5,0,MOT,1737,3300,CHI
1,1,2,9,0.875468737,10,1,you,"('FAT', 'MOT')",Providence,nai48.xml,13,3,1,MOT,120,74,FAT
4,15,21,187,0.859132318,202,15,want,"('CHI', 'MOT')",Providence,nai48.xml,227,25,4,MOT,1737,3300,CHI
2,7,10,79,0.857450232,86,7,and,"('FAT', 'CHI')",Providence,nai48.xml,98,12,2,CHI,976,694,FAT
0,1,1,11,0.84729786,12,1,can,"('FAT', 'MOT')",Providence,nai48.xml,13,1,0,MOT,120,74,FAT
0,1,1,11,0.84729786,12,1,to,"('FAT', 'MOT')",Providence,nai48.xml,13,1,0,MOT,120,74,FAT
0,2,1,17,0.84729786,19,2,are,"('MOT', 'FAT')",Providence,nai48.xml,20,1,0,FAT,250,138,MOT
4,7,15,69,0.84218276,76,7,a,"('MOT', 'CHI')",Providence,nai48.xml,95,19,4,CHI,867,714,MOT
0,3,8,87,0.832909123,90,3,of,"('FAT', 'CHI')",Providence,nai48.xml,98,8,0,CHI,976,694,FAT
0,24,2,201,0.819779831,225,24,can,"('CHI', 'MOT')",Providence,nai48.xml,227,2,0,MOT,1737,3300,CHI
2,3,1,10,0.810930216,13,3,the,"('CHI', 'FAT')",Providence,nai48.xml,16,3,2,FAT,130,94,CHI
1,20,7,199,0.744202351,219,20,do,"('CHI', 'MOT')",Providence,nai48.xml,227,8,1,MOT,1737,3300,CHI
0,4,7,87,0.725937003,91,4,what,"('FAT', 'CHI')",Providence,nai48.xml,98,7,0,CHI,976,694,FAT
0,4,7,84,0.693147181,88,4,what,"('MOT', 'CHI')",Providence,nai48.xml,95,7,0,CHI,867,714,MOT
0,7,4,84,0.661398482,91,7,they,"('MOT', 'CHI')",Providence,nai48.xml,95,4,0,CHI,867,714,MOT
2,13,7,73,0.538996501,86,13,that,"('MOT', 'CHI')",Providence,nai48.xml,95,9,2,CHI,867,714,MOT
0,26,3,198,0.515260221,224,26,have,"('CHI', 'MOT')",Providence,nai48.xml,227,3,0,MOT,1737,3300,CHI
0,2,2,16,0.510825624,18,2,we,"('MOT', 'FAT')",Providence,nai48.xml,20,2,0,FAT,250,138,MOT
1,9,8,80,0.503526321,89,9,on,"('FAT', 'CHI')",Providence,nai48.xml,98,9,1,CHI,976,694,FAT
14,32,35,146,0.472673858,178,32,the,"('CHI', 'MOT')",Providence,nai48.xml,227,49,14,MOT,1737,3300,CHI
0,2,1,10,0.441832752,12,2,oh,"('FAT', 'MOT')",Providence,nai48.xml,13,1,0,MOT,120,74,FAT
4,12,15,67,0.394415272,79,12,the,"('FAT', 'CHI')",Providence,nai48.xml,98,19,4,CHI,976,694,FAT
20,69,17,121,0.389960922,190,69,you,"('CHI', 'MOT')",Providence,nai48.xml,227,37,20,MOT,1737,3300,CHI
9,14,22,53,0.332133835,67,14,a,"('FAT', 'CHI')",Providence,nai48.xml,98,31,9,CHI,976,694,FAT
1,10,9,78,0.310154928,88,10,it,"('FAT', 'CHI')",Providence,nai48.xml,98,10,1,CHI,976,694,FAT
0,5,10,80,0.189242,85,5,do,"('MOT', 'CHI')",Providence,nai48.xml,95,10,0,CHI,867,714,MOT
0,1,3,9,0.182321557,10,1,and,"('FAT', 'MOT')",Providence,nai48.xml,13,3,0,MOT,120,74,FAT
2,9,16,68,0.169742775,77,9,you,"('MOT', 'CHI')",Providence,nai48.xml,95,18,2,CHI,867,714,MOT
1,2,6,11,0.105360516,13,2,you,"('MOT', 'FAT')",Providence,nai48.xml,20,7,1,FAT,250,138,MOT
0,8,8,79,-0.011173301,87,8,and,"('MOT', 'CHI')",Providence,nai48.xml,95,8,0,CHI,867,714,MOT
2,13,14,66,-0.036367644,79,13,is,"('MOT', 'CHI')",Providence,nai48.xml,95,16,2,CHI,867,714,MOT
1,21,6,67,-0.09531018,88,21,think,"('MOT', 'CHI')",Providence,nai48.xml,95,7,1,CHI,867,714,MOT
3,24,16,52,-0.520395075,76,24,the,"('MOT', 'CHI')",Providence,nai48.xml,95,19,3,CHI,867,714,MOT
0,17,33,177,-1.16760516,194,17,think,"('CHI', 'MOT')",Providence,nai48.xml,227,33,0,MOT,1737,3300,CHI
1,0,0,49,3.526360525,49,0,with,"('CHI', 'FAT')",Providence,nai49.xml,50,1,1,FAT,316,395,CHI
1,0,0,49,3.526360525,49,0,did,"('CHI', 'FAT')",Providence,nai49.xml,50,1,1,FAT,316,395,CHI
1,0,0,49,3.526360525,49,0,big,"('CHI', 'FAT')",Providence,nai49.xml,50,1,1,FAT,316,395,CHI
1,0,0,47,3.48635519,47,0,there,"('FAT', 'CHI')",Providence,nai49.xml,48,1,1,CHI,424,326,FAT
1,0,2,77,3.453157121,77,0,put,"('MOT', 'CHI')",Providence,nai49.xml,80,3,1,CHI,1046,516,MOT
1,1,0,59,3.028522096,60,1,see,"('CHI', 'MOT')",Providence,nai49.xml,61,1,1,MOT,448,759,CHI
1,2,0,85,2.984558973,87,2,want,"('MOT', 'FAT')",Providence,nai49.xml,88,1,1,FAT,1157,699,MOT
3,1,4,80,2.914763211,81,1,he,"('MOT', 'FAT')",Providence,nai49.xml,88,7,3,FAT,1157,699,MOT
1,1,0,48,2.833213344,49,1,one,"('CHI', 'FAT')",Providence,nai49.xml,50,1,1,FAT,316,395,CHI
1,1,0,46,2.793208009,47,1,at,"('FAT', 'CHI')",Providence,nai49.xml,48,1,1,CHI,424,326,FAT
1,0,3,46,2.772588722,46,0,to,"('CHI', 'FAT')",Providence,nai49.xml,50,4,1,FAT,316,395,CHI
0,1,1,86,2.696876901,87,1,did,"('MOT', 'FAT')",Providence,nai49.xml,88,1,0,FAT,1157,699,MOT
0,1,1,78,2.602689685,79,1,with,"('MOT', 'CHI')",Providence,nai49.xml,80,1,0,CHI,1046,516,MOT
0,1,1,78,2.602689685,79,1,did,"('MOT', 'CHI')",Providence,nai49.xml,80,1,0,CHI,1046,516,MOT
0,1,1,78,2.602689685,79,1,wanna,"('MOT', 'CHI')",Providence,nai49.xml,80,1,0,CHI,1046,516,MOT
1,1,3,75,2.564949357,76,1,there,"('MOT', 'CHI')",Providence,nai49.xml,80,4,1,CHI,1046,516,MOT
1,1,1,48,2.545531272,49,1,gonna,"('FAT', 'MOT')",Providence,nai49.xml,51,2,1,MOT,433,605,FAT
1,1,1,48,2.545531272,49,1,he,"('FAT', 'MOT')",Providence,nai49.xml,51,2,1,MOT,433,605,FAT
1,1,1,47,2.525728644,48,1,want,"('CHI', 'FAT')",Providence,nai49.xml,50,2,1,FAT,316,395,CHI
1,1,2,57,2.48490665,58,1,at,"('CHI', 'MOT')",Providence,nai49.xml,61,3,1,MOT,448,759,CHI
1,0,9,70,2.48490665,70,0,for,"('MOT', 'CHI')",Providence,nai49.xml,80,10,1,CHI,1046,516,MOT
1,2,0,47,2.427748236,49,2,not,"('CHI', 'FAT')",Providence,nai49.xml,50,1,1,FAT,316,395,CHI
2,1,6,71,2.406945108,72,1,not,"('MOT', 'CHI')",Providence,nai49.xml,80,8,2,CHI,1046,516,MOT
0,1,2,85,2.397895273,86,1,my,"('MOT', 'FAT')",Providence,nai49.xml,88,2,0,FAT,1157,699,MOT
1,2,2,75,2.354544832,77,2,was,"('MOT', 'CHI')",Providence,nai49.xml,80,3,1,CHI,1046,516,MOT
0,1,1,59,2.335374916,60,1,go,"('CHI', 'MOT')",Providence,nai49.xml,61,1,0,MOT,448,759,CHI
0,1,1,59,2.335374916,60,1,was,"('CHI', 'MOT')",Providence,nai49.xml,61,1,0,MOT,448,759,CHI
0,1,1,59,2.335374916,60,1,are,"('CHI', 'MOT')",Providence,nai49.xml,61,1,0,MOT,448,759,CHI
2,1,3,45,2.33075597,46,1,in,"('FAT', 'MOT')",Providence,nai49.xml,51,5,2,MOT,433,605,FAT
1,2,1,57,2.319114395,59,2,think,"('CHI', 'MOT')",Providence,nai49.xml,61,2,1,MOT,448,759,CHI
0,1,2,77,2.302585093,78,1,of,"('MOT', 'CHI')",Providence,nai49.xml,80,2,0,CHI,1046,516,MOT
1,1,2,47,2.302585093,48,1,did,"('FAT', 'MOT')",Providence,nai49.xml,51,3,1,MOT,433,605,FAT
0,2,1,85,2.291411792,87,2,little,"('MOT', 'FAT')",Providence,nai49.xml,88,1,0,FAT,1157,699,MOT
1,1,2,44,2.240709689,45,1,was,"('FAT', 'CHI')",Providence,nai49.xml,48,3,1,CHI,424,326,FAT
2,4,0,55,2.213753879,59,4,have,"('CHI', 'MOT')",Providence,nai49.xml,61,2,2,MOT,448,759,CHI
0,2,1,77,2.197224577,79,2,go,"('MOT', 'CHI')",Providence,nai49.xml,80,1,0,CHI,1046,516,MOT
0,2,1,77,2.197224577,79,2,up,"('MOT', 'CHI')",Providence,nai49.xml,80,1,0,CHI,1046,516,MOT
0,1,1,49,2.159484249,50,1,wanna,"('FAT', 'MOT')",Providence,nai49.xml,51,1,0,MOT,433,605,FAT
0,1,1,49,2.159484249,50,1,one,"('FAT', 'MOT')",Providence,nai49.xml,51,1,0,MOT,433,605,FAT
0,1,1,49,2.159484249,50,1,where,"('FAT', 'MOT')",Providence,nai49.xml,51,1,0,MOT,433,605,FAT
1,3,0,47,2.159484249,50,3,at,"('FAT', 'MOT')",Providence,nai49.xml,51,1,1,MOT,433,605,FAT
1,2,1,46,2.120263536,48,2,on,"('CHI', 'FAT')",Providence,nai49.xml,50,2,1,FAT,316,395,CHI
0,1,1,46,2.100060829,47,1,like,"('FAT', 'CHI')",Providence,nai49.xml,48,1,0,CHI,424,326,FAT
0,1,1,46,2.100060829,47,1,see,"('FAT', 'CHI')",Providence,nai49.xml,48,1,0,CHI,424,326,FAT
0,1,3,76,2.066862759,77,1,see,"('MOT', 'CHI')",Providence,nai49.xml,80,3,0,CHI,1046,516,MOT
0,1,3,76,2.066862759,77,1,at,"('MOT', 'CHI')",Providence,nai49.xml,80,3,0,CHI,1046,516,MOT
0,1,3,76,2.066862759,77,1,one,"('MOT', 'CHI')",Providence,nai49.xml,80,3,0,CHI,1046,516,MOT
0,1,2,58,2.031432322,59,1,want,"('CHI', 'MOT')",Providence,nai49.xml,61,2,0,MOT,448,759,CHI
0,2,2,84,1.992430165,86,2,with,"('MOT', 'FAT')",Providence,nai49.xml,88,2,0,FAT,1157,699,MOT
0,2,2,84,1.992430165,86,2,there,"('MOT', 'FAT')",Providence,nai49.xml,88,2,0,FAT,1157,699,MOT
0,2,2,84,1.992430165,86,2,see,"('MOT', 'FAT')",Providence,nai49.xml,88,2,0,FAT,1157,699,MOT
0,2,2,84,1.992430165,86,2,put,"('MOT', 'FAT')",Providence,nai49.xml,88,2,0,FAT,1157,699,MOT
0,2,2,84,1.992430165,86,2,at,"('MOT', 'FAT')",Providence,nai49.xml,88,2,0,FAT,1157,699,MOT
0,2,2,84,1.992430165,86,2,on,"('MOT', 'FAT')",Providence,nai49.xml,88,2,0,FAT,1157,699,MOT
1,2,4,73,1.992430165,75,2,gonna,"('MOT', 'CHI')",Providence,nai49.xml,80,5,1,CHI,1046,516,MOT
1,4,0,46,1.936340698,50,4,on,"('FAT', 'MOT')",Providence,nai49.xml,51,1,1,MOT,433,605,FAT
1,1,4,44,1.904237453,45,1,put,"('CHI', 'FAT')",Providence,nai49.xml,50,5,1,FAT,316,395,CHI
2,1,12,65,1.852384091,66,1,that,"('MOT', 'CHI')",Providence,nai49.xml,80,14,2,CHI,1046,516,MOT
0,1,2,48,1.852384091,49,1,get,"('FAT', 'MOT')",Providence,nai49.xml,51,2,0,MOT,433,605,FAT
0,1,2,48,1.852384091,49,1,with,"('FAT', 'MOT')",Providence,nai49.xml,51,2,0,MOT,433,605,FAT
1,1,10,76,1.804498495,77,1,but,"('MOT', 'FAT')",Providence,nai49.xml,88,11,1,FAT,1157,699,MOT
1,3,4,80,1.803593927,83,3,no,"('MOT', 'FAT')",Providence,nai49.xml,88,5,1,FAT,1157,699,MOT
0,1,5,82,1.803593927,83,1,can,"('MOT', 'FAT')",Providence,nai49.xml,88,5,0,FAT,1157,699,MOT
0,1,2,45,1.791759469,46,1,go,"('FAT', 'CHI')",Providence,nai49.xml,48,2,0,CHI,424,326,FAT
0,1,2,45,1.791759469,46,1,not,"('FAT', 'CHI')",Providence,nai49.xml,48,2,0,CHI,424,326,FAT
1,3,1,43,1.791759469,46,3,and,"('FAT', 'CHI')",Providence,nai49.xml,48,2,1,CHI,424,326,FAT
2,5,1,53,1.791759469,58,5,some,"('CHI', 'MOT')",Providence,nai49.xml,61,3,2,MOT,448,759,CHI
0,2,1,48,1.754019141,50,2,there,"('FAT', 'MOT')",Providence,nai49.xml,51,1,0,MOT,433,605,FAT
0,2,1,48,1.754019141,50,2,big,"('FAT', 'MOT')",Providence,nai49.xml,51,1,0,MOT,433,605,FAT
2,7,0,52,1.74375025,59,7,on,"('CHI', 'MOT')",Providence,nai49.xml,61,2,2,MOT,448,759,CHI
0,1,5,74,1.704748092,75,1,this,"('MOT', 'CHI')",Providence,nai49.xml,80,5,0,CHI,1046,516,MOT
1,2,7,78,1.698669046,80,2,we,"('MOT', 'FAT')",Providence,nai49.xml,88,8,1,FAT,1157,699,MOT
0,3,1,57,1.642227735,60,3,there,"('CHI', 'MOT')",Providence,nai49.xml,61,1,0,MOT,448,759,CHI
0,3,1,57,1.642227735,60,3,did,"('CHI', 'MOT')",Providence,nai49.xml,61,1,0,MOT,448,759,CHI
0,3,1,57,1.642227735,60,3,not,"('CHI', 'MOT')",Providence,nai49.xml,61,1,0,MOT,448,759,CHI
0,2,2,57,1.625967214,59,2,put,"('CHI', 'MOT')",Providence,nai49.xml,61,2,0,MOT,448,759,CHI
0,2,2,57,1.625967214,59,2,one,"('CHI', 'MOT')",Providence,nai49.xml,61,2,0,MOT,448,759,CHI
1,5,1,54,1.625967214,59,5,and,"('CHI', 'MOT')",Providence,nai49.xml,61,2,1,MOT,448,759,CHI
1,3,2,45,1.609437912,48,3,can,"('FAT', 'MOT')",Providence,nai49.xml,51,3,1,MOT,433,605,FAT
0,1,4,56,1.592630794,57,1,in,"('CHI', 'MOT')",Providence,nai49.xml,61,4,0,MOT,448,759,CHI
0,1,6,73,1.558144618,74,1,we,"('MOT', 'CHI')",Providence,nai49.xml,80,6,0,CHI,1046,516,MOT
1,3,6,78,1.52846885,81,3,like,"('MOT', 'FAT')",Providence,nai49.xml,88,7,1,FAT,1157,699,MOT
0,1,7,80,1.52846885,81,1,what,"('MOT', 'FAT')",Providence,nai49.xml,88,7,0,FAT,1157,699,MOT
0,1,7,80,1.52846885,81,1,this,"('MOT', 'FAT')",Providence,nai49.xml,88,7,0,FAT,1157,699,MOT
2,0,0,4,1.504077397,4,0,it,"('CHI', 'GR2')",Providence,nai49.xml,6,2,2,GR2,33,49,CHI
2,6,4,76,1.504077397,82,6,are,"('MOT', 'FAT')",Providence,nai49.xml,88,6,2,FAT,1157,699,MOT
2,3,4,42,1.483023988,45,3,and,"('FAT', 'MOT')",Providence,nai49.xml,51,6,2,MOT,433,605,FAT
1,6,1,53,1.471816535,59,6,with,"('CHI', 'MOT')",Providence,nai49.xml,61,2,1,MOT,448,759,CHI
0,3,1,47,1.466337069,50,3,little,"('FAT', 'MOT')",Providence,nai49.xml,51,1,0,MOT,433,605,FAT
0,3,1,47,1.466337069,50,3,no,"('FAT', 'MOT')",Providence,nai49.xml,51,1,0,MOT,433,605,FAT
0,3,1,47,1.466337069,50,3,not,"('FAT', 'MOT')",Providence,nai49.xml,51,1,0,MOT,433,605,FAT
2,3,4,41,1.461517782,44,3,do,"('CHI', 'FAT')",Providence,nai49.xml,50,6,2,FAT,316,395,CHI
0,3,1,46,1.446918983,49,3,like,"('CHI', 'FAT')",Providence,nai49.xml,50,1,0,FAT,316,395,CHI
0,3,1,46,1.446918983,49,3,what,"('CHI', 'FAT')",Providence,nai49.xml,50,1,0,FAT,316,395,CHI
0,3,1,46,1.446918983,49,3,some,"('CHI', 'FAT')",Providence,nai49.xml,50,1,0,FAT,316,395,CHI
0,2,2,47,1.446918983,49,2,want,"('FAT', 'MOT')",Providence,nai49.xml,51,2,0,MOT,433,605,FAT
0,2,2,47,1.446918983,49,2,we,"('FAT', 'MOT')",Providence,nai49.xml,51,2,0,MOT,433,605,FAT
1,5,1,44,1.446918983,49,5,what,"('FAT', 'MOT')",Providence,nai49.xml,51,2,1,MOT,433,605,FAT
1,5,1,43,1.427116356,48,5,it,"('CHI', 'FAT')",Providence,nai49.xml,50,2,1,FAT,316,395,CHI
5,8,2,46,1.422662005,54,8,a,"('CHI', 'MOT')",Providence,nai49.xml,61,7,5,MOT,448,759,CHI
0,4,1,56,1.419084184,60,4,wanna,"('CHI', 'MOT')",Providence,nai49.xml,61,1,0,MOT,448,759,CHI
0,1,4,46,1.406913648,47,1,are,"('FAT', 'MOT')",Providence,nai49.xml,51,4,0,MOT,433,605,FAT
0,2,2,44,1.386294361,46,2,some,"('FAT', 'CHI')",Providence,nai49.xml,48,2,0,CHI,424,326,FAT
2,4,7,67,1.381738545,71,4,is,"('MOT', 'CHI')",Providence,nai49.xml,80,9,2,CHI,1046,516,MOT
0,1,4,43,1.343734747,44,1,it,"('FAT', 'CHI')",Providence,nai49.xml,48,4,0,CHI,424,326,FAT
0,3,2,56,1.338285142,59,3,is,"('CHI', 'MOT')",Providence,nai49.xml,61,2,0,MOT,448,759,CHI
1,4,2,41,1.324418957,45,4,do,"('FAT', 'CHI')",Providence,nai49.xml,48,3,1,CHI,424,326,FAT
4,5,4,38,1.32175584,43,5,it,"('FAT', 'MOT')",Providence,nai49.xml,51,8,4,MOT,433,605,FAT
1,3,8,76,1.303406701,79,3,have,"('MOT', 'FAT')",Providence,nai49.xml,88,9,1,FAT,1157,699,MOT
0,3,4,81,1.276293466,84,3,not,"('MOT', 'FAT')",Providence,nai49.xml,88,4,0,FAT,1157,699,MOT
0,2,6,80,1.252762968,82,2,up,"('MOT', 'FAT')",Providence,nai49.xml,88,6,0,FAT,1157,699,MOT
0,5,1,55,1.236762627,60,5,this,"('CHI', 'MOT')",Providence,nai49.xml,61,1,0,MOT,448,759,CHI
1,6,2,52,1.232143681,58,6,gonna,"('CHI', 'MOT')",Providence,nai49.xml,61,3,1,MOT,448,759,CHI
1,3,4,43,1.232143681,46,3,have,"('FAT', 'MOT')",Providence,nai49.xml,51,5,1,MOT,433,605,FAT
1,2,6,42,1.225951711,44,2,do,"('FAT', 'MOT')",Providence,nai49.xml,51,7,1,MOT,433,605,FAT
0,1,5,44,1.211090272,45,1,in,"('CHI', 'FAT')",Providence,nai49.xml,50,5,0,FAT,316,395,CHI
0,5,2,73,1.203972804,78,5,what,"('MOT', 'CHI')",Providence,nai49.xml,80,2,0,CHI,1046,516,MOT
1,5,2,43,1.203972804,48,5,was,"('FAT', 'MOT')",Providence,nai49.xml,51,3,1,MOT,433,605,FAT
0,1,9,70,1.199416988,71,1,are,"('MOT', 'CHI')",Providence,nai49.xml,80,9,0,CHI,1046,516,MOT
4,6,9,61,1.189584067,67,6,it,"('MOT', 'CHI')",Providence,nai49.xml,80,13,4,CHI,1046,516,MOT
1,4,7,76,1.187843422,80,4,oh,"('MOT', 'FAT')",Providence,nai49.xml,88,8,1,FAT,1157,699,MOT
1,4,3,43,1.183770097,47,4,that,"('FAT', 'MOT')",Providence,nai49.xml,51,4,1,MOT,433,605,FAT
2,8,1,39,1.183770097,47,8,that,"('CHI', 'FAT')",Providence,nai49.xml,50,3,2,FAT,316,395,CHI
0,3,2,46,1.15923691,49,3,like,"('FAT', 'MOT')",Providence,nai49.xml,51,2,0,MOT,433,605,FAT
1,3,10,74,1.111351314,77,3,for,"('MOT', 'FAT')",Providence,nai49.xml,88,11,1,FAT,1157,699,MOT
0,5,1,45,1.060871961,50,5,this,"('FAT', 'MOT')",Providence,nai49.xml,51,1,0,MOT,433,605,FAT
2,4,12,70,1.047318994,74,4,to,"('MOT', 'FAT')",Providence,nai49.xml,88,14,2,FAT,1157,699,MOT
1,6,2,41,1.029619417,47,6,a,"('CHI', 'FAT')",Providence,nai49.xml,50,3,1,FAT,316,395,CHI
2,8,5,65,1.021651248,73,8,some,"('MOT', 'CHI')",Providence,nai49.xml,80,7,2,CHI,1046,516,MOT
0,2,7,71,1.021651248,73,2,on,"('MOT', 'CHI')",Providence,nai49.xml,80,7,0,CHI,1046,516,MOT
0,1,6,41,1.011600912,42,1,of,"('FAT', 'CHI')",Providence,nai49.xml,48,6,0,CHI,424,326,FAT
0,9,1,70,0.993251773,79,9,no,"('MOT', 'CHI')",Providence,nai49.xml,80,1,0,CHI,1046,516,MOT
0,2,4,44,0.980829253,46,2,think,"('CHI', 'FAT')",Providence,nai49.xml,50,4,0,FAT,316,395,CHI
0,3,6,79,0.965080896,82,3,was,"('MOT', 'FAT')",Providence,nai49.xml,88,6,0,FAT,1157,699,MOT
0,3,6,79,0.965080896,82,3,some,"('MOT', 'FAT')",Providence,nai49.xml,88,6,0,FAT,1157,699,MOT
5,4,10,31,0.960026125,35,4,the,"('CHI', 'FAT')",Providence,nai49.xml,50,15,5,FAT,316,395,CHI
2,1,15,30,0.95753369,31,1,you,"('FAT', 'CHI')",Providence,nai49.xml,48,17,2,CHI,424,326,FAT
0,2,4,42,0.938269639,44,2,in,"('FAT', 'CHI')",Providence,nai49.xml,48,4,0,CHI,424,326,FAT
0,4,2,45,0.936093359,49,4,they,"('FAT', 'MOT')",Providence,nai49.xml,51,2,0,MOT,433,605,FAT
0,4,2,44,0.916290732,48,4,gonna,"('CHI', 'FAT')",Providence,nai49.xml,50,2,0,FAT,316,395,CHI
0,1,9,51,0.897941593,52,1,no,"('CHI', 'MOT')",Providence,nai49.xml,61,9,0,MOT,448,759,CHI
1,4,10,73,0.888207763,77,4,think,"('MOT', 'FAT')",Providence,nai49.xml,88,11,1,FAT,1157,699,MOT
2,18,0,41,0.878752813,59,18,you,"('CHI', 'MOT')",Providence,nai49.xml,61,2,2,MOT,448,759,CHI
1,0,2,4,0.875468737,4,0,the,"('GR2', 'CHI')",Providence,nai49.xml,7,3,1,CHI,50,37,GR2
3,6,13,66,0.854077547,72,6,and,"('MOT', 'FAT')",Providence,nai49.xml,88,16,3,FAT,1157,699,MOT
6,10,6,39,0.840783179,49,10,the,"('CHI', 'MOT')",Providence,nai49.xml,61,12,6,MOT,448,759,CHI
0,6,3,71,0.814099791,77,6,think,"('MOT', 'CHI')",Providence,nai49.xml,80,3,0,CHI,1046,516,MOT
4,7,6,34,0.806289837,41,7,the,"('FAT', 'MOT')",Providence,nai49.xml,51,10,4,MOT,433,605,FAT
2,8,7,63,0.79395188,71,8,do,"('MOT', 'CHI')",Providence,nai49.xml,80,9,2,CHI,1046,516,MOT
0,2,5,41,0.762140052,43,2,yeah,"('FAT', 'CHI')",Providence,nai49.xml,48,5,0,CHI,424,326,FAT
0,5,2,44,0.753771802,49,5,for,"('FAT', 'MOT')",Providence,nai49.xml,51,2,0,MOT,433,605,FAT
0,1,8,39,0.741937345,40,1,are,"('FAT', 'CHI')",Providence,nai49.xml,48,8,0,CHI,424,326,FAT
0,4,6,78,0.741937345,82,4,gonna,"('MOT', 'FAT')",Providence,nai49.xml,88,6,0,FAT,1157,699,MOT
0,4,6,78,0.741937345,82,4,do,"('MOT', 'FAT')",Providence,nai49.xml,88,6,0,FAT,1157,699,MOT
0,3,7,70,0.733969175,73,3,in,"('MOT', 'CHI')",Providence,nai49.xml,80,7,0,CHI,1046,516,MOT
0,3,4,44,0.713766468,47,3,but,"('FAT', 'MOT')",Providence,nai49.xml,51,4,0,MOT,433,605,FAT
0,2,11,75,0.705886206,77,2,of,"('MOT', 'FAT')",Providence,nai49.xml,88,11,0,FAT,1157,699,MOT
1,0,0,1,0.693147181,1,0,a,"('FAT', 'GR2')",Providence,nai49.xml,2,1,1,GR2,21,15,FAT
0,5,2,41,0.693147181,46,5,no,"('FAT', 'CHI')",Providence,nai49.xml,48,2,0,CHI,424,326,FAT
1,5,5,40,0.672093771,45,5,to,"('FAT', 'MOT')",Providence,nai49.xml,51,6,1,MOT,433,605,FAT
6,15,9,58,0.657596196,73,15,you,"('MOT', 'FAT')",Providence,nai49.xml,88,15,6,FAT,1157,699,MOT
0,7,2,52,0.645137961,59,7,that,"('CHI', 'MOT')",Providence,nai49.xml,61,2,0,MOT,448,759,CHI
4,6,9,32,0.644357016,38,6,you,"('FAT', 'MOT')",Providence,nai49.xml,51,13,4,MOT,433,605,FAT
1,6,9,72,0.644357016,78,6,is,"('MOT', 'FAT')",Providence,nai49.xml,88,10,1,FAT,1157,699,MOT
0,2,6,40,0.606135804,42,2,for,"('FAT', 'CHI')",Providence,nai49.xml,48,6,0,CHI,424,326,FAT
3,10,11,64,0.546543706,74,10,a,"('MOT', 'FAT')",Providence,nai49.xml,88,14,3,FAT,1157,699,MOT
1,5,6,39,0.53280453,44,5,oh,"('FAT', 'MOT')",Providence,nai49.xml,51,7,1,MOT,433,605,FAT
2,10,5,44,0.528844129,54,10,it,"('CHI', 'MOT')",Providence,nai49.xml,61,7,2,MOT,448,759,CHI
3,15,2,30,0.517943092,45,15,you,"('CHI', 'FAT')",Providence,nai49.xml,50,5,3,FAT,316,395,CHI
0,5,3,43,0.510825624,48,5,yeah,"('FAT', 'MOT')",Providence,nai49.xml,51,3,0,MOT,433,605,FAT
0,5,3,43,0.510825624,48,5,is,"('FAT', 'MOT')",Providence,nai49.xml,51,3,0,MOT,433,605,FAT
0,9,1,38,0.490622916,47,9,think,"('FAT', 'CHI')",Providence,nai49.xml,48,1,0,CHI,424,326,FAT
0,2,7,39,0.46536325,41,2,what,"('FAT', 'CHI')",Providence,nai49.xml,48,7,0,CHI,424,326,FAT
5,10,17,56,0.435318071,66,10,the,"('MOT', 'FAT')",Providence,nai49.xml,88,22,5,FAT,1157,699,MOT
0,4,4,40,0.427444015,44,4,that,"('FAT', 'CHI')",Providence,nai49.xml,48,4,0,CHI,424,326,FAT
2,7,13,58,0.390650022,65,7,to,"('MOT', 'CHI')",Providence,nai49.xml,80,15,2,CHI,1046,516,MOT
1,1,31,47,0.385662481,48,1,you,"('MOT', 'CHI')",Providence,nai49.xml,80,32,1,CHI,1046,516,MOT
1,6,6,35,0.31121257,41,6,to,"('FAT', 'CHI')",Providence,nai49.xml,48,7,1,CHI,424,326,FAT
1,3,11,33,0.30538165,36,3,a,"('FAT', 'CHI')",Providence,nai49.xml,48,12,1,CHI,424,326,FAT
0,1,1,5,0.287682072,6,1,with,"('GR2', 'CHI')",Providence,nai49.xml,7,1,0,CHI,50,37,GR2
1,7,12,68,0.24946086,75,7,in,"('MOT', 'FAT')",Providence,nai49.xml,88,13,1,FAT,1157,699,MOT
0,9,5,74,0.194156014,83,9,yeah,"('MOT', 'FAT')",Providence,nai49.xml,88,5,0,FAT,1157,699,MOT
1,6,10,44,0.133531393,50,6,do,"('CHI', 'MOT')",Providence,nai49.xml,61,11,1,MOT,448,759,CHI
0,5,5,41,0.133531393,46,5,some,"('FAT', 'MOT')",Providence,nai49.xml,51,5,0,MOT,433,605,FAT
1,8,6,33,0.059898142,41,8,the,"('FAT', 'CHI')",Providence,nai49.xml,48,7,1,CHI,424,326,FAT
0,6,6,49,0.017699577,55,6,what,"('CHI', 'MOT')",Providence,nai49.xml,61,6,0,MOT,448,759,CHI
4,10,20,46,0.013889112,56,10,the,"('MOT', 'CHI')",Providence,nai49.xml,80,24,4,CHI,1046,516,MOT
1,11,10,66,0.012739026,77,11,it,"('MOT', 'FAT')",Providence,nai49.xml,88,11,1,FAT,1157,699,MOT
1,10,8,42,-0.113659318,52,10,to,"('CHI', 'MOT')",Providence,nai49.xml,61,9,1,MOT,448,759,CHI
0,3,20,65,-0.228841572,68,3,that,"('MOT', 'FAT')",Providence,nai49.xml,88,20,0,FAT,1157,699,MOT
0,10,9,61,-0.505331104,71,10,want,"('MOT', 'CHI')",Providence,nai49.xml,80,9,0,CHI,1046,516,MOT
0,11,5,35,-0.559615788,46,11,a,"('FAT', 'MOT')",Providence,nai49.xml,51,5,0,MOT,433,605,FAT
0,1,1,0,-0.693147181,1,1,you,"('FAT', 'GR2')",Providence,nai49.xml,2,1,0,GR2,21,15,FAT
3,2,0,177,3.876741191,179,2,big,"('CHI', 'MOT')",Providence,nai50.xml,182,3,3,MOT,1399,1682,CHI
2,0,1,76,3.845883203,76,0,he,"('MOT', 'CHI')",Providence,nai50.xml,79,3,2,CHI,947,388,MOT
1,3,0,178,3.417726684,181,3,not,"('CHI', 'MOT')",Providence,nai50.xml,182,1,1,MOT,1399,1682,CHI
1,4,0,177,3.194583132,181,4,have,"('CHI', 'MOT')",Providence,nai50.xml,182,1,1,MOT,1399,1682,CHI
0,1,2,179,3.124565145,180,1,look,"('CHI', 'MOT')",Providence,nai50.xml,182,2,0,MOT,1399,1682,CHI
0,1,2,179,3.124565145,180,1,she,"('CHI', 'MOT')",Providence,nai50.xml,182,2,0,MOT,1399,1682,CHI
1,0,4,74,3.077970372,74,0,for,"('MOT', 'CHI')",Providence,nai50.xml,79,5,1,CHI,947,388,MOT
2,6,0,174,2.970414466,180,6,make,"('CHI', 'MOT')",Providence,nai50.xml,182,2,2,MOT,1399,1682,CHI
2,5,1,174,2.895911938,179,5,at,"('CHI', 'MOT')",Providence,nai50.xml,182,3,2,MOT,1399,1682,CHI
0,1,1,93,2.772588722,94,1,make,"('FAT', 'CHI')",Providence,nai50.xml,95,1,0,CHI,1132,868,FAT
0,1,1,93,2.772588722,94,1,where,"('FAT', 'CHI')",Providence,nai50.xml,95,1,0,CHI,1132,868,FAT
5,1,9,80,2.744864174,81,1,it,"('FAT', 'CHI')",Providence,nai50.xml,95,14,5,CHI,1132,868,FAT
1,1,3,90,2.740840024,91,1,they,"('FAT', 'CHI')",Providence,nai50.xml,95,4,1,CHI,1132,868,FAT
0,3,1,178,2.724579503,181,3,some,"('CHI', 'MOT')",Providence,nai50.xml,182,1,0,MOT,1399,1682,CHI
0,3,1,178,2.724579503,181,3,one,"('CHI', 'MOT')",Providence,nai50.xml,182,1,0,MOT,1399,1682,CHI
0,2,2,178,2.719100037,180,2,wanna,"('CHI', 'MOT')",Providence,nai50.xml,182,2,0,MOT,1399,1682,CHI
1,2,5,174,2.696876901,176,2,little,"('CHI', 'MOT')",Providence,nai50.xml,182,6,1,MOT,1399,1682,CHI
1,4,2,175,2.672768387,179,4,get,"('CHI', 'MOT')",Providence,nai50.xml,182,3,1,MOT,1399,1682,CHI
0,1,1,77,2.590267165,78,1,some,"('MOT', 'CHI')",Providence,nai50.xml,79,1,0,CHI,947,388,MOT
1,0,8,70,2.571918027,70,0,with,"('MOT', 'CHI')",Providence,nai50.xml,79,9,1,CHI,947,388,MOT
4,6,4,168,2.531426665,174,6,for,"('CHI', 'MOT')",Providence,nai50.xml,182,8,4,MOT,1399,1682,CHI
1,2,2,90,2.528391762,92,2,all,"('FAT', 'CHI')",Providence,nai50.xml,95,3,1,CHI,1132,868,FAT
0,4,1,177,2.501435952,181,4,can,"('CHI', 'MOT')",Providence,nai50.xml,182,1,0,MOT,1399,1682,CHI
0,1,2,92,2.47443535,93,1,with,"('FAT', 'CHI')",Providence,nai50.xml,95,2,0,CHI,1132,868,FAT
0,2,1,92,2.367123614,94,2,look,"('FAT', 'CHI')",Providence,nai50.xml,95,1,0,CHI,1132,868,FAT
0,2,1,92,2.367123614,94,2,wanna,"('FAT', 'CHI')",Providence,nai50.xml,95,1,0,CHI,1132,868,FAT
0,5,1,176,2.319114395,181,5,go,"('CHI', 'MOT')",Providence,nai50.xml,182,1,0,MOT,1399,1682,CHI
5,11,2,164,2.285777975,175,11,they,"('CHI', 'MOT')",Providence,nai50.xml,182,7,5,MOT,1399,1682,CHI
0,1,3,91,2.240709689,92,1,have,"('FAT', 'CHI')",Providence,nai50.xml,95,3,0,CHI,1132,868,FAT
1,9,1,171,2.208274414,180,9,we,"('CHI', 'MOT')",Providence,nai50.xml,182,2,1,MOT,1399,1682,CHI
0,6,1,175,2.164963715,181,6,like,"('CHI', 'MOT')",Providence,nai50.xml,182,1,0,MOT,1399,1682,CHI
1,6,3,172,2.148434413,178,6,with,"('CHI', 'MOT')",Providence,nai50.xml,182,4,1,MOT,1399,1682,CHI
3,7,6,166,2.073743521,173,7,he,"('CHI', 'MOT')",Providence,nai50.xml,182,9,3,MOT,1399,1682,CHI
0,2,2,91,2.068970242,93,2,go,"('FAT', 'CHI')",Providence,nai50.xml,95,2,0,CHI,1132,868,FAT
0,2,2,91,2.068970242,93,2,not,"('FAT', 'CHI')",Providence,nai50.xml,95,2,0,CHI,1132,868,FAT
0,1,3,75,2.054123734,76,1,yeah,"('MOT', 'CHI')",Providence,nai50.xml,79,3,0,CHI,947,388,MOT
0,1,3,75,2.054123734,76,1,of,"('MOT', 'CHI')",Providence,nai50.xml,79,3,0,CHI,947,388,MOT
0,1,3,75,2.054123734,76,1,can,"('MOT', 'CHI')",Providence,nai50.xml,79,3,0,CHI,947,388,MOT
2,5,2,86,2.047692843,91,5,in,"('FAT', 'CHI')",Providence,nai50.xml,95,4,2,CHI,1132,868,FAT
0,1,4,90,2.047692843,91,1,my,"('FAT', 'CHI')",Providence,nai50.xml,95,4,0,CHI,1132,868,FAT
0,7,1,174,2.031432322,181,7,are,"('CHI', 'MOT')",Providence,nai50.xml,182,1,0,MOT,1399,1682,CHI
1,2,5,87,2.025952857,89,2,of,"('FAT', 'CHI')",Providence,nai50.xml,95,6,1,CHI,1132,868,FAT
5,3,7,64,2.000514283,67,3,a,"('MOT', 'CHI')",Providence,nai50.xml,79,12,5,CHI,947,388,MOT
1,13,1,167,1.871802177,180,13,of,"('CHI', 'MOT')",Providence,nai50.xml,182,2,1,MOT,1399,1682,CHI
0,1,4,74,1.858898772,75,1,in,"('MOT', 'CHI')",Providence,nai50.xml,79,4,0,CHI,947,388,MOT
0,1,4,74,1.858898772,75,1,this,"('MOT', 'CHI')",Providence,nai50.xml,79,4,0,CHI,947,388,MOT
0,1,4,74,1.858898772,75,1,think,"('MOT', 'CHI')",Providence,nai50.xml,79,4,0,CHI,947,388,MOT
0,1,4,74,1.858898772,75,1,are,"('MOT', 'CHI')",Providence,nai50.xml,79,4,0,CHI,947,388,MOT
0,1,4,74,1.858898772,75,1,on,"('MOT', 'CHI')",Providence,nai50.xml,79,4,0,CHI,947,388,MOT
1,7,4,170,1.855181296,177,7,put,"('CHI', 'MOT')",Providence,nai50.xml,182,5,1,MOT,1399,1682,CHI
0,2,3,90,1.835244581,92,2,was,"('FAT', 'CHI')",Providence,nai50.xml,95,3,0,CHI,1132,868,FAT
0,3,2,90,1.781288169,93,3,see,"('FAT', 'CHI')",Providence,nai50.xml,95,2,0,CHI,1132,868,FAT
0,3,2,90,1.781288169,93,3,on,"('FAT', 'CHI')",Providence,nai50.xml,95,2,0,CHI,1132,868,FAT
0,7,2,173,1.738270784,180,7,there,"('CHI', 'MOT')",Providence,nai50.xml,182,2,0,MOT,1399,1682,CHI
1,3,5,86,1.738270784,89,3,some,"('FAT', 'CHI')",Providence,nai50.xml,95,6,1,CHI,1132,868,FAT
1,7,5,169,1.716047647,176,7,this,"('CHI', 'MOT')",Providence,nai50.xml,182,6,1,MOT,1399,1682,CHI
1,4,4,86,1.659587696,90,4,that,"('FAT', 'CHI')",Providence,nai50.xml,95,5,1,CHI,1132,868,FAT
0,8,2,172,1.620487749,180,8,gonna,"('CHI', 'MOT')",Providence,nai50.xml,182,2,0,MOT,1399,1682,CHI
0,1,6,72,1.544899391,73,1,go,"('MOT', 'CHI')",Providence,nai50.xml,79,6,0,CHI,947,388,MOT
1,0,0,5,1.540445041,5,0,what,"('CHI', 'FAT')",Providence,nai50.xml,6,1,1,FAT,32,36,CHI
5,11,11,155,1.540445041,166,11,that,"('CHI', 'MOT')",Providence,nai50.xml,182,16,5,MOT,1399,1682,CHI
12,14,16,140,1.505557782,154,14,is,"('CHI', 'MOT')",Providence,nai50.xml,182,28,12,MOT,1399,1682,CHI
3,4,10,78,1.499623046,82,4,are,"('FAT', 'CHI')",Providence,nai50.xml,95,13,3,CHI,1132,868,FAT
0,5,1,73,1.491654877,78,5,no,"('MOT', 'CHI')",Providence,nai50.xml,79,1,0,CHI,947,388,MOT
0,2,5,88,1.477266139,90,2,want,"('FAT', 'CHI')",Providence,nai50.xml,95,5,0,CHI,1132,868,FAT
0,2,5,88,1.477266139,90,2,up,"('FAT', 'CHI')",Providence,nai50.xml,95,5,0,CHI,1132,868,FAT
0,2,5,88,1.477266139,90,2,can,"('FAT', 'CHI')",Providence,nai50.xml,95,5,0,CHI,1132,868,FAT
1,8,6,167,1.474847758,175,8,on,"('CHI', 'MOT')",Providence,nai50.xml,182,7,1,MOT,1399,1682,CHI
4,15,7,156,1.425191427,171,15,it,"('CHI', 'MOT')",Providence,nai50.xml,182,11,4,MOT,1399,1682,CHI
6,19,7,150,1.383791231,169,19,in,"('CHI', 'MOT')",Providence,nai50.xml,182,13,6,MOT,1399,1682,CHI
0,4,2,73,1.373715579,77,4,want,"('MOT', 'CHI')",Providence,nai50.xml,79,2,0,CHI,947,388,MOT
0,3,4,88,1.354545663,91,3,she,"('FAT', 'CHI')",Providence,nai50.xml,95,4,0,CHI,1132,868,FAT
0,1,1,20,1.343734747,21,1,gonna,"('MOT', 'FAT')",Providence,nai50.xml,22,1,0,FAT,195,142,MOT
0,1,1,20,1.343734747,21,1,for,"('MOT', 'FAT')",Providence,nai50.xml,22,1,0,FAT,195,142,MOT
0,1,1,20,1.343734747,21,1,with,"('MOT', 'FAT')",Providence,nai50.xml,22,1,0,FAT,195,142,MOT
0,1,1,20,1.343734747,21,1,was,"('MOT', 'FAT')",Providence,nai50.xml,22,1,0,FAT,195,142,MOT
0,1,1,20,1.343734747,21,1,my,"('MOT', 'FAT')",Providence,nai50.xml,22,1,0,FAT,195,142,MOT
0,1,1,20,1.343734747,21,1,some,"('MOT', 'FAT')",Providence,nai50.xml,22,1,0,FAT,195,142,MOT
0,1,1,20,1.343734747,21,1,are,"('MOT', 'FAT')",Providence,nai50.xml,22,1,0,FAT,195,142,MOT
0,4,3,88,1.324418957,92,4,do,"('FAT', 'CHI')",Providence,nai50.xml,95,3,0,CHI,1132,868,FAT
1,2,12,80,1.31730149,82,2,get,"('FAT', 'CHI')",Providence,nai50.xml,95,13,1,CHI,1132,868,FAT
0,2,5,72,1.286210903,74,2,like,"('MOT', 'CHI')",Providence,nai50.xml,79,5,0,CHI,947,388,MOT
0,1,9,69,1.185623666,70,1,where,"('MOT', 'CHI')",Providence,nai50.xml,79,9,0,CHI,947,388,MOT
5,11,18,148,1.16938136,159,11,to,"('CHI', 'MOT')",Providence,nai50.xml,182,23,5,MOT,1399,1682,CHI
0,10,1,84,1.06784063,94,10,think,"('FAT', 'CHI')",Providence,nai50.xml,95,1,0,CHI,1132,868,FAT
0,20,1,161,1.066351426,181,20,oh,"('CHI', 'MOT')",Providence,nai50.xml,182,1,0,MOT,1399,1682,CHI
3,4,13,59,1.060871961,63,4,what,"('MOT', 'CHI')",Providence,nai50.xml,79,16,3,CHI,947,388,MOT
0,3,6,86,1.045123604,89,3,yeah,"('FAT', 'CHI')",Providence,nai50.xml,95,6,0,CHI,1132,868,FAT
1,2,2,17,1.029619417,19,2,oh,"('MOT', 'FAT')",Providence,nai50.xml,22,3,1,FAT,195,142,MOT
1,2,2,17,1.029619417,19,2,the,"('MOT', 'FAT')",Providence,nai50.xml,22,3,1,FAT,195,142,MOT
10,27,11,134,1.023946748,161,27,a,"('CHI', 'MOT')",Providence,nai50.xml,182,21,10,MOT,1399,1682,CHI
0,2,18,162,1.017643226,164,2,no,"('CHI', 'MOT')",Providence,nai50.xml,182,18,0,MOT,1399,1682,CHI
0,1,2,19,1.011600912,20,1,is,"('MOT', 'FAT')",Providence,nai50.xml,22,2,0,FAT,195,142,MOT
1,1,4,16,0.99852883,17,1,a,"('MOT', 'FAT')",Providence,nai50.xml,22,5,1,FAT,195,142,MOT
0,1,14,80,0.953104705,81,1,oh,"('FAT', 'CHI')",Providence,nai50.xml,95,14,0,CHI,1132,868,FAT
0,2,1,19,0.938269639,21,2,of,"('MOT', 'FAT')",Providence,nai50.xml,22,1,0,FAT,195,142,MOT
18,30,17,117,0.903480168,147,30,the,"('CHI', 'MOT')",Providence,nai50.xml,182,35,18,MOT,1399,1682,CHI
1,2,15,61,0.878550404,63,2,it,"('MOT', 'CHI')",Providence,nai50.xml,79,16,1,CHI,947,388,MOT
2,31,3,146,0.874352043,177,31,you,"('CHI', 'MOT')",Providence,nai50.xml,182,5,2,MOT,1399,1682,CHI
0,3,8,84,0.799756916,87,3,there,"('FAT', 'CHI')",Providence,nai50.xml,95,8,0,CHI,1132,868,FAT
6,7,20,62,0.796943974,69,7,a,"('FAT', 'CHI')",Providence,nai50.xml,95,26,6,CHI,1132,868,FAT
0,2,11,82,0.79078565,84,2,and,"('FAT', 'CHI')",Providence,nai50.xml,95,11,0,CHI,1132,868,FAT
0,2,9,68,0.780158558,70,2,do,"('MOT', 'CHI')",Providence,nai50.xml,79,9,0,CHI,947,388,MOT
0,1,3,18,0.741937345,19,1,in,"('MOT', 'FAT')",Providence,nai50.xml,22,3,0,FAT,195,142,MOT
0,1,3,18,0.741937345,19,1,it,"('MOT', 'FAT')",Providence,nai50.xml,22,3,0,FAT,195,142,MOT
0,3,7,69,0.720546155,72,3,is,"('MOT', 'CHI')",Providence,nai50.xml,79,7,0,CHI,947,388,MOT
1,24,4,153,0.715747012,177,24,do,"('CHI', 'MOT')",Providence,nai50.xml,182,5,1,MOT,1399,1682,CHI
0,4,7,84,0.693147181,88,4,little,"('FAT', 'CHI')",Providence,nai50.xml,95,7,0,CHI,1132,868,FAT
4,9,14,68,0.680568398,77,9,is,"('FAT', 'CHI')",Providence,nai50.xml,95,18,4,CHI,1132,868,FAT
0,3,1,18,0.650587566,21,3,yeah,"('MOT', 'FAT')",Providence,nai50.xml,22,1,0,FAT,195,142,MOT
0,4,6,69,0.628608659,73,4,there,"('MOT', 'CHI')",Providence,nai50.xml,79,6,0,CHI,947,388,MOT
7,16,31,128,0.540955365,144,16,think,"('CHI', 'MOT')",Providence,nai50.xml,182,38,7,MOT,1399,1682,CHI
0,1,4,17,0.510825624,18,1,that,"('MOT', 'FAT')",Providence,nai50.xml,22,4,0,FAT,195,142,MOT
0,3,9,67,0.492476485,70,3,wanna,"('MOT', 'CHI')",Providence,nai50.xml,79,9,0,CHI,947,388,MOT
6,15,13,61,0.485507816,76,15,the,"('FAT', 'CHI')",Providence,nai50.xml,95,19,6,CHI,1132,868,FAT
0,1,5,16,0.30538165,17,1,and,"('MOT', 'FAT')",Providence,nai50.xml,22,5,0,FAT,195,142,MOT
0,4,9,66,0.269332934,70,4,that,"('MOT', 'CHI')",Providence,nai50.xml,79,9,0,CHI,947,388,MOT
1,25,8,148,0.201941344,173,25,and,"('CHI', 'MOT')",Providence,nai50.xml,182,9,1,MOT,1399,1682,CHI
0,5,10,80,0.189242,85,5,what,"('FAT', 'CHI')",Providence,nai50.xml,95,10,0,CHI,1132,868,FAT
1,20,11,150,0.15706189,170,20,what,"('CHI', 'MOT')",Providence,nai50.xml,182,12,1,MOT,1399,1682,CHI
0,1,1,4,0.15415068,5,1,the,"('CHI', 'FAT')",Providence,nai50.xml,6,1,0,FAT,32,36,CHI
0,1,1,4,0.15415068,5,1,and,"('CHI', 'FAT')",Providence,nai50.xml,6,1,0,FAT,32,36,CHI
1,3,5,13,0.117783036,16,3,to,"('MOT', 'FAT')",Providence,nai50.xml,22,6,1,FAT,195,142,MOT
4,9,25,57,0.09237332,66,9,you,"('FAT', 'CHI')",Providence,nai50.xml,95,29,4,CHI,1132,868,FAT
0,7,9,79,0,86,7,to,"('FAT', 'CHI')",Providence,nai50.xml,95,9,0,CHI,1132,868,FAT
0,6,9,64,-0.067139303,70,6,to,"('MOT', 'CHI')",Providence,nai50.xml,79,9,0,CHI,947,388,MOT
0,2,21,56,-0.139761942,58,2,you,"('MOT', 'CHI')",Providence,nai50.xml,79,21,0,CHI,947,388,MOT
0,4,3,15,-0.174353387,19,4,you,"('MOT', 'FAT')",Providence,nai50.xml,22,3,0,FAT,195,142,MOT
0,1,1,2,-0.182321557,3,1,but,"('FAT', 'MOT')",Providence,nai50.xml,4,1,0,MOT,29,21,FAT
0,1,1,2,-0.182321557,3,1,the,"('FAT', 'MOT')",Providence,nai50.xml,4,1,0,MOT,29,21,FAT
2,8,22,47,-0.313657559,55,8,the,"('MOT', 'CHI')",Providence,nai50.xml,79,24,2,CHI,947,388,MOT
1,0,0,129,4.469732215,129,0,for,"('CHI', 'FAT')",Providence,nai51.xml,130,1,1,FAT,787,1335,CHI
2,0,0,68,3.96081317,68,0,wanna,"('CHI', 'MOT')",Providence,nai51.xml,70,2,2,MOT,522,686,CHI
1,0,2,127,3.943521672,127,0,want,"('CHI', 'FAT')",Providence,nai51.xml,130,3,1,FAT,787,1335,CHI
4,2,1,123,3.409102561,125,2,at,"('CHI', 'FAT')",Providence,nai51.xml,130,5,4,FAT,787,1335,CHI
1,2,0,127,3.371119926,129,2,some,"('CHI', 'FAT')",Providence,nai51.xml,130,1,1,FAT,787,1335,CHI
1,0,2,67,3.317815773,67,0,want,"('CHI', 'MOT')",Providence,nai51.xml,70,3,1,MOT,522,686,CHI
4,4,0,122,3.060270795,126,4,with,"('CHI', 'FAT')",Providence,nai51.xml,130,4,4,FAT,787,1335,CHI
2,2,0,66,2.862200881,68,2,on,"('CHI', 'MOT')",Providence,nai51.xml,70,2,2,MOT,522,686,CHI
1,1,1,67,2.862200881,68,1,he,"('CHI', 'MOT')",Providence,nai51.xml,70,2,1,MOT,522,686,CHI
1,4,0,125,2.860294303,129,4,my,"('CHI', 'FAT')",Providence,nai51.xml,130,1,1,FAT,787,1335,CHI
1,2,2,125,2.844909384,127,2,see,"('CHI', 'FAT')",Providence,nai51.xml,130,3,1,FAT,787,1335,CHI
2,5,0,123,2.788092909,128,5,wanna,"('CHI', 'FAT')",Providence,nai51.xml,130,2,2,FAT,787,1335,CHI
1,2,0,67,2.75860248,69,2,not,"('CHI', 'MOT')",Providence,nai51.xml,70,1,1,MOT,522,686,CHI
3,6,0,121,2.690758704,127,6,on,"('CHI', 'FAT')",Providence,nai51.xml,130,3,3,FAT,787,1335,CHI
0,2,1,127,2.677972746,129,2,have,"('CHI', 'FAT')",Providence,nai51.xml,130,1,0,FAT,787,1335,CHI
0,2,1,127,2.677972746,129,2,make,"('CHI', 'FAT')",Providence,nai51.xml,130,1,0,FAT,787,1335,CHI
0,2,1,127,2.677972746,129,2,one,"('CHI', 'FAT')",Providence,nai51.xml,130,1,0,FAT,787,1335,CHI
2,3,0,65,2.574518808,68,3,one,"('CHI', 'MOT')",Providence,nai51.xml,70,2,2,MOT,522,686,CHI
2,4,2,122,2.549445171,126,4,of,"('CHI', 'FAT')",Providence,nai51.xml,130,4,2,FAT,787,1335,CHI
3,6,1,120,2.500655007,126,6,like,"('CHI', 'FAT')",Providence,nai51.xml,130,4,3,FAT,787,1335,CHI
0,3,1,126,2.390290673,129,3,go,"('CHI', 'FAT')",Providence,nai51.xml,130,1,0,FAT,787,1335,CHI
2,5,2,121,2.367123614,126,5,they,"('CHI', 'FAT')",Providence,nai51.xml,130,4,2,FAT,787,1335,CHI
0,1,2,67,2.1690537,68,1,for,"('CHI', 'MOT')",Providence,nai51.xml,70,2,0,MOT,522,686,CHI
0,4,1,125,2.167147122,129,4,she,"('CHI', 'FAT')",Providence,nai51.xml,130,1,0,FAT,787,1335,CHI
2,3,2,63,2.140066163,66,3,was,"('CHI', 'MOT')",Providence,nai51.xml,70,4,2,MOT,522,686,CHI
2,3,2,63,2.140066163,66,3,she,"('CHI', 'MOT')",Providence,nai51.xml,70,4,2,MOT,522,686,CHI
2,4,1,63,2.113842968,67,4,get,"('CHI', 'MOT')",Providence,nai51.xml,70,3,2,MOT,522,686,CHI
1,1,6,62,1.977162693,63,1,think,"('CHI', 'MOT')",Providence,nai51.xml,70,7,1,MOT,522,686,CHI
1,5,3,121,1.961658506,126,5,in,"('CHI', 'FAT')",Providence,nai51.xml,130,4,1,FAT,787,1335,CHI
5,7,6,112,1.943159116,119,7,it,"('CHI', 'FAT')",Providence,nai51.xml,130,11,5,FAT,787,1335,CHI
0,1,3,66,1.931521412,67,1,with,"('CHI', 'MOT')",Providence,nai51.xml,70,3,0,MOT,522,686,CHI
2,6,4,118,1.909542505,124,6,no,"('CHI', 'FAT')",Providence,nai51.xml,130,6,2,FAT,787,1335,CHI
0,4,2,124,1.871802177,128,4,put,"('CHI', 'FAT')",Providence,nai51.xml,130,2,0,FAT,787,1335,CHI
2,8,3,117,1.799664649,125,8,is,"('CHI', 'FAT')",Providence,nai51.xml,130,5,2,FAT,787,1335,CHI
0,2,2,66,1.763588592,68,2,do,"('CHI', 'MOT')",Providence,nai51.xml,70,2,0,MOT,522,686,CHI
0,1,4,65,1.734601055,66,1,did,"('CHI', 'MOT')",Providence,nai51.xml,70,4,0,MOT,522,686,CHI
18,14,6,92,1.660423467,106,14,a,"('CHI', 'FAT')",Providence,nai51.xml,130,24,18,FAT,787,1335,CHI
0,4,3,123,1.640936579,127,4,there,"('CHI', 'FAT')",Providence,nai51.xml,130,3,0,FAT,787,1335,CHI
4,9,7,110,1.537694008,119,9,and,"('CHI', 'FAT')",Providence,nai51.xml,130,11,4,FAT,787,1335,CHI
2,11,3,114,1.511982576,125,11,that,"('CHI', 'FAT')",Providence,nai51.xml,130,5,2,FAT,787,1335,CHI
3,18,1,108,1.502126177,126,18,are,"('CHI', 'FAT')",Providence,nai51.xml,130,4,3,FAT,787,1335,CHI
0,3,2,65,1.47590652,68,3,like,"('CHI', 'MOT')",Providence,nai51.xml,70,2,0,MOT,522,686,CHI
0,10,1,119,1.378689762,129,10,not,"('CHI', 'FAT')",Providence,nai51.xml,130,1,0,FAT,787,1335,CHI
2,16,2,110,1.325669739,126,16,what,"('CHI', 'FAT')",Providence,nai51.xml,130,4,2,FAT,787,1335,CHI
16,17,9,88,1.319833555,105,17,the,"('CHI', 'FAT')",Providence,nai51.xml,130,25,16,FAT,787,1335,CHI
3,8,3,56,1.299282984,64,8,that,"('CHI', 'MOT')",Providence,nai51.xml,70,6,3,MOT,522,686,CHI
3,7,4,56,1.284015512,63,7,is,"('CHI', 'MOT')",Providence,nai51.xml,70,7,3,MOT,522,686,CHI
0,4,2,64,1.252762968,68,4,are,"('CHI', 'MOT')",Providence,nai51.xml,70,2,0,MOT,522,686,CHI
0,3,3,64,1.238374231,67,3,we,"('CHI', 'MOT')",Providence,nai51.xml,70,3,0,MOT,522,686,CHI
2,6,5,57,1.129864832,63,6,in,"('CHI', 'MOT')",Providence,nai51.xml,70,7,2,MOT,522,686,CHI
3,6,7,54,1.082611947,60,6,it,"('CHI', 'MOT')",Providence,nai51.xml,70,10,3,MOT,522,686,CHI
0,3,4,63,1.041453875,66,3,and,"('CHI', 'MOT')",Providence,nai51.xml,70,4,0,MOT,522,686,CHI
0,4,3,63,1.01523068,67,4,there,"('CHI', 'MOT')",Providence,nai51.xml,70,3,0,MOT,522,686,CHI
2,6,6,56,1.00900013,62,6,to,"('CHI', 'MOT')",Providence,nai51.xml,70,8,2,MOT,522,686,CHI
1,6,4,59,1.006019502,65,6,what,"('CHI', 'MOT')",Providence,nai51.xml,70,5,1,MOT,522,686,CHI
4,11,14,101,0.864997437,112,11,to,"('CHI', 'FAT')",Providence,nai51.xml,130,18,4,FAT,787,1335,CHI
3,12,4,51,0.798507696,63,12,the,"('CHI', 'MOT')",Providence,nai51.xml,70,7,3,MOT,522,686,CHI
3,10,7,50,0.630626824,60,10,a,"('CHI', 'MOT')",Providence,nai51.xml,70,10,3,MOT,522,686,CHI
0,5,9,116,0.622529613,121,5,yeah,"('CHI', 'FAT')",Providence,nai51.xml,130,9,0,FAT,787,1335,CHI
1,10,9,110,0.614366303,120,10,do,"('CHI', 'FAT')",Providence,nai51.xml,130,10,1,FAT,787,1335,CHI
8,31,12,79,0.358945092,110,31,you,"('CHI', 'FAT')",Providence,nai51.xml,130,20,8,FAT,787,1335,CHI
0,7,10,113,0.239672853,120,7,think,"('CHI', 'FAT')",Providence,nai51.xml,130,10,0,FAT,787,1335,CHI
1,12,8,49,-0.126562723,61,12,you,"('CHI', 'MOT')",Providence,nai51.xml,70,9,1,MOT,522,686,CHI
0,1,1,1,-0.405465108,2,1,yeah,"('FAT', 'MOT')",Providence,nai51.xml,3,1,0,MOT,21,24,FAT
0,1,1,1,-0.405465108,2,1,a,"('FAT', 'MOT')",Providence,nai51.xml,3,1,0,MOT,21,24,FAT
0,1,1,1,-0.405465108,2,1,yeah,"('MOT', 'ADU')",Providence,nai51.xml,3,1,0,ADU,14,12,MOT
0,5,15,50,-0.581921545,55,5,yeah,"('CHI', 'MOT')",Providence,nai51.xml,70,15,0,MOT,522,686,CHI
1,0,2,200,4.391976966,200,0,one,"('MOT', 'CHI')",Providence,nai52.xml,203,3,1,CHI,2306,1244,MOT
1,0,12,190,3.242592351,190,0,some,"('MOT', 'CHI')",Providence,nai52.xml,203,13,1,CHI,2306,1244,MOT
1,1,6,195,3.091042453,196,1,little,"('MOT', 'CHI')",Providence,nai52.xml,203,7,1,CHI,2306,1244,MOT
0,1,3,199,3.005682604,200,1,but,"('MOT', 'CHI')",Providence,nai52.xml,203,3,0,CHI,2306,1244,MOT
0,1,3,199,3.005682604,200,1,where,"('MOT', 'CHI')",Providence,nai52.xml,203,3,0,CHI,2306,1244,MOT
0,2,2,199,2.828299329,201,2,she,"('MOT', 'CHI')",Providence,nai52.xml,203,2,0,CHI,2306,1244,MOT
1,3,0,92,2.782951509,95,3,all,"('CHI', 'MOT')",Providence,nai52.xml,96,1,1,MOT,474,1223,CHI
3,3,8,189,2.702908802,192,3,was,"('MOT', 'CHI')",Providence,nai52.xml,203,11,3,CHI,2306,1244,MOT
0,2,3,198,2.600217496,200,2,go,"('MOT', 'CHI')",Providence,nai52.xml,203,3,0,CHI,2306,1244,MOT
0,2,3,198,2.600217496,200,2,wanna,"('MOT', 'CHI')",Providence,nai52.xml,203,3,0,CHI,2306,1244,MOT
2,3,7,191,2.592537314,194,3,on,"('MOT', 'CHI')",Providence,nai52.xml,203,9,2,CHI,2306,1244,MOT
1,4,0,91,2.559807958,95,4,she,"('CHI', 'MOT')",Providence,nai52.xml,96,1,1,MOT,474,1223,CHI
0,1,6,196,2.520716102,197,1,my,"('MOT', 'CHI')",Providence,nai52.xml,203,6,0,CHI,2306,1244,MOT
1,3,1,91,2.48490665,94,3,big,"('CHI', 'MOT')",Providence,nai52.xml,96,2,1,MOT,474,1223,CHI
0,2,4,197,2.41293315,199,2,did,"('MOT', 'CHI')",Providence,nai52.xml,203,4,0,CHI,2306,1244,MOT
0,1,7,195,2.397895273,196,1,not,"('MOT', 'CHI')",Providence,nai52.xml,203,7,0,CHI,2306,1244,MOT
0,2,1,93,2.377486401,95,2,want,"('CHI', 'MOT')",Providence,nai52.xml,96,1,0,MOT,474,1223,CHI
0,2,1,93,2.377486401,95,2,we,"('CHI', 'MOT')",Providence,nai52.xml,96,1,0,MOT,474,1223,CHI
1,5,0,90,2.377486401,95,5,was,"('CHI', 'MOT')",Providence,nai52.xml,96,1,1,MOT,474,1223,CHI
0,2,5,196,2.253794929,198,2,at,"('MOT', 'CHI')",Providence,nai52.xml,203,5,0,CHI,2306,1244,MOT
1,6,0,89,2.223335721,95,6,at,"('CHI', 'MOT')",Providence,nai52.xml,96,1,1,MOT,474,1223,CHI
1,11,1,190,2.135152149,201,11,no,"('MOT', 'CHI')",Providence,nai52.xml,203,2,1,CHI,2306,1244,MOT
1,3,9,190,2.094945728,193,3,there,"('MOT', 'CHI')",Providence,nai52.xml,203,10,1,CHI,2306,1244,MOT
1,7,0,88,2.089804329,95,7,do,"('CHI', 'MOT')",Providence,nai52.xml,96,1,1,MOT,474,1223,CHI
1,2,13,187,2.074219598,189,2,are,"('MOT', 'CHI')",Providence,nai52.xml,203,14,1,CHI,2306,1244,MOT
1,3,3,89,2.058388132,92,3,like,"('CHI', 'MOT')",Providence,nai52.xml,96,4,1,MOT,474,1223,CHI
2,5,2,87,2.058388132,92,5,on,"('CHI', 'MOT')",Providence,nai52.xml,96,4,2,MOT,474,1223,CHI
1,4,2,89,2.028148247,93,4,go,"('CHI', 'MOT')",Providence,nai52.xml,96,3,1,MOT,474,1223,CHI
0,2,7,194,1.992430165,196,2,want,"('MOT', 'CHI')",Providence,nai52.xml,203,7,0,CHI,2306,1244,MOT
0,4,1,91,1.866660777,95,4,this,"('CHI', 'MOT')",Providence,nai52.xml,96,1,0,MOT,474,1223,CHI
0,3,2,91,1.791759469,94,3,wanna,"('CHI', 'MOT')",Providence,nai52.xml,96,2,0,MOT,474,1223,CHI
1,7,1,87,1.791759469,94,7,with,"('CHI', 'MOT')",Providence,nai52.xml,96,2,1,MOT,474,1223,CHI
0,2,9,192,1.781607098,194,2,can,"('MOT', 'CHI')",Providence,nai52.xml,203,9,0,CHI,2306,1244,MOT
8,6,28,161,1.743626983,167,6,it,"('MOT', 'CHI')",Providence,nai52.xml,203,36,8,CHI,2306,1244,MOT
1,6,2,87,1.691676011,93,6,see,"('CHI', 'MOT')",Providence,nai52.xml,96,3,1,MOT,474,1223,CHI
0,1,16,186,1.658228077,187,1,of,"('MOT', 'CHI')",Providence,nai52.xml,203,16,0,CHI,2306,1244,MOT
0,4,6,193,1.604425371,197,4,yeah,"('MOT', 'CHI')",Providence,nai52.xml,203,6,0,CHI,2306,1244,MOT
0,4,6,193,1.604425371,197,4,with,"('MOT', 'CHI')",Providence,nai52.xml,203,6,0,CHI,2306,1244,MOT
0,2,11,190,1.604296513,192,2,gonna,"('MOT', 'CHI')",Providence,nai52.xml,203,11,0,CHI,2306,1244,MOT
0,3,8,192,1.594324275,195,3,get,"('MOT', 'CHI')",Providence,nai52.xml,203,8,0,CHI,2306,1244,MOT
0,6,1,89,1.530188541,95,6,there,"('CHI', 'MOT')",Providence,nai52.xml,96,1,0,MOT,474,1223,CHI
1,10,1,84,1.473305738,94,10,is,"('CHI', 'MOT')",Providence,nai52.xml,96,2,1,MOT,474,1223,CHI
0,2,13,188,1.450832882,190,2,this,"('MOT', 'CHI')",Providence,nai52.xml,203,13,0,CHI,2306,1244,MOT
0,4,8,191,1.371180723,195,4,think,"('MOT', 'CHI')",Providence,nai52.xml,203,8,0,CHI,2306,1244,MOT
0,4,3,89,1.335001067,93,4,think,"('CHI', 'MOT')",Providence,nai52.xml,96,3,0,MOT,474,1223,CHI
2,5,8,81,1.299282984,86,5,what,"('CHI', 'MOT')",Providence,nai52.xml,96,10,2,MOT,474,1223,CHI
4,18,1,73,1.251688277,91,18,that,"('CHI', 'MOT')",Providence,nai52.xml,96,5,4,MOT,474,1223,CHI
4,16,2,74,1.218571604,90,16,to,"('CHI', 'MOT')",Providence,nai52.xml,96,6,4,MOT,474,1223,CHI
0,5,3,88,1.15267951,93,5,yeah,"('CHI', 'MOT')",Providence,nai52.xml,96,3,0,MOT,474,1223,CHI
0,4,4,88,1.142097401,92,4,can,"('CHI', 'MOT')",Providence,nai52.xml,96,4,0,MOT,474,1223,CHI
12,13,34,144,1.123595219,157,13,a,"('MOT', 'CHI')",Providence,nai52.xml,203,46,12,CHI,2306,1244,MOT
0,6,3,87,0.99852883,93,6,they,"('CHI', 'MOT')",Providence,nai52.xml,96,3,0,MOT,474,1223,CHI
1,17,1,77,0.980829253,94,17,and,"('CHI', 'MOT')",Providence,nai52.xml,96,2,1,MOT,474,1223,CHI
1,0,0,2,0.980829253,2,0,in,"('FAT', 'MOT')",Providence,nai52.xml,3,1,1,MOT,39,45,FAT
1,9,4,82,0.977251432,91,9,in,"('CHI', 'MOT')",Providence,nai52.xml,96,5,1,MOT,474,1223,CHI
0,5,11,187,0.911149332,192,5,see,"('MOT', 'CHI')",Providence,nai52.xml,203,11,0,CHI,2306,1244,MOT
1,5,24,173,0.798507696,178,5,that,"('MOT', 'CHI')",Providence,nai52.xml,203,25,1,CHI,2306,1244,MOT
2,8,23,170,0.798507696,178,8,and,"('MOT', 'CHI')",Providence,nai52.xml,203,25,2,CHI,2306,1244,MOT
2,8,25,168,0.715875432,176,8,is,"('MOT', 'CHI')",Providence,nai52.xml,203,27,2,CHI,2306,1244,MOT
0,7,4,85,0.672093771,92,7,it,"('CHI', 'MOT')",Providence,nai52.xml,96,4,0,MOT,474,1223,CHI
1,15,3,77,0.672093771,92,15,are,"('CHI', 'MOT')",Providence,nai52.xml,96,4,1,MOT,474,1223,CHI
8,27,6,55,0.523248144,82,27,the,"('CHI', 'MOT')",Providence,nai52.xml,96,14,8,MOT,474,1223,CHI
3,32,2,59,0.476476144,91,32,a,"('CHI', 'MOT')",Providence,nai52.xml,96,5,3,MOT,474,1223,CHI
1,6,31,165,0.374168101,171,6,to,"('MOT', 'CHI')",Providence,nai52.xml,203,32,1,CHI,2306,1244,MOT
0,27,1,68,0.14389418,95,27,you,"('CHI', 'MOT')",Providence,nai52.xml,96,1,0,MOT,474,1223,CHI
8,31,35,129,0.01242252,160,31,the,"('MOT', 'CHI')",Providence,nai52.xml,203,43,8,CHI,2306,1244,MOT
0,9,17,177,-0.010582109,186,9,what,"('MOT', 'CHI')",Providence,nai52.xml,203,17,0,CHI,2306,1244,MOT
0,10,21,172,-0.318453731,182,10,in,"('MOT', 'CHI')",Providence,nai52.xml,203,21,0,CHI,2306,1244,MOT
1,7,67,128,-0.714808677,135,7,you,"('MOT', 'CHI')",Providence,nai52.xml,203,68,1,CHI,2306,1244,MOT
0,2,1,0,-0.810930216,2,2,you,"('FAT', 'MOT')",Providence,nai52.xml,3,1,0,MOT,39,45,FAT
0,2,1,0,-0.810930216,2,2,to,"('FAT', 'MOT')",Providence,nai52.xml,3,1,0,MOT,39,45,FAT
2,0,6,442,4.891851758,442,0,all,"('MOT', 'CHI')",Providence,nai53.xml,450,8,2,CHI,5656,2994,MOT
0,2,1,447,3.914242762,449,2,she,"('MOT', 'CHI')",Providence,nai53.xml,450,1,0,CHI,5656,2994,MOT
1,2,4,443,3.751183337,445,2,big,"('MOT', 'CHI')",Providence,nai53.xml,450,5,1,CHI,5656,2994,MOT
0,1,5,444,3.463501265,445,1,my,"('MOT', 'CHI')",Providence,nai53.xml,450,5,0,CHI,5656,2994,MOT
0,2,3,445,3.398972687,447,2,make,"('MOT', 'CHI')",Providence,nai53.xml,450,3,0,CHI,5656,2994,MOT
0,2,6,442,2.922265122,444,2,look,"('MOT', 'CHI')",Providence,nai53.xml,450,6,0,CHI,5656,2994,MOT
1,0,0,19,2.63905733,19,0,was,"('CHI', 'MOT')",Providence,nai53.xml,20,1,1,MOT,127,166,CHI
1,0,0,19,2.63905733,19,0,at,"('CHI', 'MOT')",Providence,nai53.xml,20,1,1,MOT,127,166,CHI
2,3,21,424,2.554899022,427,3,little,"('MOT', 'CHI')",Providence,nai53.xml,450,23,2,CHI,5656,2994,MOT
1,4,12,433,2.46015848,437,4,where,"('MOT', 'CHI')",Providence,nai53.xml,450,13,1,CHI,5656,2994,MOT
0,2,11,437,2.425483229,439,2,but,"('MOT', 'CHI')",Providence,nai53.xml,450,11,0,CHI,5656,2994,MOT
4,7,18,421,2.415727749,428,7,they,"('MOT', 'CHI')",Providence,nai53.xml,450,22,4,CHI,5656,2994,MOT
3,5,21,421,2.395561549,426,5,up,"('MOT', 'CHI')",Providence,nai53.xml,450,24,3,CHI,5656,2994,MOT
1,0,1,18,2.302585093,18,0,in,"('CHI', 'MOT')",Providence,nai53.xml,20,2,1,MOT,127,166,CHI
1,3,20,426,2.237466694,429,3,was,"('MOT', 'CHI')",Providence,nai53.xml,450,21,1,CHI,5656,2994,MOT
4,8,22,416,2.134448171,424,8,want,"('MOT', 'CHI')",Providence,nai53.xml,450,26,4,CHI,5656,2994,MOT
3,5,31,411,2.046497386,416,5,some,"('MOT', 'CHI')",Providence,nai53.xml,450,34,3,CHI,5656,2994,MOT
1,6,14,429,1.993956883,435,6,he,"('MOT', 'CHI')",Providence,nai53.xml,450,15,1,CHI,5656,2994,MOT
1,1,0,18,1.945910149,19,1,and,"('CHI', 'MOT')",Providence,nai53.xml,20,1,1,MOT,127,166,CHI
0,2,20,428,1.878770846,430,2,this,"('MOT', 'CHI')",Providence,nai53.xml,450,20,0,CHI,5656,2994,MOT
3,8,24,415,1.873863123,423,8,like,"('MOT', 'CHI')",Providence,nai53.xml,450,27,3,CHI,5656,2994,MOT
1,8,12,429,1.872371815,437,8,did,"('MOT', 'CHI')",Providence,nai53.xml,450,13,1,CHI,5656,2994,MOT
1,8,12,429,1.872371815,437,8,put,"('MOT', 'CHI')",Providence,nai53.xml,450,13,1,CHI,5656,2994,MOT
1,6,17,426,1.824549292,432,6,not,"('MOT', 'CHI')",Providence,nai53.xml,450,18,1,CHI,5656,2994,MOT
6,15,26,403,1.687215613,418,15,gonna,"('MOT', 'CHI')",Providence,nai53.xml,450,32,6,CHI,5656,2994,MOT
0,5,12,433,1.655957928,438,5,get,"('MOT', 'CHI')",Providence,nai53.xml,450,12,0,CHI,5656,2994,MOT
7,13,37,393,1.62300999,406,13,in,"('MOT', 'CHI')",Providence,nai53.xml,450,44,7,CHI,5656,2994,MOT
1,1,1,17,1.609437912,18,1,he,"('CHI', 'MOT')",Providence,nai53.xml,20,2,1,MOT,127,166,CHI
1,1,1,17,1.609437912,18,1,that,"('CHI', 'MOT')",Providence,nai53.xml,20,2,1,MOT,127,166,CHI
2,1,2,15,1.504077397,16,1,the,"('CHI', 'MOT')",Providence,nai53.xml,20,4,2,MOT,127,166,CHI
1,7,21,421,1.499437017,428,7,for,"('MOT', 'CHI')",Providence,nai53.xml,450,22,1,CHI,5656,2994,MOT
2,10,25,413,1.385510355,423,10,with,"('MOT', 'CHI')",Providence,nai53.xml,450,27,2,CHI,5656,2994,MOT
0,7,12,431,1.368275856,438,7,one,"('MOT', 'CHI')",Providence,nai53.xml,450,12,0,CHI,5656,2994,MOT
1,1,2,16,1.335001067,17,1,no,"('CHI', 'MOT')",Providence,nai53.xml,20,3,1,MOT,127,166,CHI
0,6,15,429,1.300809702,435,6,at,"('MOT', 'CHI')",Providence,nai53.xml,450,15,0,CHI,5656,2994,MOT
1,0,0,3,1.203972804,3,0,have,"('MOT', 'FAT')",Providence,nai53.xml,4,1,1,FAT,32,18,MOT
0,6,17,427,1.184996903,433,6,wanna,"('MOT', 'CHI')",Providence,nai53.xml,450,17,0,CHI,5656,2994,MOT
0,8,13,429,1.179224635,437,8,go,"('MOT', 'CHI')",Providence,nai53.xml,450,13,0,CHI,5656,2994,MOT
3,10,41,396,1.171024866,406,10,we,"('MOT', 'CHI')",Providence,nai53.xml,450,44,3,CHI,5656,2994,MOT
1,6,35,408,1.140336132,414,6,of,"('MOT', 'CHI')",Providence,nai53.xml,450,36,1,CHI,5656,2994,MOT
0,3,35,412,1.035873948,415,3,have,"('MOT', 'CHI')",Providence,nai53.xml,450,35,0,CHI,5656,2994,MOT
3,57,6,384,1.021525848,441,57,no,"('MOT', 'CHI')",Providence,nai53.xml,450,9,3,CHI,5656,2994,MOT
1,11,23,415,1.009267188,426,11,see,"('MOT', 'CHI')",Providence,nai53.xml,450,24,1,CHI,5656,2994,MOT
1,2,2,15,0.929535959,17,2,to,"('CHI', 'MOT')",Providence,nai53.xml,20,3,1,MOT,127,166,CHI
0,1,2,17,0.916290732,18,1,a,"('CHI', 'MOT')",Providence,nai53.xml,20,2,0,MOT,127,166,CHI
0,7,20,423,0.897941593,430,7,can,"('MOT', 'CHI')",Providence,nai53.xml,450,20,0,CHI,5656,2994,MOT
1,11,26,412,0.89303387,423,11,on,"('MOT', 'CHI')",Providence,nai53.xml,450,27,1,CHI,5656,2994,MOT
0,2,1,17,0.84729786,19,2,it,"('CHI', 'MOT')",Providence,nai53.xml,20,1,0,MOT,127,166,CHI
0,2,1,17,0.84729786,19,2,is,"('CHI', 'MOT')",Providence,nai53.xml,20,1,0,MOT,127,166,CHI
12,24,72,342,0.799809175,366,24,a,"('MOT', 'CHI')",Providence,nai53.xml,450,84,12,CHI,5656,2994,MOT
10,38,40,362,0.779541997,400,38,what,"('MOT', 'CHI')",Providence,nai53.xml,450,50,10,CHI,5656,2994,MOT
0,4,38,408,0.727548607,412,4,yeah,"('MOT', 'CHI')",Providence,nai53.xml,450,38,0,CHI,5656,2994,MOT
9,26,63,352,0.642854387,378,26,it,"('MOT', 'CHI')",Providence,nai53.xml,450,72,9,CHI,5656,2994,MOT
0,3,1,16,0.559615788,19,3,you,"('CHI', 'MOT')",Providence,nai53.xml,20,1,0,MOT,127,166,CHI
14,32,78,326,0.554351889,358,32,to,"('MOT', 'CHI')",Providence,nai53.xml,450,92,14,CHI,5656,2994,MOT
3,21,38,388,0.552645007,409,21,is,"('MOT', 'CHI')",Providence,nai53.xml,450,41,3,CHI,5656,2994,MOT
19,44,72,315,0.545348249,359,44,the,"('MOT', 'CHI')",Providence,nai53.xml,450,91,19,CHI,5656,2994,MOT
3,14,56,377,0.541179908,391,14,do,"('MOT', 'CHI')",Providence,nai53.xml,450,59,3,CHI,5656,2994,MOT
20,27,131,272,0.388990271,299,27,you,"('MOT', 'CHI')",Providence,nai53.xml,450,151,20,CHI,5656,2994,MOT
0,10,29,411,0.215489702,421,10,are,"('MOT', 'CHI')",Providence,nai53.xml,450,29,0,CHI,5656,2994,MOT
0,12,25,413,0.19599779,425,12,there,"('MOT', 'CHI')",Providence,nai53.xml,450,25,0,CHI,5656,2994,MOT
1,2,0,1,0.105360516,3,2,of,"('MOT', 'FAT')",Providence,nai53.xml,4,1,1,FAT,32,18,MOT
1,2,1,0,-0.405465108,2,2,a,"('MOT', 'FAT')",Providence,nai53.xml,4,2,1,FAT,32,18,MOT
4,35,74,337,-0.431851863,372,35,that,"('MOT', 'CHI')",Providence,nai53.xml,450,78,4,CHI,5656,2994,MOT
1,21,54,374,-0.45701026,395,21,and,"('MOT', 'CHI')",Providence,nai53.xml,450,55,1,CHI,5656,2994,MOT
0,1,1,0,-0.693147181,1,1,you,"('CHI', 'FAT')",Providence,nai53.xml,2,1,0,FAT,10,11,CHI
1,0,3,197,4.194692536,197,0,little,"('MOT', 'CHI')",Providence,nai54.xml,201,4,1,CHI,1764,1240,MOT
2,0,1,80,3.895893623,80,0,make,"('CHI', 'GRA')",Providence,nai54.xml,83,3,2,GRA,835,753,CHI
2,1,3,195,3.74782199,196,1,get,"('MOT', 'CHI')",Providence,nai54.xml,201,5,2,CHI,1764,1240,MOT
1,0,8,192,3.563110067,192,0,in,"('MOT', 'CHI')",Providence,nai54.xml,201,9,1,CHI,1764,1240,MOT
1,0,8,192,3.563110067,192,0,think,"('MOT', 'CHI')",Providence,nai54.xml,201,9,1,CHI,1764,1240,MOT
0,1,1,199,3.516508228,200,1,we,"('MOT', 'CHI')",Providence,nai54.xml,201,1,0,CHI,1764,1240,MOT
0,1,1,199,3.516508228,200,1,big,"('MOT', 'CHI')",Providence,nai54.xml,201,1,0,CHI,1764,1240,MOT
2,2,3,194,3.342356882,196,2,he,"('MOT', 'CHI')",Providence,nai54.xml,201,5,2,CHI,1764,1240,MOT
0,1,2,198,3.223863366,199,1,did,"('MOT', 'CHI')",Providence,nai54.xml,201,2,0,CHI,1764,1240,MOT
0,1,4,196,2.808398175,197,1,but,"('MOT', 'CHI')",Providence,nai54.xml,201,4,0,CHI,1764,1240,MOT
2,1,4,76,2.695471419,77,1,he,"('CHI', 'GRA')",Providence,nai54.xml,83,6,2,GRA,835,753,CHI
0,1,5,195,2.649209701,196,1,gonna,"('MOT', 'CHI')",Providence,nai54.xml,201,5,0,CHI,1764,1240,MOT
0,1,5,195,2.649209701,196,1,for,"('MOT', 'CHI')",Providence,nai54.xml,201,5,0,CHI,1764,1240,MOT
0,1,5,195,2.649209701,196,1,up,"('MOT', 'CHI')",Providence,nai54.xml,201,5,0,CHI,1764,1240,MOT
0,1,1,81,2.63905733,82,1,did,"('CHI', 'GRA')",Providence,nai54.xml,83,1,0,GRA,835,753,CHI
0,1,1,81,2.63905733,82,1,at,"('CHI', 'GRA')",Providence,nai54.xml,83,1,0,GRA,835,753,CHI
1,3,0,79,2.63905733,82,3,with,"('CHI', 'GRA')",Providence,nai54.xml,83,1,1,GRA,835,753,CHI
0,2,3,196,2.590267165,198,2,put,"('MOT', 'CHI')",Providence,nai54.xml,201,3,0,CHI,1764,1240,MOT
2,3,7,189,2.582280814,192,3,she,"('MOT', 'CHI')",Providence,nai54.xml,201,9,2,CHI,1764,1240,MOT
5,3,15,178,2.523908808,181,3,like,"('MOT', 'CHI')",Providence,nai54.xml,201,20,5,CHI,1764,1240,MOT
0,2,4,195,2.402933067,197,2,was,"('MOT', 'CHI')",Providence,nai54.xml,201,4,0,CHI,1764,1240,MOT
0,2,4,195,2.402933067,197,2,some,"('MOT', 'CHI')",Providence,nai54.xml,201,4,0,CHI,1764,1240,MOT
0,1,2,80,2.339399066,81,1,not,"('CHI', 'GRA')",Providence,nai54.xml,83,2,0,GRA,835,753,CHI
0,3,3,195,2.302585093,198,3,on,"('MOT', 'CHI')",Providence,nai54.xml,201,3,0,CHI,1764,1240,MOT
0,2,5,194,2.243744593,196,2,there,"('MOT', 'CHI')",Providence,nai54.xml,201,5,0,CHI,1764,1240,MOT
0,2,5,194,2.243744593,196,2,all,"('MOT', 'CHI')",Providence,nai54.xml,201,5,0,CHI,1764,1240,MOT
0,2,1,80,2.233592222,82,2,this,"('CHI', 'GRA')",Providence,nai54.xml,83,1,0,GRA,835,753,CHI
0,2,1,80,2.233592222,82,2,wanna,"('CHI', 'GRA')",Providence,nai54.xml,83,1,0,GRA,835,753,CHI
0,2,1,80,2.233592222,82,2,one,"('CHI', 'GRA')",Providence,nai54.xml,83,1,0,GRA,835,753,CHI
0,2,1,80,2.233592222,82,2,where,"('CHI', 'GRA')",Providence,nai54.xml,83,1,0,GRA,835,753,CHI
0,3,4,194,2.115250994,197,3,can,"('MOT', 'CHI')",Providence,nai54.xml,201,4,0,CHI,1764,1240,MOT
0,2,6,193,2.105149898,195,2,see,"('MOT', 'CHI')",Providence,nai54.xml,201,6,0,CHI,1764,1240,MOT
1,0,38,162,2.079441542,162,0,you,"('MOT', 'CHI')",Providence,nai54.xml,201,39,1,CHI,1764,1240,MOT
2,2,6,73,2.041220329,75,2,go,"('CHI', 'GRA')",Providence,nai54.xml,83,8,2,GRA,835,753,CHI
1,10,2,188,1.984131362,198,10,want,"('MOT', 'CHI')",Providence,nai54.xml,201,3,1,CHI,1764,1240,MOT
0,3,1,79,1.945910149,82,3,was,"('CHI', 'GRA')",Providence,nai54.xml,83,1,0,GRA,835,753,CHI
1,4,2,76,1.880990603,80,4,all,"('CHI', 'GRA')",Providence,nai54.xml,83,3,1,GRA,835,753,CHI
0,2,9,190,1.771350598,192,2,not,"('MOT', 'CHI')",Providence,nai54.xml,201,9,0,CHI,1764,1240,MOT
2,5,3,73,1.742969305,78,5,in,"('CHI', 'GRA')",Providence,nai54.xml,83,5,2,GRA,835,753,CHI
0,4,1,78,1.722766598,82,4,they,"('CHI', 'GRA')",Providence,nai54.xml,83,1,0,GRA,835,753,CHI
1,7,6,187,1.694595721,194,7,with,"('MOT', 'CHI')",Providence,nai54.xml,201,7,1,CHI,1764,1240,MOT
1,4,3,75,1.686398954,79,4,can,"('CHI', 'GRA')",Providence,nai54.xml,83,4,1,GRA,835,753,CHI
0,2,11,188,1.593933726,190,2,do,"('MOT', 'CHI')",Providence,nai54.xml,201,11,0,CHI,1764,1240,MOT
1,8,1,73,1.52846885,81,8,want,"('CHI', 'GRA')",Providence,nai54.xml,83,2,1,GRA,835,753,CHI
5,8,4,66,1.527372959,74,8,it,"('CHI', 'GRA')",Providence,nai54.xml,83,9,5,GRA,835,753,CHI
2,7,3,71,1.455287233,78,7,do,"('CHI', 'GRA')",Providence,nai54.xml,83,5,2,GRA,835,753,CHI
2,6,4,71,1.44270845,77,6,put,"('CHI', 'GRA')",Providence,nai54.xml,83,6,2,GRA,835,753,CHI
0,5,6,190,1.412002718,195,5,go,"('MOT', 'CHI')",Providence,nai54.xml,201,6,0,CHI,1764,1240,MOT
4,7,6,66,1.362577835,73,7,on,"('CHI', 'GRA')",Providence,nai54.xml,83,10,4,GRA,835,753,CHI
0,12,2,187,1.352061189,199,12,no,"('MOT', 'CHI')",Providence,nai54.xml,201,2,0,CHI,1764,1240,MOT
0,2,16,183,1.24212457,185,2,and,"('MOT', 'CHI')",Providence,nai54.xml,201,16,0,CHI,1764,1240,MOT
4,9,5,65,1.239690887,74,9,a,"('CHI', 'GRA')",Providence,nai54.xml,83,9,4,GRA,835,753,CHI
0,3,12,186,1.226921737,189,3,have,"('MOT', 'CHI')",Providence,nai54.xml,201,12,0,CHI,1764,1240,MOT
6,18,12,165,1.226094721,183,18,to,"('MOT', 'CHI')",Providence,nai54.xml,201,18,6,CHI,1764,1240,MOT
1,4,19,177,1.202152968,181,4,that,"('MOT', 'CHI')",Providence,nai54.xml,201,20,1,CHI,1764,1240,MOT
0,2,6,75,1.191394022,77,2,up,"('CHI', 'GRA')",Providence,nai54.xml,83,6,0,GRA,835,753,CHI
1,14,5,181,1.188859167,195,14,yeah,"('MOT', 'CHI')",Providence,nai54.xml,201,6,1,CHI,1764,1240,MOT
0,4,3,76,1.187843422,80,4,there,"('CHI', 'GRA')",Providence,nai54.xml,83,3,0,GRA,835,753,CHI
0,6,2,75,1.086636098,81,6,are,"('CHI', 'GRA')",Providence,nai54.xml,83,2,0,GRA,835,753,CHI
5,7,35,154,1.06839851,161,7,a,"('MOT', 'CHI')",Providence,nai54.xml,201,40,5,CHI,1764,1240,MOT
4,5,14,60,1.026638789,65,5,to,"('CHI', 'GRA')",Providence,nai54.xml,83,18,4,GRA,835,753,CHI
1,5,19,176,1.019831411,181,5,what,"('MOT', 'CHI')",Providence,nai54.xml,201,20,1,CHI,1764,1240,MOT
0,10,1,72,0.934309237,82,10,yeah,"('CHI', 'GRA')",Providence,nai54.xml,83,1,0,GRA,835,753,CHI
3,10,21,167,0.917688356,177,10,it,"('MOT', 'CHI')",Providence,nai54.xml,201,24,3,CHI,1764,1240,MOT
0,7,3,73,0.717839793,80,7,of,"('CHI', 'GRA')",Providence,nai54.xml,83,3,0,GRA,835,753,CHI
0,6,4,73,0.656779536,79,6,and,"('CHI', 'GRA')",Providence,nai54.xml,83,4,0,GRA,835,753,CHI
15,36,21,129,0.642078462,165,36,the,"('MOT', 'CHI')",Providence,nai54.xml,201,36,15,CHI,1764,1240,MOT
3,24,2,54,0.603535022,78,24,you,"('CHI', 'GRA')",Providence,nai54.xml,83,5,3,GRA,835,753,CHI
0,8,3,72,0.600056757,80,8,what,"('CHI', 'GRA')",Providence,nai54.xml,83,3,0,GRA,835,753,CHI
2,9,10,62,0.447429307,71,9,gonna,"('CHI', 'GRA')",Providence,nai54.xml,83,12,2,GRA,835,753,CHI
6,18,10,49,0.345205917,67,18,the,"('CHI', 'GRA')",Providence,nai54.xml,83,16,6,GRA,835,753,CHI
1,10,8,64,0.228089975,74,10,is,"('CHI', 'GRA')",Providence,nai54.xml,83,9,1,GRA,835,753,CHI
0,9,17,175,-0.021277398,184,9,is,"('MOT', 'CHI')",Providence,nai54.xml,201,17,0,CHI,1764,1240,MOT
0,5,12,66,-0.140357358,71,5,that,"('CHI', 'GRA')",Providence,nai54.xml,83,12,0,GRA,835,753,CHI
1,0,6,173,3.660708577,173,0,wanna,"('MOT', 'CHI')",Providence,nai55.xml,180,7,1,CHI,2079,1140,MOT
2,0,10,168,3.595353396,168,0,think,"('MOT', 'CHI')",Providence,nai55.xml,180,12,2,CHI,2079,1140,MOT
0,1,1,178,3.406737562,179,1,little,"('MOT', 'CHI')",Providence,nai55.xml,180,1,0,CHI,2079,1140,MOT
2,2,2,174,3.390024081,176,2,she,"('MOT', 'CHI')",Providence,nai55.xml,180,4,2,CHI,2079,1140,MOT
5,1,11,163,3.320228319,164,1,he,"('MOT', 'CHI')",Providence,nai55.xml,180,16,5,CHI,2079,1140,MOT
0,1,2,177,3.113515309,178,1,put,"('MOT', 'CHI')",Providence,nai55.xml,180,2,0,CHI,2079,1140,MOT
3,3,3,171,3.091042453,174,3,all,"('MOT', 'CHI')",Providence,nai55.xml,180,6,3,CHI,2079,1140,MOT
2,2,5,171,2.967561397,173,2,not,"('MOT', 'CHI')",Providence,nai55.xml,180,7,2,CHI,2079,1140,MOT
1,1,8,170,2.755396322,171,1,some,"('MOT', 'CHI')",Providence,nai55.xml,180,9,1,CHI,2079,1140,MOT
2,3,7,168,2.467714249,171,3,did,"('MOT', 'CHI')",Providence,nai55.xml,180,9,2,CHI,2079,1140,MOT
1,2,7,170,2.451005098,172,2,was,"('MOT', 'CHI')",Providence,nai55.xml,180,8,1,CHI,2079,1140,MOT
0,1,6,173,2.397895273,174,1,for,"('MOT', 'CHI')",Providence,nai55.xml,180,6,0,CHI,2079,1140,MOT
0,1,6,173,2.397895273,174,1,see,"('MOT', 'CHI')",Providence,nai55.xml,180,6,0,CHI,2079,1140,MOT
1,1,13,165,2.351375257,166,1,we,"('MOT', 'CHI')",Providence,nai55.xml,180,14,1,CHI,2079,1140,MOT
2,4,6,168,2.345644582,172,4,up,"('MOT', 'CHI')",Providence,nai55.xml,180,8,2,CHI,2079,1140,MOT
1,2,10,167,2.171249091,169,2,go,"('MOT', 'CHI')",Providence,nai55.xml,180,11,1,CHI,2079,1140,MOT
0,2,5,173,2.131627295,175,2,get,"('MOT', 'CHI')",Providence,nai55.xml,180,5,0,CHI,2079,1140,MOT
0,2,6,172,1.992430165,174,2,where,"('MOT', 'CHI')",Providence,nai55.xml,180,6,0,CHI,2079,1140,MOT
0,1,10,169,1.969440646,170,1,there,"('MOT', 'CHI')",Providence,nai55.xml,180,10,0,CHI,2079,1140,MOT
0,4,3,173,1.968509981,177,4,no,"('MOT', 'CHI')",Providence,nai55.xml,180,3,0,CHI,2079,1140,MOT
0,2,7,171,1.868949108,173,2,at,"('MOT', 'CHI')",Providence,nai55.xml,180,7,0,CHI,2079,1140,MOT
0,1,12,167,1.803593927,168,1,can,"('MOT', 'CHI')",Providence,nai55.xml,180,12,0,CHI,2079,1140,MOT
0,2,8,170,1.757857918,172,2,one,"('MOT', 'CHI')",Providence,nai55.xml,180,8,0,CHI,2079,1140,MOT
0,3,6,171,1.704748092,174,3,yeah,"('MOT', 'CHI')",Providence,nai55.xml,180,6,0,CHI,2079,1140,MOT
1,4,10,165,1.660423467,169,4,they,"('MOT', 'CHI')",Providence,nai55.xml,180,11,1,CHI,2079,1140,MOT
0,3,7,170,1.581267035,173,3,like,"('MOT', 'CHI')",Providence,nai55.xml,180,7,0,CHI,2079,1140,MOT
0,3,8,169,1.470175845,172,3,have,"('MOT', 'CHI')",Providence,nai55.xml,180,8,0,CHI,2079,1140,MOT
2,5,15,158,1.468359314,163,5,do,"('MOT', 'CHI')",Providence,nai55.xml,180,17,2,CHI,2079,1140,MOT
6,7,27,140,1.315066852,147,7,a,"('MOT', 'CHI')",Providence,nai55.xml,180,33,6,CHI,2079,1140,MOT
0,7,5,168,1.150798042,175,7,want,"('MOT', 'CHI')",Providence,nai55.xml,180,5,0,CHI,2079,1140,MOT
0,2,18,160,1.005521866,162,2,of,"('MOT', 'CHI')",Providence,nai55.xml,180,18,0,CHI,2079,1140,MOT
1,9,10,160,0.967276287,169,9,gonna,"('MOT', 'CHI')",Providence,nai55.xml,180,11,1,CHI,2079,1140,MOT
0,3,15,162,0.898486107,165,3,are,"('MOT', 'CHI')",Providence,nai55.xml,180,15,0,CHI,2079,1140,MOT
2,11,13,154,0.898486107,165,11,it,"('MOT', 'CHI')",Providence,nai55.xml,180,15,2,CHI,2079,1140,MOT
0,4,13,163,0.812410601,167,4,on,"('MOT', 'CHI')",Providence,nai55.xml,180,13,0,CHI,2079,1140,MOT
1,6,19,154,0.743790913,160,6,is,"('MOT', 'CHI')",Providence,nai55.xml,180,20,1,CHI,2079,1140,MOT
7,12,33,128,0.732649624,140,12,to,"('MOT', 'CHI')",Providence,nai55.xml,180,40,7,CHI,2079,1140,MOT
2,10,18,150,0.697270898,160,10,what,"('MOT', 'CHI')",Providence,nai55.xml,180,20,2,CHI,2079,1140,MOT
8,14,45,113,0.341653595,127,14,you,"('MOT', 'CHI')",Providence,nai55.xml,180,53,8,CHI,2079,1140,MOT
1,7,25,147,0.331357136,154,7,that,"('MOT', 'CHI')",Providence,nai55.xml,180,26,1,CHI,2079,1140,MOT
0,7,18,155,0.024692613,162,7,in,"('MOT', 'CHI')",Providence,nai55.xml,180,18,0,CHI,2079,1140,MOT
4,13,51,112,-0.228483599,125,13,the,"('MOT', 'CHI')",Providence,nai55.xml,180,55,4,CHI,2079,1140,MOT
1,13,26,140,-0.269780862,153,13,and,"('MOT', 'CHI')",Providence,nai55.xml,180,27,1,CHI,2079,1140,MOT
0,2,2,361,3.414990704,363,2,big,"('CHI', 'MOT')",Providence,nai56.xml,365,2,0,MOT,3247,4432,CHI
2,9,0,354,3.309630188,363,9,wanna,"('CHI', 'MOT')",Providence,nai56.xml,365,2,2,MOT,3247,4432,CHI
1,7,3,354,2.716349004,361,7,up,"('CHI', 'MOT')",Providence,nai56.xml,365,4,1,MOT,3247,4432,CHI
3,12,3,347,2.63078142,359,12,she,"('CHI', 'MOT')",Providence,nai56.xml,365,6,3,MOT,3247,4432,CHI
1,8,4,352,2.441656666,360,8,little,"('CHI', 'MOT')",Providence,nai56.xml,365,5,1,MOT,3247,4432,CHI
0,5,4,356,2.310883896,361,5,go,"('CHI', 'MOT')",Providence,nai56.xml,365,4,0,MOT,3247,4432,CHI
2,9,7,347,2.278664909,356,9,all,"('CHI', 'MOT')",Providence,nai56.xml,365,9,2,MOT,3247,4432,CHI
0,12,1,352,2.239071687,364,12,where,"('CHI', 'MOT')",Providence,nai56.xml,365,1,0,MOT,3247,4432,CHI
0,13,1,351,2.164963715,364,13,with,"('CHI', 'MOT')",Providence,nai56.xml,365,1,0,MOT,3247,4432,CHI
1,13,3,348,2.156733216,361,13,did,"('CHI', 'MOT')",Providence,nai56.xml,365,4,1,MOT,3247,4432,CHI
2,17,3,343,2.153974594,360,17,get,"('CHI', 'MOT')",Providence,nai56.xml,365,5,2,MOT,3247,4432,CHI
1,16,2,346,2.147649792,362,16,can,"('CHI', 'MOT')",Providence,nai56.xml,365,3,1,MOT,3247,4432,CHI
1,9,6,349,2.079441542,358,9,make,"('CHI', 'MOT')",Providence,nai56.xml,365,7,1,MOT,3247,4432,CHI
3,24,3,335,1.976854953,359,24,of,"('CHI', 'MOT')",Providence,nai56.xml,365,6,3,MOT,3247,4432,CHI
10,32,5,318,1.931805543,350,32,on,"('CHI', 'MOT')",Providence,nai56.xml,365,15,10,MOT,3247,4432,CHI
3,13,10,339,1.908483744,352,13,one,"('CHI', 'MOT')",Providence,nai56.xml,365,13,3,MOT,3247,4432,CHI
0,13,2,350,1.874545663,363,13,like,"('CHI', 'MOT')",Providence,nai56.xml,365,2,0,MOT,3247,4432,CHI
4,16,10,335,1.870103903,351,16,gonna,"('CHI', 'MOT')",Providence,nai56.xml,365,14,4,MOT,3247,4432,CHI
0,3,12,350,1.846766099,353,3,no,"('CHI', 'MOT')",Providence,nai56.xml,365,12,0,MOT,3247,4432,CHI
2,12,12,339,1.627542266,351,12,was,"('CHI', 'MOT')",Providence,nai56.xml,365,14,2,MOT,3247,4432,CHI
1,17,5,342,1.612211839,359,17,see,"('CHI', 'MOT')",Providence,nai56.xml,365,6,1,MOT,3247,4432,CHI
1,11,9,344,1.601069663,355,11,want,"('CHI', 'MOT')",Providence,nai56.xml,365,10,1,MOT,3247,4432,CHI
0,12,4,349,1.537694008,361,12,we,"('CHI', 'MOT')",Providence,nai56.xml,365,4,0,MOT,3247,4432,CHI
0,16,3,346,1.454502611,362,16,at,"('CHI', 'MOT')",Providence,nai56.xml,365,3,0,MOT,3247,4432,CHI
1,13,9,342,1.446918983,355,13,have,"('CHI', 'MOT')",Providence,nai56.xml,365,10,1,MOT,3247,4432,CHI
1,24,4,336,1.420005418,360,24,this,"('CHI', 'MOT')",Providence,nai56.xml,365,5,1,MOT,3247,4432,CHI
1,13,10,341,1.364071224,354,13,for,"('CHI', 'MOT')",Providence,nai56.xml,365,11,1,MOT,3247,4432,CHI
2,21,9,333,1.317551209,354,21,put,"('CHI', 'MOT')",Providence,nai56.xml,365,11,2,MOT,3247,4432,CHI
7,28,18,312,1.251119583,340,28,he,"('CHI', 'MOT')",Providence,nai56.xml,365,25,7,MOT,3247,4432,CHI
0,17,4,344,1.212271607,361,17,some,"('CHI', 'MOT')",Providence,nai56.xml,365,4,0,MOT,3247,4432,CHI
8,52,12,293,0.98521499,345,52,it,"('CHI', 'MOT')",Providence,nai56.xml,365,20,8,MOT,3247,4432,CHI
9,55,14,287,0.898999235,342,55,that,"('CHI', 'MOT')",Providence,nai56.xml,365,23,9,MOT,3247,4432,CHI
1,19,12,333,0.858661619,352,19,they,"('CHI', 'MOT')",Providence,nai56.xml,365,13,1,MOT,3247,4432,CHI
1,25,9,330,0.827879775,355,25,are,"('CHI', 'MOT')",Providence,nai56.xml,365,10,1,MOT,3247,4432,CHI
8,37,26,294,0.784261969,331,37,in,"('CHI', 'MOT')",Providence,nai56.xml,365,34,8,MOT,3247,4432,CHI
0,42,2,321,0.752402877,363,42,oh,"('CHI', 'MOT')",Providence,nai56.xml,365,2,0,MOT,3247,4432,CHI
13,51,28,273,0.713510877,324,51,is,"('CHI', 'MOT')",Providence,nai56.xml,365,41,13,MOT,3247,4432,CHI
11,65,18,271,0.684310599,336,65,a,"('CHI', 'MOT')",Providence,nai56.xml,365,29,11,MOT,3247,4432,CHI
1,27,10,327,0.670924044,354,27,do,"('CHI', 'MOT')",Providence,nai56.xml,365,11,1,MOT,3247,4432,CHI
1,22,14,328,0.588070796,350,22,yeah,"('CHI', 'MOT')",Providence,nai56.xml,365,15,1,MOT,3247,4432,CHI
0,12,18,335,0.294390291,347,12,there,"('CHI', 'MOT')",Providence,nai56.xml,365,18,0,MOT,3247,4432,CHI
5,67,16,277,0.283196323,344,67,to,"('CHI', 'MOT')",Providence,nai56.xml,365,21,5,MOT,3247,4432,CHI
3,47,18,297,0.226037909,344,47,and,"('CHI', 'MOT')",Providence,nai56.xml,365,21,3,MOT,3247,4432,CHI
6,50,30,279,0.178616732,329,50,what,"('CHI', 'MOT')",Providence,nai56.xml,365,36,6,MOT,3247,4432,CHI
4,93,11,257,0.096560962,350,93,you,"('CHI', 'MOT')",Providence,nai56.xml,365,15,4,MOT,3247,4432,CHI
14,69,46,236,0.059268322,305,69,the,"('CHI', 'MOT')",Providence,nai56.xml,365,60,14,MOT,3247,4432,CHI
0,1,2,353,3.795489189,354,1,she,"('MOT', 'CHI')",Providence,nai57.xml,356,2,0,CHI,4485,2075,MOT
2,1,10,343,3.612846554,344,1,get,"('MOT', 'CHI')",Providence,nai57.xml,356,12,2,CHI,4485,2075,MOT
0,1,6,349,3.091042453,350,1,make,"('MOT', 'CHI')",Providence,nai57.xml,356,6,0,CHI,4485,2075,MOT
1,4,6,345,2.747270914,349,4,where,"('MOT', 'CHI')",Providence,nai57.xml,356,7,1,CHI,4485,2075,MOT
0,2,6,348,2.685577345,350,2,put,"('MOT', 'CHI')",Providence,nai57.xml,356,6,0,CHI,4485,2075,MOT
0,1,10,345,2.674148649,346,1,all,"('MOT', 'CHI')",Providence,nai57.xml,356,10,0,CHI,4485,2075,MOT
2,7,6,341,2.574518808,348,7,he,"('MOT', 'CHI')",Providence,nai57.xml,356,8,2,CHI,4485,2075,MOT
0,3,6,347,2.397895273,350,3,my,"('MOT', 'CHI')",Providence,nai57.xml,356,6,0,CHI,4485,2075,MOT
0,1,14,341,2.374905755,342,1,this,"('MOT', 'CHI')",Providence,nai57.xml,356,14,0,CHI,4485,2075,MOT
0,1,15,340,2.311369923,341,1,can,"('MOT', 'CHI')",Providence,nai57.xml,356,15,0,CHI,4485,2075,MOT
0,1,19,336,2.088330489,337,1,at,"('MOT', 'CHI')",Providence,nai57.xml,356,19,0,CHI,4485,2075,MOT
0,1,21,334,1.991441534,335,1,think,"('MOT', 'CHI')",Providence,nai57.xml,356,21,0,CHI,4485,2075,MOT
0,1,23,332,1.902107526,333,1,see,"('MOT', 'CHI')",Providence,nai57.xml,356,23,0,CHI,4485,2075,MOT
0,4,9,343,1.847738737,347,4,not,"('MOT', 'CHI')",Providence,nai57.xml,356,9,0,CHI,4485,2075,MOT
0,3,12,341,1.821087084,344,3,little,"('MOT', 'CHI')",Providence,nai57.xml,356,12,0,CHI,4485,2075,MOT
0,6,7,343,1.717651497,349,6,was,"('MOT', 'CHI')",Providence,nai57.xml,356,7,0,CHI,4485,2075,MOT
0,15,2,339,1.716047647,354,15,no,"('MOT', 'CHI')",Providence,nai57.xml,356,2,0,CHI,4485,2075,MOT
0,1,28,327,1.704748092,328,1,of,"('MOT', 'CHI')",Providence,nai57.xml,356,28,0,CHI,4485,2075,MOT
0,1,28,327,1.704748092,328,1,some,"('MOT', 'CHI')",Providence,nai57.xml,356,28,0,CHI,4485,2075,MOT
0,4,11,341,1.67493751,345,4,up,"('MOT', 'CHI')",Providence,nai57.xml,356,11,0,CHI,4485,2075,MOT
1,4,23,328,1.636753723,332,4,have,"('MOT', 'CHI')",Providence,nai57.xml,356,24,1,CHI,4485,2075,MOT
1,6,16,333,1.63468053,339,6,wanna,"('MOT', 'CHI')",Providence,nai57.xml,356,17,1,CHI,4485,2075,MOT
3,9,22,322,1.596014892,331,9,gonna,"('MOT', 'CHI')",Providence,nai57.xml,356,25,3,CHI,4485,2075,MOT
0,8,6,342,1.586965057,350,8,go,"('MOT', 'CHI')",Providence,nai57.xml,356,6,0,CHI,4485,2075,MOT
0,3,16,337,1.558144618,340,3,with,"('MOT', 'CHI')",Providence,nai57.xml,356,16,0,CHI,4485,2075,MOT
5,10,31,310,1.530829582,320,10,in,"('MOT', 'CHI')",Providence,nai57.xml,356,36,5,CHI,4485,2075,MOT
0,7,8,341,1.47590652,348,7,did,"('MOT', 'CHI')",Providence,nai57.xml,356,8,0,CHI,4485,2075,MOT
1,5,23,327,1.454432166,332,5,they,"('MOT', 'CHI')",Providence,nai57.xml,356,24,1,CHI,4485,2075,MOT
1,5,24,326,1.413693335,331,5,like,"('MOT', 'CHI')",Providence,nai57.xml,356,25,1,CHI,4485,2075,MOT
1,0,1,6,1.386294361,6,0,in,"('MOT', 'FAT')",Providence,nai57.xml,8,2,1,FAT,120,77,MOT
2,7,28,319,1.346448453,326,7,on,"('MOT', 'CHI')",Providence,nai57.xml,356,30,2,CHI,4485,2075,MOT
0,3,20,333,1.345709081,336,3,we,"('MOT', 'CHI')",Providence,nai57.xml,356,20,0,CHI,4485,2075,MOT
1,5,26,324,1.336210257,329,5,are,"('MOT', 'CHI')",Providence,nai57.xml,356,27,1,CHI,4485,2075,MOT
1,2,0,12,1.268511325,14,2,in,"('CHI', 'FAT')",Providence,nai57.xml,15,1,1,FAT,59,118,CHI
1,2,0,12,1.268511325,14,2,do,"('CHI', 'FAT')",Providence,nai57.xml,15,1,1,FAT,59,118,CHI
0,6,13,337,1.189584067,343,6,yeah,"('MOT', 'CHI')",Providence,nai57.xml,356,13,0,CHI,4485,2075,MOT
0,3,24,329,1.166750094,332,3,for,"('MOT', 'CHI')",Providence,nai57.xml,356,24,0,CHI,4485,2075,MOT
0,15,5,336,1.147969186,351,15,one,"('MOT', 'CHI')",Providence,nai57.xml,356,5,0,CHI,4485,2075,MOT
1,1,0,6,1.098612289,7,1,oh,"('MOT', 'FAT')",Providence,nai57.xml,8,1,1,FAT,120,77,MOT
3,7,49,297,1.041453875,304,7,it,"('MOT', 'CHI')",Providence,nai57.xml,356,52,3,CHI,4485,2075,MOT
0,2,36,318,1.038353097,320,2,oh,"('MOT', 'CHI')",Providence,nai57.xml,356,36,0,CHI,4485,2075,MOT
1,1,2,11,1.029619417,12,1,what,"('CHI', 'FAT')",Providence,nai57.xml,15,3,1,FAT,59,118,CHI
1,10,19,326,1.02725535,336,10,want,"('MOT', 'CHI')",Providence,nai57.xml,356,20,1,CHI,4485,2075,MOT
0,1,1,13,0.980829253,14,1,was,"('CHI', 'FAT')",Providence,nai57.xml,15,1,0,FAT,59,118,CHI
1,6,32,317,0.975714152,323,6,do,"('MOT', 'CHI')",Providence,nai57.xml,356,33,1,CHI,4485,2075,MOT
1,0,0,1,0.693147181,1,0,of,"('CHI', 'MOT')",Providence,nai57.xml,2,1,1,MOT,9,23,CHI
12,25,67,252,0.543615447,277,25,a,"('MOT', 'CHI')",Providence,nai57.xml,356,79,12,CHI,4485,2075,MOT
0,11,15,330,0.519610453,341,11,there,"('MOT', 'CHI')",Providence,nai57.xml,356,15,0,CHI,4485,2075,MOT
2,10,48,296,0.47957308,306,10,and,"('MOT', 'CHI')",Providence,nai57.xml,356,50,2,CHI,4485,2075,MOT
0,1,1,6,0.405465108,7,1,it,"('MOT', 'FAT')",Providence,nai57.xml,8,1,0,FAT,120,77,MOT
3,18,40,295,0.387765531,313,18,what,"('MOT', 'CHI')",Providence,nai57.xml,356,43,3,CHI,4485,2075,MOT
2,5,101,248,0.194156014,253,5,you,"('MOT', 'CHI')",Providence,nai57.xml,356,103,2,CHI,4485,2075,MOT
16,37,89,214,0.056187839,251,37,the,"('MOT', 'CHI')",Providence,nai57.xml,356,105,16,CHI,4485,2075,MOT
0,1,1,3,0,4,1,want,"('FAT', 'CHI')",Providence,nai57.xml,5,1,0,CHI,25,35,FAT
0,1,2,5,0,6,1,what,"('MOT', 'FAT')",Providence,nai57.xml,8,2,0,FAT,120,77,MOT
0,2,1,5,0,7,2,my,"('MOT', 'FAT')",Providence,nai57.xml,8,1,0,FAT,120,77,MOT
0,2,1,5,0,7,2,is,"('MOT', 'FAT')",Providence,nai57.xml,8,1,0,FAT,120,77,MOT
4,20,64,268,-0.013698844,288,20,to,"('MOT', 'CHI')",Providence,nai57.xml,356,68,4,CHI,4485,2075,MOT
7,34,61,254,-0.054520839,288,34,that,"('MOT', 'CHI')",Providence,nai57.xml,356,68,7,CHI,4485,2075,MOT
1,13,53,289,-0.254234138,302,13,is,"('MOT', 'CHI')",Providence,nai57.xml,356,54,1,CHI,4485,2075,MOT
0,4,2,9,-0.287682072,13,4,the,"('CHI', 'FAT')",Providence,nai57.xml,15,2,0,FAT,59,118,CHI
0,2,2,4,-0.405465108,6,2,that,"('MOT', 'FAT')",Providence,nai57.xml,8,2,0,FAT,120,77,MOT
0,2,2,4,-0.405465108,6,2,the,"('MOT', 'FAT')",Providence,nai57.xml,8,2,0,FAT,120,77,MOT
0,2,1,2,-0.405465108,4,2,it,"('FAT', 'CHI')",Providence,nai57.xml,5,1,0,CHI,25,35,FAT
3,0,2,73,3.757872326,73,0,no,"('CHI', 'MOT')",Providence,nai58.xml,78,5,3,MOT,511,890,CHI
1,1,0,76,3.270835564,77,1,up,"('CHI', 'MOT')",Providence,nai58.xml,78,1,1,MOT,511,890,CHI
1,0,0,31,3.091042453,31,0,he,"('CHI', 'FAT')",Providence,nai58.xml,32,1,1,FAT,156,255,CHI
2,2,0,74,2.970414466,76,2,like,"('CHI', 'MOT')",Providence,nai58.xml,78,2,2,MOT,511,890,CHI
1,0,0,22,2.772588722,22,0,wanna,"('MOT', 'FAT')",Providence,nai58.xml,23,1,1,FAT,207,214,MOT
2,3,0,73,2.682732393,76,3,little,"('CHI', 'MOT')",Providence,nai58.xml,78,2,2,MOT,511,890,CHI
2,3,0,73,2.682732393,76,3,at,"('CHI', 'MOT')",Providence,nai58.xml,78,2,2,MOT,511,890,CHI
0,1,1,76,2.577688383,77,1,think,"('CHI', 'MOT')",Providence,nai58.xml,78,1,0,MOT,511,890,CHI
1,0,1,21,2.442347035,21,0,with,"('MOT', 'FAT')",Providence,nai58.xml,23,2,1,FAT,207,214,MOT
1,0,1,21,2.442347035,21,0,was,"('MOT', 'FAT')",Providence,nai58.xml,23,2,1,FAT,207,214,MOT
1,1,0,30,2.397895273,31,1,want,"('CHI', 'FAT')",Providence,nai58.xml,32,1,1,FAT,156,255,CHI
1,1,0,30,2.397895273,31,1,up,"('CHI', 'FAT')",Providence,nai58.xml,32,1,1,FAT,156,255,CHI
0,1,2,75,2.277267285,76,1,yeah,"('CHI', 'MOT')",Providence,nai58.xml,78,2,0,MOT,511,890,CHI
2,1,1,28,2.2300144,29,1,a,"('CHI', 'FAT')",Providence,nai58.xml,32,3,2,FAT,156,255,CHI
1,0,2,21,2.219203484,21,0,some,"('MOT', 'CHI')",Providence,nai58.xml,24,3,1,CHI,221,202,MOT
1,0,2,20,2.174751721,20,0,we,"('MOT', 'FAT')",Providence,nai58.xml,23,3,1,FAT,207,214,MOT
0,2,1,75,2.172223275,77,2,there,"('CHI', 'MOT')",Providence,nai58.xml,78,1,0,MOT,511,890,CHI
1,1,1,29,2.079441542,30,1,did,"('CHI', 'FAT')",Providence,nai58.xml,32,2,1,FAT,156,255,CHI
1,1,0,21,2.079441542,22,1,do,"('MOT', 'FAT')",Providence,nai58.xml,23,1,1,FAT,207,214,MOT
1,2,0,29,1.992430165,31,2,like,"('CHI', 'FAT')",Providence,nai58.xml,32,1,1,FAT,156,255,CHI
1,1,7,69,1.974081026,70,1,want,"('CHI', 'MOT')",Providence,nai58.xml,78,8,1,MOT,511,890,CHI
0,1,1,39,1.945910149,40,1,see,"('FAT', 'CHI')",Providence,nai58.xml,41,1,0,CHI,694,228,FAT
0,1,1,39,1.945910149,40,1,can,"('FAT', 'CHI')",Providence,nai58.xml,41,1,0,CHI,694,228,FAT
1,1,2,30,1.887069649,31,1,one,"('FAT', 'MOT')",Providence,nai58.xml,34,3,1,MOT,433,321,FAT
0,3,1,74,1.884541203,77,3,one,"('CHI', 'MOT')",Providence,nai58.xml,78,1,0,MOT,511,890,CHI
1,1,2,28,1.824549292,29,1,to,"('CHI', 'FAT')",Providence,nai58.xml,32,3,1,FAT,156,255,CHI
1,1,1,21,1.791759469,22,1,was,"('MOT', 'CHI')",Providence,nai58.xml,24,2,1,CHI,221,202,MOT
0,1,1,32,1.763588592,33,1,get,"('FAT', 'MOT')",Providence,nai58.xml,34,1,0,MOT,433,321,FAT
0,1,1,32,1.763588592,33,1,with,"('FAT', 'MOT')",Providence,nai58.xml,34,1,0,MOT,433,321,FAT
0,1,1,32,1.763588592,33,1,are,"('FAT', 'MOT')",Providence,nai58.xml,34,1,0,MOT,433,321,FAT
0,1,1,32,1.763588592,33,1,not,"('FAT', 'MOT')",Providence,nai58.xml,34,1,0,MOT,433,321,FAT
1,2,0,21,1.714798428,23,2,he,"('MOT', 'CHI')",Providence,nai58.xml,24,1,1,CHI,221,202,MOT
1,2,0,20,1.673976434,22,2,want,"('MOT', 'FAT')",Providence,nai58.xml,23,1,1,FAT,207,214,MOT
0,4,1,73,1.661397651,77,4,was,"('CHI', 'MOT')",Providence,nai58.xml,78,1,0,MOT,511,890,CHI
0,4,1,73,1.661397651,77,4,on,"('CHI', 'MOT')",Providence,nai58.xml,78,1,0,MOT,511,890,CHI
0,1,2,38,1.634130525,39,1,are,"('FAT', 'CHI')",Providence,nai58.xml,41,2,0,CHI,694,228,FAT
0,3,2,73,1.584120104,76,3,gonna,"('CHI', 'MOT')",Providence,nai58.xml,78,2,0,MOT,511,890,CHI
2,2,4,33,1.531476371,35,2,what,"('FAT', 'CHI')",Providence,nai58.xml,41,6,2,CHI,694,228,FAT
0,5,1,72,1.479076095,77,5,in,"('CHI', 'MOT')",Providence,nai58.xml,78,1,0,MOT,511,890,CHI
0,5,1,72,1.479076095,77,5,have,"('CHI', 'MOT')",Providence,nai58.xml,78,1,0,MOT,511,890,CHI
0,5,1,72,1.479076095,77,5,put,"('CHI', 'MOT')",Providence,nai58.xml,78,1,0,MOT,511,890,CHI
0,1,2,31,1.446918983,32,1,yeah,"('FAT', 'MOT')",Providence,nai58.xml,34,2,0,MOT,433,321,FAT
0,1,2,31,1.446918983,32,1,but,"('FAT', 'MOT')",Providence,nai58.xml,34,2,0,MOT,433,321,FAT
0,1,1,22,1.427116356,23,1,want,"('MOT', 'CHI')",Providence,nai58.xml,24,1,0,CHI,221,202,MOT
0,1,1,22,1.427116356,23,1,what,"('MOT', 'CHI')",Providence,nai58.xml,24,1,0,CHI,221,202,MOT
0,1,1,22,1.427116356,23,1,can,"('MOT', 'CHI')",Providence,nai58.xml,24,1,0,CHI,221,202,MOT
1,2,2,27,1.419084184,29,2,for,"('CHI', 'FAT')",Providence,nai58.xml,32,3,1,FAT,156,255,CHI
3,8,3,64,1.413693335,72,8,and,"('CHI', 'MOT')",Providence,nai58.xml,78,6,3,MOT,511,890,CHI
2,7,3,66,1.390748711,73,7,to,"('CHI', 'MOT')",Providence,nai58.xml,78,5,2,MOT,511,890,CHI
0,1,2,29,1.386294361,30,1,with,"('CHI', 'FAT')",Providence,nai58.xml,32,2,0,FAT,156,255,CHI
0,1,2,29,1.386294361,30,1,is,"('CHI', 'FAT')",Providence,nai58.xml,32,2,0,FAT,156,255,CHI
0,1,1,21,1.386294361,22,1,but,"('MOT', 'FAT')",Providence,nai58.xml,23,1,0,FAT,207,214,MOT
2,3,2,27,1.386294361,30,3,a,"('FAT', 'MOT')",Providence,nai58.xml,34,4,2,MOT,433,321,FAT
0,4,2,72,1.360976553,76,4,for,"('CHI', 'MOT')",Providence,nai58.xml,78,2,0,MOT,511,890,CHI
0,2,1,31,1.358123484,33,2,want,"('FAT', 'MOT')",Providence,nai58.xml,34,1,0,MOT,433,321,FAT
0,2,1,31,1.358123484,33,2,can,"('FAT', 'MOT')",Providence,nai58.xml,34,1,0,MOT,433,321,FAT
0,2,1,29,1.299282984,31,2,yeah,"('CHI', 'FAT')",Providence,nai58.xml,32,1,0,FAT,156,255,CHI
1,3,7,67,1.280933845,70,3,this,"('CHI', 'MOT')",Providence,nai58.xml,78,8,1,MOT,511,890,CHI
0,3,1,37,1.252762968,40,3,want,"('FAT', 'CHI')",Providence,nai58.xml,41,1,0,CHI,694,228,FAT
3,1,5,14,1.223775432,15,1,you,"('MOT', 'FAT')",Providence,nai58.xml,23,8,3,FAT,207,214,MOT
0,1,3,30,1.193922468,31,1,did,"('FAT', 'MOT')",Providence,nai58.xml,34,3,0,MOT,433,321,FAT
0,1,4,36,1.178654996,37,1,of,"('FAT', 'CHI')",Providence,nai58.xml,41,4,0,CHI,694,228,FAT
0,5,2,71,1.178654996,76,5,what,"('CHI', 'MOT')",Providence,nai58.xml,78,2,0,MOT,511,890,CHI
1,1,6,26,1.170071253,27,1,think,"('FAT', 'MOT')",Providence,nai58.xml,34,7,1,MOT,433,321,FAT
1,5,5,67,1.126011263,72,5,it,"('CHI', 'MOT')",Providence,nai58.xml,78,6,1,MOT,511,890,CHI
1,9,2,66,1.124929597,75,9,that,"('CHI', 'MOT')",Providence,nai58.xml,78,3,1,MOT,511,890,CHI
0,1,2,21,1.098612289,22,1,of,"('MOT', 'CHI')",Providence,nai58.xml,24,2,0,CHI,221,202,MOT
0,1,2,21,1.098612289,22,1,see,"('MOT', 'CHI')",Providence,nai58.xml,24,2,0,CHI,221,202,MOT
0,3,1,30,1.070441412,33,3,go,"('FAT', 'MOT')",Providence,nai58.xml,34,1,0,MOT,433,321,FAT
0,1,2,20,1.056052674,21,1,of,"('MOT', 'FAT')",Providence,nai58.xml,23,2,0,FAT,207,214,MOT
0,1,2,20,1.056052674,21,1,there,"('MOT', 'FAT')",Providence,nai58.xml,23,2,0,FAT,207,214,MOT
0,2,2,30,1.041453875,32,2,like,"('FAT', 'MOT')",Providence,nai58.xml,34,2,0,MOT,433,321,FAT
0,2,2,30,1.041453875,32,2,what,"('FAT', 'MOT')",Providence,nai58.xml,34,2,0,MOT,433,321,FAT
0,2,1,21,1.021651248,23,2,did,"('MOT', 'CHI')",Providence,nai58.xml,24,1,0,CHI,221,202,MOT
5,15,3,55,0.993251773,70,15,a,"('CHI', 'MOT')",Providence,nai58.xml,78,8,5,MOT,511,890,CHI
0,2,1,20,0.980829253,22,2,in,"('MOT', 'FAT')",Providence,nai58.xml,23,1,0,FAT,207,214,MOT
0,2,1,20,0.980829253,22,2,it,"('MOT', 'FAT')",Providence,nai58.xml,23,1,0,FAT,207,214,MOT
1,3,3,25,0.916290732,28,3,and,"('CHI', 'FAT')",Providence,nai58.xml,32,4,1,FAT,156,255,CHI
1,4,2,25,0.90825856,29,4,the,"('CHI', 'FAT')",Providence,nai58.xml,32,3,1,FAT,156,255,CHI
1,2,7,31,0.84729786,33,2,do,"('FAT', 'CHI')",Providence,nai58.xml,41,8,1,CHI,694,228,FAT
0,1,6,34,0.83832919,35,1,that,"('FAT', 'CHI')",Providence,nai58.xml,41,6,0,CHI,694,228,FAT
0,1,3,20,0.832909123,21,1,like,"('MOT', 'CHI')",Providence,nai58.xml,24,3,0,CHI,221,202,MOT
0,1,5,28,0.794929875,29,1,in,"('FAT', 'MOT')",Providence,nai58.xml,34,5,0,MOT,433,321,FAT
0,1,5,28,0.794929875,29,1,was,"('FAT', 'MOT')",Providence,nai58.xml,34,5,0,MOT,433,321,FAT
1,3,4,26,0.794929875,29,3,and,"('FAT', 'MOT')",Providence,nai58.xml,34,5,1,MOT,433,321,FAT
0,2,3,29,0.78845736,31,2,gonna,"('FAT', 'MOT')",Providence,nai58.xml,34,3,0,MOT,433,321,FAT
0,1,3,19,0.78845736,20,1,are,"('MOT', 'FAT')",Providence,nai58.xml,23,3,0,FAT,207,214,MOT
2,2,8,22,0.773189888,24,2,it,"('FAT', 'MOT')",Providence,nai58.xml,34,10,2,MOT,433,321,FAT
0,3,2,29,0.753771802,32,3,of,"('FAT', 'MOT')",Providence,nai58.xml,34,2,0,MOT,433,321,FAT
0,3,2,29,0.753771802,32,3,on,"('FAT', 'MOT')",Providence,nai58.xml,34,2,0,MOT,433,321,FAT
0,5,4,69,0.747214402,74,5,go,"('CHI', 'MOT')",Providence,nai58.xml,78,4,0,MOT,511,890,CHI
1,2,8,30,0.723000144,32,2,and,"('FAT', 'CHI')",Providence,nai58.xml,41,9,1,CHI,694,228,FAT
0,2,2,20,0.693147181,22,2,do,"('MOT', 'CHI')",Providence,nai58.xml,24,2,0,CHI,221,202,MOT
0,7,3,68,0.654925968,75,7,wanna,"('CHI', 'MOT')",Providence,nai58.xml,78,3,0,MOT,511,890,CHI
0,2,2,19,0.650587566,21,2,and,"('MOT', 'FAT')",Providence,nai58.xml,23,2,0,FAT,207,214,MOT
1,3,3,17,0.606135804,20,3,to,"('MOT', 'CHI')",Providence,nai58.xml,24,4,1,CHI,221,202,MOT
1,6,2,23,0.571786324,29,6,it,"('CHI', 'FAT')",Providence,nai58.xml,32,3,1,FAT,156,255,CHI
0,1,4,18,0.559615788,19,1,can,"('MOT', 'FAT')",Providence,nai58.xml,23,4,0,FAT,207,214,MOT
0,8,3,67,0.537142932,75,8,is,"('CHI', 'MOT')",Providence,nai58.xml,78,3,0,MOT,511,890,CHI
0,3,3,28,0.500775288,31,3,is,"('FAT', 'MOT')",Providence,nai58.xml,34,3,0,MOT,433,321,FAT
1,2,10,28,0.495321437,30,2,it,"('FAT', 'CHI')",Providence,nai58.xml,41,11,1,CHI,694,228,FAT
0,4,1,18,0.470003629,22,4,oh,"('MOT', 'FAT')",Providence,nai58.xml,23,1,0,FAT,207,214,MOT
0,4,1,18,0.470003629,22,4,that,"('MOT', 'FAT')",Providence,nai58.xml,23,1,0,FAT,207,214,MOT
0,4,1,18,0.470003629,22,4,to,"('MOT', 'FAT')",Providence,nai58.xml,23,1,0,FAT,207,214,MOT
0,1,9,31,0.435318071,32,1,you,"('FAT', 'CHI')",Providence,nai58.xml,41,9,0,CHI,694,228,FAT
1,3,8,29,0.435318071,32,3,a,"('FAT', 'CHI')",Providence,nai58.xml,41,9,1,CHI,694,228,FAT
0,6,5,67,0.425667815,73,6,my,"('CHI', 'MOT')",Providence,nai58.xml,78,5,0,MOT,511,890,CHI
1,4,3,16,0.382992252,20,4,it,"('MOT', 'CHI')",Providence,nai58.xml,24,4,1,CHI,221,202,MOT
6,16,10,46,0.38120813,62,16,the,"('CHI', 'MOT')",Providence,nai58.xml,78,16,6,MOT,511,890,CHI
0,10,3,65,0.336472237,75,10,do,"('CHI', 'MOT')",Providence,nai58.xml,78,3,0,MOT,511,890,CHI
0,4,3,27,0.277631737,31,4,that,"('FAT', 'MOT')",Providence,nai58.xml,34,3,0,MOT,433,321,FAT
2,5,7,20,0.204794413,25,5,the,"('FAT', 'MOT')",Providence,nai58.xml,34,9,2,MOT,433,321,FAT
1,4,4,15,0.182321557,19,4,the,"('MOT', 'CHI')",Providence,nai58.xml,24,5,1,CHI,221,202,MOT
0,6,3,32,0.133531393,38,6,this,"('FAT', 'CHI')",Providence,nai58.xml,41,3,0,CHI,694,228,FAT
1,4,7,22,0.113328685,26,4,you,"('FAT', 'MOT')",Providence,nai58.xml,34,8,1,MOT,433,321,FAT
0,3,3,17,0.09531018,20,3,a,"('MOT', 'FAT')",Providence,nai58.xml,23,3,0,FAT,207,214,MOT
1,3,6,14,0.054067221,17,3,a,"('MOT', 'CHI')",Providence,nai58.xml,24,7,1,CHI,221,202,MOT
0,1,7,15,0,16,1,the,"('MOT', 'FAT')",Providence,nai58.xml,23,7,0,FAT,207,214,MOT
2,8,6,18,-0.068992871,26,8,to,"('FAT', 'MOT')",Providence,nai58.xml,34,8,2,MOT,433,321,FAT
0,6,4,31,-0.074107972,37,6,to,"('FAT', 'CHI')",Providence,nai58.xml,41,4,0,CHI,694,228,FAT
0,11,1,20,-0.087011377,31,11,you,"('CHI', 'FAT')",Providence,nai58.xml,32,1,0,FAT,156,255,CHI
0,4,3,16,-0.127833372,20,4,have,"('MOT', 'FAT')",Providence,nai58.xml,23,3,0,FAT,207,214,MOT
0,7,5,22,-0.591364486,29,7,oh,"('FAT', 'MOT')",Providence,nai58.xml,34,5,0,MOT,433,321,FAT
0,6,11,24,-1.045123604,30,6,the,"('FAT', 'CHI')",Providence,nai58.xml,41,11,0,CHI,694,228,FAT
1,0,1,103,3.96081317,103,0,where,"('FAT', 'CHI')",Providence,nai59a.xml,105,2,1,CHI,1123,637,FAT
1,0,1,76,3.663561646,76,0,they,"('MOT', 'CHI')",Providence,nai59a.xml,78,2,1,CHI,749,577,MOT
2,3,0,142,3.316456153,145,3,he,"('CHI', 'MOT')",Providence,nai59a.xml,147,2,2,MOT,1214,1317,CHI
0,1,1,145,3.205452805,146,1,get,"('CHI', 'MOT')",Providence,nai59a.xml,147,1,0,MOT,1214,1317,CHI
0,1,1,145,3.205452805,146,1,my,"('CHI', 'MOT')",Providence,nai59a.xml,147,1,0,MOT,1214,1317,CHI
1,0,7,97,2.985681938,97,0,like,"('FAT', 'CHI')",Providence,nai59a.xml,105,8,1,CHI,1123,637,FAT
1,1,1,75,2.970414466,76,1,up,"('MOT', 'CHI')",Providence,nai59a.xml,78,2,1,CHI,749,577,MOT
0,1,2,144,2.910991045,145,1,have,"('CHI', 'MOT')",Providence,nai59a.xml,147,2,0,MOT,1214,1317,CHI
2,4,1,140,2.863343086,144,4,look,"('CHI', 'MOT')",Providence,nai59a.xml,147,3,2,MOT,1214,1317,CHI
0,2,1,144,2.799987696,146,2,but,"('CHI', 'MOT')",Providence,nai59a.xml,147,1,0,MOT,1214,1317,CHI
0,2,1,144,2.799987696,146,2,big,"('CHI', 'MOT')",Providence,nai59a.xml,147,1,0,MOT,1214,1317,CHI
2,2,1,73,2.734367509,75,2,want,"('MOT', 'CHI')",Providence,nai59a.xml,78,3,2,CHI,749,577,MOT
1,4,1,141,2.687847494,145,4,at,"('CHI', 'MOT')",Providence,nai59a.xml,147,2,1,MOT,1214,1317,CHI
1,4,1,141,2.687847494,145,4,think,"('CHI', 'MOT')",Providence,nai59a.xml,147,2,1,MOT,1214,1317,CHI
0,1,1,81,2.63905733,82,1,with,"('FAT', 'MOT')",Providence,nai59a.xml,83,1,0,MOT,835,854,FAT
0,1,1,76,2.577688383,77,1,see,"('MOT', 'CHI')",Providence,nai59a.xml,78,1,0,CHI,749,577,MOT
0,1,2,102,2.574518808,103,1,one,"('FAT', 'CHI')",Providence,nai59a.xml,105,2,0,CHI,1123,637,FAT
0,1,2,102,2.574518808,103,1,big,"('FAT', 'CHI')",Providence,nai59a.xml,105,2,0,CHI,1123,637,FAT
2,2,4,97,2.535678975,99,2,he,"('FAT', 'CHI')",Providence,nai59a.xml,105,6,2,CHI,1123,637,FAT
0,3,1,143,2.512305624,146,3,was,"('CHI', 'MOT')",Providence,nai59a.xml,147,1,0,MOT,1214,1317,CHI
0,3,1,143,2.512305624,146,3,they,"('CHI', 'MOT')",Providence,nai59a.xml,147,1,0,MOT,1214,1317,CHI
0,3,1,143,2.512305624,146,3,did,"('CHI', 'MOT')",Providence,nai59a.xml,147,1,0,MOT,1214,1317,CHI
0,2,1,102,2.466214517,104,2,for,"('FAT', 'CHI')",Providence,nai59a.xml,105,1,0,CHI,1123,637,FAT
0,2,1,102,2.466214517,104,2,make,"('FAT', 'CHI')",Providence,nai59a.xml,105,1,0,CHI,1123,637,FAT
1,1,4,77,2.436116486,78,1,no,"('FAT', 'MOT')",Providence,nai59a.xml,83,5,1,MOT,835,854,FAT
1,0,14,90,2.381722414,90,0,are,"('FAT', 'CHI')",Providence,nai59a.xml,105,15,1,CHI,1123,637,FAT
3,8,1,135,2.374044057,143,8,like,"('CHI', 'MOT')",Providence,nai59a.xml,147,4,3,MOT,1214,1317,CHI
1,6,1,139,2.351375257,145,6,in,"('CHI', 'MOT')",Providence,nai59a.xml,147,2,1,MOT,1214,1317,CHI
1,3,1,78,2.339399066,81,3,can,"('FAT', 'MOT')",Providence,nai59a.xml,83,2,1,MOT,835,854,FAT
0,4,1,142,2.289162073,146,4,yeah,"('CHI', 'MOT')",Providence,nai59a.xml,147,1,0,MOT,1214,1317,CHI
0,1,2,75,2.277267285,76,1,yeah,"('MOT', 'CHI')",Providence,nai59a.xml,78,2,0,CHI,749,577,MOT
0,1,2,75,2.277267285,76,1,not,"('MOT', 'CHI')",Providence,nai59a.xml,78,2,0,CHI,749,577,MOT
0,2,3,142,2.275556421,144,2,go,"('CHI', 'MOT')",Providence,nai59a.xml,147,3,0,MOT,1214,1317,CHI
0,2,3,142,2.275556421,144,2,little,"('CHI', 'MOT')",Providence,nai59a.xml,147,3,0,MOT,1214,1317,CHI
1,4,3,139,2.268683541,143,4,can,"('CHI', 'MOT')",Providence,nai59a.xml,147,4,1,MOT,1214,1317,CHI
0,2,1,80,2.233592222,82,2,at,"('FAT', 'MOT')",Providence,nai59a.xml,83,1,0,MOT,835,854,FAT
1,2,3,77,2.197224577,79,2,little,"('FAT', 'MOT')",Providence,nai59a.xml,83,4,1,MOT,835,854,FAT
0,2,1,75,2.172223275,77,2,on,"('MOT', 'CHI')",Providence,nai59a.xml,78,1,0,CHI,749,577,MOT
1,2,3,72,2.133508763,74,2,little,"('MOT', 'CHI')",Providence,nai59a.xml,78,4,1,CHI,749,577,MOT
1,8,1,137,2.100060829,145,8,do,"('CHI', 'MOT')",Providence,nai59a.xml,147,2,1,MOT,1214,1317,CHI
0,1,3,74,2.041220329,75,1,of,"('MOT', 'CHI')",Providence,nai59a.xml,78,3,0,CHI,749,577,MOT
2,5,1,70,2.041220329,75,5,this,"('MOT', 'CHI')",Providence,nai59a.xml,78,3,2,CHI,749,577,MOT
0,1,3,74,2.041220329,75,1,my,"('MOT', 'CHI')",Providence,nai59a.xml,78,3,0,CHI,749,577,MOT
1,0,2,17,2.028148247,17,0,on,"('MOT', 'FAT')",Providence,nai59a.xml,20,3,1,FAT,436,165,MOT
0,4,2,141,1.994700313,145,4,wanna,"('CHI', 'MOT')",Providence,nai59a.xml,147,2,0,MOT,1214,1317,CHI
2,0,3,15,1.985915484,15,0,you,"('MOT', 'FAT')",Providence,nai59a.xml,20,5,2,FAT,436,165,MOT
0,1,5,99,1.985915484,100,1,was,"('FAT', 'CHI')",Providence,nai59a.xml,105,5,0,CHI,1123,637,FAT
0,1,5,99,1.985915484,100,1,up,"('FAT', 'CHI')",Providence,nai59a.xml,105,5,0,CHI,1123,637,FAT
0,1,5,99,1.985915484,100,1,some,"('FAT', 'CHI')",Providence,nai59a.xml,105,5,0,CHI,1123,637,FAT
0,1,5,99,1.985915484,100,1,wanna,"('FAT', 'CHI')",Providence,nai59a.xml,105,5,0,CHI,1123,637,FAT
1,3,4,97,1.985915484,100,3,not,"('FAT', 'CHI')",Providence,nai59a.xml,105,5,1,CHI,1123,637,FAT
0,3,1,79,1.945910149,82,3,up,"('FAT', 'MOT')",Providence,nai59a.xml,83,1,0,MOT,835,854,FAT
0,3,1,79,1.945910149,82,3,all,"('FAT', 'MOT')",Providence,nai59a.xml,83,1,0,MOT,835,854,FAT
0,2,3,100,1.936340698,102,2,what,"('FAT', 'CHI')",Providence,nai59a.xml,105,3,0,CHI,1123,637,FAT
0,2,3,100,1.936340698,102,2,this,"('FAT', 'CHI')",Providence,nai59a.xml,105,3,0,CHI,1123,637,FAT
1,6,3,137,1.932211305,143,6,of,"('CHI', 'MOT')",Providence,nai59a.xml,147,4,1,MOT,1214,1317,CHI
0,2,5,140,1.925290862,142,2,not,"('CHI', 'MOT')",Providence,nai59a.xml,147,5,0,MOT,1214,1317,CHI
0,1,4,73,1.84582669,74,1,oh,"('MOT', 'CHI')",Providence,nai59a.xml,78,4,0,CHI,749,577,MOT
0,7,1,139,1.819158443,146,7,there,"('CHI', 'MOT')",Providence,nai59a.xml,147,1,0,MOT,1214,1317,CHI
0,7,1,139,1.819158443,146,7,are,"('CHI', 'MOT')",Providence,nai59a.xml,147,1,0,MOT,1214,1317,CHI
1,4,2,71,1.818076778,75,4,gonna,"('MOT', 'CHI')",Providence,nai59a.xml,78,3,1,CHI,749,577,MOT
1,0,3,16,1.791759469,16,0,that,"('MOT', 'FAT')",Providence,nai59a.xml,20,4,1,FAT,436,165,MOT
0,4,3,140,1.764730797,144,4,with,"('CHI', 'MOT')",Providence,nai59a.xml,147,3,0,MOT,1214,1317,CHI
1,4,4,96,1.762771932,100,4,yeah,"('FAT', 'CHI')",Providence,nai59a.xml,105,5,1,CHI,1123,637,FAT
3,6,10,128,1.644988897,134,6,gonna,"('CHI', 'MOT')",Providence,nai59a.xml,147,13,3,MOT,1214,1317,CHI
1,7,4,135,1.637608789,142,7,up,"('CHI', 'MOT')",Providence,nai59a.xml,147,5,1,MOT,1214,1317,CHI
0,2,3,73,1.635755221,75,2,go,"('MOT', 'CHI')",Providence,nai59a.xml,78,3,0,CHI,749,577,MOT
2,3,10,90,1.62713749,93,3,it,"('FAT', 'CHI')",Providence,nai59a.xml,105,12,2,CHI,1123,637,FAT
1,4,5,95,1.619388243,99,4,in,"('FAT', 'CHI')",Providence,nai59a.xml,105,6,1,CHI,1123,637,FAT
0,1,1,27,1.609437912,28,1,it,"('CHI', 'FAT')",Providence,nai59a.xml,29,1,0,FAT,188,467,CHI
0,1,1,27,1.609437912,28,1,with,"('CHI', 'FAT')",Providence,nai59a.xml,29,1,0,FAT,188,467,CHI
0,1,1,27,1.609437912,28,1,little,"('CHI', 'FAT')",Providence,nai59a.xml,29,1,0,FAT,188,467,CHI
1,3,0,25,1.609437912,28,3,all,"('CHI', 'FAT')",Providence,nai59a.xml,29,1,1,FAT,188,467,CHI
0,1,1,27,1.609437912,28,1,do,"('CHI', 'FAT')",Providence,nai59a.xml,29,1,0,FAT,188,467,CHI
0,1,8,96,1.599387577,97,1,have,"('FAT', 'CHI')",Providence,nai59a.xml,105,8,0,CHI,1123,637,FAT
0,3,2,73,1.584120104,76,3,for,"('MOT', 'CHI')",Providence,nai59a.xml,78,2,0,CHI,749,577,MOT
0,3,2,73,1.584120104,76,3,there,"('MOT', 'CHI')",Providence,nai59a.xml,78,2,0,CHI,749,577,MOT
2,3,8,70,1.544899391,73,3,of,"('FAT', 'MOT')",Providence,nai59a.xml,83,10,2,MOT,835,854,FAT
0,5,1,77,1.540445041,82,5,get,"('FAT', 'MOT')",Providence,nai59a.xml,83,1,0,MOT,835,854,FAT
0,5,1,77,1.540445041,82,5,what,"('FAT', 'MOT')",Providence,nai59a.xml,83,1,0,MOT,835,854,FAT
0,5,1,77,1.540445041,82,5,wanna,"('FAT', 'MOT')",Providence,nai59a.xml,83,1,0,MOT,835,854,FAT
1,2,0,17,1.540445041,19,2,all,"('MOT', 'FAT')",Providence,nai59a.xml,20,1,1,FAT,436,165,MOT
0,1,6,71,1.531476371,72,1,can,"('MOT', 'CHI')",Providence,nai59a.xml,78,6,0,CHI,749,577,MOT
1,3,6,73,1.466337069,76,3,like,"('FAT', 'MOT')",Providence,nai59a.xml,83,7,1,MOT,835,854,FAT
0,2,4,72,1.440361582,74,2,with,"('MOT', 'CHI')",Providence,nai59a.xml,78,4,0,CHI,749,577,MOT
0,2,6,97,1.437066686,99,2,want,"('FAT', 'CHI')",Providence,nai59a.xml,105,6,0,CHI,1123,637,FAT
0,2,6,97,1.437066686,99,2,of,"('FAT', 'CHI')",Providence,nai59a.xml,105,6,0,CHI,1123,637,FAT
0,2,6,97,1.437066686,99,2,on,"('FAT', 'CHI')",Providence,nai59a.xml,105,6,0,CHI,1123,637,FAT
0,4,3,98,1.425515074,102,4,go,"('FAT', 'CHI')",Providence,nai59a.xml,105,3,0,CHI,1123,637,FAT
0,3,3,77,1.410986974,80,3,gonna,"('FAT', 'MOT')",Providence,nai59a.xml,83,3,0,MOT,835,854,FAT
0,3,3,77,1.410986974,80,3,was,"('FAT', 'MOT')",Providence,nai59a.xml,83,3,0,MOT,835,854,FAT
0,1,7,70,1.400087683,71,1,what,"('MOT', 'CHI')",Providence,nai59a.xml,78,7,0,CHI,749,577,MOT
0,6,1,76,1.386294361,82,6,do,"('FAT', 'MOT')",Providence,nai59a.xml,83,1,0,MOT,835,854,FAT
1,1,2,16,1.335001067,17,1,they,"('MOT', 'FAT')",Providence,nai59a.xml,20,3,1,FAT,436,165,MOT
0,6,2,97,1.32175584,103,6,my,"('FAT', 'CHI')",Providence,nai59a.xml,105,2,0,CHI,1123,637,FAT
0,9,2,136,1.301553133,145,9,we,"('CHI', 'MOT')",Providence,nai59a.xml,147,2,0,MOT,1214,1317,CHI
0,1,2,26,1.287854288,27,1,for,"('CHI', 'FAT')",Providence,nai59a.xml,29,2,0,FAT,188,467,CHI
0,1,2,26,1.287854288,27,1,is,"('CHI', 'FAT')",Providence,nai59a.xml,29,2,0,FAT,188,467,CHI
2,19,2,124,1.287854288,143,19,what,"('CHI', 'MOT')",Providence,nai59a.xml,147,4,2,MOT,1214,1317,CHI
0,4,6,137,1.273965176,141,4,make,"('CHI', 'MOT')",Providence,nai59a.xml,147,6,0,MOT,1214,1317,CHI
0,1,1,18,1.252762968,19,1,oh,"('MOT', 'FAT')",Providence,nai59a.xml,20,1,0,FAT,436,165,MOT
0,1,1,18,1.252762968,19,1,there,"('MOT', 'FAT')",Providence,nai59a.xml,20,1,0,FAT,436,165,MOT
0,1,1,18,1.252762968,19,1,see,"('MOT', 'FAT')",Providence,nai59a.xml,20,1,0,FAT,436,165,MOT
0,1,1,18,1.252762968,19,1,are,"('MOT', 'FAT')",Providence,nai59a.xml,20,1,0,FAT,436,165,MOT
1,5,0,23,1.203972804,28,5,have,"('CHI', 'FAT')",Providence,nai59a.xml,29,1,1,FAT,188,467,CHI
0,2,1,26,1.203972804,28,2,want,"('CHI', 'FAT')",Providence,nai59a.xml,29,1,0,FAT,188,467,CHI
0,2,1,26,1.203972804,28,2,he,"('CHI', 'FAT')",Providence,nai59a.xml,29,1,0,FAT,188,467,CHI
0,4,3,76,1.187843422,80,4,there,"('FAT', 'MOT')",Providence,nai59a.xml,83,3,0,MOT,835,854,FAT
0,4,3,76,1.187843422,80,4,are,"('FAT', 'MOT')",Providence,nai59a.xml,83,3,0,MOT,835,854,FAT
2,7,5,69,1.178654996,76,7,we,"('FAT', 'MOT')",Providence,nai59a.xml,83,7,2,MOT,835,854,FAT
0,3,6,96,1.149384614,99,3,with,"('FAT', 'CHI')",Providence,nai59a.xml,105,6,0,CHI,1123,637,FAT
0,3,6,96,1.149384614,99,3,did,"('FAT', 'CHI')",Providence,nai59a.xml,105,6,0,CHI,1123,637,FAT
0,2,6,70,1.126011263,72,2,have,"('MOT', 'CHI')",Providence,nai59a.xml,78,6,0,CHI,749,577,MOT
0,2,6,70,1.126011263,72,2,do,"('MOT', 'CHI')",Providence,nai59a.xml,78,6,0,CHI,749,577,MOT
1,4,7,71,1.124929597,75,4,have,"('FAT', 'MOT')",Providence,nai59a.xml,83,8,1,MOT,835,854,FAT
0,4,3,71,1.124929597,75,4,he,"('MOT', 'CHI')",Providence,nai59a.xml,78,3,0,CHI,749,577,MOT
1,5,12,129,1.105992396,134,5,for,"('CHI', 'MOT')",Providence,nai59a.xml,147,13,1,MOT,1214,1317,CHI
9,15,15,108,1.10021357,123,15,a,"('CHI', 'MOT')",Providence,nai59a.xml,147,24,9,MOT,1214,1317,CHI
1,1,3,15,1.098612289,16,1,like,"('MOT', 'FAT')",Providence,nai59a.xml,20,4,1,FAT,436,165,MOT
1,3,2,23,1.029619417,26,3,they,"('CHI', 'FAT')",Providence,nai59a.xml,29,3,1,FAT,188,467,CHI
3,6,9,60,1.020834588,66,6,and,"('MOT', 'CHI')",Providence,nai59a.xml,78,12,3,CHI,749,577,MOT
0,5,3,75,1.005521866,80,5,not,"('FAT', 'MOT')",Providence,nai59a.xml,83,3,0,MOT,835,854,FAT
1,4,11,89,0.99852883,93,4,is,"('FAT', 'CHI')",Providence,nai59a.xml,105,12,1,CHI,1123,637,FAT
3,6,14,82,0.995754903,88,6,the,"('FAT', 'CHI')",Providence,nai59a.xml,105,17,3,CHI,1123,637,FAT
0,4,4,75,0.993251773,79,4,some,"('FAT', 'MOT')",Providence,nai59a.xml,83,4,0,MOT,835,854,FAT
0,4,4,75,0.993251773,79,4,on,"('FAT', 'MOT')",Providence,nai59a.xml,83,4,0,MOT,835,854,FAT
1,7,4,66,0.985283603,73,7,is,"('MOT', 'CHI')",Providence,nai59a.xml,78,5,1,CHI,749,577,MOT
2,12,8,125,0.983230215,137,12,on,"('CHI', 'MOT')",Providence,nai59a.xml,147,10,2,MOT,1214,1317,CHI
2,11,9,125,0.976009967,136,11,and,"('CHI', 'MOT')",Providence,nai59a.xml,147,11,2,MOT,1214,1317,CHI
4,9,7,58,0.976009967,67,9,to,"('MOT', 'CHI')",Providence,nai59a.xml,78,11,4,CHI,749,577,MOT
0,7,3,95,0.955511445,102,7,little,"('FAT', 'CHI')",Providence,nai59a.xml,105,3,0,CHI,1123,637,FAT
6,13,17,111,0.924258902,124,13,to,"('CHI', 'MOT')",Providence,nai59a.xml,147,23,6,MOT,1214,1317,CHI
0,3,1,25,0.916290732,28,3,was,"('CHI', 'FAT')",Providence,nai59a.xml,29,1,0,FAT,188,467,CHI
0,3,1,25,0.916290732,28,3,are,"('CHI', 'FAT')",Providence,nai59a.xml,29,1,0,FAT,188,467,CHI
0,1,2,17,0.916290732,18,1,did,"('MOT', 'FAT')",Providence,nai59a.xml,20,2,0,FAT,436,165,MOT
0,2,11,92,0.900786545,94,2,do,"('FAT', 'CHI')",Providence,nai59a.xml,105,11,0,CHI,1123,637,FAT
0,2,2,25,0.88238918,27,2,did,"('CHI', 'FAT')",Providence,nai59a.xml,29,2,0,FAT,188,467,CHI
10,22,13,102,0.879807139,124,22,it,"('CHI', 'MOT')",Providence,nai59a.xml,147,23,10,MOT,1214,1317,CHI
0,2,9,67,0.766172316,69,2,that,"('MOT', 'CHI')",Providence,nai59a.xml,78,9,0,CHI,749,577,MOT
1,4,10,63,0.752866415,67,4,it,"('MOT', 'CHI')",Providence,nai59a.xml,78,11,1,CHI,749,577,MOT
0,9,2,72,0.729961154,81,9,this,"('FAT', 'MOT')",Providence,nai59a.xml,83,2,0,MOT,835,854,FAT
0,12,1,65,0.705886206,77,12,no,"('MOT', 'CHI')",Providence,nai59a.xml,78,1,0,CHI,749,577,MOT
2,5,26,114,0.701445983,119,5,this,"('CHI', 'MOT')",Providence,nai59a.xml,147,28,2,MOT,1214,1317,CHI
1,1,5,13,0.693147181,14,1,the,"('MOT', 'FAT')",Providence,nai59a.xml,20,6,1,FAT,436,165,MOT
0,8,6,133,0.686178511,141,8,want,"('CHI', 'MOT')",Providence,nai59a.xml,147,6,0,MOT,1214,1317,CHI
0,6,4,73,0.656779536,79,6,think,"('FAT', 'MOT')",Providence,nai59a.xml,83,4,0,MOT,835,854,FAT
1,7,7,68,0.654925968,75,7,in,"('FAT', 'MOT')",Providence,nai59a.xml,83,8,1,MOT,835,854,FAT
0,1,3,16,0.641853886,17,1,a,"('MOT', 'FAT')",Providence,nai59a.xml,20,3,0,FAT,436,165,MOT
1,3,2,14,0.641853886,17,3,for,"('MOT', 'FAT')",Providence,nai59a.xml,20,3,1,FAT,436,165,MOT
3,13,15,116,0.626702081,129,13,the,"('CHI', 'MOT')",Providence,nai59a.xml,147,18,3,MOT,1214,1317,CHI
2,13,5,63,0.619039208,76,13,you,"('FAT', 'MOT')",Providence,nai59a.xml,83,7,2,MOT,835,854,FAT
4,11,10,58,0.614622417,69,11,the,"('FAT', 'MOT')",Providence,nai59a.xml,83,14,4,MOT,835,854,FAT
3,15,14,115,0.552068582,130,15,is,"('CHI', 'MOT')",Providence,nai59a.xml,147,17,3,MOT,1214,1317,CHI
1,9,6,67,0.550046337,76,9,but,"('FAT', 'MOT')",Providence,nai59a.xml,83,7,1,MOT,835,854,FAT
1,1,27,49,0.550046337,50,1,you,"('MOT', 'CHI')",Providence,nai59a.xml,78,28,1,CHI,749,577,MOT
1,1,37,66,0.54522705,67,1,you,"('FAT', 'CHI')",Providence,nai59a.xml,105,38,1,CHI,1123,637,FAT
0,28,1,118,0.531304155,146,28,that,"('CHI', 'MOT')",Providence,nai59a.xml,147,1,0,MOT,1214,1317,CHI
0,7,4,72,0.523248144,79,7,yeah,"('FAT', 'MOT')",Providence,nai59a.xml,83,4,0,MOT,835,854,FAT
0,7,4,72,0.523248144,79,7,for,"('FAT', 'MOT')",Providence,nai59a.xml,83,4,0,MOT,835,854,FAT
1,6,13,85,0.507247802,91,6,to,"('FAT', 'CHI')",Providence,nai59a.xml,105,14,1,CHI,1123,637,FAT
0,3,9,66,0.478490243,69,3,in,"('MOT', 'CHI')",Providence,nai59a.xml,78,9,0,CHI,749,577,MOT
2,11,8,62,0.446287103,73,11,to,"('FAT', 'MOT')",Providence,nai59a.xml,83,10,2,MOT,835,854,FAT
1,4,2,13,0.418710335,17,4,and,"('MOT', 'FAT')",Providence,nai59a.xml,20,3,1,FAT,436,165,MOT
0,1,4,15,0.405465108,16,1,in,"('MOT', 'FAT')",Providence,nai59a.xml,20,4,0,FAT,436,165,MOT
0,1,4,15,0.405465108,16,1,have,"('MOT', 'FAT')",Providence,nai59a.xml,20,4,0,FAT,436,165,MOT
0,17,2,86,0.377294231,103,17,no,"('FAT', 'CHI')",Providence,nai59a.xml,105,2,0,CHI,1123,637,FAT
2,12,8,61,0.366244395,73,12,that,"('FAT', 'MOT')",Providence,nai59a.xml,83,10,2,MOT,835,854,FAT
0,3,15,87,0.302280872,90,3,that,"('FAT', 'CHI')",Providence,nai59a.xml,105,15,0,CHI,1123,637,FAT
2,9,16,78,0.288931292,87,9,a,"('FAT', 'CHI')",Providence,nai59a.xml,105,18,2,CHI,1123,637,FAT
1,7,11,64,0.26510775,71,7,is,"('FAT', 'MOT')",Providence,nai59a.xml,83,12,1,MOT,835,854,FAT
0,6,9,90,0.241162057,96,6,gonna,"('FAT', 'CHI')",Providence,nai59a.xml,105,9,0,CHI,1123,637,FAT
0,12,7,128,0.193653123,140,12,put,"('CHI', 'MOT')",Providence,nai59a.xml,147,7,0,MOT,1214,1317,CHI
0,40,1,106,0.185027918,146,40,you,"('CHI', 'MOT')",Providence,nai59a.xml,147,1,0,MOT,1214,1317,CHI
1,11,8,63,0.141078598,74,11,it,"('FAT', 'MOT')",Providence,nai59a.xml,83,9,1,MOT,835,854,FAT
0,4,3,22,0.113328685,26,4,in,"('CHI', 'FAT')",Providence,nai59a.xml,29,3,0,FAT,188,467,CHI
1,6,4,18,0.05942342,24,6,the,"('CHI', 'FAT')",Providence,nai59a.xml,29,5,1,FAT,188,467,CHI
0,6,11,88,0.053488685,94,6,and,"('FAT', 'CHI')",Providence,nai59a.xml,105,11,0,CHI,1123,637,FAT
0,2,4,14,0,16,2,we,"('MOT', 'FAT')",Providence,nai59a.xml,20,4,0,FAT,436,165,MOT
0,3,3,14,-0.051293294,17,3,do,"('MOT', 'FAT')",Providence,nai59a.xml,20,3,0,FAT,436,165,MOT
0,7,2,20,-0.098440073,27,7,to,"('CHI', 'FAT')",Providence,nai59a.xml,29,2,0,FAT,188,467,CHI
0,7,2,20,-0.098440073,27,7,and,"('CHI', 'FAT')",Providence,nai59a.xml,29,2,0,FAT,188,467,CHI
1,7,15,55,-0.117783036,62,7,the,"('MOT', 'CHI')",Providence,nai59a.xml,78,16,1,CHI,749,577,MOT
0,7,9,67,-0.146603474,74,7,and,"('FAT', 'MOT')",Providence,nai59a.xml,83,9,0,MOT,835,854,FAT
0,8,2,19,-0.216223108,27,8,a,"('CHI', 'FAT')",Providence,nai59a.xml,29,2,0,FAT,188,467,CHI
0,4,3,13,-0.274436846,17,4,yeah,"('MOT', 'FAT')",Providence,nai59a.xml,20,3,0,FAT,436,165,MOT
0,7,10,61,-0.315852949,68,7,a,"('MOT', 'CHI')",Providence,nai59a.xml,78,10,0,CHI,749,577,MOT
2,19,13,49,-0.481838087,68,19,a,"('FAT', 'MOT')",Providence,nai59a.xml,83,15,2,MOT,835,854,FAT
0,3,5,12,-0.498991166,15,3,to,"('MOT', 'FAT')",Providence,nai59a.xml,20,5,0,FAT,436,165,MOT
0,18,6,59,-0.654432668,77,18,oh,"('FAT', 'MOT')",Providence,nai59a.xml,83,6,0,MOT,835,854,FAT
1,0,0,51,3.564826805,51,0,see,"('MOT', 'CHI')",Providence,nai59b.xml,52,1,1,CHI,394,303,MOT
1,0,2,73,3.401197382,73,0,put,"('CHI', 'MOT')",Providence,nai59b.xml,76,3,1,MOT,860,741,CHI
1,1,0,74,3.245193133,75,1,all,"('FAT', 'CHI')",Providence,nai59b.xml,76,1,1,CHI,742,430,FAT
1,0,2,49,3.015534901,49,0,at,"('MOT', 'CHI')",Providence,nai59b.xml,52,3,1,CHI,394,303,MOT
1,2,0,87,3.00678211,89,2,can,"('CHI', 'FAT')",Providence,nai59b.xml,90,1,1,FAT,464,1113,CHI
1,1,1,73,2.944438979,74,1,get,"('FAT', 'CHI')",Providence,nai59b.xml,76,2,1,CHI,742,430,FAT
1,1,1,73,2.944438979,74,1,this,"('FAT', 'CHI')",Providence,nai59b.xml,76,2,1,CHI,742,430,FAT
1,0,5,70,2.890371758,70,0,make,"('CHI', 'MOT')",Providence,nai59b.xml,76,6,1,MOT,860,741,CHI
1,0,5,70,2.890371758,70,0,of,"('FAT', 'CHI')",Providence,nai59b.xml,76,6,1,CHI,742,430,FAT
3,1,5,67,2.63905733,68,1,what,"('FAT', 'CHI')",Providence,nai59b.xml,76,8,3,CHI,742,430,FAT
2,1,4,69,2.602689685,70,1,was,"('FAT', 'CHI')",Providence,nai59b.xml,76,6,2,CHI,742,430,FAT
0,1,1,74,2.552045953,75,1,was,"('CHI', 'MOT')",Providence,nai59b.xml,76,1,0,MOT,860,741,CHI
0,1,1,74,2.552045953,75,1,up,"('CHI', 'MOT')",Providence,nai59b.xml,76,1,0,MOT,860,741,CHI
0,1,1,74,2.552045953,75,1,do,"('FAT', 'CHI')",Providence,nai59b.xml,76,1,0,CHI,742,430,FAT
1,2,2,85,2.473733349,87,2,up,"('CHI', 'FAT')",Providence,nai59b.xml,90,3,1,FAT,464,1113,CHI
1,1,2,48,2.32238772,49,1,did,"('MOT', 'CHI')",Providence,nai59b.xml,52,3,1,CHI,394,303,MOT
0,2,1,87,2.313634929,89,2,yeah,"('CHI', 'FAT')",Providence,nai59b.xml,90,1,0,FAT,464,1113,CHI
0,2,1,87,2.313634929,89,2,there,"('CHI', 'FAT')",Providence,nai59b.xml,90,1,0,FAT,464,1113,CHI
0,2,1,87,2.313634929,89,2,my,"('CHI', 'FAT')",Providence,nai59b.xml,90,1,0,FAT,464,1113,CHI
0,2,1,87,2.313634929,89,2,at,"('CHI', 'FAT')",Providence,nai59b.xml,90,1,0,FAT,464,1113,CHI
1,0,4,33,2.302585093,33,0,a,"('FAT', 'MOT')",Providence,nai59b.xml,38,5,1,MOT,387,269,FAT
1,1,1,35,2.251291799,36,1,not,"('FAT', 'MOT')",Providence,nai59b.xml,38,2,1,MOT,387,269,FAT
1,1,1,35,2.251291799,36,1,one,"('MOT', 'FAT')",Providence,nai59b.xml,38,2,1,FAT,322,344,MOT
0,1,2,73,2.251291799,74,1,gonna,"('CHI', 'MOT')",Providence,nai59b.xml,76,2,0,MOT,860,741,CHI
0,1,2,73,2.251291799,74,1,they,"('CHI', 'MOT')",Providence,nai59b.xml,76,2,0,MOT,860,741,CHI
0,1,2,73,2.251291799,74,1,see,"('FAT', 'CHI')",Providence,nai59b.xml,76,2,0,CHI,742,430,FAT
2,1,2,33,2.197224577,34,1,of,"('FAT', 'MOT')",Providence,nai59b.xml,38,4,2,MOT,387,269,FAT
0,1,1,50,2.178532444,51,1,little,"('MOT', 'CHI')",Providence,nai59b.xml,52,1,0,CHI,394,303,MOT
0,2,1,73,2.146580845,75,2,we,"('CHI', 'MOT')",Providence,nai59b.xml,76,1,0,MOT,860,741,CHI
0,2,1,73,2.146580845,75,2,at,"('CHI', 'MOT')",Providence,nai59b.xml,76,1,0,MOT,860,741,CHI
0,2,1,73,2.146580845,75,2,in,"('FAT', 'CHI')",Providence,nai59b.xml,76,1,0,CHI,742,430,FAT
0,2,1,73,2.146580845,75,2,yeah,"('FAT', 'CHI')",Providence,nai59b.xml,76,1,0,CHI,742,430,FAT
1,0,13,62,2.079441542,62,0,oh,"('FAT', 'CHI')",Providence,nai59b.xml,76,14,1,CHI,742,430,FAT
0,3,1,86,2.025952857,89,3,go,"('CHI', 'FAT')",Providence,nai59b.xml,90,1,0,FAT,464,1113,CHI
0,3,1,86,2.025952857,89,3,did,"('CHI', 'FAT')",Providence,nai59b.xml,90,1,0,FAT,464,1113,CHI
0,1,3,72,2.014903021,73,1,get,"('CHI', 'MOT')",Providence,nai59b.xml,76,3,0,MOT,860,741,CHI
0,1,3,72,2.014903021,73,1,like,"('FAT', 'CHI')",Providence,nai59b.xml,76,3,0,CHI,742,430,FAT
0,1,3,72,2.014903021,73,1,one,"('FAT', 'CHI')",Providence,nai59b.xml,76,3,0,CHI,742,430,FAT
0,1,3,72,2.014903021,73,1,not,"('FAT', 'CHI')",Providence,nai59b.xml,76,3,0,CHI,742,430,FAT
1,5,1,83,2.014903021,88,5,of,"('CHI', 'FAT')",Providence,nai59b.xml,90,2,1,FAT,464,1113,CHI
1,1,2,34,2.00148,35,1,gonna,"('MOT', 'FAT')",Providence,nai59b.xml,38,3,1,FAT,322,344,MOT
0,1,1,36,1.871802177,37,1,like,"('FAT', 'MOT')",Providence,nai59b.xml,38,1,0,MOT,387,269,FAT
0,1,1,36,1.871802177,37,1,yeah,"('FAT', 'MOT')",Providence,nai59b.xml,38,1,0,MOT,387,269,FAT
0,1,1,36,1.871802177,37,1,have,"('FAT', 'MOT')",Providence,nai59b.xml,38,1,0,MOT,387,269,FAT
0,1,1,36,1.871802177,37,1,up,"('FAT', 'MOT')",Providence,nai59b.xml,38,1,0,MOT,387,269,FAT
0,1,1,36,1.871802177,37,1,she,"('FAT', 'MOT')",Providence,nai59b.xml,38,1,0,MOT,387,269,FAT
0,1,1,36,1.871802177,37,1,do,"('FAT', 'MOT')",Providence,nai59b.xml,38,1,0,MOT,387,269,FAT
0,1,2,49,1.871802177,50,1,in,"('MOT', 'CHI')",Providence,nai59b.xml,52,2,0,CHI,394,303,MOT
0,1,2,49,1.871802177,50,1,like,"('MOT', 'CHI')",Providence,nai59b.xml,52,2,0,CHI,394,303,MOT
0,1,2,49,1.871802177,50,1,yeah,"('MOT', 'CHI')",Providence,nai59b.xml,52,2,0,CHI,394,303,MOT
0,1,2,49,1.871802177,50,1,of,"('MOT', 'CHI')",Providence,nai59b.xml,52,2,0,CHI,394,303,MOT
0,1,1,36,1.871802177,37,1,want,"('MOT', 'FAT')",Providence,nai59b.xml,38,1,0,FAT,322,344,MOT
0,1,1,36,1.871802177,37,1,for,"('MOT', 'FAT')",Providence,nai59b.xml,38,1,0,FAT,322,344,MOT
0,1,1,36,1.871802177,37,1,they,"('MOT', 'FAT')",Providence,nai59b.xml,38,1,0,FAT,322,344,MOT
0,1,1,36,1.871802177,37,1,but,"('MOT', 'FAT')",Providence,nai59b.xml,38,1,0,FAT,322,344,MOT
0,1,1,36,1.871802177,37,1,wanna,"('MOT', 'FAT')",Providence,nai59b.xml,38,1,0,FAT,322,344,MOT
3,10,0,77,1.867597546,87,10,was,"('CHI', 'FAT')",Providence,nai59b.xml,90,3,3,FAT,464,1113,CHI
0,3,1,72,1.858898772,75,3,see,"('CHI', 'MOT')",Providence,nai59b.xml,76,1,0,MOT,860,741,CHI
0,3,1,72,1.858898772,75,3,my,"('FAT', 'CHI')",Providence,nai59b.xml,76,1,0,CHI,742,430,FAT
0,2,2,72,1.84582669,74,2,go,"('CHI', 'MOT')",Providence,nai59b.xml,76,2,0,MOT,860,741,CHI
0,2,2,72,1.84582669,74,2,but,"('CHI', 'MOT')",Providence,nai59b.xml,76,2,0,MOT,860,741,CHI
0,2,2,72,1.84582669,74,2,do,"('CHI', 'MOT')",Providence,nai59b.xml,76,2,0,MOT,860,741,CHI
1,2,1,34,1.84582669,36,2,no,"('FAT', 'MOT')",Providence,nai59b.xml,38,2,1,MOT,387,269,FAT
1,2,1,34,1.84582669,36,2,and,"('MOT', 'FAT')",Providence,nai59b.xml,38,2,1,FAT,322,344,MOT
3,4,4,65,1.842311748,69,4,little,"('CHI', 'MOT')",Providence,nai59b.xml,76,7,3,MOT,860,741,CHI
0,4,1,85,1.802809305,89,4,gonna,"('CHI', 'FAT')",Providence,nai59b.xml,90,1,0,FAT,464,1113,CHI
1,4,2,69,1.791759469,73,4,of,"('CHI', 'MOT')",Providence,nai59b.xml,76,3,1,MOT,860,741,CHI
1,7,1,81,1.727220948,88,7,what,"('CHI', 'FAT')",Providence,nai59b.xml,90,2,1,FAT,464,1113,CHI
1,10,0,79,1.707499126,89,10,oh,"('CHI', 'FAT')",Providence,nai59b.xml,90,1,1,FAT,464,1113,CHI
2,7,2,79,1.704748092,86,7,in,"('CHI', 'FAT')",Providence,nai59b.xml,90,4,2,FAT,464,1113,CHI
1,2,6,67,1.659990192,69,2,are,"('FAT', 'CHI')",Providence,nai59b.xml,76,7,1,CHI,742,430,FAT
1,3,4,68,1.651402112,71,3,on,"('CHI', 'MOT')",Providence,nai59b.xml,76,5,1,MOT,860,741,CHI
5,5,6,60,1.639743262,65,5,it,"('CHI', 'MOT')",Providence,nai59b.xml,76,11,5,MOT,860,741,CHI
5,10,2,73,1.639290876,83,10,it,"('CHI', 'FAT')",Providence,nai59b.xml,90,7,5,FAT,464,1113,CHI
0,1,3,48,1.62924054,49,1,oh,"('MOT', 'CHI')",Providence,nai59b.xml,52,3,0,CHI,394,303,MOT
0,1,3,48,1.62924054,49,1,do,"('MOT', 'CHI')",Providence,nai59b.xml,52,3,0,CHI,394,303,MOT
0,1,3,48,1.62924054,49,1,and,"('MOT', 'CHI')",Providence,nai59b.xml,52,3,0,CHI,394,303,MOT
0,5,1,84,1.620487749,89,5,want,"('CHI', 'FAT')",Providence,nai59b.xml,90,1,0,FAT,464,1113,CHI
1,1,4,32,1.609437912,33,1,my,"('FAT', 'MOT')",Providence,nai59b.xml,38,5,1,MOT,387,269,FAT
0,2,3,71,1.609437912,73,2,there,"('FAT', 'CHI')",Providence,nai59b.xml,76,3,0,CHI,742,430,FAT
0,1,2,35,1.558144618,36,1,gonna,"('FAT', 'MOT')",Providence,nai59b.xml,38,2,0,MOT,387,269,FAT
0,1,2,35,1.558144618,36,1,for,"('FAT', 'MOT')",Providence,nai59b.xml,38,2,0,MOT,387,269,FAT
0,1,2,35,1.558144618,36,1,there,"('FAT', 'MOT')",Providence,nai59b.xml,38,2,0,MOT,387,269,FAT
0,1,6,69,1.504077397,70,1,it,"('FAT', 'CHI')",Providence,nai59b.xml,76,6,0,CHI,742,430,FAT
0,3,3,84,1.492904096,87,3,not,"('CHI', 'FAT')",Providence,nai59b.xml,90,3,0,FAT,464,1113,CHI
0,2,2,48,1.466337069,50,2,what,"('MOT', 'CHI')",Providence,nai59b.xml,52,2,0,CHI,394,303,MOT
0,2,1,35,1.466337069,37,2,up,"('MOT', 'FAT')",Providence,nai59b.xml,38,1,0,FAT,322,344,MOT
0,2,1,35,1.466337069,37,2,my,"('MOT', 'FAT')",Providence,nai59b.xml,38,1,0,FAT,322,344,MOT
0,2,1,35,1.466337069,37,2,think,"('MOT', 'FAT')",Providence,nai59b.xml,38,1,0,FAT,322,344,MOT
1,3,3,45,1.427116356,48,3,a,"('MOT', 'CHI')",Providence,nai59b.xml,52,4,1,CHI,394,303,MOT
0,2,4,70,1.413693335,72,2,gonna,"('FAT', 'CHI')",Providence,nai59b.xml,76,4,0,CHI,742,430,FAT
1,3,6,66,1.372308119,69,3,is,"('FAT', 'CHI')",Providence,nai59b.xml,76,7,1,CHI,742,430,FAT
0,3,3,70,1.32175584,73,3,yeah,"('CHI', 'MOT')",Providence,nai59b.xml,76,3,0,MOT,860,741,CHI
0,1,3,34,1.30833282,35,1,this,"('FAT', 'MOT')",Providence,nai59b.xml,38,3,0,MOT,387,269,FAT
0,1,3,34,1.30833282,35,1,have,"('MOT', 'FAT')",Providence,nai59b.xml,38,3,0,FAT,322,344,MOT
0,1,3,34,1.30833282,35,1,this,"('MOT', 'FAT')",Providence,nai59b.xml,38,3,0,FAT,322,344,MOT
0,1,3,34,1.30833282,35,1,all,"('MOT', 'FAT')",Providence,nai59b.xml,38,3,0,FAT,322,344,MOT
1,6,3,66,1.259542655,72,6,like,"('CHI', 'MOT')",Providence,nai59b.xml,76,4,1,MOT,860,741,CHI
0,1,5,46,1.252762968,47,1,gonna,"('MOT', 'CHI')",Providence,nai59b.xml,52,5,0,CHI,394,303,MOT
0,1,5,46,1.252762968,47,1,that,"('MOT', 'CHI')",Providence,nai59b.xml,52,5,0,CHI,394,303,MOT
0,2,5,69,1.245937003,71,2,this,"('CHI', 'MOT')",Providence,nai59b.xml,76,5,0,MOT,860,741,CHI
0,2,5,69,1.245937003,71,2,want,"('FAT', 'CHI')",Providence,nai59b.xml,76,5,0,CHI,742,430,FAT
2,3,11,60,1.178654996,63,3,that,"('FAT', 'CHI')",Providence,nai59b.xml,76,13,2,CHI,742,430,FAT
0,3,1,34,1.178654996,37,3,in,"('FAT', 'MOT')",Providence,nai59b.xml,38,1,0,MOT,387,269,FAT
0,3,2,47,1.178654996,50,3,want,"('MOT', 'CHI')",Providence,nai59b.xml,52,2,0,CHI,394,303,MOT
0,3,2,47,1.178654996,50,3,no,"('MOT', 'CHI')",Providence,nai59b.xml,52,2,0,CHI,394,303,MOT
0,3,1,34,1.178654996,37,3,in,"('MOT', 'FAT')",Providence,nai59b.xml,38,1,0,FAT,322,344,MOT
0,3,1,34,1.178654996,37,3,see,"('MOT', 'FAT')",Providence,nai59b.xml,38,1,0,FAT,322,344,MOT
0,3,1,34,1.178654996,37,3,no,"('MOT', 'FAT')",Providence,nai59b.xml,38,1,0,FAT,322,344,MOT
0,7,1,68,1.165751592,75,7,some,"('CHI', 'MOT')",Providence,nai59b.xml,76,1,0,MOT,860,741,CHI
0,2,2,34,1.15267951,36,2,was,"('FAT', 'MOT')",Providence,nai59b.xml,38,2,0,MOT,387,269,FAT
0,2,2,34,1.15267951,36,2,did,"('FAT', 'MOT')",Providence,nai59b.xml,38,2,0,MOT,387,269,FAT
0,2,2,34,1.15267951,36,2,think,"('FAT', 'MOT')",Providence,nai59b.xml,38,2,0,MOT,387,269,FAT
0,2,2,34,1.15267951,36,2,on,"('FAT', 'MOT')",Providence,nai59b.xml,38,2,0,MOT,387,269,FAT
0,2,2,34,1.15267951,36,2,like,"('MOT', 'FAT')",Providence,nai59b.xml,38,2,0,FAT,322,344,MOT
0,2,2,34,1.15267951,36,2,yeah,"('MOT', 'FAT')",Providence,nai59b.xml,38,2,0,FAT,322,344,MOT
0,2,7,81,1.14681439,83,2,no,"('CHI', 'FAT')",Providence,nai59b.xml,90,7,0,FAT,464,1113,CHI
0,1,4,33,1.098612289,34,1,what,"('FAT', 'MOT')",Providence,nai59b.xml,38,4,0,MOT,387,269,FAT
0,4,3,69,1.098612289,73,4,in,"('CHI', 'MOT')",Providence,nai59b.xml,76,3,0,MOT,860,741,CHI
0,5,3,82,1.087438988,87,5,get,"('CHI', 'FAT')",Providence,nai59b.xml,90,3,0,FAT,464,1113,CHI
0,8,1,67,1.047968556,75,8,that,"('CHI', 'MOT')",Providence,nai59b.xml,76,1,0,MOT,860,741,CHI
2,5,8,61,1.041453875,66,5,is,"('CHI', 'MOT')",Providence,nai59b.xml,76,10,2,MOT,860,741,CHI
0,2,4,46,1.021651248,48,2,not,"('MOT', 'CHI')",Providence,nai59b.xml,52,4,0,CHI,394,303,MOT
1,7,4,64,0.958254931,71,7,and,"('CHI', 'MOT')",Providence,nai59b.xml,76,5,1,MOT,860,741,CHI
0,4,1,33,0.955511445,37,4,was,"('MOT', 'FAT')",Providence,nai59b.xml,38,1,0,FAT,322,344,MOT
0,6,3,81,0.933288308,87,6,is,"('CHI', 'FAT')",Providence,nai59b.xml,90,3,0,FAT,464,1113,CHI
0,5,3,68,0.916290732,73,5,are,"('CHI', 'MOT')",Providence,nai59b.xml,76,3,0,MOT,860,741,CHI
2,5,3,28,0.916290732,33,5,oh,"('MOT', 'FAT')",Providence,nai59b.xml,38,5,2,FAT,322,344,MOT
0,2,3,33,0.902867712,35,2,we,"('FAT', 'MOT')",Providence,nai59b.xml,38,3,0,MOT,387,269,FAT
0,2,3,33,0.902867712,35,2,all,"('FAT', 'MOT')",Providence,nai59b.xml,38,3,0,MOT,387,269,FAT
0,2,3,33,0.902867712,35,2,not,"('MOT', 'FAT')",Providence,nai59b.xml,38,3,0,FAT,322,344,MOT
0,4,4,68,0.902867712,72,4,have,"('CHI', 'MOT')",Providence,nai59b.xml,76,4,0,MOT,860,741,CHI
1,4,3,30,0.875468737,34,4,is,"('MOT', 'FAT')",Providence,nai59b.xml,38,4,1,FAT,322,344,MOT
6,19,4,61,0.871990473,80,19,a,"('CHI', 'FAT')",Providence,nai59b.xml,90,10,6,FAT,464,1113,CHI
0,3,2,33,0.864997437,36,3,and,"('FAT', 'MOT')",Providence,nai59b.xml,38,2,0,MOT,387,269,FAT
2,5,4,27,0.753771802,32,5,a,"('MOT', 'FAT')",Providence,nai59b.xml,38,6,2,FAT,322,344,MOT
0,8,2,66,0.747214402,74,8,oh,"('CHI', 'MOT')",Providence,nai59b.xml,76,2,0,MOT,860,741,CHI
1,16,2,71,0.739132294,87,16,that,"('CHI', 'FAT')",Providence,nai59b.xml,90,3,1,FAT,464,1113,CHI
5,9,11,51,0.725937003,60,9,a,"('CHI', 'MOT')",Providence,nai59b.xml,76,16,5,MOT,860,741,CHI
0,5,4,67,0.720546155,72,5,on,"('FAT', 'CHI')",Providence,nai59b.xml,76,4,0,CHI,742,430,FAT
1,6,7,62,0.693147181,68,6,to,"('FAT', 'CHI')",Providence,nai59b.xml,76,8,1,CHI,742,430,FAT
6,18,7,59,0.662868821,77,18,the,"('CHI', 'FAT')",Providence,nai59b.xml,90,13,6,FAT,464,1113,CHI
0,9,2,65,0.641853886,74,9,what,"('CHI', 'MOT')",Providence,nai59b.xml,76,2,0,MOT,860,741,CHI
0,4,2,32,0.641853886,36,4,it,"('FAT', 'MOT')",Providence,nai59b.xml,38,2,0,MOT,387,269,FAT
1,3,6,28,0.606135804,31,3,it,"('MOT', 'FAT')",Providence,nai59b.xml,38,7,1,FAT,322,344,MOT
0,6,4,66,0.566395475,72,6,no,"('FAT', 'CHI')",Providence,nai59b.xml,76,4,0,CHI,742,430,FAT
0,2,5,31,0.510825624,33,2,to,"('MOT', 'FAT')",Providence,nai59b.xml,38,5,0,FAT,322,344,MOT
2,27,2,59,0.451985124,86,27,you,"('CHI', 'FAT')",Providence,nai59b.xml,90,4,2,FAT,464,1113,CHI
0,3,9,64,0.449916871,67,3,want,"('CHI', 'MOT')",Providence,nai59b.xml,76,9,0,MOT,860,741,CHI
0,3,4,31,0.405465108,34,3,you,"('FAT', 'MOT')",Providence,nai59b.xml,38,4,0,MOT,387,269,FAT
0,6,3,43,0.376477571,49,6,are,"('MOT', 'CHI')",Providence,nai59b.xml,52,3,0,CHI,394,303,MOT
3,7,6,22,0.342944751,29,7,the,"('MOT', 'FAT')",Providence,nai59b.xml,38,9,3,FAT,322,344,MOT
1,8,8,59,0.332133835,67,8,the,"('FAT', 'CHI')",Providence,nai59b.xml,76,9,1,CHI,742,430,FAT
3,10,7,32,0.287682072,42,10,to,"('MOT', 'CHI')",Providence,nai59b.xml,52,10,3,CHI,394,303,MOT
0,3,7,42,0.266628663,45,3,it,"('MOT', 'CHI')",Providence,nai59b.xml,52,7,0,CHI,394,303,MOT
0,9,1,28,0.262364264,37,9,that,"('MOT', 'FAT')",Providence,nai59b.xml,38,1,0,FAT,322,344,MOT
2,6,7,23,0.188794071,29,6,you,"('MOT', 'FAT')",Providence,nai59b.xml,38,9,2,FAT,322,344,MOT
3,13,11,49,0.133531393,62,13,the,"('CHI', 'MOT')",Providence,nai59b.xml,76,14,3,MOT,860,741,CHI
0,12,4,74,0.120627988,86,12,to,"('CHI', 'FAT')",Providence,nai59b.xml,90,4,0,FAT,464,1113,CHI
2,7,16,51,0.117783036,58,7,to,"('CHI', 'MOT')",Providence,nai59b.xml,76,18,2,MOT,860,741,CHI
1,18,4,53,0.093257493,71,18,you,"('CHI', 'MOT')",Providence,nai59b.xml,76,5,1,MOT,860,741,CHI
0,2,9,27,-0.062520357,29,2,oh,"('FAT', 'MOT')",Providence,nai59b.xml,38,9,0,MOT,387,269,FAT
0,2,9,27,-0.062520357,29,2,that,"('FAT', 'MOT')",Providence,nai59b.xml,38,9,0,MOT,387,269,FAT
1,3,25,47,-0.074107972,50,3,you,"('FAT', 'CHI')",Providence,nai59b.xml,76,26,1,CHI,742,430,FAT
2,9,16,49,-0.105360516,58,9,a,"('FAT', 'CHI')",Providence,nai59b.xml,76,18,2,CHI,742,430,FAT
0,7,5,40,-0.133531393,47,7,the,"('MOT', 'CHI')",Providence,nai59b.xml,52,5,0,CHI,394,303,MOT
0,5,5,28,-0.182321557,33,5,the,"('FAT', 'MOT')",Providence,nai59b.xml,38,5,0,MOT,387,269,FAT
1,6,12,33,-0.247241103,39,6,you,"('MOT', 'CHI')",Providence,nai59b.xml,52,13,1,CHI,394,303,MOT
0,4,7,27,-0.310154928,31,4,of,"('MOT', 'FAT')",Providence,nai59b.xml,38,7,0,FAT,322,344,MOT
1,0,4,195,4.03044076,195,0,some,"('MOT', 'CHI')",Providence,nai59c.xml,200,5,1,CHI,1834,1978,MOT
1,0,1,105,3.979681654,105,0,go,"('CHI', 'FAT')",Providence,nai59c.xml,107,2,1,FAT,668,1127,CHI
1,1,0,105,3.583518938,106,1,do,"('CHI', 'FAT')",Providence,nai59c.xml,107,1,1,FAT,668,1127,CHI
0,1,1,198,3.511545439,199,1,one,"('MOT', 'CHI')",Providence,nai59c.xml,200,1,0,CHI,1834,1978,MOT
1,1,1,104,3.286534473,105,1,make,"('CHI', 'FAT')",Providence,nai59c.xml,107,2,1,FAT,668,1127,CHI
0,1,2,197,3.218875825,198,1,up,"('MOT', 'CHI')",Providence,nai59c.xml,200,2,0,CHI,1834,1978,MOT
0,1,1,141,3.17805383,142,1,all,"('CHI', 'MOT')",Providence,nai59c.xml,143,1,0,MOT,1292,1265,CHI
1,3,0,139,3.17805383,142,3,at,"('CHI', 'MOT')",Providence,nai59c.xml,143,1,1,MOT,1292,1265,CHI
1,2,3,194,3.091042453,196,2,at,"('MOT', 'CHI')",Providence,nai59c.xml,200,4,1,CHI,1834,1978,MOT
0,1,3,196,2.990719732,197,1,look,"('MOT', 'CHI')",Providence,nai59c.xml,200,3,0,CHI,1834,1978,MOT
0,1,3,196,2.990719732,197,1,did,"('MOT', 'CHI')",Providence,nai59c.xml,200,3,0,CHI,1834,1978,MOT
1,2,2,138,2.940924037,140,2,she,"('CHI', 'MOT')",Providence,nai59c.xml,143,3,1,MOT,1292,1265,CHI
1,2,2,138,2.940924037,140,2,put,"('CHI', 'MOT')",Providence,nai59c.xml,143,3,1,MOT,1292,1265,CHI
1,2,1,103,2.881069365,105,2,with,"('CHI', 'FAT')",Providence,nai59c.xml,107,2,1,FAT,668,1127,CHI
1,2,1,103,2.881069365,105,2,all,"('CHI', 'FAT')",Providence,nai59c.xml,107,2,1,FAT,668,1127,CHI
2,2,2,101,2.862200881,103,2,they,"('CHI', 'FAT')",Providence,nai59c.xml,107,4,2,FAT,668,1127,CHI
0,2,2,196,2.813410717,198,2,yeah,"('MOT', 'CHI')",Providence,nai59c.xml,200,2,0,CHI,1834,1978,MOT
1,1,9,189,2.772588722,190,1,see,"('MOT', 'CHI')",Providence,nai59c.xml,200,10,1,CHI,1834,1978,MOT
1,3,1,102,2.593387293,105,3,was,"('CHI', 'FAT')",Providence,nai59c.xml,107,2,1,FAT,668,1127,CHI
1,7,0,135,2.48490665,142,7,think,"('CHI', 'MOT')",Providence,nai59c.xml,143,1,1,MOT,1292,1265,CHI
0,2,1,104,2.48490665,106,2,some,"('CHI', 'FAT')",Providence,nai59c.xml,107,1,0,FAT,668,1127,CHI
0,2,2,139,2.47793798,141,2,some,"('CHI', 'MOT')",Providence,nai59c.xml,143,2,0,MOT,1292,1265,CHI
2,5,2,134,2.463853241,139,5,of,"('CHI', 'MOT')",Providence,nai59c.xml,143,4,2,MOT,1292,1265,CHI
4,5,4,130,2.435074276,135,5,he,"('CHI', 'MOT')",Providence,nai59c.xml,143,8,4,MOT,1292,1265,CHI
0,2,4,194,2.397895273,196,2,we,"('MOT', 'CHI')",Providence,nai59c.xml,200,4,0,CHI,1834,1978,MOT
0,1,3,103,2.360854001,104,1,he,"('CHI', 'FAT')",Providence,nai59c.xml,107,3,0,FAT,668,1127,CHI
0,1,3,103,2.360854001,104,1,where,"('CHI', 'FAT')",Providence,nai59c.xml,107,3,0,FAT,668,1127,CHI
1,3,2,101,2.360854001,104,3,have,"('CHI', 'FAT')",Providence,nai59c.xml,107,3,1,FAT,668,1127,CHI
0,3,3,194,2.297572551,197,3,but,"('MOT', 'CHI')",Providence,nai59c.xml,200,3,0,CHI,1834,1978,MOT
0,1,8,191,2.272125886,192,1,there,"('MOT', 'CHI')",Providence,nai59c.xml,200,8,0,CHI,1834,1978,MOT
0,4,1,138,2.261763098,142,4,look,"('CHI', 'MOT')",Providence,nai59c.xml,143,1,0,MOT,1292,1265,CHI
0,2,3,138,2.247776856,140,2,my,"('CHI', 'MOT')",Providence,nai59c.xml,143,3,0,MOT,1292,1265,CHI
1,6,3,190,2.243744593,196,6,not,"('MOT', 'CHI')",Providence,nai59c.xml,200,4,1,CHI,1834,1978,MOT
1,0,0,12,2.233592222,12,0,they,"('MOT', 'FAT')",Providence,nai59c.xml,13,1,1,FAT,51,67,MOT
1,0,0,12,2.233592222,12,0,to,"('MOT', 'FAT')",Providence,nai59c.xml,13,1,1,FAT,51,67,MOT
0,3,1,103,2.197224577,106,3,like,"('CHI', 'FAT')",Providence,nai59c.xml,107,1,0,FAT,668,1127,CHI
0,3,1,103,2.197224577,106,3,see,"('CHI', 'FAT')",Providence,nai59c.xml,107,1,0,FAT,668,1127,CHI
0,3,1,103,2.197224577,106,3,little,"('CHI', 'FAT')",Providence,nai59c.xml,107,1,0,FAT,668,1127,CHI
0,2,2,103,2.187922185,105,2,at,"('CHI', 'FAT')",Providence,nai59c.xml,107,2,0,FAT,668,1127,CHI
2,2,11,128,2.174751721,130,2,this,"('CHI', 'MOT')",Providence,nai59c.xml,143,13,2,MOT,1292,1265,CHI
1,3,5,134,2.161885211,137,3,for,"('CHI', 'MOT')",Providence,nai59c.xml,143,6,1,MOT,1292,1265,CHI
0,5,2,193,2.120263536,198,5,she,"('MOT', 'CHI')",Providence,nai59c.xml,200,2,0,CHI,1834,1978,MOT
3,5,6,129,2.109294505,134,5,gonna,"('CHI', 'MOT')",Providence,nai59c.xml,143,9,3,MOT,1292,1265,CHI
2,8,4,186,2.100060829,194,8,he,"('MOT', 'CHI')",Providence,nai59c.xml,200,6,2,CHI,1834,1978,MOT
2,7,5,186,2.094945728,193,7,with,"('MOT', 'CHI')",Providence,nai59c.xml,200,7,2,CHI,1834,1978,MOT
1,6,2,134,2.093626177,140,6,there,"('CHI', 'MOT')",Providence,nai59c.xml,143,3,1,MOT,1292,1265,CHI
0,5,1,137,2.079441542,142,5,did,"('CHI', 'MOT')",Providence,nai59c.xml,143,1,0,MOT,1292,1265,CHI
0,4,3,193,2.074429,197,4,get,"('MOT', 'CHI')",Providence,nai59c.xml,200,3,0,CHI,1834,1978,MOT
2,4,11,183,2.02287119,187,4,of,"('MOT', 'CHI')",Providence,nai59c.xml,200,13,2,CHI,1834,1978,MOT
0,4,1,102,1.974081026,106,4,there,"('CHI', 'FAT')",Providence,nai59c.xml,107,1,0,FAT,668,1127,CHI
0,4,1,102,1.974081026,106,4,on,"('CHI', 'FAT')",Providence,nai59c.xml,107,1,0,FAT,668,1127,CHI
0,4,2,137,1.967112357,141,4,was,"('CHI', 'MOT')",Providence,nai59c.xml,143,2,0,MOT,1292,1265,CHI
0,3,5,192,1.950999219,195,3,they,"('MOT', 'CHI')",Providence,nai59c.xml,200,5,0,CHI,1834,1978,MOT
2,6,8,184,1.925290862,190,6,for,"('MOT', 'CHI')",Providence,nai59c.xml,200,10,2,CHI,1834,1978,MOT
0,1,8,134,1.924248652,135,1,no,"('CHI', 'MOT')",Providence,nai59c.xml,143,8,0,MOT,1292,1265,CHI
1,3,7,132,1.924248652,135,3,like,"('CHI', 'MOT')",Providence,nai59c.xml,143,8,1,MOT,1292,1265,CHI
1,2,7,97,1.907070316,99,2,no,"('CHI', 'FAT')",Providence,nai59c.xml,107,8,1,FAT,668,1127,CHI
1,5,4,133,1.897119985,138,5,little,"('CHI', 'MOT')",Providence,nai59c.xml,143,5,1,MOT,1292,1265,CHI
0,2,5,136,1.897119985,138,2,not,"('CHI', 'MOT')",Providence,nai59c.xml,143,5,0,MOT,1292,1265,CHI
1,1,2,30,1.887069649,31,1,on,"('FAT', 'CHI')",Providence,nai59c.xml,34,3,1,CHI,319,221,FAT
1,5,7,187,1.866660777,192,5,have,"('MOT', 'CHI')",Providence,nai59c.xml,200,8,1,CHI,1834,1978,MOT
0,3,6,191,1.812378756,194,3,think,"('MOT', 'CHI')",Providence,nai59c.xml,200,6,0,CHI,1834,1978,MOT
0,5,1,101,1.791759469,106,5,think,"('CHI', 'FAT')",Providence,nai59c.xml,107,1,0,FAT,668,1127,CHI
0,5,2,136,1.7847908,141,5,go,"('CHI', 'MOT')",Providence,nai59c.xml,143,2,0,MOT,1292,1265,CHI
1,4,4,98,1.782190018,102,4,gonna,"('CHI', 'FAT')",Providence,nai59c.xml,107,5,1,FAT,668,1127,CHI
0,2,9,189,1.766182627,191,2,little,"('MOT', 'CHI')",Providence,nai59c.xml,200,9,0,CHI,1834,1978,MOT
0,1,1,32,1.763588592,33,1,it,"('FAT', 'CHI')",Providence,nai59c.xml,34,1,0,CHI,319,221,FAT
0,1,1,32,1.763588592,33,1,have,"('FAT', 'CHI')",Providence,nai59c.xml,34,1,0,CHI,319,221,FAT
0,1,1,32,1.763588592,33,1,this,"('FAT', 'CHI')",Providence,nai59c.xml,34,1,0,CHI,319,221,FAT
0,4,3,136,1.736951233,140,4,want,"('CHI', 'MOT')",Providence,nai59c.xml,143,3,0,MOT,1292,1265,CHI
1,2,1,30,1.734601055,32,2,is,"('FAT', 'CHI')",Providence,nai59c.xml,34,2,1,CHI,319,221,FAT
0,4,2,101,1.677096561,105,4,did,"('CHI', 'FAT')",Providence,nai59c.xml,107,2,0,FAT,668,1127,CHI
1,5,9,185,1.673976434,190,5,put,"('MOT', 'CHI')",Providence,nai59c.xml,200,10,1,CHI,1834,1978,MOT
2,0,10,22,1.637608789,22,0,a,"('FAT', 'CHI')",Providence,nai59c.xml,34,12,2,CHI,319,221,FAT
0,7,3,190,1.604425371,197,7,my,"('MOT', 'CHI')",Providence,nai59c.xml,200,3,0,CHI,1834,1978,MOT
0,2,5,100,1.599868461,102,2,this,"('CHI', 'FAT')",Providence,nai59c.xml,107,5,0,FAT,668,1127,CHI
1,5,10,184,1.588711782,189,5,wanna,"('MOT', 'CHI')",Providence,nai59c.xml,200,11,1,CHI,1834,1978,MOT
0,9,1,133,1.568615918,142,9,we,"('CHI', 'MOT')",Providence,nai59c.xml,143,1,0,MOT,1292,1265,CHI
4,9,8,122,1.558144618,131,9,it,"('CHI', 'MOT')",Providence,nai59c.xml,143,12,4,MOT,1292,1265,CHI
1,1,1,15,1.504077397,16,1,in,"('FAT', 'MOT')",Providence,nai59c.xml,18,2,1,MOT,91,177,FAT
0,7,1,99,1.504077397,106,7,but,"('CHI', 'FAT')",Providence,nai59c.xml,107,1,0,FAT,668,1127,CHI
0,7,1,99,1.504077397,106,7,one,"('CHI', 'FAT')",Providence,nai59c.xml,107,1,0,FAT,668,1127,CHI
1,1,4,28,1.488077055,29,1,the,"('FAT', 'CHI')",Providence,nai59c.xml,34,5,1,CHI,319,221,FAT
1,2,2,29,1.481604541,31,2,what,"('FAT', 'CHI')",Providence,nai59c.xml,34,3,1,CHI,319,221,FAT
1,8,7,184,1.461195669,192,8,what,"('MOT', 'CHI')",Providence,nai59c.xml,200,8,1,CHI,1834,1978,MOT
1,2,0,15,1.440361582,17,2,the,"('FAT', 'MOT')",Providence,nai59c.xml,18,1,1,MOT,91,177,FAT
1,6,10,183,1.434561102,189,6,want,"('MOT', 'CHI')",Providence,nai59c.xml,200,11,1,CHI,1834,1978,MOT
0,5,4,134,1.365240952,139,5,they,"('CHI', 'MOT')",Providence,nai59c.xml,143,4,0,MOT,1292,1265,CHI
0,3,7,133,1.343734747,136,3,with,"('CHI', 'MOT')",Providence,nai59c.xml,143,7,0,MOT,1292,1265,CHI
0,6,2,99,1.340624324,105,6,that,"('CHI', 'FAT')",Providence,nai59c.xml,107,2,0,FAT,668,1127,CHI
2,10,6,125,1.318112849,135,10,in,"('CHI', 'MOT')",Providence,nai59c.xml,143,8,2,MOT,1292,1265,CHI
0,5,7,188,1.284015512,193,5,can,"('MOT', 'CHI')",Providence,nai59c.xml,200,7,0,CHI,1834,1978,MOT
0,5,7,188,1.284015512,193,5,are,"('MOT', 'CHI')",Providence,nai59c.xml,200,7,0,CHI,1834,1978,MOT
0,9,1,97,1.280933845,106,9,oh,"('CHI', 'FAT')",Providence,nai59c.xml,107,1,0,FAT,668,1127,CHI
0,5,3,99,1.262241712,104,5,for,"('CHI', 'FAT')",Providence,nai59c.xml,107,3,0,FAT,668,1127,CHI
4,15,6,118,1.257217319,133,15,a,"('CHI', 'MOT')",Providence,nai59c.xml,143,10,4,MOT,1292,1265,CHI
1,4,18,177,1.248672983,181,4,do,"('MOT', 'CHI')",Providence,nai59c.xml,200,19,1,CHI,1834,1978,MOT
0,6,4,133,1.211090272,139,6,are,"('CHI', 'MOT')",Providence,nai59c.xml,143,4,0,MOT,1292,1265,CHI
0,7,2,98,1.207092932,105,7,she,"('CHI', 'FAT')",Providence,nai59c.xml,107,2,0,FAT,668,1127,CHI
0,1,3,30,1.193922468,31,1,gonna,"('FAT', 'CHI')",Providence,nai59c.xml,34,3,0,CHI,319,221,FAT
0,1,3,30,1.193922468,31,1,she,"('FAT', 'CHI')",Providence,nai59c.xml,34,3,0,CHI,319,221,FAT
0,1,3,30,1.193922468,31,1,to,"('FAT', 'CHI')",Providence,nai59c.xml,34,3,0,CHI,319,221,FAT
1,1,1,10,1.178654996,11,1,the,"('MOT', 'FAT')",Providence,nai59c.xml,13,2,1,FAT,51,67,MOT
0,1,1,16,1.15267951,17,1,oh,"('FAT', 'MOT')",Providence,nai59c.xml,18,1,0,MOT,91,177,FAT
0,1,1,16,1.15267951,17,1,did,"('FAT', 'MOT')",Providence,nai59c.xml,18,1,0,MOT,91,177,FAT
1,2,0,10,1.134979933,12,2,have,"('MOT', 'FAT')",Providence,nai59c.xml,13,1,1,FAT,51,67,MOT
0,10,4,186,1.098612289,196,10,go,"('MOT', 'CHI')",Providence,nai59c.xml,200,4,0,CHI,1834,1978,MOT
5,11,9,82,1.088140989,93,11,is,"('CHI', 'FAT')",Providence,nai59c.xml,107,14,5,FAT,668,1127,CHI
0,4,11,185,1.077886158,189,4,make,"('MOT', 'CHI')",Providence,nai59c.xml,200,11,0,CHI,1834,1978,MOT
1,8,5,93,1.05121005,101,8,it,"('CHI', 'FAT')",Providence,nai59c.xml,107,6,1,FAT,668,1127,CHI
2,9,10,122,1.047318994,131,9,on,"('CHI', 'MOT')",Providence,nai59c.xml,143,12,2,MOT,1292,1265,CHI
2,2,50,146,1.021651248,148,2,you,"('MOT', 'CHI')",Providence,nai59c.xml,200,52,2,CHI,1834,1978,MOT
6,17,6,78,0.99119204,95,17,the,"('CHI', 'FAT')",Providence,nai59c.xml,107,12,6,FAT,668,1127,CHI
0,1,4,29,0.980829253,30,1,for,"('FAT', 'CHI')",Providence,nai59c.xml,34,4,0,CHI,319,221,FAT
0,1,1,11,0.84729786,12,1,in,"('MOT', 'FAT')",Providence,nai59c.xml,13,1,0,FAT,51,67,MOT
3,14,16,167,0.843207875,181,14,on,"('MOT', 'CHI')",Providence,nai59c.xml,200,19,3,CHI,1834,1978,MOT
1,7,8,91,0.820980552,98,7,to,"('CHI', 'FAT')",Providence,nai59c.xml,107,9,1,FAT,668,1127,CHI
2,16,4,85,0.820686391,101,16,a,"('CHI', 'FAT')",Providence,nai59c.xml,107,6,2,FAT,668,1127,CHI
0,1,2,15,0.810930216,16,1,it,"('FAT', 'MOT')",Providence,nai59c.xml,18,2,0,MOT,91,177,FAT
1,3,1,13,0.810930216,16,3,we,"('FAT', 'MOT')",Providence,nai59c.xml,18,2,1,MOT,91,177,FAT
0,12,3,128,0.781439788,140,12,do,"('CHI', 'MOT')",Providence,nai59c.xml,143,3,0,MOT,1292,1265,CHI
2,21,8,169,0.780158558,190,21,this,"('MOT', 'CHI')",Providence,nai59c.xml,200,10,2,CHI,1834,1978,MOT
0,2,1,15,0.747214402,17,2,at,"('FAT', 'MOT')",Providence,nai59c.xml,18,1,0,MOT,91,177,FAT
0,2,1,15,0.747214402,17,2,not,"('FAT', 'MOT')",Providence,nai59c.xml,18,1,0,MOT,91,177,FAT
2,16,8,117,0.685767073,133,16,what,"('CHI', 'MOT')",Providence,nai59c.xml,143,10,2,MOT,1292,1265,CHI
2,16,13,169,0.663294217,185,16,gonna,"('MOT', 'CHI')",Providence,nai59c.xml,200,15,2,CHI,1834,1978,MOT
0,10,3,94,0.656105909,104,10,in,"('CHI', 'FAT')",Providence,nai59c.xml,107,3,0,FAT,668,1127,CHI
0,20,3,177,0.639344475,197,20,no,"('MOT', 'CHI')",Providence,nai59c.xml,200,3,0,CHI,1834,1978,MOT
0,1,6,27,0.628608659,28,1,and,"('FAT', 'CHI')",Providence,nai59c.xml,34,6,0,CHI,319,221,FAT
0,6,6,95,0.609377297,101,6,what,"('CHI', 'FAT')",Providence,nai59c.xml,107,6,0,FAT,668,1127,CHI
2,15,15,168,0.601940412,183,15,in,"('MOT', 'CHI')",Providence,nai59c.xml,200,17,2,CHI,1834,1978,MOT
4,28,12,156,0.577516998,184,28,is,"('MOT', 'CHI')",Providence,nai59c.xml,200,16,4,CHI,1834,1978,MOT
0,15,3,125,0.573800423,140,15,have,"('CHI', 'MOT')",Providence,nai59c.xml,143,3,0,MOT,1292,1265,CHI
2,9,18,114,0.53329848,123,9,is,"('CHI', 'MOT')",Providence,nai59c.xml,143,20,2,MOT,1292,1265,CHI
3,17,12,111,0.53024371,128,17,to,"('CHI', 'MOT')",Providence,nai59c.xml,143,15,3,MOT,1292,1265,CHI
0,6,14,180,0.517943092,186,6,like,"('MOT', 'CHI')",Providence,nai59c.xml,200,14,0,CHI,1834,1978,MOT
0,3,1,14,0.459532329,17,3,that,"('FAT', 'MOT')",Providence,nai59c.xml,18,1,0,MOT,91,177,FAT
0,10,6,127,0.457137119,137,10,and,"('CHI', 'MOT')",Providence,nai59c.xml,143,6,0,MOT,1292,1265,CHI
0,2,2,14,0.405465108,16,2,they,"('FAT', 'MOT')",Providence,nai59c.xml,18,2,0,MOT,91,177,FAT
0,17,2,88,0.396162715,105,17,you,"('CHI', 'FAT')",Providence,nai59c.xml,107,2,0,FAT,668,1127,CHI
2,20,6,79,0.366625275,99,20,and,"('CHI', 'FAT')",Providence,nai59c.xml,107,8,2,FAT,668,1127,CHI
0,19,3,121,0.350656872,140,19,that,"('CHI', 'MOT')",Providence,nai59c.xml,143,3,0,MOT,1292,1265,CHI
3,19,14,107,0.298153372,126,19,the,"('CHI', 'MOT')",Providence,nai59c.xml,143,17,3,MOT,1292,1265,CHI
0,4,1,13,0.236388778,17,4,you,"('FAT', 'MOT')",Providence,nai59c.xml,18,1,0,MOT,91,177,FAT
8,27,34,131,0.156004248,158,27,a,"('MOT', 'CHI')",Providence,nai59c.xml,200,42,8,CHI,1834,1978,MOT
0,38,2,103,-0.087011377,141,38,you,"('CHI', 'MOT')",Providence,nai59c.xml,143,2,0,MOT,1292,1265,CHI
5,28,32,135,-0.133152533,163,28,the,"('MOT', 'CHI')",Providence,nai59c.xml,200,37,5,CHI,1834,1978,MOT
0,8,21,171,-0.134221762,179,8,that,"('MOT', 'CHI')",Providence,nai59c.xml,200,21,0,CHI,1834,1978,MOT
0,12,19,169,-0.399985642,181,12,it,"('MOT', 'CHI')",Providence,nai59c.xml,200,19,0,CHI,1834,1978,MOT
0,21,12,167,-0.483075711,188,21,and,"('MOT', 'CHI')",Providence,nai59c.xml,200,12,0,CHI,1834,1978,MOT
1,27,28,144,-0.91975294,171,27,to,"('MOT', 'CHI')",Providence,nai59c.xml,200,29,1,CHI,1834,1978,MOT
1,0,0,111,4.321922711,111,0,where,"('CHI', 'MOT')",Providence,nai59d.xml,112,1,1,MOT,787,1139,CHI
1,2,1,289,3.88841314,291,2,they,"('MOT', 'CHI')",Providence,nai59d.xml,293,2,1,CHI,2681,2834,MOT
1,0,3,108,3.601868077,108,0,big,"('CHI', 'MOT')",Providence,nai59d.xml,112,4,1,MOT,787,1139,CHI
1,1,7,284,3.356897123,285,1,some,"('MOT', 'CHI')",Providence,nai59d.xml,293,8,1,CHI,2681,2834,MOT
2,1,11,279,3.339321978,280,1,have,"('MOT', 'CHI')",Providence,nai59d.xml,293,13,2,CHI,2681,2834,MOT
1,2,0,109,3.223310422,111,2,wanna,"('CHI', 'MOT')",Providence,nai59d.xml,112,1,1,MOT,787,1139,CHI
0,1,4,288,3.188416617,289,1,look,"('MOT', 'CHI')",Providence,nai59d.xml,293,4,0,CHI,2681,2834,MOT
0,1,4,288,3.188416617,289,1,but,"('MOT', 'CHI')",Providence,nai59d.xml,293,4,0,CHI,2681,2834,MOT
0,1,4,288,3.188416617,289,1,did,"('MOT', 'CHI')",Providence,nai59d.xml,293,4,0,CHI,2681,2834,MOT
5,6,4,278,3.103945858,284,6,she,"('MOT', 'CHI')",Providence,nai59d.xml,293,9,5,CHI,2681,2834,MOT
1,3,0,108,2.935628349,111,3,there,"('CHI', 'MOT')",Providence,nai59d.xml,112,1,1,MOT,787,1139,CHI
0,1,6,286,2.893837966,287,1,up,"('MOT', 'CHI')",Providence,nai59d.xml,293,6,0,CHI,2681,2834,MOT
2,6,4,281,2.739687286,287,6,wanna,"('MOT', 'CHI')",Providence,nai59d.xml,293,6,2,CHI,2681,2834,MOT
1,3,1,107,2.63905733,110,3,gonna,"('CHI', 'MOT')",Providence,nai59d.xml,112,2,1,MOT,787,1139,CHI
1,3,1,107,2.63905733,110,3,not,"('CHI', 'MOT')",Providence,nai59d.xml,112,2,1,MOT,787,1139,CHI
0,2,5,286,2.625358485,288,2,little,"('MOT', 'CHI')",Providence,nai59d.xml,293,5,0,CHI,2681,2834,MOT
0,2,5,286,2.625358485,288,2,put,"('MOT', 'CHI')",Providence,nai59d.xml,293,5,0,CHI,2681,2834,MOT
1,0,0,18,2.590267165,18,0,there,"('FAT', 'MOT')",Providence,nai59d.xml,19,1,1,MOT,120,248,FAT
0,2,1,109,2.530163241,111,2,but,"('CHI', 'MOT')",Providence,nai59d.xml,112,1,0,MOT,787,1139,CHI
0,2,1,109,2.530163241,111,2,did,"('CHI', 'MOT')",Providence,nai59d.xml,112,1,0,MOT,787,1139,CHI
0,3,4,286,2.495269437,289,3,all,"('MOT', 'CHI')",Providence,nai59d.xml,293,4,0,CHI,2681,2834,MOT
0,2,6,285,2.488372858,287,2,make,"('MOT', 'CHI')",Providence,nai59d.xml,293,6,0,CHI,2681,2834,MOT
3,6,9,275,2.44677378,281,6,he,"('MOT', 'CHI')",Providence,nai59d.xml,293,12,3,CHI,2681,2834,MOT
0,1,3,108,2.406945108,109,1,put,"('CHI', 'MOT')",Providence,nai59d.xml,112,3,0,MOT,787,1139,CHI
0,2,7,284,2.367123614,286,2,think,"('MOT', 'CHI')",Providence,nai59d.xml,293,7,0,CHI,2681,2834,MOT
0,5,3,285,2.275556421,290,5,not,"('MOT', 'CHI')",Providence,nai59d.xml,293,3,0,CHI,2681,2834,MOT
1,1,8,102,2.256065077,103,1,no,"('CHI', 'MOT')",Providence,nai59d.xml,112,9,1,MOT,787,1139,CHI
0,3,1,108,2.242481169,111,3,one,"('CHI', 'MOT')",Providence,nai59d.xml,112,1,0,MOT,787,1139,CHI
0,2,2,108,2.233592222,110,2,they,"('CHI', 'MOT')",Providence,nai59d.xml,112,2,0,MOT,787,1139,CHI
1,4,11,277,2.090098836,281,4,at,"('MOT', 'CHI')",Providence,nai59d.xml,293,12,1,CHI,2681,2834,MOT
1,0,0,10,2.079441542,10,0,that,"('CHI', 'FAT')",Providence,nai59d.xml,11,1,1,FAT,68,78,CHI
1,0,0,10,2.079441542,10,0,do,"('CHI', 'FAT')",Providence,nai59d.xml,11,1,1,FAT,68,78,CHI
1,0,0,10,2.079441542,10,0,the,"('CHI', 'FAT')",Providence,nai59d.xml,11,1,1,FAT,68,78,CHI
7,10,17,259,2.025568552,269,10,what,"('MOT', 'CHI')",Providence,nai59d.xml,293,24,7,CHI,2681,2834,MOT
0,4,1,107,2.019337618,111,4,little,"('CHI', 'MOT')",Providence,nai59d.xml,112,1,0,MOT,787,1139,CHI
0,4,6,283,1.977547234,287,4,yeah,"('MOT', 'CHI')",Providence,nai59d.xml,293,6,0,CHI,2681,2834,MOT
0,3,8,282,1.970602762,285,3,with,"('MOT', 'CHI')",Providence,nai59d.xml,293,8,0,CHI,2681,2834,MOT
1,2,7,102,1.955388893,104,2,my,"('CHI', 'MOT')",Providence,nai59d.xml,112,8,1,MOT,787,1139,CHI
0,3,2,107,1.945910149,110,3,all,"('CHI', 'MOT')",Providence,nai59d.xml,112,2,0,MOT,787,1139,CHI
0,6,4,283,1.935653649,289,6,was,"('MOT', 'CHI')",Providence,nai59d.xml,293,4,0,CHI,2681,2834,MOT
1,1,0,17,1.897119985,18,1,some,"('FAT', 'MOT')",Providence,nai59d.xml,19,1,1,MOT,120,248,FAT
1,3,18,271,1.882731247,274,3,can,"('MOT', 'CHI')",Providence,nai59d.xml,293,19,1,CHI,2681,2834,MOT
1,8,7,277,1.852819726,285,8,one,"('MOT', 'CHI')",Providence,nai59d.xml,293,8,1,CHI,2681,2834,MOT
1,0,0,7,1.791759469,7,0,on,"('MOT', 'FAT')",Providence,nai59d.xml,8,1,1,FAT,77,39,MOT
1,0,1,9,1.704748092,9,0,gonna,"('CHI', 'FAT')",Providence,nai59d.xml,11,2,1,FAT,68,78,CHI
0,6,1,105,1.682865381,111,6,with,"('CHI', 'MOT')",Providence,nai59d.xml,112,1,0,MOT,787,1139,CHI
0,4,9,280,1.648658626,284,4,see,"('MOT', 'CHI')",Providence,nai59d.xml,293,9,0,CHI,2681,2834,MOT
0,6,6,281,1.641074997,287,6,there,"('MOT', 'CHI')",Providence,nai59d.xml,293,6,0,CHI,2681,2834,MOT
0,5,8,280,1.565137654,285,5,get,"('MOT', 'CHI')",Providence,nai59d.xml,293,8,0,CHI,2681,2834,MOT
1,1,1,16,1.558144618,17,1,want,"('FAT', 'MOT')",Providence,nai59d.xml,19,2,1,MOT,120,248,FAT
1,1,1,16,1.558144618,17,1,on,"('FAT', 'MOT')",Providence,nai59d.xml,19,2,1,MOT,120,248,FAT
1,20,3,269,1.530188541,289,20,no,"('MOT', 'CHI')",Providence,nai59d.xml,293,4,1,CHI,2681,2834,MOT
0,2,18,273,1.529672944,275,2,we,"('MOT', 'CHI')",Providence,nai59d.xml,293,18,0,CHI,2681,2834,MOT
0,3,4,105,1.522426535,108,3,go,"('CHI', 'MOT')",Providence,nai59d.xml,112,4,0,MOT,787,1139,CHI
0,2,19,272,1.477266139,274,2,are,"('MOT', 'CHI')",Providence,nai59d.xml,293,19,0,CHI,2681,2834,MOT
0,8,1,103,1.431550953,111,8,can,"('CHI', 'MOT')",Providence,nai59d.xml,112,1,0,MOT,787,1139,CHI
0,8,1,103,1.431550953,111,8,do,"('CHI', 'MOT')",Providence,nai59d.xml,112,1,0,MOT,787,1139,CHI
1,8,12,272,1.429779473,280,8,like,"('MOT', 'CHI')",Providence,nai59d.xml,293,13,1,CHI,2681,2834,MOT
0,6,2,104,1.386294361,110,6,have,"('CHI', 'MOT')",Providence,nai59d.xml,112,2,0,MOT,787,1139,CHI
1,0,1,6,1.386294361,6,0,it,"('MOT', 'FAT')",Providence,nai59d.xml,8,2,1,FAT,77,39,MOT
1,0,1,6,1.386294361,6,0,have,"('MOT', 'FAT')",Providence,nai59d.xml,8,2,1,FAT,77,39,MOT
0,3,5,104,1.359143372,107,3,want,"('CHI', 'MOT')",Providence,nai59d.xml,112,5,0,MOT,787,1139,CHI
0,6,9,278,1.312186389,284,6,want,"('MOT', 'CHI')",Providence,nai59d.xml,293,9,0,CHI,2681,2834,MOT
0,6,9,278,1.312186389,284,6,on,"('MOT', 'CHI')",Providence,nai59d.xml,293,9,0,CHI,2681,2834,MOT
0,4,4,104,1.299282984,108,4,get,"('CHI', 'MOT')",Providence,nai59d.xml,112,4,0,MOT,787,1139,CHI
1,3,11,97,1.292768303,100,3,what,"('CHI', 'MOT')",Providence,nai59d.xml,112,12,1,MOT,787,1139,CHI
1,1,2,15,1.280933845,16,1,it,"('FAT', 'MOT')",Providence,nai59d.xml,19,3,1,MOT,120,248,FAT
0,7,8,278,1.277455581,285,7,for,"('MOT', 'CHI')",Providence,nai59d.xml,293,8,0,CHI,2681,2834,MOT
0,7,2,103,1.252762968,110,7,like,"('CHI', 'MOT')",Providence,nai59d.xml,112,2,0,MOT,787,1139,CHI
1,3,0,15,1.203972804,18,3,and,"('FAT', 'MOT')",Providence,nai59d.xml,19,1,1,MOT,120,248,FAT
0,1,1,17,1.203972804,18,1,see,"('FAT', 'MOT')",Providence,nai59d.xml,19,1,0,MOT,120,248,FAT
0,1,1,17,1.203972804,18,1,not,"('FAT', 'MOT')",Providence,nai59d.xml,19,1,0,MOT,120,248,FAT
2,10,5,95,1.176321273,105,10,are,"('CHI', 'MOT')",Providence,nai59d.xml,112,7,2,MOT,787,1139,CHI
1,2,1,15,1.15267951,17,2,she,"('FAT', 'MOT')",Providence,nai59d.xml,19,2,1,MOT,120,248,FAT
1,9,4,98,1.135999821,107,9,and,"('CHI', 'MOT')",Providence,nai59d.xml,112,5,1,MOT,787,1139,CHI
1,1,0,6,1.098612289,7,1,a,"('MOT', 'FAT')",Providence,nai59d.xml,8,1,1,FAT,77,39,MOT
1,0,2,5,1.029619417,5,0,the,"('MOT', 'FAT')",Providence,nai59d.xml,8,3,1,FAT,77,39,MOT
1,16,9,267,1.027516367,283,16,go,"('MOT', 'CHI')",Providence,nai59d.xml,293,10,1,CHI,2681,2834,MOT
0,7,3,102,1.020650747,109,7,in,"('CHI', 'MOT')",Providence,nai59d.xml,112,3,0,MOT,787,1139,CHI
0,7,3,102,1.020650747,109,7,of,"('CHI', 'MOT')",Providence,nai59d.xml,112,3,0,MOT,787,1139,CHI
0,6,4,102,0.962810748,108,6,it,"('CHI', 'MOT')",Providence,nai59d.xml,112,4,0,MOT,787,1139,CHI
0,5,5,102,0.953678264,107,5,for,"('CHI', 'MOT')",Providence,nai59d.xml,112,5,0,MOT,787,1139,CHI
0,10,2,100,0.934309237,110,10,we,"('CHI', 'MOT')",Providence,nai59d.xml,112,2,0,MOT,787,1139,CHI
4,19,22,248,0.876212508,267,19,in,"('MOT', 'CHI')",Providence,nai59d.xml,293,26,4,CHI,2681,2834,MOT
1,9,20,263,0.868195978,272,9,do,"('MOT', 'CHI')",Providence,nai59d.xml,293,21,1,CHI,2681,2834,MOT
4,13,10,85,0.802962047,98,13,a,"('CHI', 'MOT')",Providence,nai59d.xml,112,14,4,MOT,787,1139,CHI
0,2,1,16,0.798507696,18,2,yeah,"('FAT', 'MOT')",Providence,nai59d.xml,19,1,0,MOT,120,248,FAT
0,2,1,16,0.798507696,18,2,have,"('FAT', 'MOT')",Providence,nai59d.xml,19,1,0,MOT,120,248,FAT
0,2,1,16,0.798507696,18,2,but,"('FAT', 'MOT')",Providence,nai59d.xml,19,1,0,MOT,120,248,FAT
0,2,38,253,0.761584342,255,2,oh,"('MOT', 'CHI')",Providence,nai59d.xml,293,38,0,CHI,2681,2834,MOT
1,3,0,7,0.693147181,10,3,it,"('CHI', 'FAT')",Providence,nai59d.xml,11,1,1,FAT,68,78,CHI
0,1,1,9,0.693147181,10,1,no,"('CHI', 'FAT')",Providence,nai59d.xml,11,1,0,FAT,68,78,CHI
2,6,17,87,0.662056593,93,6,is,"('CHI', 'MOT')",Providence,nai59d.xml,112,19,2,MOT,787,1139,CHI
1,2,1,7,0.606135804,9,2,what,"('CHI', 'FAT')",Providence,nai59d.xml,11,2,1,FAT,68,78,CHI
0,1,3,15,0.587786665,16,1,is,"('FAT', 'MOT')",Providence,nai59d.xml,19,3,0,MOT,120,248,FAT
1,3,2,13,0.587786665,16,3,a,"('FAT', 'MOT')",Providence,nai59d.xml,19,3,1,MOT,120,248,FAT
0,8,16,269,0.543615447,277,8,of,"('MOT', 'CHI')",Providence,nai59d.xml,293,16,0,CHI,2681,2834,MOT
1,5,16,90,0.531659711,95,5,this,"('CHI', 'MOT')",Providence,nai59d.xml,112,17,1,MOT,787,1139,CHI
0,1,1,7,0.510825624,8,1,get,"('FAT', 'CHI')",Providence,nai59d.xml,9,1,0,CHI,57,88,FAT
0,1,1,7,0.510825624,8,1,to,"('FAT', 'CHI')",Providence,nai59d.xml,9,1,0,CHI,57,88,FAT
1,7,0,11,0.510825624,18,7,you,"('FAT', 'MOT')",Providence,nai59d.xml,19,1,1,MOT,120,248,FAT
1,3,68,221,0.464707942,224,3,you,"('MOT', 'CHI')",Providence,nai59d.xml,293,69,1,CHI,2681,2834,MOT
6,32,27,228,0.46239903,260,32,is,"('MOT', 'CHI')",Providence,nai59d.xml,293,33,6,CHI,2681,2834,MOT
0,2,2,15,0.459532329,17,2,oh,"('FAT', 'MOT')",Providence,nai59d.xml,19,2,0,MOT,120,248,FAT
0,2,2,15,0.459532329,17,2,they,"('FAT', 'MOT')",Providence,nai59d.xml,19,2,0,MOT,120,248,FAT
5,25,8,74,0.440733247,99,25,the,"('CHI', 'MOT')",Providence,nai59d.xml,112,13,5,MOT,787,1139,CHI
0,1,1,6,0.405465108,7,1,what,"('MOT', 'FAT')",Providence,nai59d.xml,8,1,0,FAT,77,39,MOT
1,20,15,257,0.389464767,277,20,gonna,"('MOT', 'CHI')",Providence,nai59d.xml,293,16,1,CHI,2681,2834,MOT
3,18,33,239,0.361097284,257,18,a,"('MOT', 'CHI')",Providence,nai59d.xml,293,36,3,CHI,2681,2834,MOT
0,2,1,8,0.287682072,10,2,for,"('CHI', 'FAT')",Providence,nai59d.xml,11,1,0,FAT,68,78,CHI
7,33,36,217,0.275847615,250,33,to,"('MOT', 'CHI')",Providence,nai59d.xml,293,43,7,CHI,2681,2834,MOT
1,18,20,254,0.226342092,272,18,it,"('MOT', 'CHI')",Providence,nai59d.xml,293,21,1,CHI,2681,2834,MOT
0,6,29,258,0.203598955,264,6,that,"('MOT', 'CHI')",Providence,nai59d.xml,293,29,0,CHI,2681,2834,MOT
0,3,2,14,0.171850257,17,3,get,"('FAT', 'MOT')",Providence,nai59d.xml,19,2,0,MOT,120,248,FAT
0,1,2,6,0.117783036,7,1,with,"('FAT', 'CHI')",Providence,nai59d.xml,9,2,0,CHI,57,88,FAT
0,1,2,6,0.117783036,7,1,wanna,"('FAT', 'CHI')",Providence,nai59d.xml,9,2,0,CHI,57,88,FAT
0,2,1,6,0.105360516,8,2,gonna,"('FAT', 'CHI')",Providence,nai59d.xml,9,1,0,CHI,57,88,FAT
0,2,1,6,0.105360516,8,2,a,"('FAT', 'CHI')",Providence,nai59d.xml,9,1,0,CHI,57,88,FAT
0,2,1,6,0.105360516,8,2,the,"('FAT', 'CHI')",Providence,nai59d.xml,9,1,0,CHI,57,88,FAT
0,34,1,77,0.073427469,111,34,you,"('CHI', 'MOT')",Providence,nai59d.xml,112,1,0,MOT,787,1139,CHI
0,17,4,91,0.018349139,108,17,that,"('CHI', 'MOT')",Providence,nai59d.xml,112,4,0,MOT,787,1139,CHI
3,30,30,230,-0.034696401,260,30,and,"('MOT', 'CHI')",Providence,nai59d.xml,293,33,3,CHI,2681,2834,MOT
0,4,2,13,-0.051293294,17,4,to,"('FAT', 'MOT')",Providence,nai59d.xml,19,2,0,MOT,120,248,FAT
9,44,50,190,-0.151119456,234,44,the,"('MOT', 'CHI')",Providence,nai59d.xml,293,59,9,CHI,2681,2834,MOT
1,14,15,82,-0.3203073,96,14,to,"('CHI', 'MOT')",Providence,nai59d.xml,112,16,1,MOT,787,1139,CHI
0,3,4,12,-0.344840486,15,3,the,"('FAT', 'MOT')",Providence,nai59d.xml,19,4,0,MOT,120,248,FAT
0,1,3,4,-0.356674944,5,1,you,"('MOT', 'FAT')",Providence,nai59d.xml,8,3,0,FAT,77,39,MOT
0,23,17,253,-0.494871696,276,23,this,"('MOT', 'CHI')",Providence,nai59d.xml,293,17,0,CHI,2681,2834,MOT
0,1,1,245,3.721669277,246,1,where,"('CHI', 'MOT')",Providence,nai59e.xml,247,1,0,MOT,2640,2657,CHI
0,1,1,245,3.721669277,246,1,big,"('CHI', 'MOT')",Providence,nai59e.xml,247,1,0,MOT,2640,2657,CHI
2,3,1,241,3.608211551,244,3,at,"('CHI', 'MOT')",Providence,nai59e.xml,247,3,2,MOT,2640,2657,CHI
2,0,3,75,3.496507561,75,0,was,"('FAT', 'CHI')",Providence,nai59e.xml,80,5,2,CHI,1015,543,FAT
1,0,2,77,3.453157121,77,0,with,"('FAT', 'CHI')",Providence,nai59e.xml,80,3,1,CHI,1015,543,FAT
2,3,2,240,3.421816669,243,3,make,"('CHI', 'MOT')",Providence,nai59e.xml,247,4,2,MOT,2640,2657,CHI
3,0,5,72,3.387774361,72,0,he,"('FAT', 'CHI')",Providence,nai59e.xml,80,8,3,CHI,1015,543,FAT
0,1,3,243,3.202746443,244,1,put,"('CHI', 'MOT')",Providence,nai59e.xml,247,3,0,MOT,2640,2657,CHI
3,4,3,237,3.19047635,241,4,have,"('CHI', 'MOT')",Providence,nai59e.xml,247,6,3,MOT,2640,2657,CHI
1,1,2,76,2.76000994,77,1,can,"('FAT', 'CHI')",Providence,nai59e.xml,80,3,1,CHI,1015,543,FAT
0,3,2,242,2.736799614,245,3,all,"('CHI', 'MOT')",Providence,nai59e.xml,247,2,0,MOT,2640,2657,CHI
1,7,1,238,2.736799614,245,7,not,"('CHI', 'MOT')",Providence,nai59e.xml,247,2,1,MOT,2640,2657,CHI
1,3,5,238,2.720472721,241,3,look,"('CHI', 'MOT')",Providence,nai59e.xml,247,6,1,MOT,2640,2657,CHI
0,5,1,241,2.623056988,246,5,wanna,"('CHI', 'MOT')",Providence,nai59e.xml,247,1,0,MOT,2640,2657,CHI
0,1,1,78,2.602689685,79,1,on,"('FAT', 'CHI')",Providence,nai59e.xml,80,1,0,CHI,1015,543,FAT
1,1,0,37,2.590267165,38,1,that,"('CHI', 'FAT')",Providence,nai59e.xml,39,1,1,FAT,356,329,CHI
2,2,2,74,2.564949357,76,2,where,"('FAT', 'CHI')",Providence,nai59e.xml,80,4,2,CHI,1015,543,FAT
1,2,11,233,2.423537703,235,2,no,"('CHI', 'MOT')",Providence,nai59e.xml,247,12,1,MOT,2640,2657,CHI
1,10,1,235,2.418345883,245,10,they,"('CHI', 'MOT')",Providence,nai59e.xml,247,2,1,MOT,2640,2657,CHI
1,4,0,75,2.379546134,79,4,want,"('FAT', 'CHI')",Providence,nai59e.xml,80,1,1,CHI,1015,543,FAT
0,5,2,240,2.331334506,245,5,get,"('CHI', 'MOT')",Providence,nai59e.xml,247,2,0,MOT,2640,2657,CHI
0,5,2,240,2.331334506,245,5,but,"('CHI', 'MOT')",Providence,nai59e.xml,247,2,0,MOT,2640,2657,CHI
0,5,2,240,2.331334506,245,5,did,"('CHI', 'MOT')",Providence,nai59e.xml,247,2,0,MOT,2640,2657,CHI
1,7,3,236,2.32320438,243,7,one,"('CHI', 'MOT')",Providence,nai59e.xml,247,4,1,MOT,2640,2657,CHI
1,5,5,236,2.315007613,241,5,go,"('CHI', 'MOT')",Providence,nai59e.xml,247,6,1,MOT,2640,2657,CHI
0,1,2,77,2.302585093,78,1,have,"('FAT', 'CHI')",Providence,nai59e.xml,80,2,0,CHI,1015,543,FAT
0,1,2,77,2.302585093,78,1,see,"('FAT', 'CHI')",Providence,nai59e.xml,80,2,0,CHI,1015,543,FAT
0,1,2,77,2.302585093,78,1,not,"('FAT', 'CHI')",Providence,nai59e.xml,80,2,0,CHI,1015,543,FAT
1,3,1,75,2.302585093,78,3,gonna,"('FAT', 'CHI')",Providence,nai59e.xml,80,2,1,CHI,1015,543,FAT
0,4,3,240,2.286455711,244,4,she,"('CHI', 'MOT')",Providence,nai59e.xml,247,3,0,MOT,2640,2657,CHI
2,7,6,232,2.201382587,239,7,for,"('CHI', 'MOT')",Providence,nai59e.xml,247,8,2,MOT,2640,2657,CHI
1,7,4,235,2.164963715,242,7,can,"('CHI', 'MOT')",Providence,nai59e.xml,247,5,1,MOT,2640,2657,CHI
3,6,11,227,2.127381004,233,6,up,"('CHI', 'MOT')",Providence,nai59e.xml,247,14,3,MOT,2640,2657,CHI
4,2,8,66,2.120263536,68,2,it,"('FAT', 'CHI')",Providence,nai59e.xml,80,12,4,CHI,1015,543,FAT
6,11,9,221,2.083111271,232,11,of,"('CHI', 'MOT')",Providence,nai59e.xml,247,15,6,MOT,2640,2657,CHI
1,6,6,234,2.03895018,240,6,was,"('CHI', 'MOT')",Providence,nai59e.xml,247,7,1,MOT,2640,2657,CHI
2,11,4,230,2.027325541,241,11,see,"('CHI', 'MOT')",Providence,nai59e.xml,247,6,2,MOT,2640,2657,CHI
2,7,8,230,2.010727649,237,7,he,"('CHI', 'MOT')",Providence,nai59e.xml,247,10,2,MOT,2640,2657,CHI
2,3,4,71,1.963609726,74,3,one,"('FAT', 'CHI')",Providence,nai59e.xml,80,6,2,CHI,1015,543,FAT
0,3,1,76,1.909542505,79,3,get,"('FAT', 'CHI')",Providence,nai59e.xml,80,1,0,CHI,1015,543,FAT
0,3,1,76,1.909542505,79,3,my,"('FAT', 'CHI')",Providence,nai59e.xml,80,1,0,CHI,1015,543,FAT
0,1,1,37,1.897119985,38,1,with,"('CHI', 'FAT')",Providence,nai59e.xml,39,1,0,FAT,356,329,CHI
0,1,1,37,1.897119985,38,1,did,"('CHI', 'FAT')",Providence,nai59e.xml,39,1,0,FAT,356,329,CHI
0,1,1,37,1.897119985,38,1,she,"('CHI', 'FAT')",Providence,nai59e.xml,39,1,0,FAT,356,329,CHI
0,1,1,37,1.897119985,38,1,my,"('CHI', 'FAT')",Providence,nai59e.xml,39,1,0,FAT,356,329,CHI
0,1,1,37,1.897119985,38,1,where,"('CHI', 'FAT')",Providence,nai59e.xml,39,1,0,FAT,356,329,CHI
1,2,1,35,1.871802177,37,2,are,"('CHI', 'FAT')",Providence,nai59e.xml,39,2,1,FAT,356,329,CHI
0,1,4,75,1.871802177,76,1,of,"('FAT', 'CHI')",Providence,nai59e.xml,80,4,0,CHI,1015,543,FAT
0,1,4,75,1.871802177,76,1,they,"('FAT', 'CHI')",Providence,nai59e.xml,80,4,0,CHI,1015,543,FAT
0,1,4,75,1.871802177,76,1,did,"('FAT', 'CHI')",Providence,nai59e.xml,80,4,0,CHI,1015,543,FAT
10,15,13,209,1.826965725,224,15,in,"('CHI', 'MOT')",Providence,nai59e.xml,247,23,10,MOT,2640,2657,CHI
10,15,13,209,1.826965725,224,15,it,"('CHI', 'MOT')",Providence,nai59e.xml,247,23,10,MOT,2640,2657,CHI
0,4,6,237,1.804181989,241,4,my,"('CHI', 'MOT')",Providence,nai59e.xml,247,6,0,MOT,2640,2657,CHI
1,9,5,232,1.804181989,241,9,little,"('CHI', 'MOT')",Providence,nai59e.xml,247,6,1,MOT,2640,2657,CHI
0,14,1,232,1.706766256,246,14,some,"('CHI', 'MOT')",Providence,nai59e.xml,247,1,0,MOT,2640,2657,CHI
0,8,3,236,1.698669046,244,8,we,"('CHI', 'MOT')",Providence,nai59e.xml,247,3,0,MOT,2640,2657,CHI
1,1,10,68,1.69773052,69,1,are,"('FAT', 'CHI')",Providence,nai59e.xml,80,11,1,CHI,1015,543,FAT
2,12,7,226,1.616406582,238,12,on,"('CHI', 'MOT')",Providence,nai59e.xml,247,9,2,MOT,2640,2657,CHI
0,3,2,75,1.609437912,78,3,yeah,"('FAT', 'CHI')",Providence,nai59e.xml,80,2,0,CHI,1015,543,FAT
0,6,5,236,1.605347927,242,6,want,"('CHI', 'MOT')",Providence,nai59e.xml,247,5,0,MOT,2640,2657,CHI
2,6,16,223,1.599387577,229,6,gonna,"('CHI', 'MOT')",Providence,nai59e.xml,247,18,2,MOT,2640,2657,CHI
3,11,11,222,1.588384503,233,11,this,"('CHI', 'MOT')",Providence,nai59e.xml,247,14,3,MOT,2640,2657,CHI
0,1,2,36,1.584120104,37,1,want,"('CHI', 'FAT')",Providence,nai59e.xml,39,2,0,FAT,356,329,CHI
0,2,1,36,1.491654877,38,2,in,"('CHI', 'FAT')",Providence,nai59e.xml,39,1,0,FAT,356,329,CHI
0,2,1,36,1.491654877,38,2,for,"('CHI', 'FAT')",Providence,nai59e.xml,39,1,0,FAT,356,329,CHI
0,2,1,36,1.491654877,38,2,some,"('CHI', 'FAT')",Providence,nai59e.xml,39,1,0,FAT,356,329,CHI
3,3,11,63,1.446918983,66,3,and,"('FAT', 'CHI')",Providence,nai59e.xml,80,14,3,CHI,1015,543,FAT
1,1,1,13,1.386294361,14,1,up,"('MOT', 'CHI')",Providence,nai59e.xml,16,2,1,CHI,151,225,MOT
0,6,1,73,1.349926717,79,6,go,"('FAT', 'CHI')",Providence,nai59e.xml,80,1,0,CHI,1015,543,FAT
0,1,3,35,1.335001067,36,1,what,"('CHI', 'FAT')",Providence,nai59e.xml,39,3,0,FAT,356,329,CHI
1,2,0,13,1.329135947,15,2,all,"('MOT', 'CHI')",Providence,nai59e.xml,16,1,1,CHI,151,225,MOT
3,17,9,218,1.324925415,235,17,with,"('CHI', 'MOT')",Providence,nai59e.xml,247,12,3,MOT,2640,2657,CHI
1,1,1,12,1.32175584,13,1,we,"('FAT', 'MOT')",Providence,nai59e.xml,15,2,1,MOT,171,161,FAT
1,1,1,12,1.32175584,13,1,are,"('FAT', 'MOT')",Providence,nai59e.xml,15,2,1,MOT,171,161,FAT
2,17,7,221,1.290984181,238,17,like,"('CHI', 'MOT')",Providence,nai59e.xml,247,9,2,MOT,2640,2657,CHI
11,23,18,195,1.266493161,218,23,to,"('CHI', 'MOT')",Providence,nai59e.xml,247,29,11,MOT,2640,2657,CHI
4,13,18,212,1.21727677,225,13,and,"('CHI', 'MOT')",Providence,nai59e.xml,247,22,4,MOT,2640,2657,CHI
0,5,2,73,1.203972804,78,5,no,"('FAT', 'CHI')",Providence,nai59e.xml,80,2,0,CHI,1015,543,FAT
2,3,4,30,1.188224447,33,3,it,"('CHI', 'FAT')",Providence,nai59e.xml,39,6,2,FAT,356,329,CHI
0,2,2,35,1.178654996,37,2,up,"('CHI', 'FAT')",Providence,nai59e.xml,39,2,0,FAT,356,329,CHI
0,2,2,35,1.178654996,37,2,is,"('CHI', 'FAT')",Providence,nai59e.xml,39,2,0,FAT,356,329,CHI
17,29,21,180,1.152153056,209,29,a,"('CHI', 'MOT')",Providence,nai59e.xml,247,38,17,MOT,2640,2657,CHI
0,4,3,73,1.150572028,77,4,like,"('FAT', 'CHI')",Providence,nai59e.xml,80,3,0,CHI,1015,543,FAT
0,19,2,226,1.127361702,245,19,are,"('CHI', 'MOT')",Providence,nai59e.xml,247,2,0,MOT,2640,2657,CHI
0,1,1,14,1.041453875,15,1,in,"('MOT', 'CHI')",Providence,nai59e.xml,16,1,0,CHI,151,225,MOT
0,1,1,14,1.041453875,15,1,like,"('MOT', 'CHI')",Providence,nai59e.xml,16,1,0,CHI,151,225,MOT
0,1,1,14,1.041453875,15,1,have,"('MOT', 'CHI')",Providence,nai59e.xml,16,1,0,CHI,151,225,MOT
0,1,1,14,1.041453875,15,1,is,"('MOT', 'CHI')",Providence,nai59e.xml,16,1,0,CHI,151,225,MOT
1,29,3,214,1.00144854,243,29,oh,"('CHI', 'MOT')",Providence,nai59e.xml,247,4,1,MOT,2640,2657,CHI
0,1,1,13,0.980829253,14,1,was,"('FAT', 'MOT')",Providence,nai59e.xml,15,1,0,MOT,171,161,FAT
0,1,1,13,0.980829253,14,1,see,"('FAT', 'MOT')",Providence,nai59e.xml,15,1,0,MOT,171,161,FAT
0,1,1,13,0.980829253,14,1,some,"('FAT', 'MOT')",Providence,nai59e.xml,15,1,0,MOT,171,161,FAT
0,1,1,13,0.980829253,14,1,on,"('FAT', 'MOT')",Providence,nai59e.xml,15,1,0,MOT,171,161,FAT
4,17,18,208,0.965962342,225,17,what,"('CHI', 'MOT')",Providence,nai59e.xml,247,22,4,MOT,2640,2657,CHI
5,16,23,203,0.955511445,219,16,is,"('CHI', 'MOT')",Providence,nai59e.xml,247,28,5,MOT,2640,2657,CHI
0,1,5,33,0.944461609,34,1,to,"('CHI', 'FAT')",Providence,nai59e.xml,39,5,0,FAT,356,329,CHI
0,10,7,230,0.893817876,240,10,there,"('CHI', 'MOT')",Providence,nai59e.xml,247,7,0,MOT,2640,2657,CHI
0,3,2,34,0.890972924,37,3,on,"('CHI', 'FAT')",Providence,nai59e.xml,39,2,0,FAT,356,329,CHI
1,1,22,56,0.858661619,57,1,you,"('FAT', 'CHI')",Providence,nai59e.xml,80,23,1,CHI,1015,543,FAT
0,14,5,228,0.843207875,242,14,think,"('CHI', 'MOT')",Providence,nai59e.xml,247,5,0,MOT,2640,2657,CHI
4,6,14,56,0.826678573,62,6,to,"('FAT', 'CHI')",Providence,nai59e.xml,80,18,4,CHI,1015,543,FAT
2,4,14,60,0.78845736,64,4,a,"('FAT', 'CHI')",Providence,nai59e.xml,80,16,2,CHI,1015,543,FAT
2,2,2,9,0.773189888,11,2,you,"('FAT', 'MOT')",Providence,nai59e.xml,15,4,2,MOT,171,161,FAT
2,2,2,9,0.773189888,11,2,it,"('FAT', 'MOT')",Providence,nai59e.xml,15,4,2,MOT,171,161,FAT
1,5,9,65,0.693147181,70,5,is,"('FAT', 'CHI')",Providence,nai59e.xml,80,10,1,CHI,1015,543,FAT
0,1,2,13,0.693147181,14,1,a,"('MOT', 'CHI')",Providence,nai59e.xml,16,2,0,CHI,151,225,MOT
0,2,1,13,0.635988767,15,2,this,"('MOT', 'CHI')",Providence,nai59e.xml,16,1,0,CHI,151,225,MOT
0,2,1,13,0.635988767,15,2,and,"('MOT', 'CHI')",Providence,nai59e.xml,16,1,0,CHI,151,225,MOT
0,2,1,12,0.575364145,14,2,oh,"('FAT', 'MOT')",Providence,nai59e.xml,15,1,0,MOT,171,161,FAT
21,31,52,143,0.478302432,174,31,the,"('CHI', 'MOT')",Providence,nai59e.xml,247,73,21,MOT,2640,2657,CHI
1,7,3,28,0.432864082,35,7,the,"('CHI', 'FAT')",Providence,nai59e.xml,39,4,1,FAT,356,329,CHI
1,9,26,211,0.425943639,220,9,yeah,"('CHI', 'MOT')",Providence,nai59e.xml,247,27,1,MOT,2640,2657,CHI
1,23,10,213,0.422414666,236,23,do,"('CHI', 'MOT')",Providence,nai59e.xml,247,11,1,MOT,2640,2657,CHI
0,3,10,67,0.405465108,70,3,what,"('FAT', 'CHI')",Providence,nai59e.xml,80,10,0,CHI,1015,543,FAT
1,3,2,10,0.405465108,13,3,to,"('MOT', 'CHI')",Providence,nai59e.xml,16,3,1,CHI,151,225,MOT
0,1,3,12,0.405465108,13,1,gonna,"('MOT', 'CHI')",Providence,nai59e.xml,16,3,0,CHI,151,225,MOT
0,1,3,12,0.405465108,13,1,do,"('MOT', 'CHI')",Providence,nai59e.xml,16,3,0,CHI,151,225,MOT
5,68,7,167,0.386655776,235,68,you,"('CHI', 'MOT')",Providence,nai59e.xml,247,12,5,MOT,2640,2657,CHI
0,3,1,12,0.348306694,15,3,want,"('MOT', 'CHI')",Providence,nai59e.xml,16,1,0,CHI,151,225,MOT
0,2,2,12,0.287682072,14,2,see,"('MOT', 'CHI')",Providence,nai59e.xml,16,2,0,CHI,151,225,MOT
0,3,1,11,0.287682072,14,3,in,"('FAT', 'MOT')",Providence,nai59e.xml,15,1,0,MOT,171,161,FAT
0,1,1,5,0.287682072,6,1,like,"('MOT', 'FAT')",Providence,nai59e.xml,7,1,0,FAT,70,48,MOT
0,1,1,5,0.287682072,6,1,a,"('MOT', 'FAT')",Providence,nai59e.xml,7,1,0,FAT,70,48,MOT
0,4,9,67,0.283126256,71,4,in,"('FAT', 'CHI')",Providence,nai59e.xml,80,9,0,CHI,1015,543,FAT
0,3,5,31,0.251314428,34,3,and,"('CHI', 'FAT')",Providence,nai59e.xml,39,5,0,FAT,356,329,CHI
0,5,3,31,0.236388778,36,5,this,"('CHI', 'FAT')",Providence,nai59e.xml,39,3,0,FAT,356,329,CHI
0,2,2,11,0.223143551,13,2,a,"('FAT', 'MOT')",Providence,nai59e.xml,15,2,0,MOT,171,161,FAT
1,3,3,9,0.15415068,12,3,it,"('MOT', 'CHI')",Providence,nai59e.xml,16,4,1,CHI,151,225,MOT
0,11,1,27,0.105360516,38,11,you,"('CHI', 'FAT')",Providence,nai59e.xml,39,1,0,FAT,356,329,CHI
0,5,9,66,0.100804699,71,5,that,"('FAT', 'CHI')",Providence,nai59e.xml,80,9,0,CHI,1015,543,FAT
0,3,2,10,-0.064538521,13,3,the,"('FAT', 'MOT')",Providence,nai59e.xml,15,2,0,MOT,171,161,FAT
0,1,5,10,-0.074107972,11,1,you,"('MOT', 'CHI')",Providence,nai59e.xml,16,5,0,CHI,151,225,MOT
0,27,10,210,-0.340647608,237,27,that,"('CHI', 'MOT')",Providence,nai59e.xml,247,10,0,MOT,2640,2657,CHI
0,6,13,61,-0.419853846,67,6,the,"('FAT', 'CHI')",Providence,nai59e.xml,80,13,0,CHI,1015,543,FAT
0,4,3,9,-0.510825624,13,4,the,"('MOT', 'CHI')",Providence,nai59e.xml,16,3,0,CHI,151,225,MOT
0,1,3,3,-0.510825624,4,1,you,"('MOT', 'FAT')",Providence,nai59e.xml,7,3,0,FAT,70,48,MOT
0,1,3,3,-0.510825624,4,1,it,"('MOT', 'FAT')",Providence,nai59e.xml,7,3,0,FAT,70,48,MOT
0,2,5,8,-0.559615788,10,2,and,"('FAT', 'MOT')",Providence,nai59e.xml,15,5,0,MOT,171,161,FAT
0,12,8,60,-0.563469357,72,12,this,"('FAT', 'CHI')",Providence,nai59e.xml,80,8,0,CHI,1015,543,FAT
0,8,6,25,-0.721318058,33,8,a,"('CHI', 'FAT')",Providence,nai59e.xml,39,6,0,FAT,356,329,CHI
2,0,1,278,5.123963979,278,0,he,"('MOT', 'CHI')",Providence,nai60.xml,281,3,2,CHI,2817,1810,MOT
1,0,2,278,4.718498871,278,0,she,"('MOT', 'CHI')",Providence,nai60.xml,281,3,1,CHI,2817,1810,MOT
0,2,3,276,2.926739402,278,2,one,"('MOT', 'CHI')",Providence,nai60.xml,281,3,0,CHI,2817,1810,MOT
0,1,6,274,2.851428784,275,1,they,"('MOT', 'CHI')",Providence,nai60.xml,281,6,0,CHI,2817,1810,MOT
2,3,10,266,2.675379419,269,3,like,"('MOT', 'CHI')",Providence,nai60.xml,281,12,2,CHI,2817,1810,MOT
0,1,8,272,2.621038824,273,1,make,"('MOT', 'CHI')",Providence,nai60.xml,281,8,0,CHI,2817,1810,MOT
2,4,8,267,2.613739522,271,4,put,"('MOT', 'CHI')",Providence,nai60.xml,281,10,2,CHI,2817,1810,MOT
0,2,5,274,2.583098676,276,2,go,"('MOT', 'CHI')",Providence,nai60.xml,281,5,0,CHI,2817,1810,MOT
1,2,11,267,2.557596383,269,2,of,"('MOT', 'CHI')",Providence,nai60.xml,281,12,1,CHI,2817,1810,MOT
0,1,11,269,2.347705528,270,1,get,"('MOT', 'CHI')",Providence,nai60.xml,281,11,0,CHI,2817,1810,MOT
0,2,7,272,2.324564,274,2,was,"('MOT', 'CHI')",Providence,nai60.xml,281,7,0,CHI,2817,1810,MOT
0,2,7,272,2.324564,274,2,wanna,"('MOT', 'CHI')",Providence,nai60.xml,281,7,0,CHI,2817,1810,MOT
1,5,7,268,2.215573716,273,5,there,"('MOT', 'CHI')",Providence,nai60.xml,281,8,1,CHI,2817,1810,MOT
1,6,6,268,2.17041332,274,6,not,"('MOT', 'CHI')",Providence,nai60.xml,281,7,1,CHI,2817,1810,MOT
0,3,6,272,2.158281603,275,3,did,"('MOT', 'CHI')",Providence,nai60.xml,281,6,0,CHI,2817,1810,MOT
2,4,15,260,2.128231706,264,4,some,"('MOT', 'CHI')",Providence,nai60.xml,281,17,2,CHI,2817,1810,MOT
0,4,5,272,2.072273052,276,4,my,"('MOT', 'CHI')",Providence,nai60.xml,281,5,0,CHI,2817,1810,MOT
0,2,10,269,2.025952857,271,2,can,"('MOT', 'CHI')",Providence,nai60.xml,281,10,0,CHI,2817,1810,MOT
0,2,11,268,1.94224042,270,2,with,"('MOT', 'CHI')",Providence,nai60.xml,281,11,0,CHI,2817,1810,MOT
1,5,13,262,1.723510369,267,5,this,"('MOT', 'CHI')",Providence,nai60.xml,281,14,1,CHI,2817,1810,MOT
6,8,28,239,1.68261953,247,8,what,"('MOT', 'CHI')",Providence,nai60.xml,281,34,6,CHI,2817,1810,MOT
0,3,11,267,1.654558348,270,3,think,"('MOT', 'CHI')",Providence,nai60.xml,281,11,0,CHI,2817,1810,MOT
0,4,9,268,1.605794921,272,4,for,"('MOT', 'CHI')",Providence,nai60.xml,281,9,0,CHI,2817,1810,MOT
2,9,16,254,1.380024748,263,9,are,"('MOT', 'CHI')",Providence,nai60.xml,281,18,2,CHI,2817,1810,MOT
2,6,24,249,1.369573714,255,6,want,"('MOT', 'CHI')",Providence,nai60.xml,281,26,2,CHI,2817,1810,MOT
0,7,7,267,1.343734747,274,7,up,"('MOT', 'CHI')",Providence,nai60.xml,281,7,0,CHI,2817,1810,MOT
0,5,10,266,1.332805676,271,5,see,"('MOT', 'CHI')",Providence,nai60.xml,281,10,0,CHI,2817,1810,MOT
3,11,20,247,1.243193517,258,11,in,"('MOT', 'CHI')",Providence,nai60.xml,281,23,3,CHI,2817,1810,MOT
5,7,44,225,1.23581341,232,7,it,"('MOT', 'CHI')",Providence,nai60.xml,281,49,5,CHI,2817,1810,MOT
0,4,15,262,1.148335724,266,4,on,"('MOT', 'CHI')",Providence,nai60.xml,281,15,0,CHI,2817,1810,MOT
1,4,31,245,1.082801683,249,4,that,"('MOT', 'CHI')",Providence,nai60.xml,281,32,1,CHI,2817,1810,MOT
0,11,6,264,1.059669315,275,11,yeah,"('MOT', 'CHI')",Providence,nai60.xml,281,6,0,CHI,2817,1810,MOT
2,9,26,244,0.936093359,253,9,and,"('MOT', 'CHI')",Providence,nai60.xml,281,28,2,CHI,2817,1810,MOT
2,8,29,242,0.934309237,250,8,do,"('MOT', 'CHI')",Providence,nai60.xml,281,31,2,CHI,2817,1810,MOT
0,29,2,250,0.850862927,279,29,no,"('MOT', 'CHI')",Providence,nai60.xml,281,2,0,CHI,2817,1810,MOT
1,7,27,246,0.753771802,253,7,gonna,"('MOT', 'CHI')",Providence,nai60.xml,281,28,1,CHI,2817,1810,MOT
0,5,20,256,0.68935211,261,5,have,"('MOT', 'CHI')",Providence,nai60.xml,281,20,0,CHI,2817,1810,MOT
5,9,84,183,0.246173029,192,9,you,"('MOT', 'CHI')",Providence,nai60.xml,281,89,5,CHI,2817,1810,MOT
3,18,38,222,0.169592992,240,18,to,"('MOT', 'CHI')",Providence,nai60.xml,281,41,3,CHI,2817,1810,MOT
8,31,46,196,0.139858987,227,31,the,"('MOT', 'CHI')",Providence,nai60.xml,281,54,8,CHI,2817,1810,MOT
0,9,25,247,-0.045462374,256,9,is,"('MOT', 'CHI')",Providence,nai60.xml,281,25,0,CHI,2817,1810,MOT
1,17,39,224,-0.441832752,241,17,a,"('MOT', 'CHI')",Providence,nai60.xml,281,40,1,CHI,2817,1810,MOT
1,2,7,381,3.245193133,383,2,all,"('MOT', 'CHI')",Providence,nai61.xml,391,8,1,CHI,4842,2106,MOT
2,1,19,369,3.188864746,370,1,was,"('MOT', 'CHI')",Providence,nai61.xml,391,21,2,CHI,4842,2106,MOT
1,3,8,379,2.859600099,382,3,she,"('MOT', 'CHI')",Providence,nai61.xml,391,9,1,CHI,4842,2106,MOT
0,2,6,383,2.780370863,385,2,where,"('MOT', 'CHI')",Providence,nai61.xml,391,6,0,CHI,4842,2106,MOT
6,5,19,361,2.766396752,366,5,he,"('MOT', 'CHI')",Providence,nai61.xml,391,25,6,CHI,4842,2106,MOT
1,1,23,366,2.652700106,367,1,we,"('MOT', 'CHI')",Providence,nai61.xml,391,24,1,CHI,4842,2106,MOT
1,2,15,373,2.636408321,375,2,up,"('MOT', 'CHI')",Providence,nai61.xml,391,16,1,CHI,4842,2106,MOT
1,3,12,375,2.538973871,378,3,not,"('MOT', 'CHI')",Providence,nai61.xml,391,13,1,CHI,4842,2106,MOT
1,3,16,371,2.292002984,374,3,see,"('MOT', 'CHI')",Providence,nai61.xml,391,17,1,CHI,4842,2106,MOT
2,7,11,371,2.251291799,378,7,one,"('MOT', 'CHI')",Providence,nai61.xml,391,13,2,CHI,4842,2106,MOT
1,4,13,373,2.248656751,377,4,want,"('MOT', 'CHI')",Providence,nai61.xml,391,14,1,CHI,4842,2106,MOT
2,4,23,362,2.101420448,366,4,put,"('MOT', 'CHI')",Providence,nai61.xml,391,25,2,CHI,4842,2106,MOT
0,1,21,369,2.090252458,370,1,wanna,"('MOT', 'CHI')",Providence,nai61.xml,391,21,0,CHI,4842,2106,MOT
0,1,22,368,2.045001052,369,1,gonna,"('MOT', 'CHI')",Providence,nai61.xml,391,22,0,CHI,4842,2106,MOT
0,2,15,374,2.003068563,376,2,get,"('MOT', 'CHI')",Providence,nai61.xml,391,15,0,CHI,4842,2106,MOT
1,3,23,364,1.959552925,367,3,have,"('MOT', 'CHI')",Providence,nai61.xml,391,24,1,CHI,4842,2106,MOT
1,8,9,373,1.959050943,381,8,at,"('MOT', 'CHI')",Providence,nai61.xml,391,10,1,CHI,4842,2106,MOT
0,2,17,372,1.886537876,374,2,my,"('MOT', 'CHI')",Providence,nai61.xml,391,17,0,CHI,4842,2106,MOT
1,4,23,363,1.736409374,367,4,there,"('MOT', 'CHI')",Providence,nai61.xml,391,24,1,CHI,4842,2106,MOT
6,7,51,327,1.606042323,334,7,it,"('MOT', 'CHI')",Providence,nai61.xml,391,57,6,CHI,4842,2106,MOT
2,9,19,361,1.579426834,370,9,this,"('MOT', 'CHI')",Providence,nai61.xml,391,21,2,CHI,4842,2106,MOT
0,4,14,373,1.55550957,377,4,go,"('MOT', 'CHI')",Providence,nai61.xml,391,14,0,CHI,4842,2106,MOT
4,7,43,337,1.484614848,344,7,in,"('MOT', 'CHI')",Providence,nai61.xml,391,47,4,CHI,4842,2106,MOT
1,3,39,348,1.435651258,351,3,on,"('MOT', 'CHI')",Providence,nai61.xml,391,40,1,CHI,4842,2106,MOT
1,8,17,365,1.427116356,373,8,can,"('MOT', 'CHI')",Providence,nai61.xml,391,18,1,CHI,4842,2106,MOT
3,25,11,352,1.293145306,377,25,no,"('MOT', 'CHI')",Providence,nai61.xml,391,14,3,CHI,4842,2106,MOT
0,5,19,367,1.08797389,372,5,did,"('MOT', 'CHI')",Providence,nai61.xml,391,19,0,CHI,4842,2106,MOT
0,5,19,367,1.08797389,372,5,are,"('MOT', 'CHI')",Providence,nai61.xml,391,19,0,CHI,4842,2106,MOT
1,4,45,341,1.061833037,345,4,and,"('MOT', 'CHI')",Providence,nai61.xml,391,46,1,CHI,4842,2106,MOT
0,3,36,352,0.853855261,355,3,of,"('MOT', 'CHI')",Providence,nai61.xml,391,36,0,CHI,4842,2106,MOT
3,19,26,343,0.853728751,362,19,think,"('MOT', 'CHI')",Providence,nai61.xml,391,29,3,CHI,4842,2106,MOT
0,8,17,366,0.787925587,374,8,some,"('MOT', 'CHI')",Providence,nai61.xml,391,17,0,CHI,4842,2106,MOT
2,8,51,330,0.723000144,338,8,what,"('MOT', 'CHI')",Providence,nai61.xml,391,53,2,CHI,4842,2106,MOT
8,10,105,268,0.689186779,278,10,you,"('MOT', 'CHI')",Providence,nai61.xml,391,113,8,CHI,4842,2106,MOT
5,11,78,297,0.60077386,308,11,a,"('MOT', 'CHI')",Providence,nai61.xml,391,83,5,CHI,4842,2106,MOT
2,10,50,329,0.543615447,339,10,is,"('MOT', 'CHI')",Providence,nai61.xml,391,52,2,CHI,4842,2106,MOT
14,22,96,259,0.499504012,281,22,the,"('MOT', 'CHI')",Providence,nai61.xml,391,110,14,CHI,4842,2106,MOT
2,57,10,322,0.341911324,379,57,look,"('MOT', 'CHI')",Providence,nai61.xml,391,12,2,CHI,4842,2106,MOT
0,20,14,357,0.120425045,377,20,but,"('MOT', 'CHI')",Providence,nai61.xml,391,14,0,CHI,4842,2106,MOT
3,20,59,309,-0.014992785,329,20,that,"('MOT', 'CHI')",Providence,nai61.xml,391,62,3,CHI,4842,2106,MOT
4,21,71,295,-0.06335858,316,21,to,"('MOT', 'CHI')",Providence,nai61.xml,391,75,4,CHI,4842,2106,MOT
1,55,31,304,-0.969687076,359,55,yeah,"('MOT', 'CHI')",Providence,nai61.xml,391,32,1,CHI,4842,2106,MOT
1,7,0,299,3.245193133,306,7,get,"('CHI', 'MOT')",Providence,nai62.xml,307,1,1,MOT,2432,3314,CHI
0,2,2,303,3.241941098,305,2,with,"('CHI', 'MOT')",Providence,nai62.xml,307,2,0,MOT,2432,3314,CHI
1,4,2,300,3.197856458,304,4,they,"('CHI', 'MOT')",Providence,nai62.xml,307,3,1,MOT,2432,3314,CHI
1,4,2,300,3.197856458,304,4,she,"('CHI', 'MOT')",Providence,nai62.xml,307,3,1,MOT,2432,3314,CHI
1,3,4,299,3.077970372,302,3,all,"('CHI', 'MOT')",Providence,nai62.xml,307,5,1,MOT,2432,3314,CHI
3,3,10,291,2.982309253,294,3,one,"('CHI', 'MOT')",Providence,nai62.xml,307,13,3,MOT,2432,3314,CHI
1,5,3,298,2.829940019,303,5,have,"('CHI', 'MOT')",Providence,nai62.xml,307,4,1,MOT,2432,3314,CHI
0,2,5,300,2.672505264,302,2,want,"('CHI', 'MOT')",Providence,nai62.xml,307,5,0,MOT,2432,3314,CHI
1,10,1,295,2.635805294,305,10,put,"('CHI', 'MOT')",Providence,nai62.xml,307,2,1,MOT,2432,3314,CHI
0,7,1,299,2.552045953,306,7,big,"('CHI', 'MOT')",Providence,nai62.xml,307,1,0,MOT,2432,3314,CHI
0,5,2,300,2.548793917,305,5,look,"('CHI', 'MOT')",Providence,nai62.xml,307,2,0,MOT,2432,3314,CHI
1,12,1,293,2.46875121,305,12,little,"('CHI', 'MOT')",Providence,nai62.xml,307,2,1,MOT,2432,3314,CHI
0,9,1,297,2.328902401,306,9,up,"('CHI', 'MOT')",Providence,nai62.xml,307,1,0,MOT,2432,3314,CHI
2,3,19,283,2.239784192,286,3,no,"('CHI', 'MOT')",Providence,nai62.xml,307,21,2,MOT,2432,3314,CHI
3,15,4,285,2.126908079,300,15,was,"('CHI', 'MOT')",Providence,nai62.xml,307,7,3,MOT,2432,3314,CHI
2,11,5,289,2.126908079,300,11,some,"('CHI', 'MOT')",Providence,nai62.xml,307,7,2,MOT,2432,3314,CHI
1,6,8,292,2.053124233,298,6,not,"('CHI', 'MOT')",Providence,nai62.xml,307,9,1,MOT,2432,3314,CHI
0,6,4,297,1.982642158,303,6,but,"('CHI', 'MOT')",Providence,nai62.xml,307,4,0,MOT,2432,3314,CHI
1,16,2,288,1.974081026,304,16,at,"('CHI', 'MOT')",Providence,nai62.xml,307,3,1,MOT,2432,3314,CHI
3,15,7,282,1.829242562,297,15,of,"('CHI', 'MOT')",Providence,nai62.xml,307,10,3,MOT,2432,3314,CHI
7,14,17,269,1.765783983,283,14,he,"('CHI', 'MOT')",Providence,nai62.xml,307,24,7,MOT,2432,3314,CHI
1,14,4,288,1.756214532,302,14,for,"('CHI', 'MOT')",Providence,nai62.xml,307,5,1,MOT,2432,3314,CHI
0,10,3,294,1.716251917,304,10,can,"('CHI', 'MOT')",Providence,nai62.xml,307,3,0,MOT,2432,3314,CHI
1,12,6,288,1.641400263,300,12,do,"('CHI', 'MOT')",Providence,nai62.xml,307,7,1,MOT,2432,3314,CHI
6,16,15,270,1.640163069,286,16,gonna,"('CHI', 'MOT')",Providence,nai62.xml,307,21,6,MOT,2432,3314,CHI
0,19,1,287,1.635755221,306,19,think,"('CHI', 'MOT')",Providence,nai62.xml,307,1,0,MOT,2432,3314,CHI
2,13,9,283,1.591699088,296,13,go,"('CHI', 'MOT')",Providence,nai62.xml,307,11,2,MOT,2432,3314,CHI
1,17,4,285,1.573892975,302,17,on,"('CHI', 'MOT')",Providence,nai62.xml,307,5,1,MOT,2432,3314,CHI
5,28,9,265,1.338850273,293,28,and,"('CHI', 'MOT')",Providence,nai62.xml,307,14,5,MOT,2432,3314,CHI
1,58,0,248,1.247097231,306,58,oh,"('CHI', 'MOT')",Providence,nai62.xml,307,1,1,MOT,2432,3314,CHI
0,10,7,290,1.115307167,300,10,where,"('CHI', 'MOT')",Providence,nai62.xml,307,7,0,MOT,2432,3314,CHI
0,13,6,288,0.995233934,301,13,my,"('CHI', 'MOT')",Providence,nai62.xml,307,6,0,MOT,2432,3314,CHI
1,23,7,276,0.919618522,299,23,are,"('CHI', 'MOT')",Providence,nai62.xml,307,8,1,MOT,2432,3314,CHI
0,17,5,285,0.880745794,302,17,see,"('CHI', 'MOT')",Providence,nai62.xml,307,5,0,MOT,2432,3314,CHI
1,22,8,276,0.863540166,298,22,like,"('CHI', 'MOT')",Providence,nai62.xml,307,9,1,MOT,2432,3314,CHI
1,4,43,259,0.834797698,263,4,yeah,"('CHI', 'MOT')",Providence,nai62.xml,307,44,1,MOT,2432,3314,CHI
4,32,14,257,0.790521345,289,32,in,"('CHI', 'MOT')",Providence,nai62.xml,307,18,4,MOT,2432,3314,CHI
8,34,23,242,0.772990068,276,34,that,"('CHI', 'MOT')",Providence,nai62.xml,307,31,8,MOT,2432,3314,CHI
11,48,19,229,0.758562231,277,48,it,"('CHI', 'MOT')",Providence,nai62.xml,307,30,11,MOT,2432,3314,CHI
15,53,26,213,0.61339154,266,53,the,"('CHI', 'MOT')",Providence,nai62.xml,307,41,15,MOT,2432,3314,CHI
8,44,23,232,0.52167564,276,44,to,"('CHI', 'MOT')",Providence,nai62.xml,307,31,8,MOT,2432,3314,CHI
0,17,8,282,0.514153414,299,17,there,"('CHI', 'MOT')",Providence,nai62.xml,307,8,0,MOT,2432,3314,CHI
0,17,8,282,0.514153414,299,17,did,"('CHI', 'MOT')",Providence,nai62.xml,307,8,0,MOT,2432,3314,CHI
3,28,21,255,0.413391173,283,28,is,"('CHI', 'MOT')",Providence,nai62.xml,307,24,3,MOT,2432,3314,CHI
0,16,10,281,0.38232358,297,16,we,"('CHI', 'MOT')",Providence,nai62.xml,307,10,0,MOT,2432,3314,CHI
7,42,28,230,0.32045162,272,42,a,"('CHI', 'MOT')",Providence,nai62.xml,307,35,7,MOT,2432,3314,CHI
2,28,21,256,0.168432445,284,28,what,"('CHI', 'MOT')",Providence,nai62.xml,307,23,2,MOT,2432,3314,CHI
4,71,19,213,-0.230112221,284,71,you,"('CHI', 'MOT')",Providence,nai62.xml,307,23,4,MOT,2432,3314,CHI
0,14,25,268,-0.354912829,282,14,this,"('CHI', 'MOT')",Providence,nai62.xml,307,25,0,MOT,2432,3314,CHI
1,4,2,342,3.326473835,346,4,where,"('CHI', 'MOT')",Providence,nai63.xml,349,3,1,MOT,1941,4699,CHI
4,10,0,335,3.26910795,345,10,make,"('CHI', 'MOT')",Providence,nai63.xml,349,4,4,MOT,1941,4699,CHI
1,8,0,340,3.255243469,348,8,get,"('CHI', 'MOT')",Providence,nai63.xml,349,1,1,MOT,1941,4699,CHI
0,4,2,343,2.859339649,347,4,was,"('CHI', 'MOT')",Providence,nai63.xml,349,2,0,MOT,1941,4699,CHI
0,6,1,342,2.813410717,348,6,wanna,"('CHI', 'MOT')",Providence,nai63.xml,349,1,0,MOT,1941,4699,CHI
2,7,4,336,2.783273622,343,7,he,"('CHI', 'MOT')",Providence,nai63.xml,349,6,2,MOT,1941,4699,CHI
0,7,1,341,2.679879324,348,7,big,"('CHI', 'MOT')",Providence,nai63.xml,349,1,0,MOT,1941,4699,CHI
3,11,3,332,2.665490587,343,11,they,"('CHI', 'MOT')",Providence,nai63.xml,349,6,3,MOT,1941,4699,CHI
1,12,1,335,2.596975384,347,12,did,"('CHI', 'MOT')",Providence,nai63.xml,349,2,1,MOT,1941,4699,CHI
2,7,11,329,2.134166441,336,7,she,"('CHI', 'MOT')",Providence,nai63.xml,349,13,2,MOT,1941,4699,CHI
0,13,1,335,2.120263536,348,13,look,"('CHI', 'MOT')",Providence,nai63.xml,349,1,0,MOT,1941,4699,CHI
0,13,1,335,2.120263536,348,13,but,"('CHI', 'MOT')",Providence,nai63.xml,349,1,0,MOT,1941,4699,CHI
3,18,4,324,2.085272462,342,18,on,"('CHI', 'MOT')",Providence,nai63.xml,349,7,3,MOT,1941,4699,CHI
0,11,2,336,1.983870911,347,11,up,"('CHI', 'MOT')",Providence,nai63.xml,349,2,0,MOT,1941,4699,CHI
1,11,5,332,1.972343406,343,11,go,"('CHI', 'MOT')",Providence,nai63.xml,349,6,1,MOT,1941,4699,CHI
5,15,11,318,1.942929521,333,15,one,"('CHI', 'MOT')",Providence,nai63.xml,349,16,5,MOT,1941,4699,CHI
1,19,2,327,1.940179474,346,19,see,"('CHI', 'MOT')",Providence,nai63.xml,349,3,1,MOT,1941,4699,CHI
0,12,2,335,1.903828204,347,12,put,"('CHI', 'MOT')",Providence,nai63.xml,349,2,0,MOT,1941,4699,CHI
0,17,1,331,1.868949108,348,17,little,"('CHI', 'MOT')",Providence,nai63.xml,349,1,0,MOT,1941,4699,CHI
4,23,5,317,1.868299546,340,23,gonna,"('CHI', 'MOT')",Providence,nai63.xml,349,9,4,MOT,1941,4699,CHI
1,26,1,321,1.866087876,347,26,some,"('CHI', 'MOT')",Providence,nai63.xml,349,2,1,MOT,1941,4699,CHI
3,27,3,316,1.818192726,343,27,have,"('CHI', 'MOT')",Providence,nai63.xml,349,6,3,MOT,1941,4699,CHI
3,16,8,322,1.817077277,338,16,are,"('CHI', 'MOT')",Providence,nai63.xml,349,11,3,MOT,1941,4699,CHI
2,22,4,321,1.727220948,343,22,there,"('CHI', 'MOT')",Providence,nai63.xml,349,6,2,MOT,1941,4699,CHI
0,20,1,328,1.714798428,348,20,for,"('CHI', 'MOT')",Providence,nai63.xml,349,1,0,MOT,1941,4699,CHI
5,41,2,301,1.697506931,342,41,and,"('CHI', 'MOT')",Providence,nai63.xml,349,7,5,MOT,1941,4699,CHI
0,16,2,331,1.635564217,347,16,with,"('CHI', 'MOT')",Providence,nai63.xml,349,2,0,MOT,1941,4699,CHI
0,23,1,325,1.581267035,348,23,can,"('CHI', 'MOT')",Providence,nai63.xml,349,1,0,MOT,1941,4699,CHI
0,14,3,332,1.534714366,346,14,all,"('CHI', 'MOT')",Providence,nai63.xml,349,3,0,MOT,1941,4699,CHI
0,20,2,327,1.424255123,347,20,we,"('CHI', 'MOT')",Providence,nai63.xml,349,2,0,MOT,1941,4699,CHI
1,18,6,324,1.392125281,342,18,think,"('CHI', 'MOT')",Providence,nai63.xml,349,7,1,MOT,1941,4699,CHI
1,44,1,303,1.355262252,347,44,of,"('CHI', 'MOT')",Providence,nai63.xml,349,2,1,MOT,1941,4699,CHI
0,12,5,332,1.335579269,344,12,my,"('CHI', 'MOT')",Providence,nai63.xml,349,5,0,MOT,1941,4699,CHI
1,12,11,325,1.315140601,337,12,want,"('CHI', 'MOT')",Providence,nai63.xml,349,12,1,MOT,1941,4699,CHI
7,38,10,294,1.282581909,332,38,it,"('CHI', 'MOT')",Providence,nai63.xml,349,17,7,MOT,1941,4699,CHI
0,4,17,328,1.257264101,332,4,no,"('CHI', 'MOT')",Providence,nai63.xml,349,17,0,MOT,1941,4699,CHI
0,21,3,325,1.151722114,346,21,at,"('CHI', 'MOT')",Providence,nai63.xml,349,3,0,MOT,1941,4699,CHI
0,37,1,311,1.121734706,348,37,oh,"('CHI', 'MOT')",Providence,nai63.xml,349,1,0,MOT,1941,4699,CHI
0,19,4,326,1.061833037,345,19,like,"('CHI', 'MOT')",Providence,nai63.xml,349,4,0,MOT,1941,4699,CHI
7,39,20,283,0.804009773,322,39,is,"('CHI', 'MOT')",Providence,nai63.xml,349,27,7,MOT,1941,4699,CHI
26,74,21,228,0.803556156,302,74,the,"('CHI', 'MOT')",Providence,nai63.xml,349,47,26,MOT,1941,4699,CHI
1,9,29,310,0.696267308,319,9,yeah,"('CHI', 'MOT')",Providence,nai63.xml,349,30,1,MOT,1941,4699,CHI
1,26,10,312,0.661306575,338,26,do,"('CHI', 'MOT')",Providence,nai63.xml,349,11,1,MOT,1941,4699,CHI
14,78,18,239,0.577432927,317,78,a,"('CHI', 'MOT')",Providence,nai63.xml,349,32,14,MOT,1941,4699,CHI
1,26,13,309,0.444804523,335,26,this,"('CHI', 'MOT')",Providence,nai63.xml,349,14,1,MOT,1941,4699,CHI
3,29,24,293,0.398544665,322,29,what,"('CHI', 'MOT')",Providence,nai63.xml,349,27,3,MOT,1941,4699,CHI
0,29,6,314,0.362905494,343,29,in,"('CHI', 'MOT')",Providence,nai63.xml,349,6,0,MOT,1941,4699,CHI
4,61,16,268,0.193379449,329,61,that,"('CHI', 'MOT')",Providence,nai63.xml,349,20,4,MOT,1941,4699,CHI
2,41,17,289,0.121555202,330,41,to,"('CHI', 'MOT')",Providence,nai63.xml,349,19,2,MOT,1941,4699,CHI
4,93,13,239,-0.067154856,332,93,you,"('CHI', 'MOT')",Providence,nai63.xml,349,17,4,MOT,1941,4699,CHI
1,1,5,408,3.939151673,409,1,but,"('MOT', 'CHI')",Providence,nai64.xml,415,6,1,CHI,5457,2737,MOT
1,1,13,400,3.22634784,401,1,some,"('MOT', 'CHI')",Providence,nai64.xml,415,14,1,CHI,5457,2737,MOT
4,3,15,393,3.165073119,396,3,get,"('MOT', 'CHI')",Providence,nai64.xml,415,19,4,CHI,5457,2737,MOT
2,2,13,398,3.163238745,400,2,like,"('MOT', 'CHI')",Providence,nai64.xml,415,15,2,CHI,5457,2737,MOT
1,2,10,402,3.035938694,404,2,make,"('MOT', 'CHI')",Providence,nai64.xml,415,11,1,CHI,5457,2737,MOT
3,8,4,400,3.008002366,408,8,not,"('MOT', 'CHI')",Providence,nai64.xml,415,7,3,CHI,5457,2737,MOT
1,1,17,396,2.993229143,397,1,big,"('MOT', 'CHI')",Providence,nai64.xml,415,18,1,CHI,5457,2737,MOT
2,8,5,400,2.720320294,408,8,where,"('MOT', 'CHI')",Providence,nai64.xml,415,7,2,CHI,5457,2737,MOT
1,2,15,397,2.698124561,399,2,all,"('MOT', 'CHI')",Providence,nai64.xml,415,16,1,CHI,5457,2737,MOT
1,4,9,401,2.607615804,405,4,was,"('MOT', 'CHI')",Providence,nai64.xml,415,10,1,CHI,5457,2737,MOT
3,6,13,393,2.543973881,399,6,he,"('MOT', 'CHI')",Providence,nai64.xml,415,16,3,CHI,5457,2737,MOT
3,5,20,387,2.352009976,392,5,on,"('MOT', 'CHI')",Providence,nai64.xml,415,23,3,CHI,5457,2737,MOT
0,2,12,401,2.266217449,403,2,can,"('MOT', 'CHI')",Providence,nai64.xml,415,12,0,CHI,5457,2737,MOT
2,11,7,395,2.22707754,406,11,she,"('MOT', 'CHI')",Providence,nai64.xml,415,9,2,CHI,5457,2737,MOT
0,1,21,393,2.152772815,394,1,we,"('MOT', 'CHI')",Providence,nai64.xml,415,21,0,CHI,5457,2737,MOT
1,6,11,397,2.112066769,403,6,wanna,"('MOT', 'CHI')",Providence,nai64.xml,415,12,1,CHI,5457,2737,MOT
0,1,22,392,2.107684754,393,1,think,"('MOT', 'CHI')",Providence,nai64.xml,415,22,0,CHI,5457,2737,MOT
1,6,12,396,2.040601708,402,6,put,"('MOT', 'CHI')",Providence,nai64.xml,415,13,1,CHI,5457,2737,MOT
0,5,7,403,2.027173113,408,5,my,"('MOT', 'CHI')",Providence,nai64.xml,415,7,0,CHI,5457,2737,MOT
2,1,67,345,1.994987711,346,1,oh,"('MOT', 'CHI')",Providence,nai64.xml,415,69,2,CHI,5457,2737,MOT
0,3,12,400,1.978535376,403,3,go,"('MOT', 'CHI')",Providence,nai64.xml,415,12,0,CHI,5457,2737,MOT
1,4,19,391,1.976603095,395,4,have,"('MOT', 'CHI')",Providence,nai64.xml,415,20,1,CHI,5457,2737,MOT
0,3,13,399,1.907070316,402,3,with,"('MOT', 'CHI')",Providence,nai64.xml,415,13,0,CHI,5457,2737,MOT
0,5,11,399,1.649644333,404,5,up,"('MOT', 'CHI')",Providence,nai64.xml,415,11,0,CHI,5457,2737,MOT
1,5,24,385,1.576812685,390,5,of,"('MOT', 'CHI')",Providence,nai64.xml,415,25,1,CHI,5457,2737,MOT
6,11,40,358,1.506004551,369,11,in,"('MOT', 'CHI')",Providence,nai64.xml,415,46,6,CHI,5457,2737,MOT
0,5,14,396,1.43458837,401,5,want,"('MOT', 'CHI')",Providence,nai64.xml,415,14,0,CHI,5457,2737,MOT
0,8,9,398,1.416147324,406,8,look,"('MOT', 'CHI')",Providence,nai64.xml,415,9,0,CHI,5457,2737,MOT
5,12,39,359,1.319747135,371,12,it,"('MOT', 'CHI')",Providence,nai64.xml,415,44,5,CHI,5457,2737,MOT
1,10,17,387,1.288481051,397,10,they,"('MOT', 'CHI')",Providence,nai64.xml,415,18,1,CHI,5457,2737,MOT
3,38,7,367,1.246639251,405,38,no,"('MOT', 'CHI')",Providence,nai64.xml,415,10,3,CHI,5457,2737,MOT
6,19,31,359,1.226787482,378,19,what,"('MOT', 'CHI')",Providence,nai64.xml,415,37,6,CHI,5457,2737,MOT
6,31,19,359,1.15559922,390,31,one,"('MOT', 'CHI')",Providence,nai64.xml,415,25,6,CHI,5457,2737,MOT
1,10,20,384,1.141171903,394,10,gonna,"('MOT', 'CHI')",Providence,nai64.xml,415,21,1,CHI,5457,2737,MOT
0,8,13,394,1.0961401,402,8,at,"('MOT', 'CHI')",Providence,nai64.xml,415,13,0,CHI,5457,2737,MOT
2,7,45,361,1.040853455,368,7,do,"('MOT', 'CHI')",Providence,nai64.xml,415,47,2,CHI,5457,2737,MOT
0,5,24,386,0.923953605,391,5,little,"('MOT', 'CHI')",Providence,nai64.xml,415,24,0,CHI,5457,2737,MOT
1,8,31,375,0.922805413,383,8,see,"('MOT', 'CHI')",Providence,nai64.xml,415,32,1,CHI,5457,2737,MOT
2,12,33,368,0.868165627,380,12,there,"('MOT', 'CHI')",Providence,nai64.xml,415,35,2,CHI,5457,2737,MOT
7,22,46,340,0.833768008,362,22,is,"('MOT', 'CHI')",Providence,nai64.xml,415,53,7,CHI,5457,2737,MOT
9,23,62,321,0.680510597,344,23,a,"('MOT', 'CHI')",Providence,nai64.xml,415,71,9,CHI,5457,2737,MOT
11,27,62,315,0.675855683,342,27,to,"('MOT', 'CHI')",Providence,nai64.xml,415,73,11,CHI,5457,2737,MOT
0,8,26,381,0.439278472,389,8,for,"('MOT', 'CHI')",Providence,nai64.xml,415,26,0,CHI,5457,2737,MOT
1,9,46,359,0.412244795,368,9,that,"('MOT', 'CHI')",Providence,nai64.xml,415,47,1,CHI,5457,2737,MOT
15,29,93,278,0.404252252,307,29,the,"('MOT', 'CHI')",Providence,nai64.xml,415,108,15,CHI,5457,2737,MOT
3,31,28,353,0.379888266,384,31,this,"('MOT', 'CHI')",Providence,nai64.xml,415,31,3,CHI,5457,2737,MOT
2,15,47,351,0.302280872,366,15,are,"('MOT', 'CHI')",Providence,nai64.xml,415,49,2,CHI,5457,2737,MOT
4,15,100,296,-0.080386713,311,15,you,"('MOT', 'CHI')",Providence,nai64.xml,415,104,4,CHI,5457,2737,MOT
2,23,48,342,-0.125323412,365,23,and,"('MOT', 'CHI')",Providence,nai64.xml,415,50,2,CHI,5457,2737,MOT
0,43,12,360,-0.419359896,403,43,yeah,"('MOT', 'CHI')",Providence,nai64.xml,415,12,0,CHI,5457,2737,MOT
0,1,5,322,3.144767853,323,1,make,"('MOT', 'CHI')",Providence,nai65.xml,328,5,0,CHI,5265,1640,MOT
0,1,7,320,2.887280565,321,1,all,"('MOT', 'CHI')",Providence,nai65.xml,328,7,0,CHI,5265,1640,MOT
1,1,15,311,2.859021228,312,1,go,"('MOT', 'CHI')",Providence,nai65.xml,328,16,1,CHI,5265,1640,MOT
0,1,8,319,2.778819272,320,1,she,"('MOT', 'CHI')",Providence,nai65.xml,328,8,0,CHI,5265,1640,MOT
0,1,12,315,2.429846873,316,1,gonna,"('MOT', 'CHI')",Providence,nai65.xml,328,12,0,CHI,5265,1640,MOT
0,1,12,315,2.429846873,316,1,look,"('MOT', 'CHI')",Providence,nai65.xml,328,12,0,CHI,5265,1640,MOT
3,7,10,308,2.357704392,315,7,want,"('MOT', 'CHI')",Providence,nai65.xml,328,13,3,CHI,5265,1640,MOT
0,1,14,313,2.290006311,314,1,have,"('MOT', 'CHI')",Providence,nai65.xml,328,14,0,CHI,5265,1640,MOT
1,2,18,307,2.289805366,309,2,can,"('MOT', 'CHI')",Providence,nai65.xml,328,19,1,CHI,5265,1640,MOT
1,5,11,311,2.024381764,316,5,where,"('MOT', 'CHI')",Providence,nai65.xml,328,12,1,CHI,5265,1640,MOT
0,3,10,315,1.897119985,318,3,but,"('MOT', 'CHI')",Providence,nai65.xml,328,10,0,CHI,5265,1640,MOT
0,2,14,312,1.884541203,314,2,get,"('MOT', 'CHI')",Providence,nai65.xml,328,14,0,CHI,5265,1640,MOT
0,2,14,312,1.884541203,314,2,little,"('MOT', 'CHI')",Providence,nai65.xml,328,14,0,CHI,5265,1640,MOT
1,5,15,307,1.760408939,312,5,was,"('MOT', 'CHI')",Providence,nai65.xml,328,16,1,CHI,5265,1640,MOT
0,6,6,316,1.755391825,322,6,did,"('MOT', 'CHI')",Providence,nai65.xml,328,6,0,CHI,5265,1640,MOT
0,4,10,314,1.673976434,318,4,not,"('MOT', 'CHI')",Providence,nai65.xml,328,10,0,CHI,5265,1640,MOT
0,2,18,308,1.648658626,310,2,like,"('MOT', 'CHI')",Providence,nai65.xml,328,18,0,CHI,5265,1640,MOT
2,6,23,297,1.57717705,303,6,are,"('MOT', 'CHI')",Providence,nai65.xml,328,25,2,CHI,5265,1640,MOT
0,7,7,314,1.500986204,321,7,they,"('MOT', 'CHI')",Providence,nai65.xml,328,7,0,CHI,5265,1640,MOT
0,2,21,305,1.499234772,307,2,for,"('MOT', 'CHI')",Providence,nai65.xml,328,21,0,CHI,5265,1640,MOT
0,3,17,308,1.41546985,311,3,put,"('MOT', 'CHI')",Providence,nai65.xml,328,17,0,CHI,5265,1640,MOT
1,7,16,304,1.41546985,311,7,one,"('MOT', 'CHI')",Providence,nai65.xml,328,17,1,CHI,5265,1640,MOT
2,7,25,294,1.365607723,301,7,this,"('MOT', 'CHI')",Providence,nai65.xml,328,27,2,CHI,5265,1640,MOT
6,8,47,267,1.365369893,275,8,in,"('MOT', 'CHI')",Providence,nai65.xml,328,53,6,CHI,5265,1640,MOT
0,4,16,308,1.249583316,312,4,up,"('MOT', 'CHI')",Providence,nai65.xml,328,16,0,CHI,5265,1640,MOT
1,8,17,302,1.243193517,310,8,he,"('MOT', 'CHI')",Providence,nai65.xml,328,18,1,CHI,5265,1640,MOT
0,1,43,284,1.159672545,285,1,see,"('MOT', 'CHI')",Providence,nai65.xml,328,43,0,CHI,5265,1640,MOT
0,3,23,302,1.121677562,305,3,with,"('MOT', 'CHI')",Providence,nai65.xml,328,23,0,CHI,5265,1640,MOT
0,3,23,302,1.121677562,305,3,on,"('MOT', 'CHI')",Providence,nai65.xml,328,23,0,CHI,5265,1640,MOT
1,7,22,298,1.121677562,305,7,wanna,"('MOT', 'CHI')",Providence,nai65.xml,328,23,1,CHI,5265,1640,MOT
2,9,27,290,1.069150256,299,9,it,"('MOT', 'CHI')",Providence,nai65.xml,328,29,2,CHI,5265,1640,MOT
3,5,57,263,1.065822466,268,5,that,"('MOT', 'CHI')",Providence,nai65.xml,328,60,3,CHI,5265,1640,MOT
0,1,47,280,1.060479419,281,1,do,"('MOT', 'CHI')",Providence,nai65.xml,328,47,0,CHI,5265,1640,MOT
0,3,27,298,0.960142614,301,3,we,"('MOT', 'CHI')",Providence,nai65.xml,328,27,0,CHI,5265,1640,MOT
0,2,39,287,0.861138912,289,2,oh,"('MOT', 'CHI')",Providence,nai65.xml,328,39,0,CHI,5265,1640,MOT
1,31,6,290,0.807839024,321,31,no,"('MOT', 'CHI')",Providence,nai65.xml,328,7,1,CHI,5265,1640,MOT
15,16,90,207,0.682646946,223,16,the,"('MOT', 'CHI')",Providence,nai65.xml,328,105,15,CHI,5265,1640,MOT
4,14,47,263,0.56230758,277,14,is,"('MOT', 'CHI')",Providence,nai65.xml,328,51,4,CHI,5265,1640,MOT
1,11,32,284,0.346624608,295,11,what,"('MOT', 'CHI')",Providence,nai65.xml,328,33,1,CHI,5265,1640,MOT
0,5,36,287,0.254234138,292,5,of,"('MOT', 'CHI')",Providence,nai65.xml,328,36,0,CHI,5265,1640,MOT
1,6,59,262,0.218524605,268,6,and,"('MOT', 'CHI')",Providence,nai65.xml,328,60,1,CHI,5265,1640,MOT
0,6,34,288,0.160930367,294,6,there,"('MOT', 'CHI')",Providence,nai65.xml,328,34,0,CHI,5265,1640,MOT
2,6,95,225,0.008620743,231,6,you,"('MOT', 'CHI')",Providence,nai65.xml,328,97,2,CHI,5265,1640,MOT
6,22,88,212,-0.290100453,234,22,a,"('MOT', 'CHI')",Providence,nai65.xml,328,94,6,CHI,5265,1640,MOT
1,17,44,266,-0.394882999,283,17,to,"('MOT', 'CHI')",Providence,nai65.xml,328,45,1,CHI,5265,1640,MOT
0,34,15,279,-0.635988767,313,34,yeah,"('MOT', 'CHI')",Providence,nai65.xml,328,15,0,CHI,5265,1640,MOT
1,1,7,314,3.456316681,315,1,at,"('MOT', 'CHI')",Providence,nai66.xml,323,8,1,CHI,4393,2119,MOT
1,1,9,312,3.267665989,313,1,get,"('MOT', 'CHI')",Providence,nai66.xml,323,10,1,CHI,4393,2119,MOT
0,1,7,315,2.871679625,316,1,my,"('MOT', 'CHI')",Providence,nai66.xml,323,7,0,CHI,4393,2119,MOT
5,5,12,301,2.785660804,306,5,he,"('MOT', 'CHI')",Providence,nai66.xml,323,17,5,CHI,4393,2119,MOT
0,1,8,314,2.7631695,315,1,look,"('MOT', 'CHI')",Providence,nai66.xml,323,8,0,CHI,4393,2119,MOT
0,1,8,314,2.7631695,315,1,all,"('MOT', 'CHI')",Providence,nai66.xml,323,8,0,CHI,4393,2119,MOT
4,2,26,291,2.732065077,293,2,think,"('MOT', 'CHI')",Providence,nai66.xml,323,30,4,CHI,4393,2119,MOT
1,2,11,309,2.701680753,311,2,they,"('MOT', 'CHI')",Providence,nai66.xml,323,12,1,CHI,4393,2119,MOT
1,4,6,312,2.648536074,316,4,wanna,"('MOT', 'CHI')",Providence,nai66.xml,323,7,1,CHI,4393,2119,MOT
1,4,7,311,2.540025949,315,4,was,"('MOT', 'CHI')",Providence,nai66.xml,323,8,1,CHI,4393,2119,MOT
4,2,36,281,2.425645186,283,2,in,"('MOT', 'CHI')",Providence,nai66.xml,323,40,4,CHI,4393,2119,MOT
2,4,13,304,2.39253333,308,4,one,"('MOT', 'CHI')",Providence,nai66.xml,323,15,2,CHI,4393,2119,MOT
1,2,16,304,2.380195696,306,2,can,"('MOT', 'CHI')",Providence,nai66.xml,323,17,1,CHI,4393,2119,MOT
0,2,8,313,2.357704392,315,2,up,"('MOT', 'CHI')",Providence,nai66.xml,323,8,0,CHI,4393,2119,MOT
2,4,15,302,2.27483518,306,4,like,"('MOT', 'CHI')",Providence,nai66.xml,323,17,2,CHI,4393,2119,MOT
1,2,18,302,2.273597556,304,2,for,"('MOT', 'CHI')",Providence,nai66.xml,323,19,1,CHI,4393,2119,MOT
0,2,10,311,2.1690537,313,2,little,"('MOT', 'CHI')",Providence,nai66.xml,323,10,0,CHI,4393,2119,MOT
0,3,8,312,2.07002232,315,3,did,"('MOT', 'CHI')",Providence,nai66.xml,323,8,0,CHI,4393,2119,MOT
0,1,18,304,2.037968293,305,1,put,"('MOT', 'CHI')",Providence,nai66.xml,323,18,0,CHI,4393,2119,MOT
1,2,24,296,2.002480501,298,2,there,"('MOT', 'CHI')",Providence,nai66.xml,323,25,1,CHI,4393,2119,MOT
2,5,18,298,1.936122143,303,5,gonna,"('MOT', 'CHI')",Providence,nai66.xml,323,20,2,CHI,4393,2119,MOT
2,3,30,288,1.866130012,291,3,do,"('MOT', 'CHI')",Providence,nai66.xml,323,32,2,CHI,4393,2119,MOT
2,7,14,300,1.862140266,307,7,want,"('MOT', 'CHI')",Providence,nai66.xml,323,16,2,CHI,4393,2119,MOT
2,5,20,296,1.842531795,301,5,have,"('MOT', 'CHI')",Providence,nai66.xml,323,22,2,CHI,4393,2119,MOT
1,3,22,297,1.798404012,300,3,see,"('MOT', 'CHI')",Providence,nai66.xml,323,23,1,CHI,4393,2119,MOT
3,7,21,292,1.755866546,299,7,with,"('MOT', 'CHI')",Providence,nai66.xml,323,24,3,CHI,4393,2119,MOT
17,11,56,239,1.617406082,250,11,it,"('MOT', 'CHI')",Providence,nai66.xml,323,73,17,CHI,4393,2119,MOT
0,3,14,306,1.580909829,309,3,we,"('MOT', 'CHI')",Providence,nai66.xml,323,14,0,CHI,4393,2119,MOT
1,5,19,298,1.530657035,303,5,on,"('MOT', 'CHI')",Providence,nai66.xml,323,20,1,CHI,4393,2119,MOT
7,10,45,261,1.302034018,271,10,to,"('MOT', 'CHI')",Providence,nai66.xml,323,52,7,CHI,4393,2119,MOT
1,7,20,295,1.195239124,302,7,are,"('MOT', 'CHI')",Providence,nai66.xml,323,21,1,CHI,4393,2119,MOT
3,23,11,286,1.175444721,309,23,this,"('MOT', 'CHI')",Providence,nai66.xml,323,14,3,CHI,4393,2119,MOT
3,8,35,277,1.159672545,285,8,and,"('MOT', 'CHI')",Providence,nai66.xml,323,38,3,CHI,4393,2119,MOT
3,9,34,277,1.083108102,286,9,of,"('MOT', 'CHI')",Providence,nai66.xml,323,37,3,CHI,4393,2119,MOT
3,40,7,273,0.940388283,313,40,no,"('MOT', 'CHI')",Providence,nai66.xml,323,10,3,CHI,4393,2119,MOT
4,22,22,275,0.84218276,297,22,is,"('MOT', 'CHI')",Providence,nai66.xml,323,26,4,CHI,4393,2119,MOT
0,5,20,298,0.837509854,303,5,not,"('MOT', 'CHI')",Providence,nai66.xml,323,20,0,CHI,4393,2119,MOT
3,39,9,272,0.804560768,311,39,yeah,"('MOT', 'CHI')",Providence,nai66.xml,323,12,3,CHI,4393,2119,MOT
7,34,27,255,0.613897809,289,34,what,"('MOT', 'CHI')",Providence,nai66.xml,323,34,7,CHI,4393,2119,MOT
0,7,21,295,0.502091944,302,7,some,"('MOT', 'CHI')",Providence,nai66.xml,323,21,0,CHI,4393,2119,MOT
6,19,52,246,0.443081972,265,19,that,"('MOT', 'CHI')",Providence,nai66.xml,323,58,6,CHI,4393,2119,MOT
8,18,67,230,0.430441094,248,18,a,"('MOT', 'CHI')",Providence,nai66.xml,323,75,8,CHI,4393,2119,MOT
8,17,72,226,0.401391783,243,17,the,"('MOT', 'CHI')",Providence,nai66.xml,323,80,8,CHI,4393,2119,MOT
8,16,78,221,0.363137971,237,16,you,"('MOT', 'CHI')",Providence,nai66.xml,323,86,8,CHI,4393,2119,MOT
0,1,3,268,3.299533728,269,1,make,"('MOT', 'CHI')",Providence,nai67.xml,272,3,0,CHI,3750,1589,MOT
0,1,3,268,3.299533728,269,1,they,"('MOT', 'CHI')",Providence,nai67.xml,272,3,0,CHI,3750,1589,MOT
1,0,16,255,3.297784286,255,0,little,"('MOT', 'CHI')",Providence,nai67.xml,272,17,1,CHI,3750,1589,MOT
1,0,19,252,3.139438994,252,0,with,"('MOT', 'CHI')",Providence,nai67.xml,272,20,1,CHI,3750,1589,MOT
0,1,4,267,3.113515309,268,1,all,"('MOT', 'CHI')",Providence,nai67.xml,272,4,0,CHI,3750,1589,MOT
0,1,4,267,3.113515309,268,1,at,"('MOT', 'CHI')",Providence,nai67.xml,272,4,0,CHI,3750,1589,MOT
1,1,9,261,3.091042453,262,1,she,"('MOT', 'CHI')",Providence,nai67.xml,272,10,1,CHI,3750,1589,MOT
1,3,4,264,2.95565405,267,3,big,"('MOT', 'CHI')",Providence,nai67.xml,272,5,1,CHI,3750,1589,MOT
1,0,0,21,2.730029108,21,0,in,"('MOT', 'FAT')",Providence,nai67.xml,22,1,1,FAT,289,196,MOT
1,0,0,21,2.730029108,21,0,this,"('MOT', 'FAT')",Providence,nai67.xml,22,1,1,FAT,289,196,MOT
9,9,8,246,2.604637106,255,9,he,"('MOT', 'CHI')",Providence,nai67.xml,272,17,9,CHI,3750,1589,MOT
4,6,10,252,2.451620672,258,6,want,"('MOT', 'CHI')",Providence,nai67.xml,272,14,4,CHI,3750,1589,MOT
1,0,1,20,2.397895273,20,0,did,"('MOT', 'FAT')",Providence,nai67.xml,22,2,1,FAT,289,196,MOT
1,0,1,20,2.397895273,20,0,is,"('MOT', 'FAT')",Providence,nai67.xml,22,2,1,FAT,289,196,MOT
1,2,20,249,1.992430165,251,2,some,"('MOT', 'CHI')",Providence,nai67.xml,272,21,1,CHI,3750,1589,MOT
0,4,6,262,1.902107526,266,4,up,"('MOT', 'CHI')",Providence,nai67.xml,272,6,0,CHI,3750,1589,MOT
1,9,5,257,1.902107526,266,9,where,"('MOT', 'CHI')",Providence,nai67.xml,272,6,1,CHI,3750,1589,MOT
0,4,8,260,1.671473303,264,4,but,"('MOT', 'CHI')",Providence,nai67.xml,272,8,0,CHI,3750,1589,MOT
0,3,11,258,1.620910314,261,3,did,"('MOT', 'CHI')",Providence,nai67.xml,272,11,0,CHI,3750,1589,MOT
0,3,11,258,1.620910314,261,3,my,"('MOT', 'CHI')",Providence,nai67.xml,272,11,0,CHI,3750,1589,MOT
2,6,18,246,1.598993953,252,6,of,"('MOT', 'CHI')",Providence,nai67.xml,272,20,2,CHI,3750,1589,MOT
0,7,5,260,1.569359689,267,7,not,"('MOT', 'CHI')",Providence,nai67.xml,272,5,0,CHI,3750,1589,MOT
1,0,0,5,1.540445041,5,0,what,"('CHI', 'FAT')",Providence,nai67.xml,6,1,1,FAT,43,89,CHI
1,0,0,5,1.540445041,5,0,a,"('CHI', 'FAT')",Providence,nai67.xml,6,1,1,FAT,43,89,CHI
1,0,0,5,1.540445041,5,0,do,"('CHI', 'FAT')",Providence,nai67.xml,6,1,1,FAT,43,89,CHI
3,7,22,240,1.52846885,247,7,there,"('MOT', 'CHI')",Providence,nai67.xml,272,25,3,CHI,3750,1589,MOT
4,7,28,233,1.492573572,240,7,in,"('MOT', 'CHI')",Providence,nai67.xml,272,32,4,CHI,3750,1589,MOT
1,6,16,249,1.351874137,255,6,can,"('MOT', 'CHI')",Providence,nai67.xml,272,17,1,CHI,3750,1589,MOT
1,4,23,244,1.347073648,248,4,on,"('MOT', 'CHI')",Providence,nai67.xml,272,24,1,CHI,3750,1589,MOT
1,3,0,18,1.343734747,21,3,gonna,"('MOT', 'FAT')",Providence,nai67.xml,22,1,1,FAT,289,196,MOT
0,1,1,20,1.343734747,21,1,like,"('MOT', 'FAT')",Providence,nai67.xml,22,1,0,FAT,289,196,MOT
0,1,1,20,1.343734747,21,1,there,"('MOT', 'FAT')",Providence,nai67.xml,22,1,0,FAT,289,196,MOT
0,1,1,20,1.343734747,21,1,some,"('MOT', 'FAT')",Providence,nai67.xml,22,1,0,FAT,289,196,MOT
0,1,1,20,1.343734747,21,1,can,"('MOT', 'FAT')",Providence,nai67.xml,22,1,0,FAT,289,196,MOT
0,1,1,20,1.343734747,21,1,at,"('MOT', 'FAT')",Providence,nai67.xml,22,1,0,FAT,289,196,MOT
0,1,1,20,1.343734747,21,1,do,"('MOT', 'FAT')",Providence,nai67.xml,22,1,0,FAT,289,196,MOT
1,5,20,246,1.299282984,251,5,what,"('MOT', 'CHI')",Providence,nai67.xml,272,21,1,CHI,3750,1589,MOT
1,0,1,5,1.252762968,5,0,it,"('FAT', 'CHI')",Providence,nai67.xml,7,2,1,CHI,61,31,FAT
1,1,3,17,1.203972804,18,1,a,"('MOT', 'FAT')",Providence,nai67.xml,22,4,1,FAT,289,196,MOT
10,11,48,203,1.193922468,214,11,to,"('MOT', 'CHI')",Providence,nai67.xml,272,58,10,CHI,3750,1589,MOT
1,11,11,249,1.137527705,260,11,wanna,"('MOT', 'CHI')",Providence,nai67.xml,272,12,1,CHI,3750,1589,MOT
0,5,12,255,1.137527705,260,5,one,"('MOT', 'CHI')",Providence,nai67.xml,272,12,0,CHI,3750,1589,MOT
0,4,15,253,1.114176805,257,4,was,"('MOT', 'CHI')",Providence,nai67.xml,272,15,0,CHI,3750,1589,MOT
1,29,3,239,1.098612289,268,29,no,"('MOT', 'CHI')",Providence,nai67.xml,272,4,1,CHI,3750,1589,MOT
0,6,11,255,1.061294526,261,6,for,"('MOT', 'CHI')",Providence,nai67.xml,272,11,0,CHI,3750,1589,MOT
3,5,47,217,1.054937225,222,5,that,"('MOT', 'CHI')",Providence,nai67.xml,272,50,3,CHI,3750,1589,MOT
0,1,2,19,1.011600912,20,1,that,"('MOT', 'FAT')",Providence,nai67.xml,22,2,0,FAT,289,196,MOT
0,5,14,253,0.99633344,258,5,gonna,"('MOT', 'CHI')",Providence,nai67.xml,272,14,0,CHI,3750,1589,MOT
0,4,17,251,0.995199193,255,4,go,"('MOT', 'CHI')",Providence,nai67.xml,272,17,0,CHI,3750,1589,MOT
0,6,12,254,0.983377025,260,6,put,"('MOT', 'CHI')",Providence,nai67.xml,272,12,0,CHI,3750,1589,MOT
7,14,38,213,0.954965742,227,14,a,"('MOT', 'CHI')",Providence,nai67.xml,272,45,7,CHI,3750,1589,MOT
0,2,1,19,0.938269639,21,2,go,"('MOT', 'FAT')",Providence,nai67.xml,22,1,0,FAT,289,196,MOT
1,6,26,239,0.889329538,245,6,like,"('MOT', 'CHI')",Providence,nai67.xml,272,27,1,CHI,3750,1589,MOT
1,1,0,4,0.84729786,5,1,gonna,"('CHI', 'FAT')",Providence,nai67.xml,6,1,1,FAT,43,89,CHI
3,14,25,230,0.782378314,244,14,is,"('MOT', 'CHI')",Providence,nai67.xml,272,28,3,CHI,3750,1589,MOT
3,18,20,231,0.748432496,249,18,this,"('MOT', 'CHI')",Providence,nai67.xml,272,23,3,CHI,3750,1589,MOT
1,3,2,16,0.741937345,19,3,have,"('MOT', 'FAT')",Providence,nai67.xml,22,3,1,FAT,289,196,MOT
0,1,3,18,0.741937345,19,1,on,"('MOT', 'FAT')",Providence,nai67.xml,22,3,0,FAT,289,196,MOT
0,4,22,246,0.741937345,250,4,do,"('MOT', 'CHI')",Providence,nai67.xml,272,22,0,CHI,3750,1589,MOT
0,2,2,18,0.606135804,20,2,we,"('MOT', 'FAT')",Providence,nai67.xml,22,2,0,FAT,289,196,MOT
0,5,23,244,0.514817645,249,5,see,"('MOT', 'CHI')",Providence,nai67.xml,272,23,0,CHI,3750,1589,MOT
1,7,35,229,0.448390153,236,7,and,"('MOT', 'CHI')",Providence,nai67.xml,272,36,1,CHI,3750,1589,MOT
9,17,62,184,0.434959873,201,17,the,"('MOT', 'CHI')",Providence,nai67.xml,272,71,9,CHI,3750,1589,MOT
0,4,1,17,0.427444015,21,4,see,"('MOT', 'FAT')",Providence,nai67.xml,22,1,0,FAT,289,196,MOT
3,4,4,11,0.412845215,15,4,you,"('MOT', 'FAT')",Providence,nai67.xml,22,7,3,FAT,289,196,MOT
1,1,1,3,0.405465108,4,1,you,"('CHI', 'FAT')",Providence,nai67.xml,6,2,1,FAT,43,89,CHI
0,2,3,17,0.336472237,19,2,to,"('MOT', 'FAT')",Providence,nai67.xml,22,3,0,FAT,289,196,MOT
0,1,5,16,0.30538165,17,1,but,"('MOT', 'FAT')",Providence,nai67.xml,22,5,0,FAT,289,196,MOT
0,1,5,16,0.30538165,17,1,and,"('MOT', 'FAT')",Providence,nai67.xml,22,5,0,FAT,289,196,MOT
1,7,40,224,0.303543977,231,7,it,"('MOT', 'CHI')",Providence,nai67.xml,272,41,1,CHI,3750,1589,MOT
0,1,1,5,0.287682072,6,1,the,"('FAT', 'CHI')",Providence,nai67.xml,7,1,0,CHI,61,31,FAT
0,1,1,5,0.287682072,6,1,and,"('FAT', 'CHI')",Providence,nai67.xml,7,1,0,CHI,61,31,FAT
0,1,1,4,0.15415068,5,1,there,"('CHI', 'FAT')",Providence,nai67.xml,6,1,0,FAT,43,89,CHI
5,9,91,167,0.085990448,176,9,you,"('MOT', 'CHI')",Providence,nai67.xml,272,96,5,CHI,3750,1589,MOT
0,5,2,15,-0.087011377,20,5,yeah,"('MOT', 'FAT')",Providence,nai67.xml,22,2,0,FAT,289,196,MOT
1,38,12,221,-0.113944259,259,38,yeah,"('MOT', 'CHI')",Providence,nai67.xml,272,13,1,CHI,3750,1589,MOT
1,2,2,2,-0.223143551,4,2,is,"('FAT', 'CHI')",Providence,nai67.xml,7,3,1,CHI,61,31,FAT
1,0,10,286,3.791158303,286,0,she,"('MOT', 'CHI')",Providence,nai68.xml,297,11,1,CHI,4947,1903,MOT
0,1,2,294,3.614290597,295,1,make,"('MOT', 'CHI')",Providence,nai68.xml,297,2,0,CHI,4947,1903,MOT
2,1,8,286,3.586985146,287,1,little,"('MOT', 'CHI')",Providence,nai68.xml,297,10,2,CHI,4947,1903,MOT
2,1,10,284,3.425889994,285,1,up,"('MOT', 'CHI')",Providence,nai68.xml,297,12,2,CHI,4947,1903,MOT
2,2,10,283,3.020424886,285,2,look,"('MOT', 'CHI')",Providence,nai68.xml,297,12,2,CHI,4947,1903,MOT
1,2,8,286,2.866520542,288,2,they,"('MOT', 'CHI')",Providence,nai68.xml,297,9,1,CHI,4947,1903,MOT
2,1,23,271,2.722756348,272,1,there,"('MOT', 'CHI')",Providence,nai68.xml,297,25,2,CHI,4947,1903,MOT
3,3,14,277,2.697468092,280,3,put,"('MOT', 'CHI')",Providence,nai68.xml,297,17,3,CHI,4947,1903,MOT
5,4,16,272,2.674448455,276,4,he,"('MOT', 'CHI')",Providence,nai68.xml,297,21,5,CHI,4947,1903,MOT
2,3,11,281,2.660259537,284,3,get,"('MOT', 'CHI')",Providence,nai68.xml,297,13,2,CHI,4947,1903,MOT
1,2,12,282,2.542476502,284,2,have,"('MOT', 'CHI')",Providence,nai68.xml,297,13,1,CHI,4947,1903,MOT
2,3,14,278,2.467393067,281,3,want,"('MOT', 'CHI')",Providence,nai68.xml,297,16,2,CHI,4947,1903,MOT
0,1,13,283,2.254794429,284,1,some,"('MOT', 'CHI')",Providence,nai68.xml,297,13,0,CHI,4947,1903,MOT
0,1,14,282,2.186753277,283,1,see,"('MOT', 'CHI')",Providence,nai68.xml,297,14,0,CHI,4947,1903,MOT
3,3,27,264,2.128975477,267,3,think,"('MOT', 'CHI')",Providence,nai68.xml,297,30,3,CHI,4947,1903,MOT
2,2,29,264,2.094479419,266,2,on,"('MOT', 'CHI')",Providence,nai68.xml,297,31,2,CHI,4947,1903,MOT
1,3,15,278,2.061927959,281,3,for,"('MOT', 'CHI')",Providence,nai68.xml,297,16,1,CHI,4947,1903,MOT
0,2,11,284,1.999398834,286,2,but,"('MOT', 'CHI')",Providence,nai68.xml,297,11,0,CHI,4947,1903,MOT
3,5,20,269,1.996059933,274,5,are,"('MOT', 'CHI')",Providence,nai68.xml,297,23,3,CHI,4947,1903,MOT
2,10,7,278,1.972702666,288,10,wanna,"('MOT', 'CHI')",Providence,nai68.xml,297,9,2,CHI,4947,1903,MOT
1,4,13,279,1.963609726,283,4,did,"('MOT', 'CHI')",Providence,nai68.xml,297,14,1,CHI,4947,1903,MOT
4,3,43,247,1.860752341,250,3,in,"('MOT', 'CHI')",Providence,nai68.xml,297,47,4,CHI,4947,1903,MOT
0,2,13,282,1.849329321,284,2,all,"('MOT', 'CHI')",Providence,nai68.xml,297,13,0,CHI,4947,1903,MOT
0,2,13,282,1.849329321,284,2,at,"('MOT', 'CHI')",Providence,nai68.xml,297,13,0,CHI,4947,1903,MOT
3,8,16,270,1.779336949,278,8,go,"('MOT', 'CHI')",Providence,nai68.xml,297,19,3,CHI,4947,1903,MOT
2,3,32,260,1.708528815,263,3,of,"('MOT', 'CHI')",Providence,nai68.xml,297,34,2,CHI,4947,1903,MOT
2,9,13,273,1.61178809,282,9,one,"('MOT', 'CHI')",Providence,nai68.xml,297,15,2,CHI,4947,1903,MOT
0,3,13,281,1.561647249,284,3,can,"('MOT', 'CHI')",Providence,nai68.xml,297,13,0,CHI,4947,1903,MOT
2,7,19,269,1.511297645,276,7,gonna,"('MOT', 'CHI')",Providence,nai68.xml,297,21,2,CHI,4947,1903,MOT
1,2,37,257,1.470175845,259,2,with,"('MOT', 'CHI')",Providence,nai68.xml,297,38,1,CHI,4947,1903,MOT
3,4,46,244,1.366491734,248,4,and,"('MOT', 'CHI')",Providence,nai68.xml,297,49,3,CHI,4947,1903,MOT
0,2,23,272,1.302912752,274,2,we,"('MOT', 'CHI')",Providence,nai68.xml,297,23,0,CHI,4947,1903,MOT
1,5,22,269,1.302912752,274,5,like,"('MOT', 'CHI')",Providence,nai68.xml,297,23,1,CHI,4947,1903,MOT
5,12,28,252,1.254958359,264,12,what,"('MOT', 'CHI')",Providence,nai68.xml,297,33,5,CHI,4947,1903,MOT
1,24,6,266,0.953800581,290,24,no,"('MOT', 'CHI')",Providence,nai68.xml,297,7,1,CHI,4947,1903,MOT
9,16,46,226,0.923488706,242,16,it,"('MOT', 'CHI')",Providence,nai68.xml,297,55,9,CHI,4947,1903,MOT
2,22,11,262,0.911059682,284,22,yeah,"('MOT', 'CHI')",Providence,nai68.xml,297,13,2,CHI,4947,1903,MOT
0,6,15,276,0.869850745,282,6,was,"('MOT', 'CHI')",Providence,nai68.xml,297,15,0,CHI,4947,1903,MOT
1,10,19,267,0.835421236,277,10,not,"('MOT', 'CHI')",Providence,nai68.xml,297,20,1,CHI,4947,1903,MOT
19,21,65,192,0.820980552,213,21,the,"('MOT', 'CHI')",Providence,nai68.xml,297,84,19,CHI,4947,1903,MOT
1,14,15,267,0.740172119,281,14,where,"('MOT', 'CHI')",Providence,nai68.xml,297,16,1,CHI,4947,1903,MOT
7,15,50,225,0.718253102,240,15,to,"('MOT', 'CHI')",Providence,nai68.xml,297,57,7,CHI,4947,1903,MOT
1,0,0,1,0.693147181,1,0,this,"('MOT', 'ENV')",Providence,nai68.xml,2,1,1,ENV,55,33,MOT
1,0,0,1,0.693147181,1,0,is,"('MOT', 'ENV')",Providence,nai68.xml,2,1,1,ENV,55,33,MOT
5,9,66,217,0.628060564,226,9,a,"('MOT', 'CHI')",Providence,nai68.xml,297,71,5,CHI,4947,1903,MOT
10,20,54,213,0.623303607,233,20,is,"('MOT', 'CHI')",Providence,nai68.xml,297,64,10,CHI,4947,1903,MOT
1,11,22,263,0.609765572,274,11,do,"('MOT', 'CHI')",Providence,nai68.xml,297,23,1,CHI,4947,1903,MOT
5,29,25,238,0.519537564,267,29,this,"('MOT', 'CHI')",Providence,nai68.xml,297,30,5,CHI,4947,1903,MOT
4,13,78,202,-0.080538862,215,13,you,"('MOT', 'CHI')",Providence,nai68.xml,297,82,4,CHI,4947,1903,MOT
0,5,69,223,-0.616360037,228,5,that,"('MOT', 'CHI')",Providence,nai68.xml,297,69,0,CHI,4947,1903,MOT
1,0,5,189,3.865979067,189,0,he,"('MOT', 'CHI')",Providence,nai69.xml,195,6,1,CHI,2668,1364,MOT
1,0,10,184,3.353944497,184,0,think,"('MOT', 'CHI')",Providence,nai69.xml,195,11,1,CHI,2668,1364,MOT
0,1,2,192,3.193558017,193,1,all,"('MOT', 'CHI')",Providence,nai69.xml,195,2,0,CHI,2668,1364,MOT
0,2,1,192,3.080890082,194,2,little,"('MOT', 'CHI')",Providence,nai69.xml,195,1,0,CHI,2668,1364,MOT
1,4,1,189,2.970414466,193,4,my,"('MOT', 'CHI')",Providence,nai69.xml,195,2,1,CHI,2668,1364,MOT
0,1,3,191,2.965273066,192,1,at,"('MOT', 'CHI')",Providence,nai69.xml,195,3,0,CHI,2668,1364,MOT
2,0,0,17,2.656756907,17,0,of,"('CHI', 'FAT')",Providence,nai69.xml,19,2,2,FAT,107,116,CHI
0,1,5,189,2.618438042,190,1,make,"('MOT', 'CHI')",Providence,nai69.xml,195,5,0,CHI,2668,1364,MOT
0,1,5,189,2.618438042,190,1,up,"('MOT', 'CHI')",Providence,nai69.xml,195,5,0,CHI,2668,1364,MOT
1,0,0,18,2.590267165,18,0,what,"('CHI', 'FAT')",Providence,nai69.xml,19,1,1,FAT,107,116,CHI
0,1,6,188,2.479684706,189,1,we,"('MOT', 'CHI')",Providence,nai69.xml,195,6,0,CHI,2668,1364,MOT
1,0,0,15,2.427748236,15,0,not,"('FAT', 'CHI')",Providence,nai69.xml,16,1,1,CHI,82,77,FAT
2,0,1,16,2.379546134,16,0,it,"('CHI', 'FAT')",Providence,nai69.xml,19,3,2,FAT,107,116,CHI
1,0,2,25,2.379546134,25,0,like,"('MOT', 'FAT')",Providence,nai69.xml,28,3,1,FAT,228,245,MOT
2,3,10,180,2.293616423,183,3,big,"('MOT', 'CHI')",Providence,nai69.xml,195,12,2,CHI,2668,1364,MOT
1,4,5,185,2.256541154,189,4,they,"('MOT', 'CHI')",Providence,nai69.xml,195,6,1,CHI,2668,1364,MOT
1,2,10,182,2.255332208,184,2,go,"('MOT', 'CHI')",Providence,nai69.xml,195,11,1,CHI,2668,1364,MOT
0,1,9,185,2.145399509,186,1,have,"('MOT', 'CHI')",Providence,nai69.xml,195,9,0,CHI,2668,1364,MOT
0,2,1,69,2.093234864,71,2,at,"('CHI', 'MOT')",Providence,nai69.xml,72,1,0,MOT,392,2080,CHI
2,6,6,181,2.091864062,187,6,wanna,"('MOT', 'CHI')",Providence,nai69.xml,195,8,2,CHI,2668,1364,MOT
0,3,4,188,2.084636359,191,3,was,"('MOT', 'CHI')",Providence,nai69.xml,195,4,0,CHI,2668,1364,MOT
0,2,6,187,2.074219598,189,2,not,"('MOT', 'CHI')",Providence,nai69.xml,195,6,0,CHI,2668,1364,MOT
0,1,11,183,1.967650136,184,1,oh,"('MOT', 'CHI')",Providence,nai69.xml,195,11,0,CHI,2668,1364,MOT
1,6,0,65,1.939084184,71,6,some,"('CHI', 'MOT')",Providence,nai69.xml,72,1,1,MOT,392,2080,CHI
1,2,4,65,1.882731247,67,2,want,"('CHI', 'MOT')",Providence,nai69.xml,72,5,1,MOT,392,2080,CHI
0,5,3,187,1.866660777,192,5,did,"('MOT', 'CHI')",Providence,nai69.xml,195,3,0,CHI,2668,1364,MOT
1,0,2,13,1.791759469,13,0,are,"('FAT', 'CHI')",Providence,nai69.xml,16,3,1,CHI,82,77,FAT
1,1,1,21,1.791759469,22,1,are,"('FAT', 'MOT')",Providence,nai69.xml,24,2,1,MOT,145,435,FAT
3,1,3,21,1.791759469,22,1,and,"('MOT', 'FAT')",Providence,nai69.xml,28,6,3,FAT,228,245,MOT
1,4,10,180,1.744506584,184,4,of,"('MOT', 'CHI')",Providence,nai69.xml,195,11,1,CHI,2668,1364,MOT
1,2,0,21,1.714798428,23,2,not,"('FAT', 'MOT')",Providence,nai69.xml,24,1,1,MOT,145,435,FAT
0,5,4,186,1.67917125,191,5,no,"('MOT', 'CHI')",Providence,nai69.xml,195,4,0,CHI,2668,1364,MOT
2,3,0,23,1.658228077,26,3,it,"('MOT', 'FAT')",Providence,nai69.xml,28,2,2,FAT,228,245,MOT
0,2,10,183,1.647589678,185,2,there,"('MOT', 'CHI')",Providence,nai69.xml,195,10,0,CHI,2668,1364,MOT
0,4,1,67,1.58240924,71,4,look,"('CHI', 'MOT')",Providence,nai69.xml,72,1,0,MOT,392,2080,CHI
0,4,1,67,1.58240924,71,4,are,"('CHI', 'MOT')",Providence,nai69.xml,72,1,0,MOT,392,2080,CHI
0,1,1,26,1.575536361,27,1,was,"('MOT', 'FAT')",Providence,nai69.xml,28,1,0,FAT,228,245,MOT
0,1,1,26,1.575536361,27,1,they,"('MOT', 'FAT')",Providence,nai69.xml,28,1,0,FAT,228,245,MOT
0,1,1,26,1.575536361,27,1,some,"('MOT', 'FAT')",Providence,nai69.xml,28,1,0,FAT,228,245,MOT
0,1,1,26,1.575536361,27,1,to,"('MOT', 'FAT')",Providence,nai69.xml,28,1,0,FAT,228,245,MOT
2,2,0,15,1.558144618,17,2,the,"('CHI', 'FAT')",Providence,nai69.xml,19,2,2,FAT,107,116,CHI
3,5,21,166,1.489729948,171,5,do,"('MOT', 'CHI')",Providence,nai69.xml,195,24,3,CHI,2668,1364,MOT
1,10,0,61,1.48709906,71,10,up,"('CHI', 'MOT')",Providence,nai69.xml,72,1,1,MOT,392,2080,CHI
1,5,11,178,1.482686207,183,5,with,"('MOT', 'CHI')",Providence,nai69.xml,195,12,1,CHI,2668,1364,MOT
0,1,1,22,1.427116356,23,1,look,"('FAT', 'MOT')",Providence,nai69.xml,24,1,0,MOT,145,435,FAT
0,1,1,22,1.427116356,23,1,little,"('FAT', 'MOT')",Providence,nai69.xml,24,1,0,MOT,145,435,FAT
4,7,20,164,1.425191427,171,7,on,"('MOT', 'CHI')",Providence,nai69.xml,195,24,4,CHI,2668,1364,MOT
0,5,1,66,1.400087683,71,5,where,"('CHI', 'MOT')",Providence,nai69.xml,72,1,0,MOT,392,2080,CHI
4,14,0,54,1.358123484,68,14,a,"('CHI', 'MOT')",Providence,nai69.xml,72,4,4,MOT,392,2080,CHI
2,7,15,171,1.267688619,178,7,like,"('MOT', 'CHI')",Providence,nai69.xml,195,17,2,CHI,2668,1364,MOT
0,1,2,25,1.252762968,26,1,at,"('MOT', 'FAT')",Providence,nai69.xml,28,2,0,FAT,228,245,MOT
0,1,2,25,1.252762968,26,1,think,"('MOT', 'FAT')",Providence,nai69.xml,28,2,0,FAT,228,245,MOT
2,9,2,59,1.252762968,68,9,for,"('CHI', 'MOT')",Providence,nai69.xml,72,4,2,MOT,392,2080,CHI
1,3,1,23,1.252762968,26,3,a,"('MOT', 'FAT')",Providence,nai69.xml,28,2,1,FAT,228,245,MOT
0,7,5,183,1.232143681,190,7,where,"('MOT', 'CHI')",Providence,nai69.xml,195,5,0,CHI,2668,1364,MOT
0,1,1,17,1.203972804,18,1,like,"('CHI', 'FAT')",Providence,nai69.xml,19,1,0,FAT,107,116,CHI
0,1,1,17,1.203972804,18,1,do,"('CHI', 'FAT')",Providence,nai69.xml,19,1,0,FAT,107,116,CHI
1,6,13,175,1.184134462,181,6,in,"('MOT', 'CHI')",Providence,nai69.xml,195,14,1,CHI,2668,1364,MOT
0,2,1,25,1.170071253,27,2,in,"('MOT', 'FAT')",Providence,nai69.xml,28,1,0,FAT,228,245,MOT
2,16,0,54,1.155770703,70,16,this,"('CHI', 'MOT')",Providence,nai69.xml,72,2,2,MOT,392,2080,CHI
0,5,8,182,1.147402453,187,5,one,"('MOT', 'CHI')",Providence,nai69.xml,195,8,0,CHI,2668,1364,MOT
0,7,1,64,1.112405611,71,7,in,"('CHI', 'MOT')",Providence,nai69.xml,72,1,0,MOT,392,2080,CHI
0,7,1,64,1.112405611,71,7,with,"('CHI', 'MOT')",Providence,nai69.xml,72,1,0,MOT,392,2080,CHI
0,1,2,21,1.098612289,22,1,up,"('FAT', 'MOT')",Providence,nai69.xml,24,2,0,MOT,145,435,FAT
1,6,15,173,1.055362305,179,6,put,"('MOT', 'CHI')",Providence,nai69.xml,195,16,1,CHI,2668,1364,MOT
3,4,2,19,1.049822124,23,4,you,"('MOT', 'FAT')",Providence,nai69.xml,28,5,3,FAT,228,245,MOT
0,1,1,14,1.041453875,15,1,is,"('FAT', 'CHI')",Providence,nai69.xml,16,1,0,CHI,82,77,FAT
0,1,1,14,1.041453875,15,1,no,"('FAT', 'CHI')",Providence,nai69.xml,16,1,0,CHI,82,77,FAT
0,1,1,14,1.041453875,15,1,and,"('FAT', 'CHI')",Providence,nai69.xml,16,1,0,CHI,82,77,FAT
0,2,1,21,1.021651248,23,2,have,"('FAT', 'MOT')",Providence,nai69.xml,24,1,0,MOT,145,435,FAT
0,2,1,21,1.021651248,23,2,but,"('FAT', 'MOT')",Providence,nai69.xml,24,1,0,MOT,145,435,FAT
0,2,1,21,1.021651248,23,2,did,"('FAT', 'MOT')",Providence,nai69.xml,24,1,0,MOT,145,435,FAT
0,2,1,21,1.021651248,23,2,some,"('FAT', 'MOT')",Providence,nai69.xml,24,1,0,MOT,145,435,FAT
0,2,1,21,1.021651248,23,2,at,"('FAT', 'MOT')",Providence,nai69.xml,24,1,0,MOT,145,435,FAT
0,1,3,24,0.993251773,25,1,can,"('MOT', 'FAT')",Providence,nai69.xml,28,3,0,FAT,228,245,MOT
2,3,3,20,0.985283603,23,3,of,"('MOT', 'FAT')",Providence,nai69.xml,28,5,2,FAT,228,245,MOT
1,8,3,60,0.952658376,68,8,there,"('CHI', 'MOT')",Providence,nai69.xml,72,4,1,MOT,392,2080,CHI
0,9,1,62,0.889262059,71,9,like,"('CHI', 'MOT')",Providence,nai69.xml,72,1,0,MOT,392,2080,CHI
0,3,1,24,0.88238918,27,3,we,"('MOT', 'FAT')",Providence,nai69.xml,28,1,0,FAT,228,245,MOT
0,3,1,24,0.88238918,27,3,is,"('MOT', 'FAT')",Providence,nai69.xml,28,1,0,FAT,228,245,MOT
0,3,1,24,0.88238918,27,3,are,"('MOT', 'FAT')",Providence,nai69.xml,28,1,0,FAT,228,245,MOT
0,9,6,180,0.870246793,189,9,want,"('MOT', 'CHI')",Providence,nai69.xml,195,6,0,CHI,2668,1364,MOT
1,6,0,17,0.867500568,23,6,you,"('FAT', 'MOT')",Providence,nai69.xml,24,1,1,MOT,145,435,FAT
0,1,2,16,0.864997437,17,1,no,"('CHI', 'FAT')",Providence,nai69.xml,19,2,0,FAT,107,116,CHI
0,2,2,24,0.84729786,26,2,there,"('MOT', 'FAT')",Providence,nai69.xml,28,2,0,FAT,228,245,MOT
0,2,1,16,0.798507696,18,2,are,"('CHI', 'FAT')",Providence,nai69.xml,19,1,0,FAT,107,116,CHI
0,10,1,61,0.79395188,71,10,put,"('CHI', 'MOT')",Providence,nai69.xml,72,1,0,MOT,392,2080,CHI
0,10,1,61,0.79395188,71,10,think,"('CHI', 'MOT')",Providence,nai69.xml,72,1,0,MOT,392,2080,CHI
2,4,3,19,0.762140052,23,4,the,"('MOT', 'FAT')",Providence,nai69.xml,28,5,2,FAT,228,245,MOT
0,3,6,63,0.753771802,66,3,no,"('CHI', 'MOT')",Providence,nai69.xml,72,6,0,MOT,392,2080,CHI
0,3,1,20,0.733969175,23,3,no,"('FAT', 'MOT')",Providence,nai69.xml,24,1,0,MOT,145,435,FAT
0,3,1,20,0.733969175,23,3,do,"('FAT', 'MOT')",Providence,nai69.xml,24,1,0,MOT,145,435,FAT
2,16,2,52,0.722134717,68,16,it,"('CHI', 'MOT')",Providence,nai69.xml,72,4,2,MOT,392,2080,CHI
0,2,2,20,0.693147181,22,2,in,"('FAT', 'MOT')",Providence,nai69.xml,24,2,0,MOT,145,435,FAT
6,12,36,141,0.640196275,153,12,the,"('MOT', 'CHI')",Providence,nai69.xml,195,42,6,CHI,2668,1364,MOT
1,18,1,52,0.639079959,70,18,to,"('CHI', 'MOT')",Providence,nai69.xml,72,2,1,MOT,392,2080,CHI
0,12,1,59,0.626897795,71,12,we,"('CHI', 'MOT')",Providence,nai69.xml,72,1,0,MOT,392,2080,CHI
0,1,3,15,0.587786665,16,1,yeah,"('CHI', 'FAT')",Providence,nai69.xml,19,3,0,FAT,107,116,CHI
1,15,2,54,0.573800423,69,15,do,"('CHI', 'MOT')",Providence,nai69.xml,72,3,1,MOT,392,2080,CHI
7,26,2,37,0.560096673,63,26,the,"('CHI', 'MOT')",Providence,nai69.xml,72,9,7,MOT,392,2080,CHI
1,17,9,168,0.54897739,185,17,yeah,"('MOT', 'CHI')",Providence,nai69.xml,195,10,1,CHI,2668,1364,MOT
0,4,1,19,0.510825624,23,4,think,"('FAT', 'MOT')",Providence,nai69.xml,24,1,0,MOT,145,435,FAT
3,10,31,151,0.498630351,161,10,it,"('MOT', 'CHI')",Providence,nai69.xml,195,34,3,CHI,2668,1364,MOT
3,9,34,149,0.495321437,158,9,to,"('MOT', 'CHI')",Providence,nai69.xml,195,37,3,CHI,2668,1364,MOT
2,15,4,51,0.46608973,66,15,gonna,"('CHI', 'MOT')",Providence,nai69.xml,72,6,2,MOT,392,2080,CHI
2,21,2,47,0.464305608,68,21,and,"('CHI', 'MOT')",Providence,nai69.xml,72,4,2,MOT,392,2080,CHI
1,2,3,10,0.441832752,12,2,the,"('FAT', 'CHI')",Providence,nai69.xml,16,4,1,CHI,82,77,FAT
0,15,1,56,0.41925843,71,15,of,"('CHI', 'MOT')",Providence,nai69.xml,72,1,0,MOT,392,2080,CHI
0,3,2,19,0.405465108,22,3,we,"('FAT', 'MOT')",Providence,nai69.xml,24,2,0,MOT,145,435,FAT
2,5,3,14,0.405465108,19,5,the,"('FAT', 'MOT')",Providence,nai69.xml,24,5,2,MOT,145,435,FAT
1,12,16,166,0.376715695,178,12,gonna,"('MOT', 'CHI')",Providence,nai69.xml,195,17,1,CHI,2668,1364,MOT
0,5,1,18,0.328504067,23,5,a,"('FAT', 'MOT')",Providence,nai69.xml,24,1,0,MOT,145,435,FAT
0,5,1,18,0.328504067,23,5,to,"('FAT', 'MOT')",Providence,nai69.xml,24,1,0,MOT,145,435,FAT
0,4,8,60,0.277631737,64,4,yeah,"('CHI', 'MOT')",Providence,nai69.xml,72,8,0,MOT,392,2080,CHI
0,6,18,171,0.245743383,177,6,for,"('MOT', 'CHI')",Providence,nai69.xml,195,18,0,CHI,2668,1364,MOT
0,2,4,18,0.200670695,20,2,of,"('FAT', 'MOT')",Providence,nai69.xml,24,4,0,MOT,145,435,FAT
1,10,7,54,0.182321557,64,10,what,"('CHI', 'MOT')",Providence,nai69.xml,72,8,1,MOT,392,2080,CHI
4,18,31,142,0.141677356,160,18,a,"('MOT', 'CHI')",Providence,nai69.xml,195,35,4,CHI,2668,1364,MOT
1,7,2,14,0.139761942,21,7,that,"('FAT', 'MOT')",Providence,nai69.xml,24,3,1,MOT,145,435,FAT
2,21,19,153,0.042559614,174,21,what,"('MOT', 'CHI')",Providence,nai69.xml,195,21,2,CHI,2668,1364,MOT
1,18,4,49,0.036904557,67,18,is,"('CHI', 'MOT')",Providence,nai69.xml,72,5,1,MOT,392,2080,CHI
0,2,3,11,0,13,2,of,"('FAT', 'CHI')",Providence,nai69.xml,16,3,0,CHI,82,77,FAT
0,2,6,20,0,22,2,that,"('MOT', 'FAT')",Providence,nai69.xml,28,6,0,FAT,228,245,MOT
0,9,17,169,-0.054067221,178,9,are,"('MOT', 'CHI')",Providence,nai69.xml,195,17,0,CHI,2668,1364,MOT
0,8,1,15,-0.076961041,23,8,is,"('FAT', 'MOT')",Providence,nai69.xml,24,1,0,MOT,145,435,FAT
1,12,26,156,-0.10329957,168,12,and,"('MOT', 'CHI')",Providence,nai69.xml,195,27,1,CHI,2668,1364,MOT
2,22,26,145,-0.308180594,167,22,is,"('MOT', 'CHI')",Providence,nai69.xml,195,28,2,CHI,2668,1364,MOT
1,14,28,152,-0.324926246,166,14,that,"('MOT', 'CHI')",Providence,nai69.xml,195,29,1,CHI,2668,1364,MOT
1,23,5,43,-0.344840486,66,23,that,"('CHI', 'MOT')",Providence,nai69.xml,72,6,1,MOT,392,2080,CHI
0,8,3,17,-0.510825624,25,8,oh,"('MOT', 'FAT')",Providence,nai69.xml,28,3,0,FAT,228,245,MOT
0,14,20,161,-0.622942922,175,14,this,"('MOT', 'CHI')",Providence,nai69.xml,195,20,0,CHI,2668,1364,MOT
2,11,68,114,-0.818773394,125,11,you,"('MOT', 'CHI')",Providence,nai69.xml,195,70,2,CHI,2668,1364,MOT
0,29,4,39,-0.944461609,68,29,you,"('CHI', 'MOT')",Providence,nai69.xml,72,4,0,MOT,392,2080,CHI
1,2,3,336,3.63172104,338,2,big,"('CHI', 'MOT')",Providence,nai70.xml,342,4,1,MOT,3166,4108,CHI
0,2,2,338,3.349904087,340,2,she,"('CHI', 'MOT')",Providence,nai70.xml,342,2,0,MOT,3166,4108,CHI
0,4,1,337,3.129680246,341,4,they,"('CHI', 'MOT')",Providence,nai70.xml,342,1,0,MOT,3166,4108,CHI
1,4,3,334,3.120895417,338,4,at,"('CHI', 'MOT')",Providence,nai70.xml,342,4,1,MOT,3166,4108,CHI
0,5,1,336,2.947358689,341,5,did,"('CHI', 'MOT')",Providence,nai70.xml,342,1,0,MOT,3166,4108,CHI
1,5,3,333,2.93857386,338,5,little,"('CHI', 'MOT')",Providence,nai70.xml,342,4,1,MOT,3166,4108,CHI
5,5,13,319,2.791165108,324,5,not,"('CHI', 'MOT')",Providence,nai70.xml,342,18,5,MOT,3166,4108,CHI
0,8,1,333,2.541893581,341,8,there,"('CHI', 'MOT')",Providence,nai70.xml,342,1,0,MOT,3166,4108,CHI
0,3,5,334,2.493795597,337,3,my,"('CHI', 'MOT')",Providence,nai70.xml,342,5,0,MOT,3166,4108,CHI
0,5,3,334,2.430685096,339,5,look,"('CHI', 'MOT')",Providence,nai70.xml,342,3,0,MOT,3166,4108,CHI
1,7,5,329,2.357309993,336,7,where,"('CHI', 'MOT')",Providence,nai70.xml,342,6,1,MOT,3166,4108,CHI
1,7,7,327,2.128231706,334,7,up,"('CHI', 'MOT')",Providence,nai70.xml,342,8,1,MOT,3166,4108,CHI
1,14,3,324,2.022283128,338,14,have,"('CHI', 'MOT')",Providence,nai70.xml,342,4,1,MOT,3166,4108,CHI
5,12,13,312,2.01797522,324,12,he,"('CHI', 'MOT')",Providence,nai70.xml,342,18,5,MOT,3166,4108,CHI
3,11,10,318,1.995455886,329,11,one,"('CHI', 'MOT')",Providence,nai70.xml,342,13,3,MOT,3166,4108,CHI
0,6,5,331,1.934179809,337,6,was,"('CHI', 'MOT')",Providence,nai70.xml,342,5,0,MOT,3166,4108,CHI
0,13,2,327,1.809459046,340,13,but,"('CHI', 'MOT')",Providence,nai70.xml,342,2,0,MOT,3166,4108,CHI
1,8,10,323,1.739115736,331,8,put,"('CHI', 'MOT')",Providence,nai70.xml,342,11,1,MOT,3166,4108,CHI
7,20,13,302,1.724620166,322,20,on,"('CHI', 'MOT')",Providence,nai70.xml,342,20,7,MOT,3166,4108,CHI
1,15,7,319,1.435084525,334,15,want,"('CHI', 'MOT')",Providence,nai70.xml,342,8,1,MOT,3166,4108,CHI
0,13,4,325,1.398128819,338,13,get,"('CHI', 'MOT')",Providence,nai70.xml,342,4,0,MOT,3166,4108,CHI
0,10,6,326,1.345709081,336,10,go,"('CHI', 'MOT')",Providence,nai70.xml,342,6,0,MOT,3166,4108,CHI
2,29,5,306,1.32027326,335,29,we,"('CHI', 'MOT')",Providence,nai70.xml,342,7,2,MOT,3166,4108,CHI
4,27,11,300,1.240077809,327,27,of,"('CHI', 'MOT')",Providence,nai70.xml,342,15,4,MOT,3166,4108,CHI
1,14,12,315,1.079165154,329,14,make,"('CHI', 'MOT')",Providence,nai70.xml,342,13,1,MOT,3166,4108,CHI
0,19,4,319,1.041453875,338,19,see,"('CHI', 'MOT')",Providence,nai70.xml,342,4,0,MOT,3166,4108,CHI
0,19,4,319,1.041453875,338,19,think,"('CHI', 'MOT')",Providence,nai70.xml,342,4,0,MOT,3166,4108,CHI
4,25,16,297,1.041042437,322,25,in,"('CHI', 'MOT')",Providence,nai70.xml,342,20,4,MOT,3166,4108,CHI
0,14,6,322,1.035554153,336,14,all,"('CHI', 'MOT')",Providence,nai70.xml,342,6,0,MOT,3166,4108,CHI
6,40,12,284,1.02350319,324,40,it,"('CHI', 'MOT')",Providence,nai70.xml,342,18,6,MOT,3166,4108,CHI
1,0,0,2,0.980829253,2,0,get,"('CHI', 'FAT')",Providence,nai70.xml,3,1,1,FAT,20,35,CHI
1,0,0,2,0.980829253,2,0,where,"('CHI', 'FAT')",Providence,nai70.xml,3,1,1,FAT,20,35,CHI
1,0,0,2,0.980829253,2,0,the,"('CHI', 'FAT')",Providence,nai70.xml,3,1,1,FAT,20,35,CHI
1,0,1,3,0.916290732,3,0,you,"('FAT', 'CHI')",Providence,nai70.xml,5,2,1,CHI,171,33,FAT
1,0,1,3,0.916290732,3,0,to,"('FAT', 'CHI')",Providence,nai70.xml,5,2,1,CHI,171,33,FAT
13,40,27,262,0.904843346,302,40,a,"('CHI', 'MOT')",Providence,nai70.xml,342,40,13,MOT,3166,4108,CHI
0,8,13,321,0.896843597,329,8,wanna,"('CHI', 'MOT')",Providence,nai70.xml,342,13,0,MOT,3166,4108,CHI
6,32,20,284,0.87924946,316,32,is,"('CHI', 'MOT')",Providence,nai70.xml,342,26,6,MOT,3166,4108,CHI
2,0,1,2,0.875468737,2,0,do,"('FAT', 'CHI')",Providence,nai70.xml,5,3,2,CHI,171,33,FAT
0,15,7,320,0.850269631,335,15,like,"('CHI', 'MOT')",Providence,nai70.xml,342,7,0,MOT,3166,4108,CHI
0,20,5,317,0.835567521,337,20,with,"('CHI', 'MOT')",Providence,nai70.xml,342,5,0,MOT,3166,4108,CHI
0,20,5,317,0.835567521,337,20,can,"('CHI', 'MOT')",Providence,nai70.xml,342,5,0,MOT,3166,4108,CHI
1,24,9,308,0.800505699,332,24,are,"('CHI', 'MOT')",Providence,nai70.xml,342,10,1,MOT,3166,4108,CHI
3,29,15,295,0.776262087,324,29,for,"('CHI', 'MOT')",Providence,nai70.xml,342,18,3,MOT,3166,4108,CHI
10,50,21,261,0.715765269,311,50,to,"('CHI', 'MOT')",Providence,nai70.xml,342,31,10,MOT,3166,4108,CHI
1,18,14,309,0.711552608,327,18,some,"('CHI', 'MOT')",Providence,nai70.xml,342,15,1,MOT,3166,4108,CHI
3,23,23,293,0.638087403,316,23,this,"('CHI', 'MOT')",Providence,nai70.xml,342,26,3,MOT,3166,4108,CHI
1,44,5,292,0.630089045,336,44,oh,"('CHI', 'MOT')",Providence,nai70.xml,342,6,1,MOT,3166,4108,CHI
1,8,35,298,0.588436226,306,8,no,"('CHI', 'MOT')",Providence,nai70.xml,342,36,1,MOT,3166,4108,CHI
1,36,8,297,0.498464527,333,36,what,"('CHI', 'MOT')",Providence,nai70.xml,342,9,1,MOT,3166,4108,CHI
1,28,11,302,0.49192899,330,28,do,"('CHI', 'MOT')",Providence,nai70.xml,342,12,1,MOT,3166,4108,CHI
1,0,2,2,0.470003629,2,0,the,"('FAT', 'CHI')",Providence,nai70.xml,5,3,1,CHI,171,33,FAT
1,1,0,1,0.287682072,2,1,to,"('CHI', 'FAT')",Providence,nai70.xml,3,1,1,FAT,20,35,CHI
2,18,33,289,0.276596674,307,18,gonna,"('CHI', 'MOT')",Providence,nai70.xml,342,35,2,MOT,3166,4108,CHI
15,65,37,225,0.270703736,290,65,the,"('CHI', 'MOT')",Providence,nai70.xml,342,52,15,MOT,3166,4108,CHI
11,108,16,207,0.185164711,315,108,you,"('CHI', 'MOT')",Providence,nai70.xml,342,27,11,MOT,3166,4108,CHI
0,1,1,3,0,4,1,get,"('FAT', 'CHI')",Providence,nai70.xml,5,1,0,CHI,171,33,FAT
1,29,19,293,-0.018349139,322,29,and,"('CHI', 'MOT')",Providence,nai70.xml,342,20,1,MOT,3166,4108,CHI
1,14,41,286,-0.088665637,300,14,yeah,"('CHI', 'MOT')",Providence,nai70.xml,342,42,1,MOT,3166,4108,CHI
1,48,13,280,-0.172169185,328,48,that,"('CHI', 'MOT')",Providence,nai70.xml,342,14,1,MOT,3166,4108,CHI
0,1,1,1,-0.405465108,2,1,are,"('CHI', 'FAT')",Providence,nai70.xml,3,1,0,FAT,20,35,CHI
1,3,0,518,4.467821995,521,3,big,"('CHI', 'MOT')",Providence,nai71.xml,522,1,1,MOT,4604,5559,CHI
1,5,3,513,3.363457054,518,5,put,"('CHI', 'MOT')",Providence,nai71.xml,522,4,1,MOT,4604,5559,CHI
1,5,6,510,2.952206009,515,5,was,"('CHI', 'MOT')",Providence,nai71.xml,522,7,1,MOT,4604,5559,CHI
0,6,2,514,2.925463078,520,6,look,"('CHI', 'MOT')",Providence,nai71.xml,522,2,0,MOT,4604,5559,CHI
1,12,2,507,2.774509952,519,12,little,"('CHI', 'MOT')",Providence,nai71.xml,522,3,1,MOT,4604,5559,CHI
1,7,7,507,2.557227311,514,7,where,"('CHI', 'MOT')",Providence,nai71.xml,522,8,1,MOT,4604,5559,CHI
2,24,2,494,2.341805806,518,24,see,"('CHI', 'MOT')",Providence,nai71.xml,522,4,2,MOT,4604,5559,CHI
1,5,14,502,2.300622384,507,5,all,"('CHI', 'MOT')",Providence,nai71.xml,522,15,1,MOT,4604,5559,CHI
0,7,5,510,2.226552192,517,7,get,"('CHI', 'MOT')",Providence,nai71.xml,522,5,0,MOT,4604,5559,CHI
0,18,1,503,2.216530196,521,18,think,"('CHI', 'MOT')",Providence,nai71.xml,522,1,0,MOT,4604,5559,CHI
6,12,28,476,1.991847244,488,12,he,"('CHI', 'MOT')",Providence,nai71.xml,522,34,6,MOT,4604,5559,CHI
2,13,11,496,1.987874348,509,13,at,"('CHI', 'MOT')",Providence,nai71.xml,522,13,2,MOT,4604,5559,CHI
0,18,3,501,1.70187315,519,18,some,"('CHI', 'MOT')",Providence,nai71.xml,522,3,0,MOT,4604,5559,CHI
4,25,12,481,1.691451064,506,25,have,"('CHI', 'MOT')",Providence,nai71.xml,522,16,4,MOT,4604,5559,CHI
1,15,9,497,1.677875074,512,15,make,"('CHI', 'MOT')",Providence,nai71.xml,522,10,1,MOT,4604,5559,CHI
0,9,8,505,1.640936579,514,9,she,"('CHI', 'MOT')",Providence,nai71.xml,522,8,0,MOT,4604,5559,CHI
1,13,12,496,1.58240924,509,13,one,"('CHI', 'MOT')",Providence,nai71.xml,522,13,1,MOT,4604,5559,CHI
0,9,9,504,1.543686535,513,9,my,"('CHI', 'MOT')",Providence,nai71.xml,522,9,0,MOT,4604,5559,CHI
0,15,5,502,1.533405012,517,15,wanna,"('CHI', 'MOT')",Providence,nai71.xml,522,5,0,MOT,4604,5559,CHI
5,23,20,474,1.530474869,497,23,can,"('CHI', 'MOT')",Providence,nai71.xml,522,25,5,MOT,4604,5559,CHI
3,25,12,482,1.527432496,507,25,on,"('CHI', 'MOT')",Providence,nai71.xml,522,15,3,MOT,4604,5559,CHI
0,18,4,500,1.517630363,518,18,did,"('CHI', 'MOT')",Providence,nai71.xml,522,4,0,MOT,4604,5559,CHI
3,19,19,481,1.431108377,500,19,gonna,"('CHI', 'MOT')",Providence,nai71.xml,522,22,3,MOT,4604,5559,CHI
5,8,77,432,1.255027975,440,8,yeah,"('CHI', 'MOT')",Providence,nai71.xml,522,82,5,MOT,4604,5559,CHI
8,37,24,453,1.231756609,490,37,what,"('CHI', 'MOT')",Providence,nai71.xml,522,32,8,MOT,4604,5559,CHI
0,17,7,498,1.160446539,515,17,they,"('CHI', 'MOT')",Providence,nai71.xml,522,7,0,MOT,4604,5559,CHI
2,16,25,479,1.106693141,495,16,not,"('CHI', 'MOT')",Providence,nai71.xml,522,27,2,MOT,4604,5559,CHI
5,31,24,462,1.096594125,493,31,in,"('CHI', 'MOT')",Providence,nai71.xml,522,29,5,MOT,4604,5559,CHI
0,10,14,498,1.063926731,508,10,up,"('CHI', 'MOT')",Providence,nai71.xml,522,14,0,MOT,4604,5559,CHI
2,6,64,450,1.060063619,456,6,no,"('CHI', 'MOT')",Providence,nai71.xml,522,66,2,MOT,4604,5559,CHI
0,17,8,497,1.053149915,514,17,with,"('CHI', 'MOT')",Providence,nai71.xml,522,8,0,MOT,4604,5559,CHI
4,41,16,461,1.003302109,502,41,we,"('CHI', 'MOT')",Providence,nai71.xml,522,20,4,MOT,4604,5559,CHI
2,37,11,472,0.989345518,509,37,are,"('CHI', 'MOT')",Providence,nai71.xml,522,13,2,MOT,4604,5559,CHI
3,36,16,467,0.95541244,503,36,like,"('CHI', 'MOT')",Providence,nai71.xml,522,19,3,MOT,4604,5559,CHI
0,12,16,494,0.775160332,506,12,want,"('CHI', 'MOT')",Providence,nai71.xml,522,16,0,MOT,4604,5559,CHI
0,24,8,490,0.724645848,514,24,for,"('CHI', 'MOT')",Providence,nai71.xml,522,8,0,MOT,4604,5559,CHI
0,84,1,437,0.718317919,521,84,oh,"('CHI', 'MOT')",Providence,nai71.xml,522,1,0,MOT,4604,5559,CHI
0,22,9,491,0.710777412,513,22,go,"('CHI', 'MOT')",Providence,nai71.xml,522,9,0,MOT,4604,5559,CHI
2,46,13,461,0.647699359,507,46,do,"('CHI', 'MOT')",Providence,nai71.xml,522,15,2,MOT,4604,5559,CHI
0,31,7,484,0.585082394,515,31,there,"('CHI', 'MOT')",Providence,nai71.xml,522,7,0,MOT,4604,5559,CHI
11,120,16,375,0.5304103,495,120,you,"('CHI', 'MOT')",Providence,nai71.xml,522,27,11,MOT,4604,5559,CHI
6,48,36,432,0.447844331,480,48,it,"('CHI', 'MOT')",Providence,nai71.xml,522,42,6,MOT,4604,5559,CHI
14,69,51,388,0.38391255,457,69,a,"('CHI', 'MOT')",Providence,nai71.xml,522,65,14,MOT,4604,5559,CHI
10,51,55,406,0.371009145,457,51,is,"('CHI', 'MOT')",Providence,nai71.xml,522,65,10,MOT,4604,5559,CHI
2,38,23,459,0.351819872,497,38,of,"('CHI', 'MOT')",Providence,nai71.xml,522,25,2,MOT,4604,5559,CHI
26,87,67,342,0.33073125,429,87,the,"('CHI', 'MOT')",Providence,nai71.xml,522,93,26,MOT,4604,5559,CHI
0,14,23,485,0.289680075,499,14,but,"('CHI', 'MOT')",Providence,nai71.xml,522,23,0,MOT,4604,5559,CHI
2,19,52,449,0.230261019,468,19,this,"('CHI', 'MOT')",Providence,nai71.xml,522,54,2,MOT,4604,5559,CHI
6,71,37,408,0.03844881,479,71,to,"('CHI', 'MOT')",Providence,nai71.xml,522,43,6,MOT,4604,5559,CHI
3,67,29,423,-0.161095152,490,67,that,"('CHI', 'MOT')",Providence,nai71.xml,522,32,3,MOT,4604,5559,CHI
4,53,48,417,-0.211551195,470,53,and,"('CHI', 'MOT')",Providence,nai71.xml,522,52,4,MOT,4604,5559,CHI
1,0,1,167,4.436751534,167,0,big,"('MOT', 'CHI')",Providence,nai72.xml,169,2,1,CHI,2377,1293,MOT
1,0,5,163,3.719651113,163,0,look,"('MOT', 'CHI')",Providence,nai72.xml,169,6,1,CHI,2377,1293,MOT
0,1,1,204,3.540959324,205,1,they,"('CHI', 'MOT')",Providence,nai72.xml,206,1,0,MOT,1703,2965,CHI
0,1,1,204,3.540959324,205,1,my,"('CHI', 'MOT')",Providence,nai72.xml,206,1,0,MOT,1703,2965,CHI
0,1,1,204,3.540959324,205,1,big,"('CHI', 'MOT')",Providence,nai72.xml,206,1,0,MOT,1703,2965,CHI
1,1,2,165,3.514526067,166,1,was,"('MOT', 'CHI')",Providence,nai72.xml,169,3,1,CHI,2377,1293,MOT
1,4,0,201,3.317815773,205,4,did,"('CHI', 'MOT')",Providence,nai72.xml,206,1,1,MOT,1703,2965,CHI
0,1,2,166,3.050457173,167,1,with,"('MOT', 'CHI')",Providence,nai72.xml,169,2,0,CHI,2377,1293,MOT
2,2,4,161,3.026503932,163,2,they,"('MOT', 'CHI')",Providence,nai72.xml,169,6,2,CHI,2377,1293,MOT
1,1,5,162,3.026503932,163,1,at,"('MOT', 'CHI')",Providence,nai72.xml,169,6,1,CHI,2377,1293,MOT
1,4,1,200,3.025291076,204,4,put,"('CHI', 'MOT')",Providence,nai72.xml,206,2,1,MOT,1703,2965,CHI
1,7,0,198,2.847812143,205,7,at,"('CHI', 'MOT')",Providence,nai72.xml,206,1,1,MOT,1703,2965,CHI
0,1,3,165,2.821378886,166,1,did,"('MOT', 'CHI')",Providence,nai72.xml,169,3,0,CHI,2377,1293,MOT
1,1,7,160,2.791165108,161,1,some,"('MOT', 'CHI')",Providence,nai72.xml,169,8,1,CHI,2377,1293,MOT
1,0,16,152,2.785660804,152,0,have,"('MOT', 'CHI')",Providence,nai72.xml,169,17,1,CHI,2377,1293,MOT
1,1,8,159,2.689701062,160,1,see,"('MOT', 'CHI')",Providence,nai72.xml,169,9,1,CHI,2377,1293,MOT
2,1,12,154,2.689122191,155,1,we,"('MOT', 'CHI')",Providence,nai72.xml,169,14,2,CHI,2377,1293,MOT
0,1,4,164,2.633087163,165,1,one,"('MOT', 'CHI')",Providence,nai72.xml,169,4,0,CHI,2377,1293,MOT
0,4,1,201,2.624668592,205,4,was,"('CHI', 'MOT')",Providence,nai72.xml,206,1,0,MOT,1703,2965,CHI
1,1,9,158,2.596497715,159,1,little,"('MOT', 'CHI')",Providence,nai72.xml,169,10,1,CHI,2377,1293,MOT
1,7,1,197,2.555287447,204,7,can,"('CHI', 'MOT')",Providence,nai72.xml,206,2,1,MOT,1703,2965,CHI
0,5,1,200,2.442347035,205,5,get,"('CHI', 'MOT')",Providence,nai72.xml,206,1,0,MOT,1703,2965,CHI
0,5,1,200,2.442347035,205,5,look,"('CHI', 'MOT')",Providence,nai72.xml,206,1,0,MOT,1703,2965,CHI
3,6,5,192,2.436116486,198,6,not,"('CHI', 'MOT')",Providence,nai72.xml,206,8,3,MOT,1703,2965,CHI
0,2,4,163,2.227622055,165,2,all,"('MOT', 'CHI')",Providence,nai72.xml,169,4,0,CHI,2377,1293,MOT
1,1,14,153,2.216642663,154,1,what,"('MOT', 'CHI')",Providence,nai72.xml,169,15,1,CHI,2377,1293,MOT
1,11,1,193,2.149822338,204,11,he,"('CHI', 'MOT')",Providence,nai72.xml,206,2,1,MOT,1703,2965,CHI
1,5,4,159,2.067465351,164,5,wanna,"('MOT', 'CHI')",Providence,nai72.xml,169,5,1,CHI,2377,1293,MOT
2,6,7,191,2.048111692,197,6,in,"('CHI', 'MOT')",Providence,nai72.xml,206,9,2,MOT,1703,2965,CHI
1,8,3,194,2.022283128,202,8,wanna,"('CHI', 'MOT')",Providence,nai72.xml,206,4,1,MOT,1703,2965,CHI
1,13,1,191,1.995671659,204,13,all,"('CHI', 'MOT')",Providence,nai72.xml,206,2,1,MOT,1703,2965,CHI
1,2,12,154,1.949079724,156,2,think,"('MOT', 'CHI')",Providence,nai72.xml,169,13,1,CHI,2377,1293,MOT
0,3,4,162,1.939939982,165,3,go,"('MOT', 'CHI')",Providence,nai72.xml,169,4,0,CHI,2377,1293,MOT
0,5,3,198,1.921812597,203,5,gonna,"('CHI', 'MOT')",Providence,nai72.xml,206,3,0,MOT,1703,2965,CHI
0,4,3,162,1.905088155,166,4,where,"('MOT', 'CHI')",Providence,nai72.xml,169,3,0,CHI,2377,1293,MOT
1,3,9,156,1.903350535,159,3,make,"('MOT', 'CHI')",Providence,nai72.xml,169,10,1,CHI,2377,1293,MOT
0,1,11,157,1.817077277,158,1,can,"('MOT', 'CHI')",Providence,nai72.xml,169,11,0,CHI,2377,1293,MOT
1,2,14,152,1.811177555,154,2,not,"('MOT', 'CHI')",Providence,nai72.xml,169,15,1,CHI,2377,1293,MOT
1,16,1,188,1.801515644,204,16,have,"('CHI', 'MOT')",Providence,nai72.xml,206,2,1,MOT,1703,2965,CHI
0,2,8,159,1.692552819,161,2,up,"('MOT', 'CHI')",Providence,nai72.xml,169,8,0,CHI,2377,1293,MOT
1,15,2,188,1.634130525,203,15,see,"('CHI', 'MOT')",Providence,nai72.xml,206,3,1,MOT,1703,2965,CHI
3,8,12,183,1.618546629,191,8,no,"('CHI', 'MOT')",Providence,nai72.xml,206,15,3,MOT,1703,2965,CHI
3,11,6,149,1.591088774,160,11,want,"('MOT', 'CHI')",Providence,nai72.xml,169,9,3,CHI,2377,1293,MOT
2,4,15,148,1.581687999,152,4,put,"('MOT', 'CHI')",Providence,nai72.xml,169,17,2,CHI,2377,1293,MOT
0,6,4,196,1.580450376,202,6,on,"('CHI', 'MOT')",Providence,nai72.xml,206,4,0,MOT,1703,2965,CHI
1,8,5,155,1.522426535,163,8,this,"('MOT', 'CHI')",Providence,nai72.xml,169,6,1,CHI,2377,1293,MOT
0,2,10,157,1.497885427,159,2,my,"('MOT', 'CHI')",Providence,nai72.xml,169,10,0,CHI,2377,1293,MOT
0,7,4,195,1.446918983,202,7,but,"('CHI', 'MOT')",Providence,nai72.xml,206,4,0,MOT,1703,2965,CHI
0,4,6,159,1.41706602,163,4,but,"('MOT', 'CHI')",Providence,nai72.xml,169,6,0,CHI,2377,1293,MOT
2,4,18,145,1.41541176,149,4,there,"('MOT', 'CHI')",Providence,nai72.xml,169,20,2,CHI,2377,1293,MOT
0,3,8,158,1.404870747,161,3,like,"('MOT', 'CHI')",Providence,nai72.xml,169,8,0,CHI,2377,1293,MOT
0,1,17,151,1.399366443,152,1,do,"('MOT', 'CHI')",Providence,nai72.xml,169,17,0,CHI,2377,1293,MOT
0,4,8,194,1.386294361,198,4,where,"('CHI', 'MOT')",Providence,nai72.xml,206,8,0,MOT,1703,2965,CHI
3,6,17,143,1.366621596,149,6,and,"('MOT', 'CHI')",Providence,nai72.xml,169,20,3,CHI,2377,1293,MOT
0,18,1,187,1.289667525,205,18,oh,"('CHI', 'MOT')",Providence,nai72.xml,206,1,0,MOT,1703,2965,CHI
2,20,4,180,1.282916007,200,20,think,"('CHI', 'MOT')",Providence,nai72.xml,206,6,2,MOT,1703,2965,CHI
3,32,2,169,1.25708263,201,32,of,"('CHI', 'MOT')",Providence,nai72.xml,206,5,3,MOT,1703,2965,CHI
0,3,10,156,1.210203354,159,3,get,"('MOT', 'CHI')",Providence,nai72.xml,169,10,0,CHI,2377,1293,MOT
0,12,3,191,1.148622709,203,12,little,"('CHI', 'MOT')",Providence,nai72.xml,206,3,0,MOT,1703,2965,CHI
0,10,4,192,1.128465252,202,10,with,"('CHI', 'MOT')",Providence,nai72.xml,206,4,0,MOT,1703,2965,CHI
6,6,36,121,1.07562277,127,6,a,"('MOT', 'CHI')",Providence,nai72.xml,169,42,6,CHI,2377,1293,MOT
2,5,23,139,0.994622575,144,5,on,"('MOT', 'CHI')",Providence,nai72.xml,169,25,2,CHI,2377,1293,MOT
1,5,16,147,0.993901335,152,5,gonna,"('MOT', 'CHI')",Providence,nai72.xml,169,17,1,CHI,2377,1293,MOT
5,26,9,166,0.99119204,192,26,there,"('CHI', 'MOT')",Providence,nai72.xml,206,14,5,MOT,1703,2965,CHI
4,12,16,137,0.970725938,149,12,is,"('MOT', 'CHI')",Providence,nai72.xml,169,20,4,CHI,2377,1293,MOT
2,17,9,178,0.926494902,195,17,do,"('CHI', 'MOT')",Providence,nai72.xml,206,11,2,MOT,1703,2965,CHI
1,19,5,181,0.926241063,200,19,we,"('CHI', 'MOT')",Providence,nai72.xml,206,6,1,MOT,1703,2965,CHI
4,16,17,169,0.871838969,185,16,go,"('CHI', 'MOT')",Providence,nai72.xml,206,21,4,MOT,1703,2965,CHI
5,53,3,145,0.798507696,198,53,that,"('CHI', 'MOT')",Providence,nai72.xml,206,8,5,MOT,1703,2965,CHI
0,13,5,188,0.7282385,201,13,like,"('CHI', 'MOT')",Providence,nai72.xml,206,5,0,MOT,1703,2965,CHI
0,14,5,187,0.659245629,201,14,some,"('CHI', 'MOT')",Providence,nai72.xml,206,5,0,MOT,1703,2965,CHI
4,39,7,156,0.63881283,195,39,is,"('CHI', 'MOT')",Providence,nai72.xml,206,11,4,MOT,1703,2965,CHI
7,21,25,153,0.632522559,174,21,one,"('CHI', 'MOT')",Providence,nai72.xml,206,32,7,MOT,1703,2965,CHI
1,21,5,142,0.628608659,163,21,yeah,"('MOT', 'CHI')",Providence,nai72.xml,169,6,1,CHI,2377,1293,MOT
0,4,15,150,0.607204751,154,4,of,"('MOT', 'CHI')",Providence,nai72.xml,169,15,0,CHI,2377,1293,MOT
8,18,26,117,0.589247586,135,18,it,"('MOT', 'CHI')",Providence,nai72.xml,169,34,8,CHI,2377,1293,MOT
1,16,10,179,0.578188208,195,16,what,"('CHI', 'MOT')",Providence,nai72.xml,206,11,1,MOT,1703,2965,CHI
4,9,32,124,0.574541438,133,9,to,"('MOT', 'CHI')",Providence,nai72.xml,169,36,4,CHI,2377,1293,MOT
1,7,20,141,0.488846717,148,7,in,"('MOT', 'CHI')",Providence,nai72.xml,169,21,1,CHI,2377,1293,MOT
7,43,14,142,0.390866309,185,43,the,"('CHI', 'MOT')",Providence,nai72.xml,206,21,7,MOT,1703,2965,CHI
1,21,10,174,0.320359098,195,21,to,"('CHI', 'MOT')",Providence,nai72.xml,206,11,1,MOT,1703,2965,CHI
1,8,23,137,0.228258652,145,8,that,"('MOT', 'CHI')",Providence,nai72.xml,169,24,1,CHI,2377,1293,MOT
6,30,24,146,0.227970592,176,30,it,"('CHI', 'MOT')",Providence,nai72.xml,206,30,6,MOT,1703,2965,CHI
2,44,7,153,0.187359351,197,44,you,"('CHI', 'MOT')",Providence,nai72.xml,206,9,2,MOT,1703,2965,CHI
1,30,6,132,0.161801827,162,30,no,"('MOT', 'CHI')",Providence,nai72.xml,169,7,1,CHI,2377,1293,MOT
0,6,17,146,0.146603474,152,6,for,"('MOT', 'CHI')",Providence,nai72.xml,169,17,0,CHI,2377,1293,MOT
5,56,13,132,0,188,56,a,"('CHI', 'MOT')",Providence,nai72.xml,206,18,5,MOT,1703,2965,CHI
0,11,15,180,-0.055429805,191,11,yeah,"('CHI', 'MOT')",Providence,nai72.xml,206,15,0,MOT,1703,2965,CHI
8,35,36,127,-0.11506933,162,35,this,"('CHI', 'MOT')",Providence,nai72.xml,206,44,8,MOT,1703,2965,CHI
1,7,37,124,-0.184824687,131,7,you,"('MOT', 'CHI')",Providence,nai72.xml,169,38,1,CHI,2377,1293,MOT
5,17,48,99,-0.335260849,116,17,the,"('MOT', 'CHI')",Providence,nai72.xml,169,53,5,CHI,2377,1293,MOT
0,31,8,167,-0.470003629,198,31,and,"('CHI', 'MOT')",Providence,nai72.xml,206,8,0,MOT,1703,2965,CHI
0,1,1,178,3.406737562,179,1,make,"('CHI', 'MOT')",Providence,nai73a.xml,180,1,0,MOT,1984,2862,CHI
1,4,0,175,3.183594011,179,4,she,"('CHI', 'MOT')",Providence,nai73a.xml,180,1,1,MOT,1984,2862,CHI
0,1,3,176,2.884800713,177,1,big,"('CHI', 'MOT')",Providence,nai73a.xml,180,3,0,MOT,1984,2862,CHI
1,6,0,173,2.847121774,179,6,little,"('CHI', 'MOT')",Providence,nai73a.xml,180,1,1,MOT,1984,2862,CHI
1,6,1,172,2.553899521,178,6,wanna,"('CHI', 'MOT')",Providence,nai73a.xml,180,2,1,MOT,1984,2862,CHI
0,4,1,175,2.49044683,179,4,get,"('CHI', 'MOT')",Providence,nai73a.xml,180,1,0,MOT,1984,2862,CHI
2,4,5,169,2.456735773,173,4,up,"('CHI', 'MOT')",Providence,nai73a.xml,180,7,2,MOT,1984,2862,CHI
2,6,3,169,2.382941723,175,6,was,"('CHI', 'MOT')",Providence,nai73a.xml,180,5,2,MOT,1984,2862,CHI
1,6,2,171,2.325184925,177,6,look,"('CHI', 'MOT')",Providence,nai73a.xml,180,3,1,MOT,1984,2862,CHI
1,9,1,169,2.197224577,178,9,at,"('CHI', 'MOT')",Providence,nai73a.xml,180,2,1,MOT,1984,2862,CHI
4,8,5,163,2.167609657,171,8,where,"('CHI', 'MOT')",Providence,nai73a.xml,180,9,4,MOT,1984,2862,CHI
1,4,6,169,2.051270665,173,4,they,"('CHI', 'MOT')",Providence,nai73a.xml,180,7,1,MOT,1984,2862,CHI
0,5,2,173,2.014903021,178,5,did,"('CHI', 'MOT')",Providence,nai73a.xml,180,2,0,MOT,1984,2862,CHI
1,12,1,166,1.934860313,178,12,have,"('CHI', 'MOT')",Providence,nai73a.xml,180,2,1,MOT,1984,2862,CHI
2,8,5,165,1.868949108,173,8,we,"('CHI', 'MOT')",Providence,nai73a.xml,180,7,2,MOT,1984,2862,CHI
4,3,25,148,1.819594268,151,3,no,"('CHI', 'MOT')",Providence,nai73a.xml,180,29,4,MOT,1984,2862,CHI
4,10,7,159,1.788256839,169,10,for,"('CHI', 'MOT')",Providence,nai73a.xml,180,11,4,MOT,1984,2862,CHI
2,18,1,159,1.732121203,177,18,are,"('CHI', 'MOT')",Providence,nai73a.xml,180,3,2,MOT,1984,2862,CHI
0,4,5,171,1.620801671,175,4,my,"('CHI', 'MOT')",Providence,nai73a.xml,180,5,0,MOT,1984,2862,CHI
3,13,6,158,1.502633353,171,13,one,"('CHI', 'MOT')",Providence,nai73a.xml,180,9,3,MOT,1984,2862,CHI
1,11,4,164,1.438480114,175,11,with,"('CHI', 'MOT')",Providence,nai73a.xml,180,5,1,MOT,1984,2862,CHI
0,10,2,168,1.408767217,178,10,all,"('CHI', 'MOT')",Providence,nai73a.xml,180,2,0,MOT,1984,2862,CHI
3,16,6,155,1.308477339,171,16,do,"('CHI', 'MOT')",Providence,nai73a.xml,180,9,3,MOT,1984,2862,CHI
2,9,10,159,1.292768303,168,9,not,"('CHI', 'MOT')",Providence,nai73a.xml,180,12,2,MOT,1984,2862,CHI
1,10,6,163,1.262813304,173,10,gonna,"('CHI', 'MOT')",Providence,nai73a.xml,180,7,1,MOT,1984,2862,CHI
2,6,17,155,1.201929903,161,6,but,"('CHI', 'MOT')",Providence,nai73a.xml,180,19,2,MOT,1984,2862,CHI
0,13,2,165,1.16760516,178,13,can,"('CHI', 'MOT')",Providence,nai73a.xml,180,2,0,MOT,1984,2862,CHI
0,11,3,166,1.093041244,177,11,like,"('CHI', 'MOT')",Providence,nai73a.xml,180,3,0,MOT,1984,2862,CHI
0,8,5,167,1.033015006,175,8,want,"('CHI', 'MOT')",Providence,nai73a.xml,180,5,0,MOT,1984,2862,CHI
0,10,4,166,0.992128808,176,10,see,"('CHI', 'MOT')",Providence,nai73a.xml,180,4,0,MOT,1984,2862,CHI
3,18,9,150,0.938596489,168,18,on,"('CHI', 'MOT')",Providence,nai73a.xml,180,12,3,MOT,1984,2862,CHI
4,13,19,144,0.82040896,157,13,yeah,"('CHI', 'MOT')",Providence,nai73a.xml,180,23,4,MOT,1984,2862,CHI
10,41,8,121,0.764359809,162,41,a,"('CHI', 'MOT')",Providence,nai73a.xml,180,18,10,MOT,1984,2862,CHI
1,18,6,155,0.716269598,173,18,of,"('CHI', 'MOT')",Providence,nai73a.xml,180,7,1,MOT,1984,2862,CHI
5,31,10,134,0.610804035,165,31,in,"('CHI', 'MOT')",Providence,nai73a.xml,180,15,5,MOT,1984,2862,CHI
7,29,16,128,0.528272537,157,29,to,"('CHI', 'MOT')",Providence,nai73a.xml,180,23,7,MOT,1984,2862,CHI
7,27,18,128,0.507645971,155,27,it,"('CHI', 'MOT')",Providence,nai73a.xml,180,25,7,MOT,1984,2862,CHI
11,28,25,116,0.463631282,144,28,is,"('CHI', 'MOT')",Providence,nai73a.xml,180,36,11,MOT,1984,2862,CHI
25,37,30,88,0.421646197,125,37,the,"('CHI', 'MOT')",Providence,nai73a.xml,180,55,25,MOT,1984,2862,CHI
1,10,19,150,0.29180579,160,10,go,"('CHI', 'MOT')",Providence,nai73a.xml,180,20,1,MOT,1984,2862,CHI
1,39,4,136,0.23450731,175,39,oh,"('CHI', 'MOT')",Providence,nai73a.xml,180,5,1,MOT,1984,2862,CHI
1,16,13,150,0.211309094,166,16,put,"('CHI', 'MOT')",Providence,nai73a.xml,180,14,1,MOT,1984,2862,CHI
0,16,7,157,0.134348053,173,16,there,"('CHI', 'MOT')",Providence,nai73a.xml,180,7,0,MOT,1984,2862,CHI
0,17,8,155,-0.033901552,172,17,what,"('CHI', 'MOT')",Providence,nai73a.xml,180,8,0,MOT,1984,2862,CHI
3,17,33,127,-0.158056935,144,17,this,"('CHI', 'MOT')",Providence,nai73a.xml,180,36,3,MOT,1984,2862,CHI
3,28,23,126,-0.263349972,154,28,and,"('CHI', 'MOT')",Providence,nai73a.xml,180,26,3,MOT,1984,2862,CHI
1,56,9,114,-0.68731626,170,56,you,"('CHI', 'MOT')",Providence,nai73a.xml,180,10,1,MOT,1984,2862,CHI
0,35,11,134,-1.006804739,169,35,that,"('CHI', 'MOT')",Providence,nai73a.xml,180,11,0,MOT,1984,2862,CHI
0,2,3,304,3.022049582,306,2,did,"('MOT', 'CHI')",Providence,nai73b.xml,309,3,0,CHI,3831,2846,MOT
0,2,3,304,3.022049582,306,2,where,"('MOT', 'CHI')",Providence,nai73b.xml,309,3,0,CHI,3831,2846,MOT
0,2,4,303,2.83647599,305,2,she,"('MOT', 'CHI')",Providence,nai73b.xml,309,4,0,CHI,3831,2846,MOT
2,6,4,297,2.793572375,303,6,put,"('MOT', 'CHI')",Providence,nai73b.xml,309,6,2,CHI,3831,2846,MOT
0,3,3,303,2.734367509,306,3,big,"('MOT', 'CHI')",Providence,nai73b.xml,309,3,0,CHI,3831,2846,MOT
1,0,33,275,2.733645748,275,0,oh,"('MOT', 'CHI')",Providence,nai73b.xml,309,34,1,CHI,3831,2846,MOT
0,1,8,300,2.718000532,301,1,at,"('MOT', 'CHI')",Providence,nai73b.xml,309,8,0,CHI,3831,2846,MOT
2,3,11,293,2.701361213,296,3,all,"('MOT', 'CHI')",Providence,nai73b.xml,309,13,2,CHI,3831,2846,MOT
3,7,7,292,2.529056434,299,7,he,"('MOT', 'CHI')",Providence,nai73b.xml,309,10,3,CHI,3831,2846,MOT
1,4,8,296,2.396241013,300,4,make,"('MOT', 'CHI')",Providence,nai73b.xml,309,9,1,CHI,3831,2846,MOT
0,4,4,301,2.325650366,305,4,they,"('MOT', 'CHI')",Providence,nai73b.xml,309,4,0,CHI,3831,2846,MOT
1,3,13,292,2.227996236,295,3,get,"('MOT', 'CHI')",Providence,nai73b.xml,309,14,1,CHI,3831,2846,MOT
1,7,6,295,2.133508763,302,7,my,"('MOT', 'CHI')",Providence,nai73b.xml,309,7,1,CHI,3831,2846,MOT
4,10,10,285,2.132686056,295,10,we,"('MOT', 'CHI')",Providence,nai73b.xml,309,14,4,CHI,3831,2846,MOT
1,5,9,294,2.123591326,299,5,was,"('MOT', 'CHI')",Providence,nai73b.xml,309,10,1,CHI,3831,2846,MOT
0,2,10,297,2.123591326,299,2,look,"('MOT', 'CHI')",Providence,nai73b.xml,309,10,0,CHI,3831,2846,MOT
2,3,22,282,2.113703605,285,3,can,"('MOT', 'CHI')",Providence,nai73b.xml,309,24,2,CHI,3831,2846,MOT
0,1,18,290,1.991293155,291,1,some,"('MOT', 'CHI')",Providence,nai73b.xml,309,18,0,CHI,3831,2846,MOT
1,9,6,293,1.910365212,302,9,have,"('MOT', 'CHI')",Providence,nai73b.xml,309,7,1,CHI,3831,2846,MOT
0,5,7,297,1.728043655,302,5,go,"('MOT', 'CHI')",Providence,nai73b.xml,309,7,0,CHI,3831,2846,MOT
2,8,15,284,1.6405285,292,8,not,"('MOT', 'CHI')",Providence,nai73b.xml,309,17,2,CHI,3831,2846,MOT
3,11,16,279,1.533619076,290,11,are,"('MOT', 'CHI')",Providence,nai73b.xml,309,19,3,CHI,3831,2846,MOT
3,11,17,278,1.483668525,289,11,there,"('MOT', 'CHI')",Providence,nai73b.xml,309,20,3,CHI,3831,2846,MOT
2,9,17,281,1.42825856,290,9,with,"('MOT', 'CHI')",Providence,nai73b.xml,309,19,2,CHI,3831,2846,MOT
0,6,9,294,1.366621596,300,6,see,"('MOT', 'CHI')",Providence,nai73b.xml,309,9,0,CHI,3831,2846,MOT
3,14,15,277,1.362684495,291,14,want,"('MOT', 'CHI')",Providence,nai73b.xml,309,18,3,CHI,3831,2846,MOT
0,6,10,293,1.276293466,299,6,but,"('MOT', 'CHI')",Providence,nai73b.xml,309,10,0,CHI,3831,2846,MOT
6,13,31,259,1.25641928,272,13,to,"('MOT', 'CHI')",Providence,nai73b.xml,309,37,6,CHI,3831,2846,MOT
3,13,20,273,1.191321687,286,13,on,"('MOT', 'CHI')",Providence,nai73b.xml,309,23,3,CHI,3831,2846,MOT
1,6,29,273,0.919855798,279,6,do,"('MOT', 'CHI')",Providence,nai73b.xml,309,30,1,CHI,3831,2846,MOT
0,9,10,290,0.919618522,299,9,gonna,"('MOT', 'CHI')",Providence,nai73b.xml,309,10,0,CHI,3831,2846,MOT
0,7,13,289,0.909601744,296,7,up,"('MOT', 'CHI')",Providence,nai73b.xml,309,13,0,CHI,3831,2846,MOT
6,22,29,252,0.819898886,274,22,it,"('MOT', 'CHI')",Providence,nai73b.xml,309,35,6,CHI,3831,2846,MOT
0,6,17,286,0.793230639,292,6,think,"('MOT', 'CHI')",Providence,nai73b.xml,309,17,0,CHI,3831,2846,MOT
0,19,5,285,0.781942679,304,19,no,"('MOT', 'CHI')",Providence,nai73b.xml,309,5,0,CHI,3831,2846,MOT
1,14,17,277,0.669537315,291,14,one,"('MOT', 'CHI')",Providence,nai73b.xml,309,18,1,CHI,3831,2846,MOT
6,33,25,245,0.557831666,278,33,is,"('MOT', 'CHI')",Providence,nai73b.xml,309,31,6,CHI,3831,2846,MOT
4,37,16,252,0.554132567,289,37,this,"('MOT', 'CHI')",Providence,nai73b.xml,309,20,4,CHI,3831,2846,MOT
3,16,33,257,0.532265955,273,16,of,"('MOT', 'CHI')",Providence,nai73b.xml,309,36,3,CHI,3831,2846,MOT
3,24,23,259,0.487703206,283,24,what,"('MOT', 'CHI')",Providence,nai73b.xml,309,26,3,CHI,3831,2846,MOT
4,19,38,248,0.424227385,267,19,and,"('MOT', 'CHI')",Providence,nai73b.xml,309,42,4,CHI,3831,2846,MOT
0,13,12,284,0.422328914,297,13,wanna,"('MOT', 'CHI')",Providence,nai73b.xml,309,12,0,CHI,3831,2846,MOT
6,50,18,235,0.415470194,285,50,yeah,"('MOT', 'CHI')",Providence,nai73b.xml,309,24,6,CHI,3831,2846,MOT
7,27,41,234,0.407368058,261,27,a,"('MOT', 'CHI')",Providence,nai73b.xml,309,48,7,CHI,3831,2846,MOT
1,17,19,272,0.385056236,289,17,for,"('MOT', 'CHI')",Providence,nai73b.xml,309,20,1,CHI,3831,2846,MOT
1,18,21,269,0.237081059,287,18,in,"('MOT', 'CHI')",Providence,nai73b.xml,309,22,1,CHI,3831,2846,MOT
3,18,41,247,0.200462644,265,18,that,"('MOT', 'CHI')",Providence,nai73b.xml,309,44,3,CHI,3831,2846,MOT
0,9,27,273,-0.020906685,282,9,like,"('MOT', 'CHI')",Providence,nai73b.xml,309,27,0,CHI,3831,2846,MOT
8,19,89,193,-0.027651531,212,19,you,"('MOT', 'CHI')",Providence,nai73b.xml,309,97,8,CHI,3831,2846,MOT
11,55,67,176,-0.471433222,231,55,the,"('MOT', 'CHI')",Providence,nai73b.xml,309,78,11,CHI,3831,2846,MOT
1,0,2,239,4.568506202,239,0,big,"('MOT', 'CHI')",Providence,nai74.xml,242,3,1,CHI,3068,2445,MOT
1,1,8,232,3.061690241,233,1,did,"('MOT', 'CHI')",Providence,nai74.xml,242,9,1,CHI,3068,2445,MOT
1,2,0,92,3.060270795,94,2,was,"('CHI', 'MOT')",Providence,nai74.xml,95,1,1,MOT,917,1126,CHI
1,4,0,90,2.549445171,94,4,are,"('CHI', 'MOT')",Providence,nai74.xml,95,1,1,MOT,917,1126,CHI
1,6,3,232,2.436116486,238,6,was,"('MOT', 'CHI')",Providence,nai74.xml,242,4,1,CHI,3068,2445,MOT
1,6,3,232,2.436116486,238,6,one,"('MOT', 'CHI')",Providence,nai74.xml,242,4,1,CHI,3068,2445,MOT
0,1,9,232,2.368543061,233,1,think,"('MOT', 'CHI')",Providence,nai74.xml,242,9,0,CHI,3068,2445,MOT
0,2,1,92,2.367123614,94,2,one,"('CHI', 'MOT')",Providence,nai74.xml,95,1,0,MOT,917,1126,CHI
1,5,0,89,2.367123614,94,5,put,"('CHI', 'MOT')",Providence,nai74.xml,95,1,1,MOT,917,1126,CHI
0,4,3,235,2.265921109,239,4,at,"('MOT', 'CHI')",Providence,nai74.xml,242,3,0,CHI,3068,2445,MOT
2,5,1,87,2.240709689,92,5,there,"('CHI', 'MOT')",Providence,nai74.xml,95,3,2,MOT,917,1126,CHI
1,3,10,228,2.192941916,231,3,we,"('MOT', 'CHI')",Providence,nai74.xml,242,11,1,CHI,3068,2445,MOT
1,0,0,11,2.159484249,11,0,is,"('TOY', 'CHI')",Providence,nai74.xml,12,1,1,CHI,134,113,TOY
0,3,1,91,2.079441542,94,3,look,"('CHI', 'MOT')",Providence,nai74.xml,95,1,0,MOT,917,1126,CHI
1,5,1,88,2.068970242,93,5,think,"('CHI', 'MOT')",Providence,nai74.xml,95,2,1,MOT,917,1126,CHI
0,1,13,228,2.041220329,229,1,get,"('MOT', 'CHI')",Providence,nai74.xml,242,13,0,CHI,3068,2445,MOT
1,0,1,13,2.014903021,13,0,did,"('ADU', 'MOT')",Providence,nai74.xml,15,2,1,MOT,84,222,ADU
3,3,24,212,2.012601524,215,3,gonna,"('MOT', 'CHI')",Providence,nai74.xml,242,27,3,CHI,3068,2445,MOT
2,2,8,83,1.981001469,85,2,wanna,"('CHI', 'MOT')",Providence,nai74.xml,95,10,2,MOT,917,1126,CHI
1,3,13,225,1.972343406,228,3,like,"('MOT', 'CHI')",Providence,nai74.xml,242,14,1,CHI,3068,2445,MOT
1,4,10,227,1.969798364,231,4,where,"('MOT', 'CHI')",Providence,nai74.xml,242,11,1,CHI,3068,2445,MOT
1,2,18,221,1.966112856,223,2,put,"('MOT', 'CHI')",Providence,nai74.xml,242,19,1,CHI,3068,2445,MOT
0,4,5,233,1.92111549,237,4,look,"('MOT', 'CHI')",Providence,nai74.xml,242,5,0,CHI,3068,2445,MOT
2,0,1,9,1.887069649,9,0,for,"('TOY', 'CHI')",Providence,nai74.xml,12,3,2,CHI,134,113,TOY
2,0,1,9,1.887069649,9,0,my,"('TOY', 'CHI')",Providence,nai74.xml,12,3,2,CHI,134,113,TOY
1,9,0,85,1.85629799,94,9,this,"('CHI', 'MOT')",Providence,nai74.xml,95,1,1,MOT,917,1126,CHI
1,5,2,87,1.835244581,92,5,go,"('CHI', 'MOT')",Providence,nai74.xml,95,3,1,MOT,917,1126,CHI
1,0,0,7,1.791759469,7,0,oh,"('MOT', 'FAT')",Providence,nai74.xml,8,1,1,FAT,68,56,MOT
1,0,1,10,1.791759469,10,0,in,"('TOY', 'CHI')",Providence,nai74.xml,12,2,1,CHI,134,113,TOY
1,0,1,10,1.791759469,10,0,with,"('TOY', 'CHI')",Providence,nai74.xml,12,2,1,CHI,134,113,TOY
1,0,1,10,1.791759469,10,0,on,"('TOY', 'CHI')",Providence,nai74.xml,12,2,1,CHI,134,113,TOY
1,5,10,226,1.787476807,231,5,my,"('MOT', 'CHI')",Providence,nai74.xml,242,11,1,CHI,3068,2445,MOT
0,3,2,90,1.781288169,93,3,like,"('CHI', 'MOT')",Providence,nai74.xml,95,2,0,MOT,917,1126,CHI
0,3,8,231,1.774952351,234,3,all,"('MOT', 'CHI')",Providence,nai74.xml,242,8,0,CHI,3068,2445,MOT
1,3,5,86,1.738270784,89,3,up,"('CHI', 'MOT')",Providence,nai74.xml,95,6,1,MOT,917,1126,CHI
4,7,4,80,1.716047647,87,7,he,"('CHI', 'MOT')",Providence,nai74.xml,95,8,4,MOT,917,1126,CHI
0,3,9,230,1.67539588,233,3,little,"('MOT', 'CHI')",Providence,nai74.xml,242,9,0,CHI,3068,2445,MOT
1,1,0,13,1.673976434,14,1,she,"('ADU', 'MOT')",Providence,nai74.xml,15,1,1,MOT,84,222,ADU
0,5,1,89,1.673976434,94,5,get,"('CHI', 'MOT')",Providence,nai74.xml,95,1,0,MOT,917,1126,CHI
1,8,1,85,1.663505134,93,8,gonna,"('CHI', 'MOT')",Providence,nai74.xml,95,2,1,MOT,917,1126,CHI
1,2,25,214,1.646825445,216,2,oh,"('MOT', 'CHI')",Providence,nai74.xml,242,26,1,CHI,3068,2445,MOT
1,1,13,80,1.646251886,81,1,no,"('CHI', 'MOT')",Providence,nai74.xml,95,14,1,MOT,917,1126,CHI
1,5,3,86,1.642227735,91,5,of,"('CHI', 'MOT')",Providence,nai74.xml,95,4,1,MOT,917,1126,CHI
2,8,12,220,1.566878298,228,8,up,"('MOT', 'CHI')",Providence,nai74.xml,242,14,2,CHI,3068,2445,MOT
0,2,14,226,1.566878298,228,2,some,"('MOT', 'CHI')",Providence,nai74.xml,242,14,0,CHI,3068,2445,MOT
0,6,1,88,1.519825754,94,6,can,"('CHI', 'MOT')",Providence,nai74.xml,95,1,0,MOT,917,1126,CHI
0,7,1,87,1.386294361,94,7,we,"('CHI', 'MOT')",Providence,nai74.xml,95,1,0,MOT,917,1126,CHI
1,0,0,4,1.386294361,4,0,up,"('MOT', 'TOY')",Providence,nai74.xml,5,1,1,TOY,39,58,MOT
1,0,1,6,1.386294361,6,0,the,"('MOT', 'FAT')",Providence,nai74.xml,8,2,1,FAT,68,56,MOT
0,5,8,229,1.369487243,234,5,have,"('MOT', 'CHI')",Providence,nai74.xml,242,8,0,CHI,3068,2445,MOT
1,10,8,223,1.356942149,233,10,want,"('MOT', 'CHI')",Providence,nai74.xml,242,9,1,CHI,3068,2445,MOT
1,6,14,221,1.347745691,227,6,see,"('MOT', 'CHI')",Providence,nai74.xml,242,15,1,CHI,3068,2445,MOT
2,11,12,217,1.279196226,228,11,there,"('MOT', 'CHI')",Providence,nai74.xml,242,14,2,CHI,3068,2445,MOT
0,6,8,228,1.215336563,234,6,wanna,"('MOT', 'CHI')",Providence,nai74.xml,242,8,0,CHI,3068,2445,MOT
6,13,24,199,1.207092932,212,13,in,"('MOT', 'CHI')",Providence,nai74.xml,242,30,6,CHI,3068,2445,MOT
4,0,0,2,1.203972804,2,0,my,"('CHI', 'TOY')",Providence,nai74.xml,6,4,4,TOY,62,85,CHI
0,3,5,87,1.189584067,90,3,want,"('CHI', 'MOT')",Providence,nai74.xml,95,5,0,MOT,917,1126,CHI
1,4,24,213,1.176944132,217,4,do,"('MOT', 'CHI')",Providence,nai74.xml,242,25,1,CHI,3068,2445,MOT
0,3,16,223,1.15267951,226,3,for,"('MOT', 'CHI')",Providence,nai74.xml,242,16,0,CHI,3068,2445,MOT
1,11,2,81,1.142097401,92,11,do,"('CHI', 'MOT')",Providence,nai74.xml,95,3,1,MOT,917,1126,CHI
2,12,13,215,1.134171591,227,12,not,"('MOT', 'CHI')",Providence,nai74.xml,242,15,2,CHI,3068,2445,MOT
2,0,1,3,1.098612289,3,0,to,"('CHI', 'TOY')",Providence,nai74.xml,6,3,2,TOY,62,85,CHI
3,13,4,75,1.049822124,88,13,to,"('CHI', 'MOT')",Providence,nai74.xml,95,7,3,MOT,917,1126,CHI
1,6,6,82,1.049822124,88,6,and,"('CHI', 'MOT')",Providence,nai74.xml,95,7,1,MOT,917,1126,CHI
3,29,6,204,1.046787221,233,29,no,"('MOT', 'CHI')",Providence,nai74.xml,242,9,3,CHI,3068,2445,MOT
1,7,5,82,1.045123604,89,7,is,"('CHI', 'MOT')",Providence,nai74.xml,95,6,1,MOT,917,1126,CHI
11,16,36,179,1.043076736,195,16,a,"('MOT', 'CHI')",Providence,nai74.xml,242,47,11,CHI,3068,2445,MOT
0,1,1,13,0.980829253,14,1,oh,"('ADU', 'MOT')",Providence,nai74.xml,15,1,0,MOT,84,222,ADU
0,1,1,13,0.980829253,14,1,was,"('ADU', 'MOT')",Providence,nai74.xml,15,1,0,MOT,84,222,ADU
0,1,1,13,0.980829253,14,1,see,"('ADU', 'MOT')",Providence,nai74.xml,15,1,0,MOT,84,222,ADU
0,1,1,13,0.980829253,14,1,that,"('ADU', 'MOT')",Providence,nai74.xml,15,1,0,MOT,84,222,ADU
0,1,1,13,0.980829253,14,1,the,"('ADU', 'MOT')",Providence,nai74.xml,15,1,0,MOT,84,222,ADU
0,1,1,13,0.980829253,14,1,on,"('ADU', 'MOT')",Providence,nai74.xml,15,1,0,MOT,84,222,ADU
0,8,2,85,0.970357953,93,8,for,"('CHI', 'MOT')",Providence,nai74.xml,95,2,0,MOT,917,1126,CHI
1,9,4,81,0.966440516,90,9,on,"('CHI', 'MOT')",Providence,nai74.xml,95,5,1,MOT,917,1126,CHI
1,1,1,7,0.916290732,8,1,the,"('FAT', 'CHI')",Providence,nai74.xml,10,2,1,CHI,65,96,FAT
1,0,1,3,0.916290732,3,0,a,"('MOT', 'TOY')",Providence,nai74.xml,5,2,1,TOY,39,58,MOT
3,7,12,73,0.880358723,80,7,in,"('CHI', 'MOT')",Providence,nai74.xml,95,15,3,MOT,917,1126,CHI
0,10,7,225,0.872940291,235,10,but,"('MOT', 'CHI')",Providence,nai74.xml,242,7,0,CHI,3068,2445,MOT
1,12,3,79,0.869037847,91,12,that,"('CHI', 'MOT')",Providence,nai74.xml,95,4,1,MOT,917,1126,CHI
1,10,15,216,0.834225779,226,10,with,"('MOT', 'CHI')",Providence,nai74.xml,242,16,1,CHI,3068,2445,MOT
0,3,24,215,0.749236647,218,3,can,"('MOT', 'CHI')",Providence,nai74.xml,242,24,0,CHI,3068,2445,MOT
0,8,3,84,0.736632292,92,8,with,"('CHI', 'MOT')",Providence,nai74.xml,95,3,0,MOT,917,1126,CHI
1,25,6,210,0.705886206,235,25,yeah,"('MOT', 'CHI')",Providence,nai74.xml,242,7,1,CHI,3068,2445,MOT
1,1,1,5,0.693147181,6,1,and,"('MOT', 'FAT')",Providence,nai74.xml,8,2,1,FAT,68,56,MOT
4,13,9,69,0.693147181,82,13,a,"('CHI', 'MOT')",Providence,nai74.xml,95,13,4,MOT,917,1126,CHI
2,16,16,208,0.69020167,224,16,and,"('MOT', 'CHI')",Providence,nai74.xml,242,18,2,CHI,3068,2445,MOT
7,15,11,62,0.680568398,77,15,it,"('CHI', 'MOT')",Providence,nai74.xml,95,18,7,MOT,917,1126,CHI
0,4,21,217,0.662239643,221,4,on,"('MOT', 'CHI')",Providence,nai74.xml,242,21,0,CHI,3068,2445,MOT
2,1,0,2,0.628608659,3,1,my,"('MOT', 'TOY')",Providence,nai74.xml,5,2,2,TOY,39,58,MOT
1,7,26,208,0.626307162,215,7,what,"('MOT', 'CHI')",Providence,nai74.xml,242,27,1,CHI,3068,2445,MOT
0,2,13,80,0.624154309,82,2,my,"('CHI', 'MOT')",Providence,nai74.xml,95,13,0,MOT,917,1126,CHI
0,7,14,221,0.586049045,228,7,go,"('MOT', 'CHI')",Providence,nai74.xml,242,14,0,CHI,3068,2445,MOT
0,11,9,222,0.576783592,233,11,he,"('MOT', 'CHI')",Providence,nai74.xml,242,9,0,CHI,3068,2445,MOT
0,2,1,12,0.575364145,14,2,but,"('ADU', 'MOT')",Providence,nai74.xml,15,1,0,MOT,84,222,ADU
0,2,1,12,0.575364145,14,2,wanna,"('ADU', 'MOT')",Providence,nai74.xml,15,1,0,MOT,84,222,ADU
1,1,1,4,0.559615788,5,1,that,"('MOT', 'ADU')",Providence,nai74.xml,7,2,1,ADU,97,67,MOT
16,13,86,127,0.505592173,140,13,you,"('MOT', 'CHI')",Providence,nai74.xml,242,102,16,CHI,3068,2445,MOT
0,7,5,83,0.496436886,90,7,but,"('CHI', 'MOT')",Providence,nai74.xml,95,5,0,MOT,917,1126,CHI
5,15,12,63,0.456758402,78,15,the,"('CHI', 'MOT')",Providence,nai74.xml,95,17,5,MOT,917,1126,CHI
0,10,12,220,0.409784769,230,10,of,"('MOT', 'CHI')",Providence,nai74.xml,242,12,0,CHI,3068,2445,MOT
5,19,34,184,0.405465108,203,19,to,"('MOT', 'CHI')",Providence,nai74.xml,242,39,5,CHI,3068,2445,MOT
0,1,1,6,0.405465108,7,1,to,"('MOT', 'FAT')",Providence,nai74.xml,8,1,0,FAT,68,56,MOT
0,4,27,211,0.403163611,215,4,are,"('MOT', 'CHI')",Providence,nai74.xml,242,27,0,CHI,3068,2445,MOT
18,31,51,142,0.380809173,173,31,the,"('MOT', 'CHI')",Providence,nai74.xml,242,69,18,CHI,3068,2445,MOT
0,10,4,81,0.342944751,91,10,see,"('CHI', 'MOT')",Providence,nai74.xml,95,4,0,MOT,917,1126,CHI
1,1,2,4,0.336472237,5,1,you,"('MOT', 'FAT')",Providence,nai74.xml,8,3,1,FAT,68,56,MOT
1,2,0,2,0.287682072,4,2,in,"('MOT', 'TOY')",Providence,nai74.xml,5,1,1,TOY,39,58,MOT
0,1,1,5,0.287682072,6,1,oh,"('MOT', 'ADU')",Providence,nai74.xml,7,1,0,ADU,97,67,MOT
0,1,1,5,0.287682072,6,1,gonna,"('MOT', 'ADU')",Providence,nai74.xml,7,1,0,ADU,97,67,MOT
2,2,3,5,0.251314428,7,2,a,"('TOY', 'CHI')",Providence,nai74.xml,12,5,2,CHI,134,113,TOY
0,14,3,78,0.225806669,92,14,oh,"('CHI', 'MOT')",Providence,nai74.xml,95,3,0,MOT,917,1126,CHI
0,1,1,4,0.15415068,5,1,the,"('CHI', 'TOY')",Providence,nai74.xml,6,1,0,TOY,62,85,CHI
3,16,38,185,0.10508688,201,16,it,"('MOT', 'CHI')",Providence,nai74.xml,242,41,3,CHI,3068,2445,MOT
0,10,18,214,0.026907453,224,10,this,"('MOT', 'CHI')",Providence,nai74.xml,242,18,0,CHI,3068,2445,MOT
0,1,1,3,0,4,1,you,"('FAT', 'MOT')",Providence,nai74.xml,5,1,0,MOT,58,32,FAT
0,1,1,3,0,4,1,and,"('FAT', 'MOT')",Providence,nai74.xml,5,1,0,MOT,58,32,FAT
0,2,2,8,0,10,2,to,"('TOY', 'CHI')",Providence,nai74.xml,12,2,0,CHI,134,113,TOY
0,3,2,10,-0.064538521,13,3,you,"('ADU', 'MOT')",Providence,nai74.xml,15,2,0,MOT,84,222,ADU
2,15,37,188,-0.064538521,203,15,that,"('MOT', 'CHI')",Providence,nai74.xml,242,39,2,CHI,3068,2445,MOT
0,3,1,6,-0.087011377,9,3,it,"('FAT', 'CHI')",Providence,nai74.xml,10,1,0,CHI,65,96,FAT
2,23,26,191,-0.105360516,214,23,is,"('MOT', 'CHI')",Providence,nai74.xml,242,28,2,CHI,3068,2445,MOT
0,5,1,9,-0.117783036,14,5,yeah,"('ADU', 'MOT')",Providence,nai74.xml,15,1,0,MOT,84,222,ADU
1,25,5,64,-0.133531393,89,25,you,"('CHI', 'MOT')",Providence,nai74.xml,95,6,1,MOT,917,1126,CHI
0,1,1,2,-0.182321557,3,1,gonna,"('CHI', 'FAT')",Providence,nai74.xml,4,1,0,FAT,38,24,CHI
0,2,1,3,-0.251314428,5,2,in,"('CHI', 'TOY')",Providence,nai74.xml,6,1,0,TOY,62,85,CHI
0,1,2,2,-0.470003629,3,1,that,"('FAT', 'MOT')",Providence,nai74.xml,5,2,0,MOT,58,32,FAT
0,1,3,3,-0.510825624,4,1,we,"('MOT', 'ADU')",Providence,nai74.xml,7,3,0,ADU,97,67,MOT
0,2,2,3,-0.538996501,5,2,it,"('MOT', 'ADU')",Providence,nai74.xml,7,2,0,ADU,97,67,MOT
0,2,2,2,-0.693147181,4,2,for,"('CHI', 'TOY')",Providence,nai74.xml,6,2,0,TOY,62,85,CHI
0,2,2,2,-0.693147181,4,2,a,"('CHI', 'TOY')",Providence,nai74.xml,6,2,0,TOY,62,85,CHI
0,2,2,2,-0.693147181,4,2,on,"('CHI', 'TOY')",Providence,nai74.xml,6,2,0,TOY,62,85,CHI
0,10,14,71,-0.751643387,81,10,yeah,"('CHI', 'MOT')",Providence,nai74.xml,95,14,0,MOT,917,1126,CHI
0,2,3,1,-1.098612289,3,2,is,"('CHI', 'TOY')",Providence,nai74.xml,6,3,0,TOY,62,85,CHI
1,3,1,248,3.453947947,251,3,wanna,"('CHI', 'MOT')",Providence,nai75.xml,253,2,1,MOT,3590,3351,CHI
0,1,2,250,3.453947947,251,1,big,"('CHI', 'MOT')",Providence,nai75.xml,253,2,0,MOT,3590,3351,CHI
3,10,2,238,2.563949857,248,10,all,"('CHI', 'MOT')",Providence,nai75.xml,253,5,3,MOT,3590,3351,CHI
0,2,5,246,2.47693848,248,2,they,"('CHI', 'MOT')",Providence,nai75.xml,253,5,0,MOT,3590,3351,CHI
2,7,4,240,2.457182102,247,7,up,"('CHI', 'MOT')",Providence,nai75.xml,253,6,2,MOT,3590,3351,CHI
0,5,2,246,2.355335658,251,5,want,"('CHI', 'MOT')",Providence,nai75.xml,253,2,0,MOT,3590,3351,CHI
1,6,5,241,2.185248386,247,6,some,"('CHI', 'MOT')",Providence,nai75.xml,253,6,1,MOT,3590,3351,CHI
1,5,7,240,2.108190955,245,5,where,"('CHI', 'MOT')",Providence,nai75.xml,253,8,1,MOT,3590,3351,CHI
1,8,4,240,2.071473372,248,8,she,"('CHI', 'MOT')",Providence,nai75.xml,253,5,1,MOT,3590,3351,CHI
0,3,6,244,2.051716994,247,3,one,"('CHI', 'MOT')",Providence,nai75.xml,253,6,0,MOT,3590,3351,CHI
0,10,1,242,2.040826706,252,10,think,"('CHI', 'MOT')",Providence,nai75.xml,253,1,0,MOT,3590,3351,CHI
1,6,7,239,1.954040275,245,6,like,"('CHI', 'MOT')",Providence,nai75.xml,253,8,1,MOT,3590,3351,CHI
3,13,6,231,1.854673295,244,13,we,"('CHI', 'MOT')",Providence,nai75.xml,253,9,3,MOT,3590,3351,CHI
1,7,7,238,1.820508883,245,7,put,"('CHI', 'MOT')",Providence,nai75.xml,253,8,1,MOT,3590,3351,CHI
0,14,1,238,1.730671777,252,14,see,"('CHI', 'MOT')",Providence,nai75.xml,253,1,0,MOT,3590,3351,CHI
0,3,9,241,1.721141902,244,3,he,"('CHI', 'MOT')",Providence,nai75.xml,253,9,0,MOT,3590,3351,CHI
0,7,4,242,1.654251928,249,7,get,"('CHI', 'MOT')",Providence,nai75.xml,253,4,0,MOT,3590,3351,CHI
5,12,16,220,1.546637011,232,12,in,"('CHI', 'MOT')",Providence,nai75.xml,253,21,5,MOT,3590,3351,CHI
3,14,9,227,1.532248274,241,14,with,"('CHI', 'MOT')",Providence,nai75.xml,253,12,3,MOT,3590,3351,CHI
0,5,7,241,1.5244447,246,5,look,"('CHI', 'MOT')",Providence,nai75.xml,253,7,0,MOT,3590,3351,CHI
4,13,13,223,1.498212277,236,13,what,"('CHI', 'MOT')",Providence,nai75.xml,253,17,4,MOT,3590,3351,CHI
0,7,6,240,1.358569813,247,7,make,"('CHI', 'MOT')",Providence,nai75.xml,253,6,0,MOT,3590,3351,CHI
1,7,13,232,1.32591385,239,7,was,"('CHI', 'MOT')",Providence,nai75.xml,253,14,1,MOT,3590,3351,CHI
1,15,6,231,1.236762627,246,15,do,"('CHI', 'MOT')",Providence,nai75.xml,253,7,1,MOT,3590,3351,CHI
0,6,9,238,1.161526114,244,6,did,"('CHI', 'MOT')",Providence,nai75.xml,253,9,0,MOT,3590,3351,CHI
1,10,11,231,1.149256021,241,10,not,"('CHI', 'MOT')",Providence,nai75.xml,253,12,1,MOT,3590,3351,CHI
4,18,14,217,1.137326801,235,18,on,"('CHI', 'MOT')",Providence,nai75.xml,253,18,4,MOT,3590,3351,CHI
1,18,6,228,1.06491237,246,18,there,"('CHI', 'MOT')",Providence,nai75.xml,253,7,1,MOT,3590,3351,CHI
1,22,5,225,0.995664319,247,22,for,"('CHI', 'MOT')",Providence,nai75.xml,253,6,1,MOT,3590,3351,CHI
1,9,16,227,0.918393782,236,9,gonna,"('CHI', 'MOT')",Providence,nai75.xml,253,17,1,MOT,3590,3351,CHI
1,20,7,225,0.855427986,245,20,of,"('CHI', 'MOT')",Providence,nai75.xml,253,8,1,MOT,3590,3351,CHI
1,15,10,227,0.852777326,242,15,have,"('CHI', 'MOT')",Providence,nai75.xml,253,11,1,MOT,3590,3351,CHI
4,9,40,200,0.830069556,209,9,no,"('CHI', 'MOT')",Providence,nai75.xml,253,44,4,MOT,3590,3351,CHI
2,15,17,219,0.745332934,234,15,go,"('CHI', 'MOT')",Providence,nai75.xml,253,19,2,MOT,3590,3351,CHI
0,19,4,230,0.737961196,249,19,can,"('CHI', 'MOT')",Providence,nai75.xml,253,4,0,MOT,3590,3351,CHI
0,10,9,234,0.70954099,244,10,at,"('CHI', 'MOT')",Providence,nai75.xml,253,9,0,MOT,3590,3351,CHI
12,41,20,180,0.708090986,221,41,a,"('CHI', 'MOT')",Providence,nai75.xml,253,32,12,MOT,3590,3351,CHI
1,13,16,223,0.581921545,236,13,this,"('CHI', 'MOT')",Providence,nai75.xml,253,17,1,MOT,3590,3351,CHI
1,19,11,222,0.551419021,241,19,my,"('CHI', 'MOT')",Providence,nai75.xml,253,12,1,MOT,3590,3351,CHI
12,37,32,172,0.450579935,209,37,to,"('CHI', 'MOT')",Providence,nai75.xml,253,44,12,MOT,3590,3351,CHI
35,45,49,124,0.442193802,169,45,the,"('CHI', 'MOT')",Providence,nai75.xml,253,84,35,MOT,3590,3351,CHI
3,63,5,182,0.434214521,245,63,oh,"('CHI', 'MOT')",Providence,nai75.xml,253,8,3,MOT,3590,3351,CHI
7,26,33,187,0.416573086,213,26,it,"('CHI', 'MOT')",Providence,nai75.xml,253,40,7,MOT,3590,3351,CHI
6,26,30,191,0.401558853,217,26,and,"('CHI', 'MOT')",Providence,nai75.xml,253,36,6,MOT,3590,3351,CHI
7,35,25,186,0.37673385,221,35,is,"('CHI', 'MOT')",Providence,nai75.xml,253,32,7,MOT,3590,3351,CHI
0,7,20,226,0.289101519,233,7,but,"('CHI', 'MOT')",Providence,nai75.xml,253,20,0,MOT,3590,3351,CHI
0,16,10,227,0.183138217,243,16,are,"('CHI', 'MOT')",Providence,nai75.xml,253,10,0,MOT,3590,3351,CHI
3,37,17,196,0.117251262,233,37,that,"('CHI', 'MOT')",Providence,nai75.xml,253,20,3,MOT,3590,3351,CHI
8,67,25,153,-0.174953807,220,67,you,"('CHI', 'MOT')",Providence,nai75.xml,253,33,8,MOT,3590,3351,CHI
0,8,31,214,-0.282086087,222,8,yeah,"('CHI', 'MOT')",Providence,nai75.xml,253,31,0,MOT,3590,3351,CHI
1,0,1,162,4.406719247,162,0,she,"('MOT', 'CHI')",Providence,nai76.xml,164,2,1,CHI,1989,1585,MOT
0,1,1,167,3.344038968,168,1,where,"('CHI', 'MOT')",Providence,nai76.xml,169,1,0,MOT,1600,2424,CHI
0,1,1,162,3.314186005,163,1,he,"('MOT', 'CHI')",Providence,nai76.xml,164,1,0,CHI,1989,1585,MOT
0,1,1,162,3.314186005,163,1,where,"('MOT', 'CHI')",Providence,nai76.xml,164,1,0,CHI,1989,1585,MOT
1,1,3,159,3.295836866,160,1,go,"('MOT', 'CHI')",Providence,nai76.xml,164,4,1,CHI,1989,1585,MOT
0,2,1,166,2.93857386,168,2,look,"('CHI', 'MOT')",Providence,nai76.xml,169,1,0,MOT,1600,2424,CHI
0,2,1,166,2.93857386,168,2,she,"('CHI', 'MOT')",Providence,nai76.xml,169,1,0,MOT,1600,2424,CHI
2,2,5,160,2.90264185,162,2,was,"('CHI', 'MOT')",Providence,nai76.xml,169,7,2,MOT,1600,2424,CHI
0,1,3,160,2.791165108,161,1,want,"('MOT', 'CHI')",Providence,nai76.xml,164,3,0,CHI,1989,1585,MOT
0,1,3,160,2.791165108,161,1,there,"('MOT', 'CHI')",Providence,nai76.xml,164,3,0,CHI,1989,1585,MOT
0,1,3,160,2.791165108,161,1,my,"('MOT', 'CHI')",Providence,nai76.xml,164,3,0,CHI,1989,1585,MOT
1,3,2,158,2.791165108,161,3,some,"('MOT', 'CHI')",Providence,nai76.xml,164,3,1,CHI,1989,1585,MOT
1,7,0,161,2.650891787,168,7,yeah,"('CHI', 'MOT')",Providence,nai76.xml,169,1,1,MOT,1600,2424,CHI
0,3,1,165,2.650891787,168,3,one,"('CHI', 'MOT')",Providence,nai76.xml,169,1,0,MOT,1600,2424,CHI
0,3,1,165,2.650891787,168,3,big,"('CHI', 'MOT')",Providence,nai76.xml,169,1,0,MOT,1600,2424,CHI
1,2,5,156,2.590267165,158,2,they,"('MOT', 'CHI')",Providence,nai76.xml,164,6,1,CHI,1989,1585,MOT
1,3,4,161,2.472930459,164,3,he,"('CHI', 'MOT')",Providence,nai76.xml,169,5,1,MOT,1600,2424,CHI
0,1,6,157,2.302585093,158,1,with,"('MOT', 'CHI')",Providence,nai76.xml,164,6,0,CHI,1989,1585,MOT
0,5,1,163,2.245426679,168,5,did,"('CHI', 'MOT')",Providence,nai76.xml,169,1,0,MOT,1600,2424,CHI
0,2,4,158,2.197224577,160,2,but,"('MOT', 'CHI')",Providence,nai76.xml,164,4,0,CHI,1989,1585,MOT
3,8,4,154,2.091711634,162,8,they,"('CHI', 'MOT')",Providence,nai76.xml,169,7,3,MOT,1600,2424,CHI
0,6,1,162,2.091275999,168,6,but,"('CHI', 'MOT')",Providence,nai76.xml,169,1,0,MOT,1600,2424,CHI
1,10,1,157,2.038856262,167,10,at,"('CHI', 'MOT')",Providence,nai76.xml,169,2,1,MOT,1600,2424,CHI
0,2,5,157,2.036881927,159,2,put,"('MOT', 'CHI')",Providence,nai76.xml,164,5,0,CHI,1989,1585,MOT
2,13,1,153,1.974081026,166,13,get,"('CHI', 'MOT')",Providence,nai76.xml,169,3,2,MOT,1600,2424,CHI
0,2,6,161,1.927891644,163,2,put,"('CHI', 'MOT')",Providence,nai76.xml,169,6,0,MOT,1600,2424,CHI
0,5,2,157,1.921812597,162,5,get,"('MOT', 'CHI')",Providence,nai76.xml,164,2,0,CHI,1989,1585,MOT
2,4,10,148,1.887069649,152,4,like,"('MOT', 'CHI')",Providence,nai76.xml,164,12,2,CHI,1989,1585,MOT
0,4,3,157,1.874874376,161,4,wanna,"('MOT', 'CHI')",Providence,nai76.xml,164,3,0,CHI,1989,1585,MOT
0,1,10,153,1.871802177,154,1,can,"('MOT', 'CHI')",Providence,nai76.xml,164,10,0,CHI,1989,1585,MOT
2,8,5,154,1.804029562,162,8,there,"('CHI', 'MOT')",Providence,nai76.xml,169,7,2,MOT,1600,2424,CHI
0,1,11,152,1.785328579,153,1,have,"('MOT', 'CHI')",Providence,nai76.xml,164,11,0,CHI,1989,1585,MOT
0,1,11,152,1.785328579,153,1,think,"('MOT', 'CHI')",Providence,nai76.xml,164,11,0,CHI,1989,1585,MOT
1,7,4,157,1.779783278,164,7,all,"('CHI', 'MOT')",Providence,nai76.xml,169,5,1,MOT,1600,2424,CHI
1,6,5,157,1.773740964,163,6,go,"('CHI', 'MOT')",Providence,nai76.xml,169,6,1,MOT,1600,2424,CHI
0,2,7,155,1.773067336,157,2,little,"('MOT', 'CHI')",Providence,nai76.xml,164,7,0,CHI,1989,1585,MOT
0,2,7,155,1.773067336,157,2,up,"('MOT', 'CHI')",Providence,nai76.xml,164,7,0,CHI,1989,1585,MOT
2,10,4,153,1.727220948,163,10,some,"('CHI', 'MOT')",Providence,nai76.xml,169,6,2,MOT,1600,2424,CHI
3,8,8,145,1.667545543,153,8,was,"('MOT', 'CHI')",Providence,nai76.xml,164,11,3,CHI,1989,1585,MOT
0,7,2,160,1.664162812,167,7,make,"('CHI', 'MOT')",Providence,nai76.xml,169,2,0,MOT,1600,2424,CHI
0,7,2,160,1.664162812,167,7,my,"('CHI', 'MOT')",Providence,nai76.xml,169,2,0,MOT,1600,2424,CHI
1,8,4,156,1.662000243,164,8,up,"('CHI', 'MOT')",Providence,nai76.xml,169,5,1,MOT,1600,2424,CHI
0,2,8,154,1.661397651,156,2,at,"('MOT', 'CHI')",Providence,nai76.xml,164,8,0,CHI,1989,1585,MOT
0,10,1,158,1.639290876,168,10,see,"('CHI', 'MOT')",Providence,nai76.xml,169,1,0,MOT,1600,2424,CHI
2,6,9,147,1.631177899,153,6,what,"('MOT', 'CHI')",Providence,nai76.xml,164,11,2,CHI,1989,1585,MOT
2,8,7,152,1.591088774,160,8,on,"('CHI', 'MOT')",Providence,nai76.xml,169,9,2,MOT,1600,2424,CHI
0,8,2,159,1.546379776,167,8,with,"('CHI', 'MOT')",Providence,nai76.xml,169,2,0,MOT,1600,2424,CHI
0,5,4,155,1.504077397,160,5,all,"('MOT', 'CHI')",Providence,nai76.xml,164,4,0,CHI,1989,1585,MOT
1,12,3,153,1.454432166,165,12,little,"('CHI', 'MOT')",Providence,nai76.xml,169,4,1,MOT,1600,2424,CHI
1,15,2,151,1.435084525,166,15,do,"('CHI', 'MOT')",Providence,nai76.xml,169,3,1,MOT,1600,2424,CHI
0,13,1,155,1.398128819,168,13,think,"('CHI', 'MOT')",Providence,nai76.xml,169,1,0,MOT,1600,2424,CHI
0,5,5,154,1.343734747,159,5,not,"('MOT', 'CHI')",Providence,nai76.xml,164,5,0,CHI,1989,1585,MOT
5,8,18,133,1.338503697,141,8,and,"('MOT', 'CHI')",Providence,nai76.xml,164,23,5,CHI,1989,1585,MOT
1,10,5,153,1.32175584,163,10,like,"('CHI', 'MOT')",Providence,nai76.xml,169,6,1,MOT,1600,2424,CHI
1,15,3,145,1.216395324,160,15,no,"('MOT', 'CHI')",Providence,nai76.xml,164,4,1,CHI,1989,1585,MOT
2,9,11,147,1.150572028,156,9,for,"('CHI', 'MOT')",Providence,nai76.xml,169,13,2,MOT,1600,2424,CHI
0,8,4,152,1.098612289,160,8,on,"('MOT', 'CHI')",Providence,nai76.xml,164,4,0,CHI,1989,1585,MOT
0,4,9,151,1.04891262,155,4,we,"('MOT', 'CHI')",Providence,nai76.xml,164,9,0,CHI,1989,1585,MOT
0,11,3,155,1.029619417,166,11,we,"('CHI', 'MOT')",Providence,nai76.xml,169,3,0,MOT,1600,2424,CHI
1,11,7,150,0.999405639,161,11,have,"('CHI', 'MOT')",Providence,nai76.xml,169,8,1,MOT,1600,2424,CHI
1,0,0,2,0.980829253,2,0,you,"('MOT', 'FAT')",Providence,nai76.xml,3,1,1,FAT,21,31,MOT
2,9,13,140,0.980093688,149,9,in,"('MOT', 'CHI')",Providence,nai76.xml,164,15,2,CHI,1989,1585,MOT
0,5,8,151,0.968250471,156,5,one,"('MOT', 'CHI')",Providence,nai76.xml,164,8,0,CHI,1989,1585,MOT
2,16,7,144,0.955100007,160,16,in,"('CHI', 'MOT')",Providence,nai76.xml,169,9,2,MOT,1600,2424,CHI
0,8,5,151,0.938269639,159,8,do,"('MOT', 'CHI')",Providence,nai76.xml,164,5,0,CHI,1989,1585,MOT
4,13,16,136,0.896617966,149,13,this,"('CHI', 'MOT')",Providence,nai76.xml,169,20,4,MOT,1600,2424,CHI
0,13,3,153,0.875468737,166,13,can,"('CHI', 'MOT')",Providence,nai76.xml,169,3,0,MOT,1600,2424,CHI
0,4,11,149,0.869037847,153,4,yeah,"('MOT', 'CHI')",Providence,nai76.xml,164,11,0,CHI,1989,1585,MOT
10,19,21,119,0.84729786,138,19,is,"('CHI', 'MOT')",Providence,nai76.xml,169,31,10,MOT,1600,2424,CHI
0,11,4,154,0.841327693,165,11,are,"('CHI', 'MOT')",Providence,nai76.xml,169,4,0,MOT,1600,2424,CHI
4,22,9,134,0.828488528,156,22,it,"('CHI', 'MOT')",Providence,nai76.xml,169,13,4,MOT,1600,2424,CHI
0,7,7,155,0.823200309,162,7,not,"('CHI', 'MOT')",Providence,nai76.xml,169,7,0,MOT,1600,2424,CHI
4,32,5,123,0.771280884,155,32,this,"('MOT', 'CHI')",Providence,nai76.xml,164,9,4,CHI,1989,1585,MOT
9,17,24,114,0.747214402,131,17,it,"('MOT', 'CHI')",Providence,nai76.xml,164,33,9,CHI,1989,1585,MOT
0,7,8,149,0.680568398,156,7,make,"('MOT', 'CHI')",Providence,nai76.xml,164,8,0,CHI,1989,1585,MOT
3,7,29,125,0.678332095,132,7,that,"('MOT', 'CHI')",Providence,nai76.xml,164,32,3,CHI,1989,1585,MOT
2,17,10,140,0.638087403,157,17,gonna,"('CHI', 'MOT')",Providence,nai76.xml,169,12,2,MOT,1600,2424,CHI
6,13,29,116,0.57113223,129,13,a,"('MOT', 'CHI')",Providence,nai76.xml,164,35,6,CHI,1989,1585,MOT
6,30,12,121,0.546628592,151,30,a,"('CHI', 'MOT')",Providence,nai76.xml,169,18,6,MOT,1600,2424,CHI
6,12,32,114,0.544111601,126,12,you,"('MOT', 'CHI')",Providence,nai76.xml,164,38,6,CHI,1989,1585,MOT
0,6,11,147,0.53256561,153,6,oh,"('MOT', 'CHI')",Providence,nai76.xml,164,11,0,CHI,1989,1585,MOT
5,20,20,124,0.435006787,144,20,and,"('CHI', 'MOT')",Providence,nai76.xml,169,25,5,MOT,1600,2424,CHI
1,15,10,143,0.430782916,158,15,what,"('CHI', 'MOT')",Providence,nai76.xml,169,11,1,MOT,1600,2424,CHI
0,8,10,146,0.36772478,154,8,of,"('MOT', 'CHI')",Providence,nai76.xml,164,10,0,CHI,1989,1585,MOT
0,6,14,144,0.30538165,150,6,are,"('MOT', 'CHI')",Providence,nai76.xml,164,14,0,CHI,1989,1585,MOT
22,38,30,79,0.262072016,117,38,the,"('CHI', 'MOT')",Providence,nai76.xml,169,52,22,MOT,1600,2424,CHI
1,18,10,140,0.258932659,158,18,of,"('CHI', 'MOT')",Providence,nai76.xml,169,11,1,MOT,1600,2424,CHI
2,26,10,131,0.232622295,157,26,you,"('CHI', 'MOT')",Providence,nai76.xml,169,12,2,MOT,1600,2424,CHI
0,26,3,140,0.218689201,166,26,oh,"('CHI', 'MOT')",Providence,nai76.xml,169,3,0,MOT,1600,2424,CHI
0,7,15,147,0.137201122,154,7,no,"('CHI', 'MOT')",Providence,nai76.xml,169,15,0,MOT,1600,2424,CHI
1,11,22,130,-0.047790664,141,11,to,"('MOT', 'CHI')",Providence,nai76.xml,164,23,1,CHI,1989,1585,MOT
19,38,38,69,-0.054018934,107,38,the,"('MOT', 'CHI')",Providence,nai76.xml,164,57,19,CHI,1989,1585,MOT
0,1,1,1,-0.405465108,2,1,the,"('CHI', 'FAT')",Providence,nai76.xml,3,1,0,FAT,17,28,CHI
0,1,1,1,-0.405465108,2,1,a,"('MOT', 'FAT')",Providence,nai76.xml,3,1,0,FAT,21,31,MOT
0,32,6,131,-0.470003629,163,32,that,"('CHI', 'MOT')",Providence,nai76.xml,169,6,0,MOT,1600,2424,CHI
0,11,18,135,-0.48342665,146,11,for,"('MOT', 'CHI')",Providence,nai76.xml,164,18,0,CHI,1989,1585,MOT
2,34,17,111,-0.510825624,145,34,is,"('MOT', 'CHI')",Providence,nai76.xml,164,19,2,CHI,1989,1585,MOT
0,2,1,0,-0.810930216,2,2,to,"('CHI', 'FAT')",Providence,nai76.xml,3,1,0,FAT,17,28,CHI
1,31,24,113,-1.084818967,144,31,to,"('CHI', 'MOT')",Providence,nai76.xml,169,25,1,MOT,1600,2424,CHI
1,3,2,299,3.414442608,302,3,make,"('CHI', 'MOT')",Providence,nai77.xml,305,3,1,MOT,2713,2892,CHI
2,2,8,293,3.208825489,295,2,but,"('CHI', 'MOT')",Providence,nai77.xml,305,10,2,MOT,2713,2892,CHI
1,4,4,296,2.848226136,300,4,want,"('CHI', 'MOT')",Providence,nai77.xml,305,5,1,MOT,2713,2892,CHI
0,5,1,299,2.833213344,304,5,they,"('CHI', 'MOT')",Providence,nai77.xml,305,1,0,MOT,2713,2892,CHI
0,4,2,299,2.724579503,303,4,where,"('CHI', 'MOT')",Providence,nai77.xml,305,2,0,MOT,2713,2892,CHI
0,3,3,299,2.721295428,302,3,get,"('CHI', 'MOT')",Providence,nai77.xml,305,3,0,MOT,2713,2892,CHI
1,7,2,295,2.721295428,302,7,was,"('CHI', 'MOT')",Providence,nai77.xml,305,3,1,MOT,2713,2892,CHI
1,8,3,293,2.41789594,301,8,some,"('CHI', 'MOT')",Providence,nai77.xml,305,4,1,MOT,2713,2892,CHI
1,6,5,293,2.374905755,299,6,up,"('CHI', 'MOT')",Providence,nai77.xml,305,6,1,MOT,2713,2892,CHI
2,9,6,288,2.193885676,297,9,see,"('CHI', 'MOT')",Providence,nai77.xml,305,8,2,MOT,2713,2892,CHI
0,6,3,296,2.16167964,302,6,little,"('CHI', 'MOT')",Providence,nai77.xml,305,3,0,MOT,2713,2892,CHI
0,11,1,293,2.140066163,304,11,one,"('CHI', 'MOT')",Providence,nai77.xml,305,1,0,MOT,2713,2892,CHI
3,9,9,284,2.131627295,293,9,go,"('CHI', 'MOT')",Providence,nai77.xml,305,12,3,MOT,2713,2892,CHI
3,11,7,284,2.1102132,295,11,can,"('CHI', 'MOT')",Providence,nai77.xml,305,10,3,MOT,2713,2892,CHI
0,10,2,293,1.936122143,303,10,all,"('CHI', 'MOT')",Providence,nai77.xml,305,2,0,MOT,2713,2892,CHI
2,11,7,285,1.912903853,296,11,on,"('CHI', 'MOT')",Providence,nai77.xml,305,9,2,MOT,2713,2892,CHI
1,12,4,288,1.892714691,300,12,at,"('CHI', 'MOT')",Providence,nai77.xml,305,5,1,MOT,2713,2892,CHI
5,13,12,275,1.878144083,288,13,we,"('CHI', 'MOT')",Providence,nai77.xml,305,17,5,MOT,2713,2892,CHI
0,5,6,294,1.835909254,299,5,look,"('CHI', 'MOT')",Providence,nai77.xml,305,6,0,MOT,2713,2892,CHI
1,0,0,7,1.791759469,7,0,one,"('MOT', 'CHI')",Providence,nai77.xml,8,1,1,CHI,58,20,MOT
1,0,1,10,1.791759469,10,0,to,"('FAT', 'MOT')",Providence,nai77.xml,12,2,1,MOT,71,123,FAT
2,14,6,283,1.788420568,297,14,like,"('CHI', 'MOT')",Providence,nai77.xml,305,8,2,MOT,2713,2892,CHI
1,14,4,286,1.749613848,300,14,there,"('CHI', 'MOT')",Providence,nai77.xml,305,5,1,MOT,2713,2892,CHI
4,13,13,275,1.695822527,288,13,in,"('CHI', 'MOT')",Providence,nai77.xml,305,17,4,MOT,2713,2892,CHI
0,7,5,293,1.685075327,300,7,put,"('CHI', 'MOT')",Providence,nai77.xml,305,5,0,MOT,2713,2892,CHI
2,12,9,282,1.659073028,294,12,are,"('CHI', 'MOT')",Providence,nai77.xml,305,11,2,MOT,2713,2892,CHI
0,19,1,285,1.62924054,304,19,yeah,"('CHI', 'MOT')",Providence,nai77.xml,305,1,0,MOT,2713,2892,CHI
2,10,12,281,1.608300903,291,10,not,"('CHI', 'MOT')",Providence,nai77.xml,305,14,2,MOT,2713,2892,CHI
1,20,3,281,1.570598079,301,20,of,"('CHI', 'MOT')",Providence,nai77.xml,305,4,1,MOT,2713,2892,CHI
3,15,11,276,1.521289526,291,15,he,"('CHI', 'MOT')",Providence,nai77.xml,305,14,3,MOT,2713,2892,CHI
1,1,0,10,1.466337069,11,1,a,"('FAT', 'MOT')",Providence,nai77.xml,12,1,1,MOT,71,123,FAT
0,14,3,288,1.399539588,302,14,wanna,"('CHI', 'MOT')",Providence,nai77.xml,305,3,0,MOT,2713,2892,CHI
2,17,9,277,1.333650628,294,17,have,"('CHI', 'MOT')",Providence,nai77.xml,305,11,2,MOT,2713,2892,CHI
2,17,10,276,1.256158557,293,17,what,"('CHI', 'MOT')",Providence,nai77.xml,305,12,2,MOT,2713,2892,CHI
1,3,41,260,1.102393012,263,3,no,"('CHI', 'MOT')",Providence,nai77.xml,305,42,1,MOT,2713,2892,CHI
0,8,9,288,1.101973636,296,8,with,"('CHI', 'MOT')",Providence,nai77.xml,305,9,0,MOT,2713,2892,CHI
7,31,15,252,1.088140989,283,31,it,"('CHI', 'MOT')",Providence,nai77.xml,305,22,7,MOT,2713,2892,CHI
3,28,9,265,1.066916558,293,28,that,"('CHI', 'MOT')",Providence,nai77.xml,305,12,3,MOT,2713,2892,CHI
1,2,0,9,1.060871961,11,2,the,"('FAT', 'MOT')",Providence,nai77.xml,12,1,1,MOT,71,123,FAT
0,7,11,287,1.045968555,294,7,my,"('CHI', 'MOT')",Providence,nai77.xml,305,11,0,MOT,2713,2892,CHI
14,35,28,228,0.920071455,263,35,to,"('CHI', 'MOT')",Providence,nai77.xml,305,42,14,MOT,2713,2892,CHI
1,13,14,277,0.897630309,290,13,gonna,"('CHI', 'MOT')",Providence,nai77.xml,305,15,1,MOT,2713,2892,CHI
0,45,1,259,0.796331417,304,45,oh,"('CHI', 'MOT')",Providence,nai77.xml,305,1,0,MOT,2713,2892,CHI
1,20,10,274,0.77403484,294,20,do,"('CHI', 'MOT')",Providence,nai77.xml,305,11,1,MOT,2713,2892,CHI
0,1,1,10,0.773189888,11,1,up,"('FAT', 'MOT')",Providence,nai77.xml,12,1,0,MOT,71,123,FAT
5,25,26,249,0.657556235,274,25,is,"('CHI', 'MOT')",Providence,nai77.xml,305,31,5,MOT,2713,2892,CHI
2,21,18,264,0.576009598,285,21,for,"('CHI', 'MOT')",Providence,nai77.xml,305,20,2,MOT,2713,2892,CHI
10,35,40,220,0.412208701,255,35,a,"('CHI', 'MOT')",Providence,nai77.xml,305,50,10,MOT,2713,2892,CHI
0,1,2,9,0.405465108,10,1,oh,"('FAT', 'MOT')",Providence,nai77.xml,12,2,0,MOT,71,123,FAT
0,1,1,6,0.405465108,7,1,the,"('MOT', 'CHI')",Providence,nai77.xml,8,1,0,CHI,58,20,MOT
2,22,21,260,0.393216486,282,22,and,"('CHI', 'MOT')",Providence,nai77.xml,305,23,2,MOT,2713,2892,CHI
0,2,1,9,0.36772478,11,2,of,"('FAT', 'MOT')",Providence,nai77.xml,12,1,0,MOT,71,123,FAT
0,2,1,9,0.36772478,11,2,this,"('FAT', 'MOT')",Providence,nai77.xml,12,1,0,MOT,71,123,FAT
12,51,39,203,0.18859117,254,51,the,"('CHI', 'MOT')",Providence,nai77.xml,305,51,12,MOT,2713,2892,CHI
9,61,26,209,0.170334862,270,61,you,"('CHI', 'MOT')",Providence,nai77.xml,305,35,9,MOT,2713,2892,CHI
0,1,1,3,0,4,1,you,"('FAT', 'CHI')",Providence,nai77.xml,5,1,0,CHI,25,19,FAT
0,2,2,8,0,10,2,it,"('FAT', 'MOT')",Providence,nai77.xml,12,2,0,MOT,71,123,FAT
0,5,1,6,-0.3254224,11,5,you,"('FAT', 'MOT')",Providence,nai77.xml,12,1,0,MOT,71,123,FAT
0,17,25,263,-0.544301553,280,17,this,"('CHI', 'MOT')",Providence,nai77.xml,305,25,0,MOT,2713,2892,CHI
1,0,0,125,4.438721978,125,0,wanna,"('CHI', 'GRA')",Providence,nai78.xml,126,1,1,GRA,1386,1238,CHI
1,0,0,125,4.438721978,125,0,big,"('CHI', 'GRA')",Providence,nai78.xml,126,1,1,GRA,1386,1238,CHI
1,0,0,115,4.356708827,115,0,big,"('CHI', 'MOT')",Providence,nai78.xml,116,1,1,MOT,787,1441,CHI
1,0,2,123,3.912023005,123,0,want,"('CHI', 'GRA')",Providence,nai78.xml,126,3,1,GRA,1386,1238,CHI
1,0,2,113,3.828641396,113,0,not,"('CHI', 'MOT')",Providence,nai78.xml,116,3,1,MOT,787,1441,CHI
2,2,0,112,3.36729583,114,2,she,"('CHI', 'MOT')",Providence,nai78.xml,116,2,2,MOT,787,1441,CHI
1,2,0,123,3.34010969,125,2,for,"('CHI', 'GRA')",Providence,nai78.xml,126,1,1,GRA,1386,1238,CHI
3,3,0,110,3.135494216,113,3,one,"('CHI', 'MOT')",Providence,nai78.xml,116,3,3,MOT,787,1441,CHI
1,0,0,32,3.120895417,32,0,wanna,"('GRA', 'MOT')",Providence,nai78.xml,33,1,1,MOT,189,336,GRA
0,1,1,124,3.052427617,125,1,they,"('CHI', 'GRA')",Providence,nai78.xml,126,1,0,GRA,1386,1238,CHI
2,2,2,120,3.028522096,122,2,go,"('CHI', 'GRA')",Providence,nai78.xml,126,4,2,GRA,1386,1238,CHI
1,0,2,45,2.93385687,45,0,one,"('GRA', 'CHI')",Providence,nai78.xml,48,3,1,CHI,456,670,GRA
1,0,2,42,2.867898902,42,0,are,"('MOT', 'GRA')",Providence,nai78.xml,45,3,1,GRA,476,268,MOT
1,0,3,44,2.730029108,44,0,to,"('GRA', 'CHI')",Providence,nai78.xml,48,4,1,CHI,456,670,GRA
2,2,4,118,2.724579503,120,2,no,"('CHI', 'GRA')",Providence,nai78.xml,126,6,2,GRA,1386,1238,CHI
0,1,2,113,2.674148649,114,1,we,"('CHI', 'MOT')",Providence,nai78.xml,116,2,0,MOT,787,1441,CHI
0,2,1,123,2.646962509,125,2,not,"('CHI', 'GRA')",Providence,nai78.xml,126,1,0,GRA,1386,1238,CHI
1,1,5,109,2.63905733,110,1,go,"('CHI', 'MOT')",Providence,nai78.xml,116,6,1,MOT,787,1441,CHI
2,0,6,44,2.624668592,44,0,can,"('MOT', 'CHI')",Providence,nai78.xml,52,8,2,CHI,502,251,MOT
3,5,1,117,2.623056988,122,5,she,"('CHI', 'GRA')",Providence,nai78.xml,126,4,3,GRA,1386,1238,CHI
1,0,13,102,2.564949357,102,0,no,"('CHI', 'MOT')",Providence,nai78.xml,116,14,1,MOT,787,1441,CHI
0,2,1,113,2.564949357,115,2,look,"('CHI', 'MOT')",Providence,nai78.xml,116,1,0,MOT,787,1441,CHI
2,0,6,40,2.533696814,40,0,what,"('GRA', 'CHI')",Providence,nai78.xml,48,8,2,CHI,456,670,GRA
1,1,1,45,2.48490665,46,1,want,"('GRA', 'CHI')",Providence,nai78.xml,48,2,1,CHI,456,670,GRA
1,0,4,40,2.48490665,40,0,to,"('MOT', 'GRA')",Providence,nai78.xml,45,5,1,GRA,476,268,MOT
1,1,1,42,2.420368129,43,1,was,"('MOT', 'GRA')",Providence,nai78.xml,45,2,1,GRA,476,268,MOT
1,2,4,109,2.376012562,111,2,he,"('CHI', 'MOT')",Providence,nai78.xml,116,5,1,MOT,787,1441,CHI
0,3,1,122,2.359280437,125,3,up,"('CHI', 'GRA')",Providence,nai78.xml,126,1,0,GRA,1386,1238,CHI
1,0,0,13,2.302585093,13,0,what,"('FAT', 'MOT')",Providence,nai78.xml,14,1,1,MOT,94,206,FAT
1,0,0,13,2.302585093,13,0,think,"('FAT', 'MOT')",Providence,nai78.xml,14,1,1,MOT,94,206,FAT
0,3,1,112,2.277267285,115,3,little,"('CHI', 'MOT')",Providence,nai78.xml,116,1,0,MOT,787,1441,CHI
0,3,1,112,2.277267285,115,3,at,"('CHI', 'MOT')",Providence,nai78.xml,116,1,0,MOT,787,1441,CHI
2,1,1,29,2.261763098,30,1,a,"('GRA', 'MOT')",Providence,nai78.xml,33,3,2,MOT,189,336,GRA
0,1,1,50,2.178532444,51,1,they,"('MOT', 'CHI')",Providence,nai78.xml,52,1,0,CHI,502,251,MOT
0,1,1,50,2.178532444,51,1,see,"('MOT', 'CHI')",Providence,nai78.xml,52,1,0,CHI,502,251,MOT
0,4,1,121,2.136136885,125,4,did,"('CHI', 'GRA')",Providence,nai78.xml,126,1,0,GRA,1386,1238,CHI
0,4,1,121,2.136136885,125,4,on,"('CHI', 'GRA')",Providence,nai78.xml,126,1,0,GRA,1386,1238,CHI
2,6,2,106,2.097141119,112,6,did,"('CHI', 'MOT')",Providence,nai78.xml,116,4,2,MOT,787,1441,CHI
2,3,7,114,2.093546148,117,3,get,"('CHI', 'GRA')",Providence,nai78.xml,126,9,2,GRA,1386,1238,CHI
0,3,2,121,2.063693185,124,3,gonna,"('CHI', 'GRA')",Providence,nai78.xml,126,2,0,GRA,1386,1238,CHI
2,8,1,105,2.036881927,113,8,of,"('CHI', 'MOT')",Providence,nai78.xml,116,3,2,MOT,787,1441,CHI
0,1,1,43,2.036881927,44,1,see,"('MOT', 'GRA')",Providence,nai78.xml,45,1,0,GRA,476,268,MOT
0,1,1,43,2.036881927,44,1,not,"('MOT', 'GRA')",Providence,nai78.xml,45,1,0,GRA,476,268,MOT
1,2,1,41,2.014903021,43,2,some,"('MOT', 'GRA')",Providence,nai78.xml,45,2,1,GRA,476,268,MOT
1,1,3,40,1.969440646,41,1,and,"('MOT', 'GRA')",Providence,nai78.xml,45,4,1,GRA,476,268,MOT
0,5,1,110,1.871802177,115,5,with,"('CHI', 'MOT')",Providence,nai78.xml,116,1,0,MOT,787,1441,CHI
0,5,1,110,1.871802177,115,5,all,"('CHI', 'MOT')",Providence,nai78.xml,116,1,0,MOT,787,1441,CHI
0,5,1,110,1.871802177,115,5,my,"('CHI', 'MOT')",Providence,nai78.xml,116,1,0,MOT,787,1441,CHI
0,5,1,110,1.871802177,115,5,think,"('CHI', 'MOT')",Providence,nai78.xml,116,1,0,MOT,787,1441,CHI
0,1,2,49,1.871802177,50,1,get,"('MOT', 'CHI')",Providence,nai78.xml,52,2,0,CHI,502,251,MOT
0,1,2,49,1.871802177,50,1,there,"('MOT', 'CHI')",Providence,nai78.xml,52,2,0,CHI,502,251,MOT
0,1,2,49,1.871802177,50,1,are,"('MOT', 'CHI')",Providence,nai78.xml,52,2,0,CHI,502,251,MOT
1,8,1,106,1.863218433,114,8,see,"('CHI', 'MOT')",Providence,nai78.xml,116,2,1,MOT,787,1441,CHI
1,7,2,116,1.832581464,123,7,do,"('CHI', 'GRA')",Providence,nai78.xml,126,3,1,GRA,1386,1238,CHI
0,3,3,120,1.832581464,123,3,with,"('CHI', 'GRA')",Providence,nai78.xml,126,3,0,GRA,1386,1238,CHI
2,7,3,104,1.800648417,111,7,for,"('CHI', 'MOT')",Providence,nai78.xml,116,5,2,MOT,787,1441,CHI
0,1,2,45,1.791759469,46,1,she,"('GRA', 'CHI')",Providence,nai78.xml,48,2,0,CHI,456,670,GRA
0,1,2,45,1.791759469,46,1,all,"('GRA', 'CHI')",Providence,nai78.xml,48,2,0,CHI,456,670,GRA
0,1,2,45,1.791759469,46,1,do,"('GRA', 'CHI')",Providence,nai78.xml,48,2,0,CHI,456,670,GRA
1,2,2,40,1.769286613,42,2,oh,"('MOT', 'GRA')",Providence,nai78.xml,45,3,1,GRA,476,268,MOT
0,2,5,119,1.767661918,121,2,he,"('CHI', 'GRA')",Providence,nai78.xml,126,5,0,GRA,1386,1238,CHI
0,1,1,31,1.734601055,32,1,but,"('GRA', 'MOT')",Providence,nai78.xml,33,1,0,MOT,189,336,GRA
0,1,1,31,1.734601055,32,1,she,"('GRA', 'MOT')",Providence,nai78.xml,33,1,0,MOT,189,336,GRA
0,1,2,42,1.727220948,43,1,one,"('MOT', 'GRA')",Providence,nai78.xml,45,2,0,GRA,476,268,MOT
0,6,1,109,1.717651497,115,6,have,"('CHI', 'MOT')",Providence,nai78.xml,116,1,0,MOT,787,1441,CHI
0,6,1,109,1.717651497,115,6,some,"('CHI', 'MOT')",Providence,nai78.xml,116,1,0,MOT,787,1441,CHI
1,8,2,115,1.714798428,123,8,this,"('CHI', 'GRA')",Providence,nai78.xml,126,3,1,GRA,1386,1238,CHI
0,2,1,45,1.694595721,47,2,did,"('GRA', 'CHI')",Providence,nai78.xml,48,1,0,CHI,456,670,GRA
0,2,1,45,1.694595721,47,2,where,"('GRA', 'CHI')",Providence,nai78.xml,48,1,0,CHI,456,670,GRA
0,5,2,119,1.658228077,124,5,have,"('CHI', 'GRA')",Providence,nai78.xml,126,2,0,GRA,1386,1238,CHI
0,5,2,119,1.658228077,124,5,one,"('CHI', 'GRA')",Providence,nai78.xml,126,2,0,GRA,1386,1238,CHI
4,12,3,107,1.643054523,119,12,a,"('CHI', 'GRA')",Providence,nai78.xml,126,7,4,GRA,1386,1238,CHI
2,11,2,111,1.642227735,122,11,in,"('CHI', 'GRA')",Providence,nai78.xml,126,4,2,GRA,1386,1238,CHI
1,2,3,42,1.631416819,44,2,that,"('GRA', 'CHI')",Providence,nai78.xml,48,4,1,CHI,456,670,GRA
0,2,1,42,1.631416819,44,2,did,"('MOT', 'GRA')",Providence,nai78.xml,45,1,0,GRA,476,268,MOT
0,2,1,42,1.631416819,44,2,wanna,"('MOT', 'GRA')",Providence,nai78.xml,45,1,0,GRA,476,268,MOT
0,2,1,42,1.631416819,44,2,think,"('MOT', 'GRA')",Providence,nai78.xml,45,1,0,GRA,476,268,MOT
0,1,3,48,1.62924054,49,1,in,"('MOT', 'CHI')",Providence,nai78.xml,52,3,0,CHI,502,251,MOT
1,1,0,12,1.609437912,13,1,is,"('CHI', 'FAT')",Providence,nai78.xml,14,1,1,FAT,163,87,CHI
1,1,0,12,1.609437912,13,1,put,"('CHI', 'FAT')",Providence,nai78.xml,14,1,1,FAT,163,87,CHI
1,1,0,12,1.609437912,13,1,on,"('CHI', 'FAT')",Providence,nai78.xml,14,1,1,FAT,163,87,CHI
0,4,3,119,1.609437912,123,4,put,"('CHI', 'GRA')",Providence,nai78.xml,126,3,0,GRA,1386,1238,CHI
0,7,1,108,1.584120104,115,7,in,"('CHI', 'MOT')",Providence,nai78.xml,116,1,0,MOT,787,1441,CHI
0,7,1,108,1.584120104,115,7,wanna,"('CHI', 'MOT')",Providence,nai78.xml,116,1,0,MOT,787,1441,CHI
0,5,2,109,1.575536361,114,5,like,"('CHI', 'MOT')",Providence,nai78.xml,116,2,0,MOT,787,1441,CHI
0,5,2,109,1.575536361,114,5,can,"('CHI', 'MOT')",Providence,nai78.xml,116,2,0,MOT,787,1441,CHI
0,1,3,44,1.547562509,45,1,was,"('GRA', 'CHI')",Providence,nai78.xml,48,3,0,CHI,456,670,GRA
0,6,2,118,1.504077397,124,6,we,"('CHI', 'GRA')",Providence,nai78.xml,126,2,0,GRA,1386,1238,CHI
4,4,3,34,1.491654877,38,4,it,"('MOT', 'GRA')",Providence,nai78.xml,45,7,4,GRA,476,268,MOT
0,1,3,41,1.481604541,42,1,we,"('MOT', 'GRA')",Providence,nai78.xml,45,3,0,GRA,476,268,MOT
0,1,3,41,1.481604541,42,1,there,"('MOT', 'GRA')",Providence,nai78.xml,45,3,0,GRA,476,268,MOT
1,17,0,98,1.466337069,115,17,that,"('CHI', 'MOT')",Providence,nai78.xml,116,1,1,MOT,787,1441,CHI
0,2,2,48,1.466337069,50,2,this,"('MOT', 'CHI')",Providence,nai78.xml,52,2,0,CHI,502,251,MOT
5,12,5,94,1.424034689,106,12,a,"('CHI', 'MOT')",Providence,nai78.xml,116,10,5,MOT,787,1441,CHI
1,13,1,101,1.421385681,114,13,are,"('CHI', 'MOT')",Providence,nai78.xml,116,2,1,MOT,787,1441,CHI
0,1,2,30,1.41706602,31,1,we,"('GRA', 'MOT')",Providence,nai78.xml,33,2,0,MOT,189,336,GRA
0,1,2,30,1.41706602,31,1,what,"('GRA', 'MOT')",Providence,nai78.xml,33,2,0,MOT,189,336,GRA
0,1,2,30,1.41706602,31,1,are,"('GRA', 'MOT')",Providence,nai78.xml,33,2,0,MOT,189,336,GRA
2,1,1,10,1.360976553,11,1,go,"('CHI', 'FAT')",Providence,nai78.xml,14,3,2,FAT,163,87,CHI
0,9,1,106,1.360976553,115,9,do,"('CHI', 'MOT')",Providence,nai78.xml,116,1,0,MOT,787,1441,CHI
0,10,1,115,1.347679525,125,10,think,"('CHI', 'GRA')",Providence,nai78.xml,126,1,0,GRA,1386,1238,CHI
2,3,4,36,1.346448453,39,3,that,"('MOT', 'GRA')",Providence,nai78.xml,45,6,2,GRA,476,268,MOT
0,1,4,43,1.343734747,44,1,can,"('GRA', 'CHI')",Providence,nai78.xml,48,4,0,CHI,456,670,GRA
0,1,4,43,1.343734747,44,1,and,"('GRA', 'CHI')",Providence,nai78.xml,48,4,0,CHI,456,670,GRA
0,3,1,41,1.343734747,44,3,little,"('MOT', 'GRA')",Providence,nai78.xml,45,1,0,GRA,476,268,MOT
0,2,1,30,1.329135947,32,2,see,"('GRA', 'MOT')",Providence,nai78.xml,33,1,0,MOT,189,336,GRA
0,2,1,30,1.329135947,32,2,on,"('GRA', 'MOT')",Providence,nai78.xml,33,1,0,MOT,189,336,GRA
0,2,2,41,1.32175584,43,2,of,"('MOT', 'GRA')",Providence,nai78.xml,45,2,0,GRA,476,268,MOT
3,10,7,106,1.274177063,116,10,of,"('CHI', 'GRA')",Providence,nai78.xml,126,10,3,GRA,1386,1238,CHI
0,10,1,105,1.265666373,115,10,what,"('CHI', 'MOT')",Providence,nai78.xml,116,1,0,MOT,787,1441,CHI
0,8,2,116,1.252762968,124,8,was,"('CHI', 'GRA')",Providence,nai78.xml,126,2,0,GRA,1386,1238,CHI
0,8,2,116,1.252762968,124,8,are,"('CHI', 'GRA')",Providence,nai78.xml,126,2,0,GRA,1386,1238,CHI
2,5,11,98,1.252762968,103,5,this,"('CHI', 'MOT')",Providence,nai78.xml,116,13,2,MOT,787,1441,CHI
0,1,5,46,1.252762968,47,1,is,"('MOT', 'CHI')",Providence,nai78.xml,52,5,0,CHI,502,251,MOT
0,1,5,46,1.252762968,47,1,that,"('MOT', 'CHI')",Providence,nai78.xml,52,5,0,CHI,502,251,MOT
0,1,5,46,1.252762968,47,1,and,"('MOT', 'CHI')",Providence,nai78.xml,52,5,0,CHI,502,251,MOT
0,3,2,47,1.178654996,50,3,want,"('MOT', 'CHI')",Providence,nai78.xml,52,2,0,CHI,502,251,MOT
0,1,3,29,1.16315081,30,1,yeah,"('GRA', 'MOT')",Providence,nai78.xml,33,3,0,MOT,189,336,GRA
0,2,3,43,1.142097401,45,2,we,"('GRA', 'CHI')",Providence,nai78.xml,48,3,0,CHI,456,670,GRA
4,15,5,92,1.1303018,107,15,it,"('CHI', 'MOT')",Providence,nai78.xml,116,9,4,MOT,787,1441,CHI
3,15,4,94,1.126011263,109,15,is,"('CHI', 'MOT')",Providence,nai78.xml,116,7,3,MOT,787,1441,CHI
2,15,3,96,1.107501236,111,15,and,"('CHI', 'MOT')",Providence,nai78.xml,116,5,2,MOT,787,1441,CHI
0,3,2,43,1.098612289,46,3,in,"('GRA', 'CHI')",Providence,nai78.xml,48,2,0,CHI,456,670,GRA
1,3,5,43,1.098612289,46,3,a,"('MOT', 'CHI')",Providence,nai78.xml,52,6,1,CHI,502,251,MOT
1,1,11,39,1.098612289,40,1,to,"('MOT', 'CHI')",Providence,nai78.xml,52,12,1,CHI,502,251,MOT
0,1,5,39,1.098612289,40,1,like,"('MOT', 'GRA')",Providence,nai78.xml,45,5,0,GRA,476,268,MOT
0,5,1,46,1.079920156,51,5,not,"('MOT', 'CHI')",Providence,nai78.xml,52,1,0,CHI,502,251,MOT
0,2,3,40,1.076139433,42,2,in,"('MOT', 'GRA')",Providence,nai78.xml,45,3,0,GRA,476,268,MOT
0,2,3,40,1.076139433,42,2,do,"('MOT', 'GRA')",Providence,nai78.xml,45,3,0,GRA,476,268,MOT
0,3,1,29,1.041453875,32,3,and,"('GRA', 'MOT')",Providence,nai78.xml,33,1,0,MOT,189,336,GRA
1,4,4,43,1.029619417,47,4,go,"('MOT', 'CHI')",Providence,nai78.xml,52,5,1,CHI,502,251,MOT
0,2,4,46,1.021651248,48,2,it,"('MOT', 'CHI')",Providence,nai78.xml,52,4,0,CHI,502,251,MOT
0,2,4,46,1.021651248,48,2,what,"('MOT', 'CHI')",Providence,nai78.xml,52,4,0,CHI,502,251,MOT
2,12,6,106,1.018569581,118,12,to,"('CHI', 'GRA')",Providence,nai78.xml,126,8,2,GRA,1386,1238,CHI
0,2,2,29,1.011600912,31,2,all,"('GRA', 'MOT')",Providence,nai78.xml,33,2,0,MOT,189,336,GRA
0,2,2,29,1.011600912,31,2,to,"('GRA', 'MOT')",Providence,nai78.xml,33,2,0,MOT,189,336,GRA
0,1,6,41,1.011600912,42,1,there,"('GRA', 'CHI')",Providence,nai78.xml,48,6,0,CHI,456,670,GRA
0,5,5,106,0.9897182,111,5,yeah,"('CHI', 'MOT')",Providence,nai78.xml,116,5,0,MOT,787,1441,CHI
1,2,7,35,0.955511445,37,2,the,"('MOT', 'GRA')",Providence,nai78.xml,45,8,1,GRA,476,268,MOT
0,1,4,28,0.949080555,29,1,have,"('GRA', 'MOT')",Providence,nai78.xml,33,4,0,MOT,189,336,GRA
0,1,6,38,0.940983344,39,1,what,"('MOT', 'GRA')",Providence,nai78.xml,45,6,0,GRA,476,268,MOT
0,1,1,12,0.916290732,13,1,a,"('CHI', 'FAT')",Providence,nai78.xml,14,1,0,FAT,163,87,CHI
0,1,1,12,0.916290732,13,1,that,"('CHI', 'FAT')",Providence,nai78.xml,14,1,0,FAT,163,87,CHI
0,1,1,12,0.916290732,13,1,the,"('CHI', 'FAT')",Providence,nai78.xml,14,1,0,FAT,163,87,CHI
0,1,1,12,0.916290732,13,1,want,"('FAT', 'MOT')",Providence,nai78.xml,14,1,0,MOT,94,206,FAT
0,1,1,12,0.916290732,13,1,yeah,"('FAT', 'MOT')",Providence,nai78.xml,14,1,0,MOT,94,206,FAT
0,1,1,12,0.916290732,13,1,is,"('FAT', 'MOT')",Providence,nai78.xml,14,1,0,MOT,94,206,FAT
1,1,0,4,0.84729786,5,1,go,"('FAT', 'CHI')",Providence,nai78.xml,6,1,1,CHI,30,55,FAT
0,9,3,104,0.832909123,113,9,gonna,"('CHI', 'MOT')",Providence,nai78.xml,116,3,0,MOT,787,1441,CHI
2,11,9,104,0.810930216,115,11,and,"('CHI', 'GRA')",Providence,nai78.xml,126,11,2,GRA,1386,1238,CHI
0,4,2,39,0.810930216,43,4,yeah,"('MOT', 'GRA')",Providence,nai78.xml,45,2,0,GRA,476,268,MOT
5,18,9,94,0.810930216,112,18,it,"('CHI', 'GRA')",Providence,nai78.xml,126,14,5,GRA,1386,1238,CHI
2,17,5,102,0.806806499,119,17,that,"('CHI', 'GRA')",Providence,nai78.xml,126,7,2,GRA,1386,1238,CHI
0,2,5,41,0.762140052,43,2,it,"('GRA', 'CHI')",Providence,nai78.xml,48,5,0,CHI,456,670,GRA
0,2,5,41,0.762140052,43,2,see,"('GRA', 'CHI')",Providence,nai78.xml,48,5,0,CHI,456,670,GRA
0,2,3,28,0.757685702,30,2,do,"('GRA', 'MOT')",Providence,nai78.xml,33,3,0,MOT,189,336,GRA
1,4,3,25,0.725937003,29,4,some,"('GRA', 'MOT')",Providence,nai78.xml,33,4,1,MOT,189,336,GRA
1,1,3,9,0.693147181,10,1,want,"('CHI', 'FAT')",Providence,nai78.xml,14,4,1,FAT,163,87,CHI
0,5,1,27,0.635988767,32,5,of,"('GRA', 'MOT')",Providence,nai78.xml,33,1,0,MOT,189,336,GRA
0,2,6,40,0.606135804,42,2,is,"('GRA', 'CHI')",Providence,nai78.xml,48,6,0,CHI,456,670,GRA
0,6,7,103,0.566395475,109,6,want,"('CHI', 'MOT')",Providence,nai78.xml,116,7,0,MOT,787,1441,CHI
2,23,4,87,0.559615788,110,23,the,"('CHI', 'MOT')",Providence,nai78.xml,116,6,2,MOT,787,1441,CHI
1,2,2,9,0.550046337,11,2,you,"('CHI', 'FAT')",Providence,nai78.xml,14,3,1,FAT,163,87,CHI
1,2,2,9,0.550046337,11,2,gonna,"('FAT', 'MOT')",Providence,nai78.xml,14,3,1,MOT,94,206,FAT
8,19,17,82,0.540384426,101,19,the,"('CHI', 'GRA')",Providence,nai78.xml,126,25,8,GRA,1386,1238,CHI
0,2,1,11,0.510825624,13,2,of,"('FAT', 'MOT')",Providence,nai78.xml,14,1,0,MOT,94,206,FAT
2,5,9,36,0.503103578,41,5,the,"('MOT', 'CHI')",Providence,nai78.xml,52,11,2,CHI,502,251,MOT
2,17,7,90,0.50169314,107,17,to,"('CHI', 'MOT')",Providence,nai78.xml,116,9,2,MOT,787,1441,CHI
0,3,3,27,0.470003629,30,3,oh,"('GRA', 'MOT')",Providence,nai78.xml,33,3,0,MOT,189,336,GRA
0,12,4,110,0.463572739,122,12,what,"('CHI', 'GRA')",Providence,nai78.xml,126,4,0,GRA,1386,1238,CHI
4,7,8,26,0.446287103,33,7,you,"('MOT', 'GRA')",Providence,nai78.xml,45,12,4,GRA,476,268,MOT
2,25,6,93,0.3254224,118,25,you,"('CHI', 'GRA')",Providence,nai78.xml,126,8,2,GRA,1386,1238,CHI
0,8,8,110,0.287682072,118,8,there,"('CHI', 'GRA')",Providence,nai78.xml,126,8,0,GRA,1386,1238,CHI
0,1,1,5,0.287682072,6,1,where,"('MOT', 'FAT')",Providence,nai78.xml,7,1,0,FAT,71,43,MOT
0,1,3,10,0.262364264,11,1,to,"('CHI', 'FAT')",Providence,nai78.xml,14,3,0,FAT,163,87,CHI
0,3,1,10,0.223143551,13,3,a,"('FAT', 'MOT')",Providence,nai78.xml,14,1,0,MOT,94,206,FAT
0,3,1,10,0.223143551,13,3,to,"('FAT', 'MOT')",Providence,nai78.xml,14,1,0,MOT,94,206,FAT
5,44,5,62,0.182321557,106,44,you,"('CHI', 'MOT')",Providence,nai78.xml,116,10,5,MOT,787,1441,CHI
2,4,2,6,0.182321557,10,4,you,"('FAT', 'MOT')",Providence,nai78.xml,14,4,2,MOT,94,206,FAT
1,13,11,101,0.168622712,114,13,is,"('CHI', 'GRA')",Providence,nai78.xml,126,12,1,GRA,1386,1238,CHI
0,2,2,10,0.15415068,12,2,go,"('FAT', 'MOT')",Providence,nai78.xml,14,2,0,MOT,94,206,FAT
0,2,2,10,0.15415068,12,2,it,"('FAT', 'MOT')",Providence,nai78.xml,14,2,0,MOT,94,206,FAT
0,1,1,4,0.15415068,5,1,a,"('FAT', 'CHI')",Providence,nai78.xml,6,1,0,CHI,30,55,FAT
0,1,14,33,0.117783036,34,1,you,"('GRA', 'CHI')",Providence,nai78.xml,48,14,0,CHI,456,670,GRA
0,3,7,35,0.105360516,38,3,is,"('MOT', 'GRA')",Providence,nai78.xml,45,7,0,GRA,476,268,MOT
0,4,6,38,0.09531018,42,4,a,"('GRA', 'CHI')",Providence,nai78.xml,48,6,0,CHI,456,670,GRA
0,2,1,4,-0.117783036,6,2,in,"('MOT', 'FAT')",Providence,nai78.xml,7,1,0,FAT,71,43,MOT
0,1,2,4,-0.133531393,5,1,the,"('MOT', 'FAT')",Providence,nai78.xml,7,2,0,FAT,71,43,MOT
1,10,6,31,-0.140772554,41,10,the,"('GRA', 'CHI')",Providence,nai78.xml,48,7,1,CHI,456,670,GRA
0,2,1,3,-0.251314428,5,2,little,"('FAT', 'CHI')",Providence,nai78.xml,6,1,0,CHI,30,55,FAT
0,5,7,33,-0.300104592,38,5,a,"('MOT', 'GRA')",Providence,nai78.xml,45,7,0,GRA,476,268,MOT
0,5,6,22,-0.503905181,27,5,the,"('GRA', 'MOT')",Providence,nai78.xml,33,6,0,MOT,189,336,GRA
0,5,2,7,-0.538996501,12,5,and,"('FAT', 'MOT')",Providence,nai78.xml,14,2,0,MOT,94,206,FAT
0,2,2,2,-0.693147181,4,2,you,"('FAT', 'CHI')",Providence,nai78.xml,6,2,0,CHI,30,55,FAT
0,2,21,29,-0.737598943,31,2,you,"('MOT', 'CHI')",Providence,nai78.xml,52,21,0,CHI,502,251,MOT
0,8,5,20,-0.741937345,28,8,you,"('GRA', 'MOT')",Providence,nai78.xml,33,5,0,MOT,189,336,GRA
1,0,1,89,3.817712326,89,0,he,"('GRA', 'MOT')",Providence,nai79.xml,91,2,1,MOT,808,1016,GRA
1,1,0,122,3.729701449,123,1,with,"('CHI', 'GRA')",Providence,nai79.xml,124,1,1,GRA,656,1305,CHI
1,1,0,122,3.729701449,123,1,up,"('CHI', 'GRA')",Providence,nai79.xml,124,1,1,GRA,656,1305,CHI
1,0,0,58,3.688879454,58,0,make,"('CHI', 'MOT')",Providence,nai79.xml,59,1,1,MOT,353,539,CHI
1,1,1,135,3.540959324,136,1,make,"('MOT', 'CHI')",Providence,nai79.xml,138,2,1,CHI,1937,732,MOT
1,0,5,132,3.511545439,132,0,they,"('MOT', 'CHI')",Providence,nai79.xml,138,6,1,CHI,1937,732,MOT
1,1,1,109,3.33220451,110,1,all,"('GRA', 'CHI')",Providence,nai79.xml,112,2,1,CHI,1177,696,GRA
1,1,2,120,3.202746443,121,1,look,"('CHI', 'GRA')",Providence,nai79.xml,124,3,1,GRA,656,1305,CHI
1,1,1,88,3.124565145,89,1,little,"('GRA', 'MOT')",Providence,nai79.xml,91,2,1,MOT,808,1016,GRA
1,1,1,87,3.113515309,88,1,make,"('MOT', 'GRA')",Providence,nai79.xml,90,2,1,GRA,913,635,MOT
1,1,2,108,3.100092289,109,1,like,"('GRA', 'CHI')",Providence,nai79.xml,112,3,1,CHI,1177,696,GRA
1,1,2,108,3.100092289,109,1,for,"('GRA', 'CHI')",Providence,nai79.xml,112,3,1,CHI,1177,696,GRA
1,1,0,57,2.995732274,58,1,go,"('CHI', 'MOT')",Providence,nai79.xml,59,1,1,MOT,353,539,CHI
1,0,10,127,2.988010227,127,0,oh,"('MOT', 'CHI')",Providence,nai79.xml,138,11,1,CHI,1937,732,MOT
0,1,1,110,2.935628349,111,1,wanna,"('GRA', 'CHI')",Providence,nai79.xml,112,1,0,CHI,1177,696,GRA
1,2,1,108,2.926739402,110,2,some,"('GRA', 'CHI')",Providence,nai79.xml,112,2,1,CHI,1177,696,GRA
1,2,1,108,2.926739402,110,2,one,"('GRA', 'CHI')",Providence,nai79.xml,112,2,1,CHI,1177,696,GRA
1,1,3,107,2.908720897,108,1,with,"('GRA', 'CHI')",Providence,nai79.xml,112,4,1,CHI,1177,696,GRA
1,1,2,87,2.890371758,88,1,we,"('GRA', 'MOT')",Providence,nai79.xml,91,3,1,MOT,808,1016,GRA
1,1,2,87,2.890371758,88,1,see,"('GRA', 'MOT')",Providence,nai79.xml,91,3,1,MOT,808,1016,GRA
1,1,4,106,2.745437733,107,1,gonna,"('GRA', 'CHI')",Providence,nai79.xml,112,5,1,CHI,1177,696,GRA
1,3,1,119,2.740840024,122,3,one,"('CHI', 'GRA')",Providence,nai79.xml,124,2,1,GRA,656,1305,CHI
0,2,1,135,2.737249356,137,2,wanna,"('MOT', 'CHI')",Providence,nai79.xml,138,1,0,CHI,1937,732,MOT
0,1,1,89,2.730029108,90,1,where,"('GRA', 'MOT')",Providence,nai79.xml,91,1,0,MOT,808,1016,GRA
0,1,1,89,2.730029108,90,1,big,"('GRA', 'MOT')",Providence,nai79.xml,91,1,0,MOT,808,1016,GRA
2,3,2,117,2.724579503,120,3,some,"('CHI', 'GRA')",Providence,nai79.xml,124,4,2,GRA,656,1305,CHI
0,1,1,88,2.719100037,89,1,can,"('MOT', 'GRA')",Providence,nai79.xml,90,1,0,GRA,913,635,MOT
1,1,3,86,2.696876901,87,1,go,"('GRA', 'MOT')",Providence,nai79.xml,91,4,1,MOT,808,1016,GRA
1,1,6,130,2.693124551,131,1,was,"('MOT', 'CHI')",Providence,nai79.xml,138,7,1,CHI,1937,732,MOT
1,1,6,130,2.693124551,131,1,look,"('MOT', 'CHI')",Providence,nai79.xml,138,7,1,CHI,1937,732,MOT
1,0,14,123,2.688247574,123,0,have,"('MOT', 'CHI')",Providence,nai79.xml,138,15,1,CHI,1937,732,MOT
0,1,2,109,2.63905733,110,1,little,"('GRA', 'CHI')",Providence,nai79.xml,112,2,0,CHI,1177,696,GRA
0,2,1,121,2.63108916,123,2,did,"('CHI', 'GRA')",Providence,nai79.xml,124,1,0,GRA,656,1305,CHI
0,2,1,121,2.63108916,123,2,wanna,"('CHI', 'GRA')",Providence,nai79.xml,124,1,0,GRA,656,1305,CHI
0,2,1,121,2.63108916,123,2,where,"('CHI', 'GRA')",Providence,nai79.xml,124,1,0,GRA,656,1305,CHI
1,1,5,105,2.602689685,106,1,she,"('GRA', 'CHI')",Providence,nai79.xml,112,6,1,CHI,1177,696,GRA
2,2,5,115,2.581898916,117,2,he,"('CHI', 'GRA')",Providence,nai79.xml,124,7,2,GRA,656,1305,CHI
1,1,4,84,2.51999797,85,1,she,"('MOT', 'GRA')",Providence,nai79.xml,90,5,1,GRA,913,635,MOT
1,3,2,118,2.509599262,121,3,at,"('CHI', 'GRA')",Providence,nai79.xml,124,3,1,GRA,656,1305,CHI
2,2,5,103,2.475604257,105,2,think,"('GRA', 'CHI')",Providence,nai79.xml,112,7,2,CHI,1177,696,GRA
0,2,2,134,2.442347035,136,2,one,"('MOT', 'CHI')",Providence,nai79.xml,138,2,0,CHI,1937,732,MOT
0,1,2,88,2.431417965,89,1,they,"('GRA', 'MOT')",Providence,nai79.xml,91,2,0,MOT,808,1016,GRA
0,1,2,88,2.431417965,89,1,all,"('GRA', 'MOT')",Providence,nai79.xml,91,2,0,MOT,808,1016,GRA
0,1,2,87,2.420368129,88,1,get,"('MOT', 'GRA')",Providence,nai79.xml,90,2,0,GRA,913,635,MOT
0,1,2,87,2.420368129,88,1,where,"('MOT', 'GRA')",Providence,nai79.xml,90,2,0,GRA,913,635,MOT
1,2,5,130,2.41293315,132,2,at,"('MOT', 'CHI')",Providence,nai79.xml,138,6,1,CHI,1937,732,MOT
0,1,3,108,2.406945108,109,1,not,"('GRA', 'CHI')",Providence,nai79.xml,112,3,0,CHI,1177,696,GRA
2,2,8,126,2.382627801,128,2,can,"('MOT', 'CHI')",Providence,nai79.xml,138,10,2,CHI,1937,732,MOT
0,3,1,120,2.343407088,123,3,all,"('CHI', 'GRA')",Providence,nai79.xml,124,1,0,GRA,656,1305,CHI
0,3,1,120,2.343407088,123,3,my,"('CHI', 'GRA')",Providence,nai79.xml,124,1,0,GRA,656,1305,CHI
1,2,4,105,2.339972625,107,2,put,"('GRA', 'CHI')",Providence,nai79.xml,112,5,1,CHI,1177,696,GRA
2,4,3,115,2.339054773,119,4,of,"('CHI', 'GRA')",Providence,nai79.xml,124,5,2,GRA,656,1305,CHI
0,2,2,120,2.335374916,122,2,get,"('CHI', 'GRA')",Providence,nai79.xml,124,2,0,GRA,656,1305,CHI
0,2,1,88,2.324564,90,2,for,"('GRA', 'MOT')",Providence,nai79.xml,91,1,0,MOT,808,1016,GRA
0,2,1,88,2.324564,90,2,make,"('GRA', 'MOT')",Providence,nai79.xml,91,1,0,MOT,808,1016,GRA
1,3,3,117,2.319114395,120,3,put,"('CHI', 'GRA')",Providence,nai79.xml,124,4,1,GRA,656,1305,CHI
0,2,1,87,2.313634929,89,2,for,"('MOT', 'GRA')",Providence,nai79.xml,90,1,0,GRA,913,635,MOT
0,1,1,57,2.302585093,58,1,with,"('CHI', 'MOT')",Providence,nai79.xml,59,1,0,MOT,353,539,CHI
0,1,1,57,2.302585093,58,1,see,"('CHI', 'MOT')",Providence,nai79.xml,59,1,0,MOT,353,539,CHI
0,1,1,57,2.302585093,58,1,where,"('CHI', 'MOT')",Providence,nai79.xml,59,1,0,MOT,353,539,CHI
0,1,5,132,2.266217449,133,1,for,"('MOT', 'CHI')",Providence,nai79.xml,138,5,0,CHI,1937,732,MOT
2,2,5,82,2.257122719,84,2,on,"('GRA', 'MOT')",Providence,nai79.xml,91,7,2,MOT,808,1016,GRA
0,3,1,108,2.242481169,111,3,make,"('GRA', 'CHI')",Providence,nai79.xml,112,1,0,CHI,1177,696,GRA
1,1,11,125,2.212972934,126,1,are,"('MOT', 'CHI')",Providence,nai79.xml,138,12,1,CHI,1937,732,MOT
0,1,3,86,2.186051277,87,1,at,"('MOT', 'GRA')",Providence,nai79.xml,90,3,0,GRA,913,635,MOT
0,1,3,86,2.186051277,87,1,one,"('MOT', 'GRA')",Providence,nai79.xml,90,3,0,GRA,913,635,MOT
1,2,7,128,2.174751721,130,2,is,"('MOT', 'CHI')",Providence,nai79.xml,138,8,1,CHI,1937,732,MOT
1,9,0,114,2.120263536,123,9,on,"('CHI', 'GRA')",Providence,nai79.xml,124,1,1,GRA,656,1305,CHI
1,4,3,116,2.095970844,120,4,in,"('CHI', 'GRA')",Providence,nai79.xml,124,4,1,GRA,656,1305,CHI
1,4,3,116,2.095970844,120,4,can,"('CHI', 'GRA')",Providence,nai79.xml,124,4,1,GRA,656,1305,CHI
2,2,3,52,2.079441542,54,2,not,"('CHI', 'MOT')",Providence,nai79.xml,59,5,2,MOT,353,539,CHI
0,1,5,106,2.052290553,107,1,get,"('GRA', 'CHI')",Providence,nai79.xml,112,5,0,CHI,1177,696,GRA
0,1,5,106,2.052290553,107,1,he,"('GRA', 'CHI')",Providence,nai79.xml,112,5,0,CHI,1177,696,GRA
0,3,2,119,2.047692843,122,3,go,"('CHI', 'GRA')",Providence,nai79.xml,124,2,0,GRA,656,1305,CHI
0,3,1,87,2.036881927,90,3,this,"('GRA', 'MOT')",Providence,nai79.xml,91,1,0,MOT,808,1016,GRA
0,3,1,86,2.025952857,89,3,my,"('MOT', 'GRA')",Providence,nai79.xml,90,1,0,GRA,913,635,MOT
0,3,1,86,2.025952857,89,3,not,"('MOT', 'GRA')",Providence,nai79.xml,90,1,0,GRA,913,635,MOT
0,2,4,132,2.022283128,134,2,did,"('MOT', 'CHI')",Providence,nai79.xml,138,4,0,CHI,1937,732,MOT
0,2,2,86,2.014903021,88,2,see,"('MOT', 'GRA')",Providence,nai79.xml,90,2,0,GRA,913,635,MOT
0,1,2,56,1.998095902,57,1,at,"('CHI', 'MOT')",Providence,nai79.xml,59,2,0,MOT,353,539,CHI
1,3,1,54,1.998095902,57,3,like,"('CHI', 'MOT')",Providence,nai79.xml,59,2,1,MOT,353,539,CHI
0,1,4,85,1.992430165,86,1,with,"('MOT', 'GRA')",Providence,nai79.xml,90,4,0,GRA,913,635,MOT
2,3,7,100,1.968383005,103,3,was,"('GRA', 'CHI')",Providence,nai79.xml,112,9,2,CHI,1177,696,GRA
0,3,2,107,1.945910149,110,3,are,"('GRA', 'CHI')",Providence,nai79.xml,112,2,0,CHI,1177,696,GRA
2,4,1,52,1.940179474,56,4,that,"('CHI', 'MOT')",Providence,nai79.xml,59,3,2,MOT,353,539,CHI
3,3,13,119,1.929909808,122,3,some,"('MOT', 'CHI')",Providence,nai79.xml,138,16,3,CHI,1937,732,MOT
0,1,6,105,1.909542505,106,1,they,"('GRA', 'CHI')",Providence,nai79.xml,112,6,0,CHI,1177,696,GRA
0,2,1,56,1.897119985,58,2,we,"('CHI', 'MOT')",Providence,nai79.xml,59,1,0,MOT,353,539,CHI
0,2,1,56,1.897119985,58,2,are,"('CHI', 'MOT')",Providence,nai79.xml,59,1,0,MOT,353,539,CHI
0,1,8,129,1.887069649,130,1,get,"('MOT', 'CHI')",Providence,nai79.xml,138,8,0,CHI,1937,732,MOT
3,3,14,118,1.867745376,121,3,a,"('MOT', 'CHI')",Providence,nai79.xml,138,17,3,CHI,1937,732,MOT
1,6,1,82,1.860752341,88,6,do,"('MOT', 'GRA')",Providence,nai79.xml,90,2,1,GRA,913,635,MOT
0,4,1,86,1.813738376,90,4,did,"('GRA', 'MOT')",Providence,nai79.xml,91,1,0,MOT,808,1016,GRA
0,4,1,86,1.813738376,90,4,she,"('GRA', 'MOT')",Providence,nai79.xml,91,1,0,MOT,808,1016,GRA
0,4,1,85,1.802809305,89,4,are,"('MOT', 'GRA')",Providence,nai79.xml,90,1,0,GRA,913,635,MOT
0,2,3,86,1.791759469,88,2,there,"('GRA', 'MOT')",Providence,nai79.xml,91,3,0,MOT,808,1016,GRA
0,1,9,128,1.78415487,129,1,go,"('MOT', 'CHI')",Providence,nai79.xml,138,9,0,CHI,1937,732,MOT
1,3,6,102,1.782457077,105,3,can,"('GRA', 'CHI')",Providence,nai79.xml,112,7,1,CHI,1177,696,GRA
1,4,3,83,1.780586169,87,4,gonna,"('GRA', 'MOT')",Providence,nai79.xml,91,4,1,MOT,808,1016,GRA
0,2,3,85,1.780586169,87,2,like,"('MOT', 'GRA')",Providence,nai79.xml,90,3,0,GRA,913,635,MOT
0,2,3,85,1.780586169,87,2,they,"('MOT', 'GRA')",Providence,nai79.xml,90,3,0,GRA,913,635,MOT
1,3,2,53,1.757857918,56,3,gonna,"('CHI', 'MOT')",Providence,nai79.xml,59,3,1,MOT,353,539,CHI
2,2,10,76,1.742969305,78,2,and,"('MOT', 'GRA')",Providence,nai79.xml,90,12,2,GRA,913,635,MOT
2,3,7,78,1.733263263,81,3,up,"('MOT', 'GRA')",Providence,nai79.xml,90,9,2,GRA,913,635,MOT
0,2,6,130,1.71978597,132,2,like,"('MOT', 'CHI')",Providence,nai79.xml,138,6,0,CHI,1937,732,MOT
0,3,3,106,1.713797928,109,3,where,"('GRA', 'CHI')",Providence,nai79.xml,112,3,0,CHI,1177,696,GRA
3,4,13,118,1.706766256,122,4,of,"('MOT', 'CHI')",Providence,nai79.xml,138,16,3,CHI,1937,732,MOT
1,0,1,9,1.704748092,9,0,is,"('FAT', 'MOT')",Providence,nai79.xml,11,2,1,MOT,62,64,FAT
3,6,4,78,1.697506931,84,6,think,"('GRA', 'MOT')",Providence,nai79.xml,91,7,3,MOT,808,1016,GRA
0,1,10,127,1.68948062,128,1,this,"('MOT', 'CHI')",Providence,nai79.xml,138,10,0,CHI,1937,732,MOT
1,3,5,81,1.681758574,84,3,gonna,"('MOT', 'GRA')",Providence,nai79.xml,90,6,1,GRA,913,635,MOT
1,2,10,99,1.664314523,101,2,have,"('GRA', 'CHI')",Providence,nai79.xml,112,11,1,CHI,1177,696,GRA
1,6,3,102,1.655957928,108,6,what,"('GRA', 'CHI')",Providence,nai79.xml,112,4,1,CHI,1177,696,GRA
0,5,1,85,1.631416819,90,5,wanna,"('GRA', 'MOT')",Providence,nai79.xml,91,1,0,MOT,808,1016,GRA
1,4,4,82,1.615135934,86,4,not,"('GRA', 'MOT')",Providence,nai79.xml,91,5,1,MOT,808,1016,GRA
0,4,3,117,1.593308531,121,4,but,"('CHI', 'GRA')",Providence,nai79.xml,124,3,0,GRA,656,1305,CHI
0,2,2,55,1.592630794,57,2,was,"('CHI', 'MOT')",Providence,nai79.xml,59,2,0,MOT,353,539,CHI
0,2,2,55,1.592630794,57,2,on,"('CHI', 'MOT')",Providence,nai79.xml,59,2,0,MOT,353,539,CHI
2,3,15,118,1.580063304,121,3,what,"('MOT', 'CHI')",Providence,nai79.xml,138,17,2,CHI,1937,732,MOT
0,3,5,130,1.573070268,133,3,but,"('MOT', 'CHI')",Providence,nai79.xml,138,5,0,CHI,1937,732,MOT
1,4,6,101,1.559313525,105,4,in,"('GRA', 'CHI')",Providence,nai79.xml,112,7,1,CHI,1177,696,GRA
0,5,2,105,1.540445041,110,5,did,"('GRA', 'CHI')",Providence,nai79.xml,112,2,0,CHI,1177,696,GRA
3,5,13,117,1.5244447,122,5,gonna,"('MOT', 'CHI')",Providence,nai79.xml,138,16,3,CHI,1937,732,MOT
0,3,4,105,1.522426535,108,3,but,"('GRA', 'CHI')",Providence,nai79.xml,112,4,0,CHI,1177,696,GRA
0,4,2,85,1.515127233,89,4,at,"('GRA', 'MOT')",Providence,nai79.xml,91,2,0,MOT,808,1016,GRA
1,8,3,112,1.508184179,120,8,this,"('CHI', 'GRA')",Providence,nai79.xml,124,4,1,GRA,656,1305,CHI
1,8,3,112,1.508184179,120,8,is,"('CHI', 'GRA')",Providence,nai79.xml,124,4,1,GRA,656,1305,CHI
1,5,5,101,1.504077397,106,5,this,"('GRA', 'CHI')",Providence,nai79.xml,112,6,1,CHI,1177,696,GRA
0,2,6,104,1.504077397,106,2,see,"('GRA', 'CHI')",Providence,nai79.xml,112,6,0,CHI,1177,696,GRA
0,2,6,104,1.504077397,106,2,on,"('GRA', 'CHI')",Providence,nai79.xml,112,6,0,CHI,1177,696,GRA
0,3,3,85,1.504077397,88,3,like,"('GRA', 'MOT')",Providence,nai79.xml,91,3,0,MOT,808,1016,GRA
0,3,3,85,1.504077397,88,3,are,"('GRA', 'MOT')",Providence,nai79.xml,91,3,0,MOT,808,1016,GRA
0,3,3,84,1.492904096,87,3,was,"('MOT', 'GRA')",Providence,nai79.xml,90,3,0,GRA,913,635,MOT
0,3,3,84,1.492904096,87,3,there,"('MOT', 'GRA')",Providence,nai79.xml,90,3,0,GRA,913,635,MOT
0,3,3,84,1.492904096,87,3,this,"('MOT', 'GRA')",Providence,nai79.xml,90,3,0,GRA,913,635,MOT
0,3,3,84,1.492904096,87,3,some,"('MOT', 'GRA')",Providence,nai79.xml,90,3,0,GRA,913,635,MOT
0,4,3,105,1.490654376,109,4,want,"('GRA', 'CHI')",Providence,nai79.xml,112,3,0,CHI,1177,696,GRA
0,2,8,128,1.481604541,130,2,there,"('MOT', 'CHI')",Providence,nai79.xml,138,8,0,CHI,1937,732,MOT
0,6,1,84,1.477266139,90,6,was,"('GRA', 'MOT')",Providence,nai79.xml,91,1,0,MOT,808,1016,GRA
1,7,4,112,1.463586035,119,7,yeah,"('CHI', 'GRA')",Providence,nai79.xml,124,5,1,GRA,656,1305,CHI
0,1,13,124,1.442989705,125,1,think,"('MOT', 'CHI')",Providence,nai79.xml,138,13,0,CHI,1937,732,MOT
1,5,4,81,1.432814377,86,5,but,"('GRA', 'MOT')",Providence,nai79.xml,91,5,1,MOT,808,1016,GRA
0,2,5,84,1.432814377,86,2,one,"('GRA', 'MOT')",Providence,nai79.xml,91,5,0,MOT,808,1016,GRA
0,2,5,83,1.421385681,85,2,on,"('MOT', 'GRA')",Providence,nai79.xml,90,5,0,GRA,913,635,MOT
0,5,3,116,1.410986974,121,5,was,"('CHI', 'GRA')",Providence,nai79.xml,124,3,0,GRA,656,1305,CHI
0,5,3,116,1.410986974,121,5,do,"('CHI', 'GRA')",Providence,nai79.xml,124,3,0,GRA,656,1305,CHI
0,4,4,116,1.402823663,120,4,gonna,"('CHI', 'GRA')",Providence,nai79.xml,124,4,0,GRA,656,1305,CHI
3,5,4,47,1.386294361,52,5,it,"('CHI', 'MOT')",Providence,nai79.xml,59,7,3,MOT,353,539,CHI
0,4,1,54,1.386294361,58,4,of,"('CHI', 'MOT')",Providence,nai79.xml,59,1,0,MOT,353,539,CHI
0,4,1,54,1.386294361,58,4,up,"('CHI', 'MOT')",Providence,nai79.xml,59,1,0,MOT,353,539,CHI
1,8,4,111,1.345803,119,8,we,"('CHI', 'GRA')",Providence,nai79.xml,124,5,1,GRA,656,1305,CHI
1,3,8,79,1.339774345,82,3,no,"('GRA', 'MOT')",Providence,nai79.xml,91,9,1,MOT,808,1016,GRA
3,5,9,73,1.337504197,78,5,to,"('MOT', 'GRA')",Providence,nai79.xml,90,12,3,GRA,913,635,MOT
7,8,13,84,1.334469293,92,8,it,"('GRA', 'CHI')",Providence,nai79.xml,112,20,7,CHI,1177,696,GRA
0,5,2,84,1.332805676,89,5,up,"('GRA', 'MOT')",Providence,nai79.xml,91,2,0,MOT,808,1016,GRA
0,3,2,54,1.304948722,57,3,have,"('CHI', 'MOT')",Providence,nai79.xml,59,2,0,MOT,353,539,CHI
0,3,2,54,1.304948722,57,3,is,"('CHI', 'MOT')",Providence,nai79.xml,59,2,0,MOT,353,539,CHI
0,3,4,83,1.299282984,86,3,what,"('MOT', 'GRA')",Providence,nai79.xml,90,4,0,GRA,913,635,MOT
0,3,4,83,1.299282984,86,3,but,"('MOT', 'GRA')",Providence,nai79.xml,90,4,0,GRA,913,635,MOT
2,6,6,77,1.292768303,83,6,is,"('GRA', 'MOT')",Providence,nai79.xml,91,8,2,MOT,808,1016,GRA
1,2,15,94,1.289130613,96,2,that,"('GRA', 'CHI')",Providence,nai79.xml,112,16,1,CHI,1177,696,GRA
0,4,3,84,1.280933845,88,4,get,"('GRA', 'MOT')",Providence,nai79.xml,91,3,0,MOT,808,1016,GRA
5,4,22,81,1.280933845,85,4,a,"('GRA', 'CHI')",Providence,nai79.xml,112,27,5,CHI,1177,696,GRA
0,4,3,83,1.269760545,87,4,of,"('MOT', 'GRA')",Providence,nai79.xml,90,3,0,GRA,913,635,MOT
0,4,3,83,1.269760545,87,4,no,"('MOT', 'GRA')",Providence,nai79.xml,90,3,0,GRA,913,635,MOT
1,3,9,77,1.228665417,80,3,think,"('MOT', 'GRA')",Providence,nai79.xml,90,10,1,GRA,913,635,MOT
0,3,6,103,1.216395324,106,3,yeah,"('GRA', 'CHI')",Providence,nai79.xml,112,6,0,CHI,1177,696,GRA
1,6,7,110,1.215336563,116,6,see,"('CHI', 'GRA')",Providence,nai79.xml,124,8,1,GRA,656,1305,CHI
0,5,1,53,1.203972804,58,5,for,"('CHI', 'MOT')",Providence,nai79.xml,59,1,0,MOT,353,539,CHI
3,6,12,91,1.202290718,97,6,we,"('GRA', 'CHI')",Providence,nai79.xml,112,15,3,CHI,1177,696,GRA
1,18,1,104,1.182695406,122,18,oh,"('CHI', 'GRA')",Providence,nai79.xml,124,2,1,GRA,656,1305,CHI
3,11,4,73,1.15851043,84,11,that,"('GRA', 'MOT')",Providence,nai79.xml,91,7,3,MOT,808,1016,GRA
1,5,6,78,1.14681439,83,5,is,"('MOT', 'GRA')",Providence,nai79.xml,90,7,1,GRA,913,635,MOT
1,5,10,108,1.081370482,113,5,no,"('CHI', 'GRA')",Providence,nai79.xml,124,11,1,GRA,656,1305,CHI
1,4,14,119,1.078809661,123,4,want,"('MOT', 'CHI')",Providence,nai79.xml,138,15,1,CHI,1937,732,MOT
0,10,2,112,1.036091932,122,10,have,"('CHI', 'GRA')",Providence,nai79.xml,124,2,0,GRA,656,1305,CHI
0,2,8,80,1.029619417,82,2,did,"('MOT', 'GRA')",Providence,nai79.xml,90,8,0,GRA,913,635,MOT
5,13,10,96,1.029018997,109,13,it,"('CHI', 'GRA')",Providence,nai79.xml,124,15,5,GRA,656,1305,CHI
1,1,1,8,1.011600912,9,1,that,"('FAT', 'MOT')",Providence,nai79.xml,11,2,1,MOT,62,64,FAT
1,6,6,77,0.992663711,83,6,it,"('MOT', 'GRA')",Providence,nai79.xml,90,7,1,GRA,913,635,MOT
0,2,5,52,0.980829253,54,2,yeah,"('CHI', 'MOT')",Providence,nai79.xml,59,5,0,MOT,353,539,CHI
1,5,4,49,0.980829253,54,5,a,"('CHI', 'MOT')",Providence,nai79.xml,59,5,1,MOT,353,539,CHI
2,8,7,74,0.934309237,82,8,a,"('GRA', 'MOT')",Providence,nai79.xml,91,9,2,MOT,808,1016,GRA
0,7,4,113,0.932820034,120,7,not,"('CHI', 'GRA')",Providence,nai79.xml,124,4,0,GRA,656,1305,CHI
1,5,8,76,0.922333046,81,5,in,"('MOT', 'GRA')",Providence,nai79.xml,90,9,1,GRA,913,635,MOT
0,4,5,82,0.921988753,86,4,what,"('GRA', 'MOT')",Providence,nai79.xml,91,5,0,MOT,808,1016,GRA
3,7,19,109,0.899483614,116,7,it,"('MOT', 'CHI')",Providence,nai79.xml,138,22,3,CHI,1937,732,MOT
0,5,2,52,0.899483614,57,5,can,"('CHI', 'MOT')",Providence,nai79.xml,59,2,0,MOT,353,539,CHI
0,16,1,107,0.896488105,123,16,that,"('CHI', 'GRA')",Providence,nai79.xml,124,1,0,GRA,656,1305,CHI
0,12,2,110,0.869037847,122,12,what,"('CHI', 'GRA')",Providence,nai79.xml,124,2,0,GRA,656,1305,CHI
0,2,16,120,0.831297519,122,2,do,"('MOT', 'CHI')",Providence,nai79.xml,138,16,0,CHI,1937,732,MOT
0,5,6,101,0.810930216,106,5,of,"('GRA', 'CHI')",Providence,nai79.xml,112,6,0,CHI,1177,696,GRA
0,5,7,112,0.790139447,117,5,there,"('CHI', 'GRA')",Providence,nai79.xml,124,7,0,GRA,656,1305,CHI
0,5,8,125,0.78845736,130,5,yeah,"('MOT', 'CHI')",Providence,nai79.xml,138,8,0,CHI,1937,732,MOT
1,4,19,114,0.780158558,118,4,to,"('MOT', 'CHI')",Providence,nai79.xml,138,20,1,CHI,1937,732,MOT
0,3,10,99,0.773189888,102,3,there,"('GRA', 'CHI')",Providence,nai79.xml,112,10,0,CHI,1177,696,GRA
1,10,2,46,0.746257006,56,10,do,"('CHI', 'MOT')",Providence,nai79.xml,59,3,1,MOT,353,539,CHI
2,6,20,110,0.745332934,116,6,that,"('MOT', 'CHI')",Providence,nai79.xml,138,22,2,CHI,1937,732,MOT
5,8,21,78,0.739667196,86,8,the,"('GRA', 'CHI')",Providence,nai79.xml,112,26,5,CHI,1177,696,GRA
2,23,4,109,0.738956717,132,23,no,"('MOT', 'CHI')",Providence,nai79.xml,138,6,2,CHI,1937,732,MOT
0,1,1,9,0.693147181,10,1,no,"('FAT', 'MOT')",Providence,nai79.xml,11,1,0,MOT,62,64,FAT
0,1,1,9,0.693147181,10,1,to,"('FAT', 'MOT')",Providence,nai79.xml,11,1,0,MOT,62,64,FAT
0,5,7,100,0.683844788,105,5,go,"('GRA', 'CHI')",Providence,nai79.xml,112,7,0,CHI,1177,696,GRA
3,10,13,86,0.682994809,96,10,to,"('GRA', 'CHI')",Providence,nai79.xml,112,16,3,CHI,1177,696,GRA
1,6,5,47,0.675128675,53,6,some,"('CHI', 'MOT')",Providence,nai79.xml,59,6,1,MOT,353,539,CHI
2,11,7,71,0.646627165,82,11,and,"('GRA', 'MOT')",Providence,nai79.xml,91,9,2,MOT,808,1016,GRA
0,11,2,78,0.639658496,89,11,do,"('GRA', 'MOT')",Providence,nai79.xml,91,2,0,MOT,808,1016,GRA
1,15,5,103,0.628608659,118,15,and,"('CHI', 'GRA')",Providence,nai79.xml,124,6,1,GRA,656,1305,CHI
1,8,7,74,0.624154309,82,8,oh,"('MOT', 'GRA')",Providence,nai79.xml,90,8,1,GRA,913,635,MOT
0,10,1,48,0.597837001,58,10,to,"('CHI', 'MOT')",Providence,nai79.xml,59,1,0,MOT,353,539,CHI
2,6,14,68,0.593063722,74,6,that,"('MOT', 'GRA')",Providence,nai79.xml,90,16,2,GRA,913,635,MOT
1,6,10,74,0.589006921,80,6,oh,"('GRA', 'MOT')",Providence,nai79.xml,91,11,1,MOT,808,1016,GRA
4,13,10,63,0.554500687,76,13,a,"('MOT', 'GRA')",Providence,nai79.xml,90,14,4,GRA,913,635,MOT
0,6,7,99,0.529694108,105,6,do,"('GRA', 'CHI')",Providence,nai79.xml,112,7,0,CHI,1177,696,GRA
8,15,26,89,0.504556011,104,15,the,"('MOT', 'CHI')",Providence,nai79.xml,138,34,8,CHI,1937,732,MOT
0,5,11,122,0.503103578,127,5,up,"('MOT', 'CHI')",Providence,nai79.xml,138,11,0,CHI,1937,732,MOT
1,24,0,34,0.470003629,58,24,you,"('CHI', 'MOT')",Providence,nai79.xml,59,1,1,MOT,353,539,CHI
0,7,7,98,0.396162715,105,7,and,"('GRA', 'CHI')",Providence,nai79.xml,112,7,0,CHI,1177,696,GRA
5,26,10,83,0.37223946,109,26,the,"('CHI', 'GRA')",Providence,nai79.xml,124,15,5,GRA,656,1305,CHI
2,21,7,94,0.371848497,115,21,a,"('CHI', 'GRA')",Providence,nai79.xml,124,9,2,GRA,656,1305,CHI
1,7,11,72,0.369097464,79,7,to,"('GRA', 'MOT')",Providence,nai79.xml,91,12,1,MOT,808,1016,GRA
0,5,8,77,0.336472237,82,5,have,"('MOT', 'GRA')",Providence,nai79.xml,90,8,0,GRA,913,635,MOT
0,1,2,8,0.318453731,9,1,it,"('FAT', 'MOT')",Providence,nai79.xml,11,2,0,MOT,62,64,FAT
0,10,6,108,0.310154928,118,10,to,"('CHI', 'GRA')",Providence,nai79.xml,124,6,0,GRA,656,1305,CHI
0,6,4,49,0.30538165,55,6,no,"('CHI', 'MOT')",Providence,nai79.xml,59,4,0,MOT,353,539,CHI
6,16,14,54,0.298320471,70,16,you,"('MOT', 'GRA')",Providence,nai79.xml,90,20,6,GRA,913,635,MOT
5,18,12,56,0.233614851,74,18,you,"('GRA', 'MOT')",Providence,nai79.xml,91,17,5,MOT,808,1016,GRA
0,6,8,77,0.194156014,83,6,in,"('GRA', 'MOT')",Providence,nai79.xml,91,8,0,MOT,808,1016,GRA
1,13,7,70,0.194156014,83,13,it,"('GRA', 'MOT')",Providence,nai79.xml,91,8,1,MOT,808,1016,GRA
0,8,6,77,0.189242,85,8,have,"('GRA', 'MOT')",Providence,nai79.xml,91,6,0,MOT,808,1016,GRA
0,7,4,48,0.171850257,55,7,want,"('CHI', 'MOT')",Providence,nai79.xml,59,4,0,MOT,353,539,CHI
0,5,16,117,0.138150338,122,5,in,"('MOT', 'CHI')",Providence,nai79.xml,138,16,0,CHI,1937,732,MOT
0,6,5,48,0.133531393,54,6,and,"('CHI', 'MOT')",Providence,nai79.xml,59,5,0,MOT,353,539,CHI
0,6,11,95,0.123869482,101,6,is,"('GRA', 'CHI')",Providence,nai79.xml,112,11,0,CHI,1177,696,GRA
0,8,11,119,0.09763847,127,8,not,"('MOT', 'CHI')",Providence,nai79.xml,138,11,0,CHI,1937,732,MOT
4,15,15,57,0.096391846,72,15,the,"('GRA', 'MOT')",Providence,nai79.xml,91,19,4,MOT,808,1016,GRA
2,5,41,90,0.074901308,95,5,you,"('MOT', 'CHI')",Providence,nai79.xml,138,43,2,CHI,1937,732,MOT
0,10,6,75,-0.011428696,85,10,of,"('GRA', 'MOT')",Providence,nai79.xml,91,6,0,MOT,808,1016,GRA
0,15,5,92,-0.027150989,107,15,no,"('GRA', 'CHI')",Providence,nai79.xml,112,5,0,CHI,1177,696,GRA
0,5,20,113,-0.09531018,118,5,and,"('MOT', 'CHI')",Providence,nai79.xml,138,20,0,CHI,1937,732,MOT
1,9,9,40,-0.162518929,49,9,the,"('CHI', 'MOT')",Providence,nai79.xml,59,10,1,MOT,353,539,CHI
0,11,7,72,-0.239479971,83,11,yeah,"('MOT', 'GRA')",Providence,nai79.xml,90,7,0,GRA,913,635,MOT
0,1,1,1,-0.405465108,2,1,we,"('GRA', 'FAT')",Providence,nai79.xml,3,1,0,FAT,15,15,GRA
0,1,1,1,-0.405465108,2,1,like,"('MOT', 'FAT')",Providence,nai79.xml,3,1,0,FAT,29,26,MOT
0,1,1,1,-0.405465108,2,1,the,"('MOT', 'FAT')",Providence,nai79.xml,3,1,0,FAT,29,26,MOT
0,31,4,89,-0.453474327,120,31,you,"('CHI', 'GRA')",Providence,nai79.xml,124,4,0,GRA,656,1305,CHI
0,9,11,71,-0.460815203,80,9,yeah,"('GRA', 'MOT')",Providence,nai79.xml,91,11,0,MOT,808,1016,GRA
0,7,18,87,-0.510825624,94,7,you,"('GRA', 'CHI')",Providence,nai79.xml,112,18,0,CHI,1177,696,GRA
0,7,16,67,-0.639079959,74,7,the,"('MOT', 'GRA')",Providence,nai79.xml,90,16,0,GRA,913,635,MOT
0,1,1,347,4.066173685,348,1,make,"('CHI', 'MOT')",Providence,nai80.xml,349,1,0,MOT,2928,4666,CHI
2,6,0,341,3.621479701,347,6,was,"('CHI', 'MOT')",Providence,nai80.xml,349,2,2,MOT,2928,4666,CHI
0,1,3,345,3.549617387,346,1,big,"('CHI', 'MOT')",Providence,nai80.xml,349,3,0,MOT,2928,4666,CHI
5,8,2,334,3.237951972,342,8,he,"('CHI', 'MOT')",Providence,nai80.xml,349,7,5,MOT,2928,4666,CHI
3,4,6,336,3.213771913,340,4,she,"('CHI', 'MOT')",Providence,nai80.xml,349,9,3,MOT,2928,4666,CHI
2,6,3,338,3.053230766,344,6,wanna,"('CHI', 'MOT')",Providence,nai80.xml,349,5,2,MOT,2928,4666,CHI
0,5,1,343,2.967561397,348,5,they,"('CHI', 'MOT')",Providence,nai80.xml,349,1,0,MOT,2928,4666,CHI
1,12,1,335,2.596975384,347,12,little,"('CHI', 'MOT')",Providence,nai80.xml,349,2,1,MOT,2928,4666,CHI
2,8,5,334,2.544804791,342,8,get,"('CHI', 'MOT')",Providence,nai80.xml,349,7,2,MOT,2928,4666,CHI
1,12,3,333,2.185763134,345,12,did,"('CHI', 'MOT')",Providence,nai80.xml,349,4,1,MOT,2928,4666,CHI
0,5,5,339,2.108769157,344,5,want,"('CHI', 'MOT')",Providence,nai80.xml,349,5,0,MOT,2928,4666,CHI
6,19,7,317,2.06517357,336,19,like,"('CHI', 'MOT')",Providence,nai80.xml,349,13,6,MOT,2928,4666,CHI
3,16,6,324,1.989996481,340,16,gonna,"('CHI', 'MOT')",Providence,nai80.xml,349,9,3,MOT,2928,4666,CHI
1,13,4,331,1.954618477,344,13,not,"('CHI', 'MOT')",Providence,nai80.xml,349,5,1,MOT,2928,4666,CHI
0,4,8,337,1.925707442,341,4,my,"('CHI', 'MOT')",Providence,nai80.xml,349,8,0,MOT,2928,4666,CHI
2,12,8,327,1.880638759,339,12,yeah,"('CHI', 'MOT')",Providence,nai80.xml,349,10,2,MOT,2928,4666,CHI
0,9,4,336,1.754980218,345,9,but,"('CHI', 'MOT')",Providence,nai80.xml,349,4,0,MOT,2928,4666,CHI
1,18,4,326,1.649236827,344,18,for,"('CHI', 'MOT')",Providence,nai80.xml,349,5,1,MOT,2928,4666,CHI
2,13,11,323,1.574550653,336,13,up,"('CHI', 'MOT')",Providence,nai80.xml,349,13,2,MOT,2928,4666,CHI
0,10,5,334,1.502633353,344,10,with,"('CHI', 'MOT')",Providence,nai80.xml,349,5,0,MOT,2928,4666,CHI
0,12,4,333,1.492615953,345,12,at,"('CHI', 'MOT')",Providence,nai80.xml,349,4,0,MOT,2928,4666,CHI
2,23,6,318,1.455703812,341,23,have,"('CHI', 'MOT')",Providence,nai80.xml,349,8,2,MOT,2928,4666,CHI
0,11,5,333,1.415621976,344,11,are,"('CHI', 'MOT')",Providence,nai80.xml,349,5,0,MOT,2928,4666,CHI
1,13,9,326,1.401065678,339,13,can,"('CHI', 'MOT')",Providence,nai80.xml,349,10,1,MOT,2928,4666,CHI
4,18,17,310,1.328597372,328,18,some,"('CHI', 'MOT')",Providence,nai80.xml,349,21,4,MOT,2928,4666,CHI
5,12,32,300,1.312641452,312,12,no,"('CHI', 'MOT')",Providence,nai80.xml,349,37,5,MOT,2928,4666,CHI
7,34,12,296,1.284706011,330,34,we,"('CHI', 'MOT')",Providence,nai80.xml,349,19,7,MOT,2928,4666,CHI
2,23,8,316,1.267534286,339,23,do,"('CHI', 'MOT')",Providence,nai80.xml,349,10,2,MOT,2928,4666,CHI
2,22,9,316,1.227114333,338,22,of,"('CHI', 'MOT')",Providence,nai80.xml,349,11,2,MOT,2928,4666,CHI
1,23,6,319,1.15851043,342,23,on,"('CHI', 'MOT')",Providence,nai80.xml,349,7,1,MOT,2928,4666,CHI
1,9,18,321,1.151174619,330,9,where,"('CHI', 'MOT')",Providence,nai80.xml,349,19,1,MOT,2928,4666,CHI
1,17,9,322,1.14975125,339,17,all,"('CHI', 'MOT')",Providence,nai80.xml,349,10,1,MOT,2928,4666,CHI
0,18,4,327,1.113126332,345,18,put,"('CHI', 'MOT')",Providence,nai80.xml,349,4,0,MOT,2928,4666,CHI
6,24,25,294,0.998847759,318,24,in,"('CHI', 'MOT')",Providence,nai80.xml,349,31,6,MOT,2928,4666,CHI
6,29,25,289,0.816526202,318,29,to,"('CHI', 'MOT')",Providence,nai80.xml,349,31,6,MOT,2928,4666,CHI
17,59,25,248,0.745178839,307,59,it,"('CHI', 'MOT')",Providence,nai80.xml,349,42,17,MOT,2928,4666,CHI
9,24,47,269,0.710241614,293,24,think,"('CHI', 'MOT')",Providence,nai80.xml,349,56,9,MOT,2928,4666,CHI
1,27,9,312,0.707918498,339,27,see,"('CHI', 'MOT')",Providence,nai80.xml,349,10,1,MOT,2928,4666,CHI
7,40,22,280,0.706433816,320,40,and,"('CHI', 'MOT')",Providence,nai80.xml,349,29,7,MOT,2928,4666,CHI
5,29,25,290,0.696267308,319,29,go,"('CHI', 'MOT')",Providence,nai80.xml,349,30,5,MOT,2928,4666,CHI
12,64,19,254,0.662375522,318,64,a,"('CHI', 'MOT')",Providence,nai80.xml,349,31,12,MOT,2928,4666,CHI
10,29,45,265,0.644006078,294,29,this,"('CHI', 'MOT')",Providence,nai80.xml,349,55,10,MOT,2928,4666,CHI
0,15,10,324,0.574387105,339,15,look,"('CHI', 'MOT')",Providence,nai80.xml,349,10,0,MOT,2928,4666,CHI
3,39,14,293,0.564116921,332,39,there,"('CHI', 'MOT')",Providence,nai80.xml,349,17,3,MOT,2928,4666,CHI
6,77,10,256,0.512960096,333,77,you,"('CHI', 'MOT')",Providence,nai80.xml,349,16,6,MOT,2928,4666,CHI
16,60,33,240,0.500940865,300,60,the,"('CHI', 'MOT')",Providence,nai80.xml,349,49,16,MOT,2928,4666,CHI
1,35,10,303,0.373624502,338,35,oh,"('CHI', 'MOT')",Providence,nai80.xml,349,11,1,MOT,2928,4666,CHI
0,18,11,320,0.319557281,338,18,one,"('CHI', 'MOT')",Providence,nai80.xml,349,11,0,MOT,2928,4666,CHI
4,46,20,279,0.291153944,325,46,is,"('CHI', 'MOT')",Providence,nai80.xml,349,24,4,MOT,2928,4666,CHI
9,70,27,243,0.154891695,313,70,that,"('CHI', 'MOT')",Providence,nai80.xml,349,36,9,MOT,2928,4666,CHI
0,20,12,317,0.14242034,337,20,what,"('CHI', 'MOT')",Providence,nai80.xml,349,12,0,MOT,2928,4666,CHI
2,0,2,127,4.166665224,127,0,one,"('MOT', 'CHI')",Providence,nai81.xml,131,4,2,CHI,1444,1335,MOT
1,0,6,124,3.33220451,124,0,can,"('MOT', 'CHI')",Providence,nai81.xml,131,7,1,CHI,1444,1335,MOT
1,2,1,127,3.083437854,129,2,make,"('MOT', 'CHI')",Providence,nai81.xml,131,2,1,CHI,1444,1335,MOT
0,1,1,103,2.871679625,104,1,my,"('CHI', 'MOT')",Providence,nai81.xml,105,1,0,MOT,1009,1461,CHI
0,1,2,128,2.795755782,129,1,little,"('MOT', 'CHI')",Providence,nai81.xml,131,2,0,CHI,1444,1335,MOT
3,3,3,122,2.764745545,125,3,get,"('MOT', 'CHI')",Providence,nai81.xml,131,6,3,CHI,1444,1335,MOT
0,2,1,128,2.685577345,130,2,he,"('MOT', 'CHI')",Providence,nai81.xml,131,1,0,CHI,1444,1335,MOT
2,2,3,98,2.679062664,100,2,want,"('CHI', 'MOT')",Providence,nai81.xml,105,5,2,MOT,1009,1461,CHI
1,2,4,124,2.500655007,126,2,up,"('MOT', 'CHI')",Providence,nai81.xml,131,5,1,CHI,1444,1335,MOT
0,2,1,102,2.466214517,104,2,they,"('CHI', 'MOT')",Providence,nai81.xml,105,1,0,MOT,1009,1461,CHI
2,6,0,97,2.420368129,103,6,we,"('CHI', 'MOT')",Providence,nai81.xml,105,2,2,MOT,1009,1461,CHI
0,3,1,127,2.397895273,130,3,my,"('MOT', 'CHI')",Providence,nai81.xml,131,1,0,CHI,1444,1335,MOT
2,4,3,122,2.395294491,126,4,for,"('MOT', 'CHI')",Providence,nai81.xml,131,5,2,CHI,1444,1335,MOT
2,5,2,122,2.374905755,127,5,want,"('MOT', 'CHI')",Providence,nai81.xml,131,4,2,CHI,1444,1335,MOT
1,2,4,98,2.273597556,100,2,there,"('CHI', 'MOT')",Providence,nai81.xml,105,5,1,MOT,1009,1461,CHI
0,1,5,125,2.212972934,126,1,was,"('MOT', 'CHI')",Providence,nai81.xml,131,5,0,CHI,1444,1335,MOT
0,1,5,125,2.212972934,126,1,did,"('MOT', 'CHI')",Providence,nai81.xml,131,5,0,CHI,1444,1335,MOT
0,1,5,125,2.212972934,126,1,all,"('MOT', 'CHI')",Providence,nai81.xml,131,5,0,CHI,1444,1335,MOT
2,6,1,96,2.187655126,102,6,go,"('CHI', 'MOT')",Providence,nai81.xml,105,3,2,MOT,1009,1461,CHI
0,3,1,101,2.178532444,104,3,up,"('CHI', 'MOT')",Providence,nai81.xml,105,1,0,MOT,1009,1461,CHI
0,3,1,101,2.178532444,104,3,where,"('CHI', 'MOT')",Providence,nai81.xml,105,1,0,MOT,1009,1461,CHI
1,5,1,98,2.1690537,103,5,with,"('CHI', 'MOT')",Providence,nai81.xml,105,2,1,MOT,1009,1461,CHI
0,2,2,101,2.1690537,103,2,all,"('CHI', 'MOT')",Providence,nai81.xml,105,2,0,MOT,1009,1461,CHI
1,5,1,98,2.1690537,103,5,some,"('CHI', 'MOT')",Providence,nai81.xml,105,2,1,MOT,1009,1461,CHI
0,2,2,101,2.1690537,103,2,one,"('CHI', 'MOT')",Providence,nai81.xml,105,2,0,MOT,1009,1461,CHI
0,2,3,126,2.159484249,128,2,on,"('MOT', 'CHI')",Providence,nai81.xml,131,3,0,CHI,1444,1335,MOT
1,4,2,98,2.118662255,102,4,was,"('CHI', 'MOT')",Providence,nai81.xml,105,3,1,MOT,1009,1461,CHI
0,3,2,126,2.102608601,129,3,big,"('MOT', 'CHI')",Providence,nai81.xml,131,2,0,CHI,1444,1335,MOT
0,1,6,124,2.071598364,125,1,see,"('MOT', 'CHI')",Providence,nai81.xml,131,6,0,CHI,1444,1335,MOT
1,2,6,96,2.002480501,98,2,no,"('CHI', 'MOT')",Providence,nai81.xml,105,7,1,MOT,1009,1461,CHI
0,2,4,125,1.969440646,127,2,they,"('MOT', 'CHI')",Providence,nai81.xml,131,4,0,CHI,1444,1335,MOT
0,2,4,125,1.969440646,127,2,at,"('MOT', 'CHI')",Providence,nai81.xml,131,4,0,CHI,1444,1335,MOT
0,4,2,125,1.87946505,129,4,wanna,"('MOT', 'CHI')",Providence,nai81.xml,131,2,0,CHI,1444,1335,MOT
0,3,3,125,1.871802177,128,3,where,"('MOT', 'CHI')",Providence,nai81.xml,131,3,0,CHI,1444,1335,MOT
2,5,6,118,1.832581464,123,5,gonna,"('MOT', 'CHI')",Providence,nai81.xml,131,8,2,CHI,1444,1335,MOT
1,3,7,120,1.832581464,123,3,think,"('MOT', 'CHI')",Providence,nai81.xml,131,8,1,CHI,1444,1335,MOT
1,5,4,121,1.807507826,126,5,with,"('MOT', 'CHI')",Providence,nai81.xml,131,5,1,CHI,1444,1335,MOT
2,6,5,118,1.791759469,124,6,go,"('MOT', 'CHI')",Providence,nai81.xml,131,7,2,CHI,1444,1335,MOT
0,2,4,99,1.74435723,101,2,did,"('CHI', 'MOT')",Providence,nai81.xml,105,4,0,MOT,1009,1461,CHI
2,4,9,116,1.728246064,120,4,have,"('MOT', 'CHI')",Providence,nai81.xml,131,11,2,CHI,1444,1335,MOT
1,6,4,120,1.653357146,126,6,she,"('MOT', 'CHI')",Providence,nai81.xml,131,5,1,CHI,1444,1335,MOT
0,3,3,99,1.648658626,102,3,on,"('CHI', 'MOT')",Providence,nai81.xml,105,3,0,MOT,1009,1461,CHI
2,11,1,91,1.648658626,102,11,that,"('CHI', 'MOT')",Providence,nai81.xml,105,3,2,MOT,1009,1461,CHI
0,6,1,98,1.618916656,104,6,of,"('CHI', 'MOT')",Providence,nai81.xml,105,1,0,MOT,1009,1461,CHI
0,6,1,98,1.618916656,104,6,little,"('CHI', 'MOT')",Providence,nai81.xml,105,1,0,MOT,1009,1461,CHI
2,1,3,20,1.595049175,21,1,the,"('ADU', 'MOT')",Providence,nai81.xml,26,5,2,MOT,150,155,ADU
2,7,4,92,1.554849722,99,7,think,"('CHI', 'MOT')",Providence,nai81.xml,105,6,2,MOT,1009,1461,CHI
0,6,2,123,1.542992813,129,6,put,"('MOT', 'CHI')",Providence,nai81.xml,131,2,0,CHI,1444,1335,MOT
1,2,14,114,1.532006172,116,2,oh,"('MOT', 'CHI')",Providence,nai81.xml,131,15,1,CHI,1444,1335,MOT
0,1,1,24,1.504077397,25,1,oh,"('ADU', 'MOT')",Providence,nai81.xml,26,1,0,MOT,150,155,ADU
0,1,1,24,1.504077397,25,1,there,"('ADU', 'MOT')",Providence,nai81.xml,26,1,0,MOT,150,155,ADU
0,1,1,24,1.504077397,25,1,no,"('ADU', 'MOT')",Providence,nai81.xml,26,1,0,MOT,150,155,ADU
0,1,1,24,1.504077397,25,1,not,"('ADU', 'MOT')",Providence,nai81.xml,26,1,0,MOT,150,155,ADU
0,5,2,98,1.47590652,103,5,but,"('CHI', 'MOT')",Providence,nai81.xml,105,2,0,MOT,1009,1461,CHI
6,17,1,81,1.463484,98,17,a,"('CHI', 'MOT')",Providence,nai81.xml,105,7,6,MOT,1009,1461,CHI
1,5,7,118,1.427116356,123,5,some,"('MOT', 'CHI')",Providence,nai81.xml,131,8,1,CHI,1444,1335,MOT
1,6,4,94,1.426299696,100,6,put,"('CHI', 'MOT')",Providence,nai81.xml,105,5,1,MOT,1009,1461,CHI
1,4,9,117,1.410986974,121,4,this,"('MOT', 'CHI')",Providence,nai81.xml,131,10,1,CHI,1444,1335,MOT
0,3,6,122,1.378451184,125,3,like,"('MOT', 'CHI')",Providence,nai81.xml,131,6,0,CHI,1444,1335,MOT
2,7,8,114,1.346448453,121,7,do,"('MOT', 'CHI')",Providence,nai81.xml,131,10,2,CHI,1444,1335,MOT
0,2,9,120,1.323774004,122,2,there,"('MOT', 'CHI')",Providence,nai81.xml,131,9,0,CHI,1444,1335,MOT
0,4,5,122,1.296682202,126,4,we,"('MOT', 'CHI')",Providence,nai81.xml,131,5,0,CHI,1444,1335,MOT
1,7,4,93,1.292768303,100,7,are,"('CHI', 'MOT')",Providence,nai81.xml,105,5,1,MOT,1009,1461,CHI
0,9,1,95,1.262241712,104,9,get,"('CHI', 'MOT')",Providence,nai81.xml,105,1,0,MOT,1009,1461,CHI
0,3,7,121,1.252762968,124,3,are,"('MOT', 'CHI')",Providence,nai81.xml,131,7,0,CHI,1444,1335,MOT
0,5,3,97,1.243193517,102,5,can,"('CHI', 'MOT')",Providence,nai81.xml,105,3,0,MOT,1009,1461,CHI
7,10,15,99,1.21302264,109,10,it,"('MOT', 'CHI')",Providence,nai81.xml,131,22,7,CHI,1444,1335,MOT
0,7,2,96,1.188224447,103,7,have,"('CHI', 'MOT')",Providence,nai81.xml,105,2,0,MOT,1009,1461,CHI
0,1,2,23,1.178654996,24,1,to,"('ADU', 'MOT')",Providence,nai81.xml,26,2,0,MOT,150,155,ADU
0,10,1,94,1.166931533,104,10,for,"('CHI', 'MOT')",Providence,nai81.xml,105,1,0,MOT,1009,1461,CHI
1,13,3,114,1.122142786,127,13,yeah,"('MOT', 'CHI')",Providence,nai81.xml,131,4,1,CHI,1444,1335,MOT
3,12,5,85,1.113879761,97,12,do,"('CHI', 'MOT')",Providence,nai81.xml,105,8,3,MOT,1009,1461,CHI
0,2,1,23,1.098612289,25,2,a,"('ADU', 'MOT')",Providence,nai81.xml,26,1,0,MOT,150,155,ADU
0,2,1,23,1.098612289,25,2,is,"('ADU', 'MOT')",Providence,nai81.xml,26,1,0,MOT,150,155,ADU
0,4,5,96,1.069624752,100,4,at,"('CHI', 'MOT')",Providence,nai81.xml,105,5,0,MOT,1009,1461,CHI
2,12,4,87,1.069341906,99,12,gonna,"('CHI', 'MOT')",Providence,nai81.xml,105,6,2,MOT,1009,1461,CHI
1,9,6,115,1.029619417,124,9,not,"('MOT', 'CHI')",Providence,nai81.xml,131,7,1,CHI,1444,1335,MOT
2,11,5,87,1.021651248,98,11,is,"('CHI', 'MOT')",Providence,nai81.xml,105,7,2,MOT,1009,1461,CHI
0,15,1,115,1.011600912,130,15,no,"('MOT', 'CHI')",Providence,nai81.xml,131,1,0,CHI,1444,1335,MOT
1,2,3,20,0.980829253,22,2,and,"('ADU', 'MOT')",Providence,nai81.xml,26,4,1,MOT,150,155,ADU
4,8,13,80,0.967584026,88,8,the,"('CHI', 'MOT')",Providence,nai81.xml,105,17,4,MOT,1009,1461,CHI
2,7,10,86,0.933990309,93,7,she,"('CHI', 'MOT')",Providence,nai81.xml,105,12,2,MOT,1009,1461,CHI
0,1,3,22,0.916290732,23,1,but,"('ADU', 'MOT')",Providence,nai81.xml,26,3,0,MOT,150,155,ADU
0,1,3,22,0.916290732,23,1,she,"('ADU', 'MOT')",Providence,nai81.xml,26,3,0,MOT,150,155,ADU
2,11,6,86,0.906240396,97,11,and,"('CHI', 'MOT')",Providence,nai81.xml,105,8,2,MOT,1009,1461,CHI
0,8,4,119,0.870828358,127,8,look,"('MOT', 'CHI')",Providence,nai81.xml,131,4,0,CHI,1444,1335,MOT
0,3,1,22,0.810930216,25,3,it,"('ADU', 'MOT')",Providence,nai81.xml,26,1,0,MOT,150,155,ADU
0,5,8,118,0.733969175,123,5,but,"('MOT', 'CHI')",Providence,nai81.xml,131,8,0,CHI,1444,1335,MOT
1,10,7,87,0.587786665,97,10,this,"('CHI', 'MOT')",Providence,nai81.xml,105,8,1,MOT,1009,1461,CHI
1,9,11,110,0.547295304,119,9,and,"('MOT', 'CHI')",Providence,nai81.xml,131,12,1,CHI,1444,1335,MOT
2,16,7,80,0.45247115,96,16,in,"('CHI', 'MOT')",Providence,nai81.xml,105,9,2,MOT,1009,1461,CHI
0,5,11,115,0.447312218,120,5,in,"('MOT', 'CHI')",Providence,nai81.xml,131,11,0,CHI,1444,1335,MOT
2,18,6,79,0.446708067,97,18,to,"('CHI', 'MOT')",Providence,nai81.xml,105,8,2,MOT,1009,1461,CHI
3,13,12,77,0.435812264,90,13,what,"('CHI', 'MOT')",Providence,nai81.xml,105,15,3,MOT,1009,1461,CHI
4,15,17,95,0.419853846,110,15,to,"('MOT', 'CHI')",Providence,nai81.xml,131,21,4,CHI,1444,1335,MOT
0,6,8,91,0.346624608,97,6,yeah,"('CHI', 'MOT')",Providence,nai81.xml,105,8,0,MOT,1009,1461,CHI
8,14,34,75,0.215844249,89,14,you,"('MOT', 'CHI')",Providence,nai81.xml,131,42,8,CHI,1444,1335,MOT
1,11,10,83,0.207639365,94,11,it,"('CHI', 'MOT')",Providence,nai81.xml,105,11,1,MOT,1009,1461,CHI
8,28,12,57,0.204794413,85,28,you,"('CHI', 'MOT')",Providence,nai81.xml,105,20,8,MOT,1009,1461,CHI
3,7,4,12,0.15415068,19,7,yeah,"('ADU', 'MOT')",Providence,nai81.xml,26,7,3,MOT,150,155,ADU
0,6,13,112,0.133531393,118,6,of,"('MOT', 'CHI')",Providence,nai81.xml,131,13,0,CHI,1444,1335,MOT
0,4,16,85,0.011049836,89,4,look,"('CHI', 'MOT')",Providence,nai81.xml,105,16,0,MOT,1009,1461,CHI
3,17,21,90,-0.070826053,107,17,the,"('MOT', 'CHI')",Providence,nai81.xml,131,24,3,CHI,1444,1335,MOT
1,16,14,100,-0.202594883,116,16,what,"('MOT', 'CHI')",Providence,nai81.xml,131,15,1,CHI,1444,1335,MOT
5,25,26,75,-0.337871817,100,25,a,"('MOT', 'CHI')",Providence,nai81.xml,131,31,5,CHI,1444,1335,MOT
0,9,20,102,-0.666239728,111,9,is,"('MOT', 'CHI')",Providence,nai81.xml,131,20,0,CHI,1444,1335,MOT
0,10,20,101,-0.761549907,111,10,that,"('MOT', 'CHI')",Providence,nai81.xml,131,20,0,CHI,1444,1335,MOT
2,1,6,244,3.612268352,245,1,go,"('MOT', 'CHI')",Providence,nai82.xml,253,8,2,CHI,4310,2015,MOT
2,1,9,241,3.337683976,242,1,he,"('MOT', 'CHI')",Providence,nai82.xml,253,11,2,CHI,4310,2015,MOT
3,3,6,241,3.107436263,244,3,did,"('MOT', 'CHI')",Providence,nai82.xml,253,9,3,CHI,4310,2015,MOT
3,1,18,231,3.01297408,232,1,have,"('MOT', 'CHI')",Providence,nai82.xml,253,21,3,CHI,4310,2015,MOT
1,2,0,82,2.950269899,84,2,not,"('CHI', 'MOT')",Providence,nai82.xml,85,1,1,MOT,652,1135,CHI
4,4,9,236,2.780887525,240,4,we,"('MOT', 'CHI')",Providence,nai82.xml,253,13,4,CHI,4310,2015,MOT
0,1,6,246,2.744864174,247,1,want,"('MOT', 'CHI')",Providence,nai82.xml,253,6,0,CHI,4310,2015,MOT
1,2,8,242,2.701971155,244,2,wanna,"('MOT', 'CHI')",Providence,nai82.xml,253,9,1,CHI,4310,2015,MOT
0,1,1,83,2.662587827,84,1,want,"('CHI', 'MOT')",Providence,nai82.xml,85,1,0,MOT,652,1135,CHI
0,1,1,83,2.662587827,84,1,but,"('CHI', 'MOT')",Providence,nai82.xml,85,1,0,MOT,652,1135,CHI
0,1,1,83,2.662587827,84,1,little,"('CHI', 'MOT')",Providence,nai82.xml,85,1,0,MOT,652,1135,CHI
1,2,9,241,2.610886453,243,2,they,"('MOT', 'CHI')",Providence,nai82.xml,253,10,1,CHI,4310,2015,MOT
3,4,10,236,2.557743974,240,4,gonna,"('MOT', 'CHI')",Providence,nai82.xml,253,13,3,CHI,4310,2015,MOT
1,1,19,232,2.368543061,233,1,some,"('MOT', 'CHI')",Providence,nai82.xml,253,20,1,CHI,4310,2015,MOT
0,1,2,82,2.363209715,83,1,look,"('CHI', 'MOT')",Providence,nai82.xml,85,2,0,MOT,652,1135,CHI
0,1,2,82,2.363209715,83,1,make,"('CHI', 'MOT')",Providence,nai82.xml,85,2,0,MOT,652,1135,CHI
0,2,6,245,2.339399066,247,2,she,"('MOT', 'CHI')",Providence,nai82.xml,253,6,0,CHI,4310,2015,MOT
1,5,5,242,2.339399066,247,5,put,"('MOT', 'CHI')",Providence,nai82.xml,253,6,1,CHI,4310,2015,MOT
2,5,8,238,2.32320438,243,5,make,"('MOT', 'CHI')",Providence,nai82.xml,253,10,2,CHI,4310,2015,MOT
1,1,20,231,2.319826899,232,1,like,"('MOT', 'CHI')",Providence,nai82.xml,253,21,1,CHI,4310,2015,MOT
0,2,1,82,2.257122719,84,2,all,"('CHI', 'MOT')",Providence,nai82.xml,85,1,0,MOT,652,1135,CHI
2,9,4,238,2.23403855,247,9,think,"('MOT', 'CHI')",Providence,nai82.xml,253,6,2,CHI,4310,2015,MOT
2,7,6,238,2.225973991,245,7,all,"('MOT', 'CHI')",Providence,nai82.xml,253,8,2,CHI,4310,2015,MOT
4,7,11,231,2.17742195,238,7,was,"('MOT', 'CHI')",Providence,nai82.xml,253,15,4,CHI,4310,2015,MOT
1,3,2,79,2.128231706,82,3,think,"('CHI', 'MOT')",Providence,nai82.xml,85,3,1,MOT,652,1135,CHI
0,3,6,244,2.051716994,247,3,look,"('MOT', 'CHI')",Providence,nai82.xml,253,6,0,CHI,4310,2015,MOT
3,3,25,222,2.023752636,225,3,do,"('MOT', 'CHI')",Providence,nai82.xml,253,28,3,CHI,4310,2015,MOT
0,3,1,81,1.969440646,84,3,did,"('CHI', 'MOT')",Providence,nai82.xml,85,1,0,MOT,652,1135,CHI
0,2,2,81,1.957744607,83,2,no,"('CHI', 'MOT')",Providence,nai82.xml,85,2,0,MOT,652,1135,CHI
0,2,2,81,1.957744607,83,2,one,"('CHI', 'MOT')",Providence,nai82.xml,85,2,0,MOT,652,1135,CHI
0,2,2,81,1.957744607,83,2,where,"('CHI', 'MOT')",Providence,nai82.xml,85,2,0,MOT,652,1135,CHI
1,5,1,78,1.957744607,83,5,there,"('CHI', 'MOT')",Providence,nai82.xml,85,2,1,MOT,652,1135,CHI
1,7,6,239,1.929909808,246,7,little,"('MOT', 'CHI')",Providence,nai82.xml,253,7,1,CHI,4310,2015,MOT
0,3,7,243,1.929909808,246,3,where,"('MOT', 'CHI')",Providence,nai82.xml,253,7,0,CHI,4310,2015,MOT
1,4,2,78,1.905088155,82,4,gonna,"('CHI', 'MOT')",Providence,nai82.xml,85,3,1,MOT,652,1135,CHI
1,4,13,235,1.795917479,239,4,with,"('MOT', 'CHI')",Providence,nai82.xml,253,14,1,CHI,4310,2015,MOT
2,6,2,75,1.779783278,81,6,for,"('CHI', 'MOT')",Providence,nai82.xml,85,4,2,MOT,652,1135,CHI
0,4,1,80,1.746297095,84,4,get,"('CHI', 'MOT')",Providence,nai82.xml,85,1,0,MOT,652,1135,CHI
0,4,1,80,1.746297095,84,4,with,"('CHI', 'MOT')",Providence,nai82.xml,85,1,0,MOT,652,1135,CHI
0,4,1,80,1.746297095,84,4,at,"('CHI', 'MOT')",Providence,nai82.xml,85,1,0,MOT,652,1135,CHI
1,5,2,77,1.722766598,82,5,they,"('CHI', 'MOT')",Providence,nai82.xml,85,3,1,MOT,652,1135,CHI
0,3,2,80,1.670062534,83,3,she,"('CHI', 'MOT')",Providence,nai82.xml,85,2,0,MOT,652,1135,CHI
1,3,20,229,1.626679719,232,3,for,"('MOT', 'CHI')",Providence,nai82.xml,253,21,1,CHI,4310,2015,MOT
2,6,3,74,1.613511238,80,6,are,"('CHI', 'MOT')",Providence,nai82.xml,85,5,2,MOT,652,1135,CHI
1,1,0,11,1.540445041,12,1,yeah,"('AD1', 'CHI')",Providence,nai82.xml,13,1,1,CHI,93,108,AD1
0,4,9,240,1.497998351,244,4,see,"('MOT', 'CHI')",Providence,nai82.xml,253,9,0,CHI,4310,2015,MOT
0,4,9,240,1.497998351,244,4,up,"('MOT', 'CHI')",Providence,nai82.xml,253,9,0,CHI,4310,2015,MOT
0,4,2,79,1.446918983,83,4,on,"('CHI', 'MOT')",Providence,nai82.xml,85,2,0,MOT,652,1135,CHI
0,6,1,78,1.409824859,84,6,see,"('CHI', 'MOT')",Providence,nai82.xml,85,1,0,MOT,652,1135,CHI
0,6,1,78,1.409824859,84,6,up,"('CHI', 'MOT')",Providence,nai82.xml,85,1,0,MOT,652,1135,CHI
0,6,1,78,1.409824859,84,6,my,"('CHI', 'MOT')",Providence,nai82.xml,85,1,0,MOT,652,1135,CHI
1,4,5,75,1.398716881,79,4,was,"('CHI', 'MOT')",Providence,nai82.xml,85,6,1,MOT,652,1135,CHI
0,10,4,239,1.335798197,249,10,my,"('MOT', 'CHI')",Providence,nai82.xml,253,4,0,CHI,4310,2015,MOT
0,4,11,238,1.322780955,242,4,but,"('MOT', 'CHI')",Providence,nai82.xml,253,11,0,CHI,4310,2015,MOT
1,4,22,226,1.311570815,230,4,can,"('MOT', 'CHI')",Providence,nai82.xml,253,23,1,CHI,4310,2015,MOT
1,8,12,232,1.276810128,240,8,on,"('MOT', 'CHI')",Providence,nai82.xml,253,13,1,CHI,4310,2015,MOT
0,5,2,78,1.264597426,83,5,we,"('CHI', 'MOT')",Providence,nai82.xml,85,2,0,MOT,652,1135,CHI
4,12,21,216,1.186730998,228,12,one,"('MOT', 'CHI')",Providence,nai82.xml,253,25,4,CHI,4310,2015,MOT
6,11,31,205,1.181936916,216,11,it,"('MOT', 'CHI')",Providence,nai82.xml,253,37,6,CHI,4310,2015,MOT
1,1,1,10,1.178654996,11,1,and,"('AD1', 'CHI')",Providence,nai82.xml,13,2,1,CHI,93,108,AD1
0,5,12,236,1.062244644,241,5,at,"('MOT', 'CHI')",Providence,nai82.xml,253,12,0,CHI,4310,2015,MOT
0,9,1,75,1.053149915,84,9,have,"('CHI', 'MOT')",Providence,nai82.xml,85,1,0,MOT,652,1135,CHI
0,5,3,77,1.029619417,82,5,can,"('CHI', 'MOT')",Providence,nai82.xml,85,3,0,MOT,652,1135,CHI
2,9,5,69,0.980829253,78,9,of,"('CHI', 'MOT')",Providence,nai82.xml,85,7,2,MOT,652,1135,CHI
3,10,27,213,0.938763588,223,10,in,"('MOT', 'CHI')",Providence,nai82.xml,253,30,3,CHI,4310,2015,MOT
2,11,4,68,0.928713252,79,11,is,"('CHI', 'MOT')",Providence,nai82.xml,85,6,2,MOT,652,1135,CHI
0,6,12,235,0.908093965,241,6,get,"('MOT', 'CHI')",Providence,nai82.xml,253,12,0,CHI,4310,2015,MOT
0,4,18,231,0.862889955,235,4,there,"('MOT', 'CHI')",Providence,nai82.xml,253,18,0,CHI,4310,2015,MOT
0,2,30,221,0.851752211,223,2,are,"('MOT', 'CHI')",Providence,nai82.xml,253,30,0,CHI,4310,2015,MOT
0,1,1,11,0.84729786,12,1,in,"('AD1', 'CHI')",Providence,nai82.xml,13,1,0,CHI,93,108,AD1
0,1,1,11,0.84729786,12,1,it,"('AD1', 'CHI')",Providence,nai82.xml,13,1,0,CHI,93,108,AD1
0,1,1,11,0.84729786,12,1,they,"('AD1', 'CHI')",Providence,nai82.xml,13,1,0,CHI,93,108,AD1
0,1,1,11,0.84729786,12,1,that,"('AD1', 'CHI')",Providence,nai82.xml,13,1,0,CHI,93,108,AD1
1,0,3,5,0.84729786,5,0,to,"('CHI', 'AD1')",Providence,nai82.xml,9,4,1,AD1,80,68,CHI
1,2,0,6,0.798507696,8,2,she,"('CHI', 'AD1')",Providence,nai82.xml,9,1,1,AD1,80,68,CHI
2,1,3,7,0.762140052,8,1,the,"('AD1', 'CHI')",Providence,nai82.xml,13,5,2,CHI,93,108,AD1
0,16,5,232,0.742337425,248,16,no,"('MOT', 'CHI')",Providence,nai82.xml,253,5,0,CHI,4310,2015,MOT
6,12,45,190,0.728788872,202,12,and,"('MOT', 'CHI')",Providence,nai82.xml,253,51,6,CHI,4310,2015,MOT
1,9,5,70,0.705569701,79,9,like,"('CHI', 'MOT')",Providence,nai82.xml,85,6,1,MOT,652,1135,CHI
19,32,39,163,0.688083879,195,32,the,"('MOT', 'CHI')",Providence,nai82.xml,253,58,19,CHI,4310,2015,MOT
0,6,4,75,0.68117099,81,6,this,"('CHI', 'MOT')",Providence,nai82.xml,85,4,0,MOT,652,1135,CHI
4,14,7,60,0.667171694,74,14,that,"('CHI', 'MOT')",Providence,nai82.xml,85,11,4,MOT,652,1135,CHI
3,15,6,61,0.572519193,76,15,to,"('CHI', 'MOT')",Providence,nai82.xml,85,9,3,MOT,652,1135,CHI
0,11,2,72,0.571450246,83,11,do,"('CHI', 'MOT')",Providence,nai82.xml,85,2,0,MOT,652,1135,CHI
1,7,29,216,0.564070138,223,7,oh,"('MOT', 'CHI')",Providence,nai82.xml,253,30,1,CHI,4310,2015,MOT
0,1,1,7,0.510825624,8,1,of,"('CHI', 'AD1')",Providence,nai82.xml,9,1,0,AD1,80,68,CHI
0,1,1,7,0.510825624,8,1,make,"('CHI', 'AD1')",Providence,nai82.xml,9,1,0,AD1,80,68,CHI
0,2,1,10,0.441832752,12,2,of,"('AD1', 'CHI')",Providence,nai82.xml,13,1,0,CHI,93,108,AD1
0,2,1,10,0.441832752,12,2,but,"('AD1', 'CHI')",Providence,nai82.xml,13,1,0,CHI,93,108,AD1
0,8,16,229,0.388867217,237,8,not,"('MOT', 'CHI')",Providence,nai82.xml,253,16,0,CHI,4310,2015,MOT
1,12,22,218,0.35605937,230,12,this,"('MOT', 'CHI')",Providence,nai82.xml,253,23,1,CHI,4310,2015,MOT
5,17,42,189,0.347105493,206,17,to,"('MOT', 'CHI')",Providence,nai82.xml,253,47,5,CHI,4310,2015,MOT
1,45,5,202,0.302517139,247,45,yeah,"('MOT', 'CHI')",Providence,nai82.xml,253,6,1,CHI,4310,2015,MOT
1,14,5,65,0.300104592,79,14,in,"('CHI', 'MOT')",Providence,nai82.xml,85,6,1,MOT,652,1135,CHI
6,18,52,177,0.190330336,195,18,that,"('MOT', 'CHI')",Providence,nai82.xml,253,58,6,CHI,4310,2015,MOT
3,14,42,194,0.175204089,208,14,is,"('MOT', 'CHI')",Providence,nai82.xml,253,45,3,CHI,4310,2015,MOT
6,17,14,48,0.169188557,65,17,the,"('CHI', 'MOT')",Providence,nai82.xml,85,20,6,MOT,652,1135,CHI
5,15,55,178,0.165035921,193,15,a,"('MOT', 'CHI')",Providence,nai82.xml,253,60,5,CHI,4310,2015,MOT
0,1,1,4,0.15415068,5,1,are,"('MOT', 'AD1')",Providence,nai82.xml,6,1,0,AD1,34,17,MOT
0,1,2,6,0.117783036,7,1,the,"('CHI', 'AD1')",Providence,nai82.xml,9,2,0,AD1,80,68,CHI
1,23,4,57,-0.024097552,80,23,you,"('CHI', 'MOT')",Providence,nai82.xml,85,5,1,MOT,652,1135,CHI
0,14,4,67,-0.080969063,81,14,it,"('CHI', 'MOT')",Providence,nai82.xml,85,4,0,MOT,652,1135,CHI
0,14,4,67,-0.080969063,81,14,a,"('CHI', 'MOT')",Providence,nai82.xml,85,4,0,MOT,652,1135,CHI
9,15,93,136,-0.083956607,151,15,you,"('MOT', 'CHI')",Providence,nai82.xml,253,102,9,CHI,4310,2015,MOT
1,9,44,199,-0.112477983,208,9,of,"('MOT', 'CHI')",Providence,nai82.xml,253,45,1,CHI,4310,2015,MOT
1,1,3,2,-0.182321557,3,1,a,"('FAT', 'CHI')",Providence,nai82.xml,7,4,1,CHI,82,41,FAT
0,1,1,2,-0.182321557,3,1,oh,"('MOT', 'AD2')",Providence,nai82.xml,4,1,0,AD2,19,23,MOT
0,11,7,67,-0.300104592,78,11,what,"('CHI', 'MOT')",Providence,nai82.xml,85,7,0,MOT,652,1135,CHI
1,14,39,199,-0.381934611,213,14,what,"('MOT', 'CHI')",Providence,nai82.xml,253,40,1,CHI,4310,2015,MOT
0,1,1,1,-0.405465108,2,1,it,"('FAT', 'MOT')",Providence,nai82.xml,3,1,0,MOT,28,51,FAT
0,3,23,59,-0.446287103,62,3,yeah,"('CHI', 'MOT')",Providence,nai82.xml,85,23,0,MOT,652,1135,CHI
0,1,2,0,-0.980829253,1,1,a,"('FAT', 'MOT')",Providence,nai82.xml,3,2,0,MOT,28,51,FAT
0,1,2,0,-0.980829253,1,1,and,"('FAT', 'MOT')",Providence,nai82.xml,3,2,0,MOT,28,51,FAT
0,23,9,53,-1.219240276,76,23,and,"('CHI', 'MOT')",Providence,nai82.xml,85,9,0,MOT,652,1135,CHI
0,2,4,1,-1.280933845,3,2,you,"('FAT', 'CHI')",Providence,nai82.xml,7,4,0,CHI,82,41,FAT
2,1,3,296,4.159998532,297,1,they,"('MOT', 'CHI')",Providence,nai83.xml,302,5,2,CHI,3074,2922,MOT
1,2,1,298,3.918667548,300,2,she,"('MOT', 'CHI')",Providence,nai83.xml,302,2,1,CHI,3074,2922,MOT
2,0,2,71,3.597312261,71,0,he,"('CHI', 'MOT')",Providence,nai83.xml,75,4,2,MOT,674,746,CHI
1,0,3,71,3.191847152,71,0,get,"('CHI', 'MOT')",Providence,nai83.xml,75,4,1,MOT,674,746,CHI
1,2,6,293,3.091042453,295,2,wanna,"('MOT', 'CHI')",Providence,nai83.xml,302,7,1,CHI,3074,2922,MOT
0,1,5,296,3.061386244,297,1,did,"('MOT', 'CHI')",Providence,nai83.xml,302,5,0,CHI,3074,2922,MOT
1,0,3,58,2.995732274,58,0,go,"('FAT', 'CHI')",Providence,nai83.xml,62,4,1,CHI,721,399,FAT
1,0,3,58,2.995732274,58,0,they,"('FAT', 'CHI')",Providence,nai83.xml,62,4,1,CHI,721,399,FAT
1,4,4,293,2.838242692,297,4,where,"('MOT', 'CHI')",Providence,nai83.xml,302,5,1,CHI,3074,2922,MOT
1,2,0,72,2.826655944,74,2,are,"('CHI', 'MOT')",Providence,nai83.xml,75,1,1,MOT,674,746,CHI
0,1,7,294,2.803360381,295,1,think,"('MOT', 'CHI')",Providence,nai83.xml,302,7,0,CHI,3074,2922,MOT
2,0,0,19,2.756840365,19,0,like,"('FAT', 'MOT')",Providence,nai83.xml,21,2,2,MOT,167,124,FAT
0,3,3,296,2.711377991,299,3,make,"('MOT', 'CHI')",Providence,nai83.xml,302,3,0,CHI,3074,2922,MOT
0,3,3,296,2.711377991,299,3,big,"('MOT', 'CHI')",Providence,nai83.xml,302,3,0,CHI,3074,2922,MOT
1,0,2,35,2.694627181,35,0,put,"('CHI', 'FAT')",Providence,nai83.xml,38,3,1,FAT,291,433,CHI
1,0,0,20,2.685577345,20,0,with,"('MOT', 'FAT')",Providence,nai83.xml,21,1,1,FAT,150,162,MOT
1,0,0,20,2.685577345,20,0,some,"('MOT', 'FAT')",Providence,nai83.xml,21,1,1,FAT,150,162,MOT
1,2,0,59,2.63905733,61,2,want,"('FAT', 'CHI')",Providence,nai83.xml,62,1,1,CHI,721,399,FAT
1,4,6,291,2.58021683,295,4,up,"('MOT', 'CHI')",Providence,nai83.xml,302,7,1,CHI,3074,2922,MOT
1,1,0,36,2.564949357,37,1,see,"('CHI', 'FAT')",Providence,nai83.xml,38,1,1,FAT,291,433,CHI
1,1,0,36,2.564949357,37,1,on,"('CHI', 'FAT')",Providence,nai83.xml,38,1,1,FAT,291,433,CHI
0,1,1,73,2.538973871,74,1,with,"('CHI', 'MOT')",Providence,nai83.xml,75,1,0,MOT,674,746,CHI
0,3,4,295,2.525728644,298,3,at,"('MOT', 'CHI')",Providence,nai83.xml,302,4,0,CHI,3074,2922,MOT
1,0,3,34,2.48490665,34,0,in,"('CHI', 'FAT')",Providence,nai83.xml,38,4,1,FAT,291,433,CHI
0,1,1,60,2.351375257,61,1,she,"('FAT', 'CHI')",Providence,nai83.xml,62,1,0,CHI,721,399,FAT
1,0,1,19,2.351375257,19,0,and,"('FAT', 'MOT')",Providence,nai83.xml,21,2,1,MOT,167,124,FAT
0,4,4,294,2.302585093,298,4,look,"('MOT', 'CHI')",Providence,nai83.xml,302,4,0,CHI,3074,2922,MOT
2,2,0,34,2.251291799,36,2,can,"('CHI', 'FAT')",Providence,nai83.xml,38,2,2,FAT,291,433,CHI
0,1,2,72,2.238046572,73,1,go,"('CHI', 'MOT')",Providence,nai83.xml,75,2,0,MOT,674,746,CHI
0,1,2,72,2.238046572,73,1,for,"('CHI', 'MOT')",Providence,nai83.xml,75,2,0,MOT,674,746,CHI
0,1,2,72,2.238046572,73,1,up,"('CHI', 'MOT')",Providence,nai83.xml,75,2,0,MOT,674,746,CHI
0,1,2,72,2.238046572,73,1,all,"('CHI', 'MOT')",Providence,nai83.xml,75,2,0,MOT,674,746,CHI
0,2,9,291,2.190467795,293,2,my,"('MOT', 'CHI')",Providence,nai83.xml,302,9,0,CHI,3074,2922,MOT
1,5,9,287,2.100060829,292,5,like,"('MOT', 'CHI')",Providence,nai83.xml,302,10,1,CHI,3074,2922,MOT
0,1,2,59,2.047692843,60,1,one,"('FAT', 'CHI')",Providence,nai83.xml,62,2,0,CHI,721,399,FAT
0,1,3,71,2.00148,72,1,some,"('CHI', 'MOT')",Providence,nai83.xml,75,3,0,MOT,674,746,CHI
1,1,2,34,2.00148,35,1,big,"('CHI', 'FAT')",Providence,nai83.xml,38,3,1,FAT,291,433,CHI
1,3,2,69,2.00148,72,3,one,"('CHI', 'MOT')",Providence,nai83.xml,75,3,1,MOT,674,746,CHI
1,1,0,19,1.992430165,20,1,have,"('MOT', 'FAT')",Providence,nai83.xml,21,1,1,FAT,150,162,MOT
2,4,2,67,1.987874348,71,4,gonna,"('CHI', 'MOT')",Providence,nai83.xml,75,4,2,MOT,674,746,CHI
3,14,6,279,1.967324244,293,14,not,"('MOT', 'CHI')",Providence,nai83.xml,302,9,3,CHI,3074,2922,MOT
0,5,5,292,1.962773955,297,5,was,"('MOT', 'CHI')",Providence,nai83.xml,302,5,0,CHI,3074,2922,MOT
0,2,1,59,1.945910149,61,2,make,"('FAT', 'CHI')",Providence,nai83.xml,62,1,0,CHI,721,399,FAT
0,2,1,59,1.945910149,61,2,but,"('FAT', 'CHI')",Providence,nai83.xml,62,1,0,CHI,721,399,FAT
2,6,15,279,1.867745376,285,6,there,"('MOT', 'CHI')",Providence,nai83.xml,302,17,2,CHI,3074,2922,MOT
1,4,15,282,1.85629799,286,4,get,"('MOT', 'CHI')",Providence,nai83.xml,302,16,1,CHI,3074,2922,MOT
1,0,3,17,1.84582669,17,0,that,"('FAT', 'MOT')",Providence,nai83.xml,21,4,1,MOT,167,124,FAT
1,2,1,34,1.84582669,36,2,go,"('CHI', 'FAT')",Providence,nai83.xml,38,2,1,FAT,291,433,CHI
4,3,5,50,1.832581464,53,3,that,"('FAT', 'CHI')",Providence,nai83.xml,62,9,4,CHI,721,399,FAT
0,1,3,58,1.808288771,59,1,in,"('FAT', 'CHI')",Providence,nai83.xml,62,3,0,CHI,721,399,FAT
1,7,10,284,1.72892889,291,7,some,"('MOT', 'CHI')",Providence,nai83.xml,302,11,1,CHI,3074,2922,MOT
1,2,4,55,1.726162187,57,2,not,"('FAT', 'CHI')",Providence,nai83.xml,62,5,1,CHI,721,399,FAT
0,5,7,290,1.704748092,295,5,he,"('MOT', 'CHI')",Providence,nai83.xml,302,7,0,CHI,3074,2922,MOT
0,7,5,290,1.675091883,297,7,but,"('MOT', 'CHI')",Providence,nai83.xml,302,5,0,CHI,3074,2922,MOT
4,16,10,272,1.673516769,288,16,can,"('MOT', 'CHI')",Providence,nai83.xml,302,14,4,CHI,3074,2922,MOT
1,1,1,18,1.658228077,19,1,we,"('MOT', 'FAT')",Providence,nai83.xml,21,2,1,FAT,150,162,MOT
0,4,1,70,1.622683139,74,4,what,"('CHI', 'MOT')",Providence,nai83.xml,75,1,0,MOT,674,746,CHI
0,2,3,70,1.596014892,72,2,have,"('CHI', 'MOT')",Providence,nai83.xml,75,3,0,MOT,674,746,CHI
0,2,3,70,1.596014892,72,2,look,"('CHI', 'MOT')",Providence,nai83.xml,75,3,0,MOT,674,746,CHI
0,2,3,70,1.596014892,72,2,but,"('CHI', 'MOT')",Providence,nai83.xml,75,3,0,MOT,674,746,CHI
0,2,3,70,1.596014892,72,2,do,"('CHI', 'MOT')",Providence,nai83.xml,75,3,0,MOT,674,746,CHI
1,4,2,55,1.58514522,59,4,this,"('FAT', 'CHI')",Providence,nai83.xml,62,3,1,CHI,721,399,FAT
1,2,5,54,1.575536361,56,2,can,"('FAT', 'CHI')",Providence,nai83.xml,62,6,1,CHI,721,399,FAT
0,1,2,35,1.558144618,36,1,little,"('CHI', 'FAT')",Providence,nai83.xml,38,2,0,FAT,291,433,CHI
0,1,2,35,1.558144618,36,1,one,"('CHI', 'FAT')",Providence,nai83.xml,38,2,0,FAT,291,433,CHI
0,3,2,70,1.544899391,73,3,of,"('CHI', 'MOT')",Providence,nai83.xml,75,2,0,MOT,674,746,CHI
1,9,10,282,1.505785339,291,9,are,"('MOT', 'CHI')",Providence,nai83.xml,302,11,1,CHI,3074,2922,MOT
0,2,1,35,1.466337069,37,2,but,"('CHI', 'FAT')",Providence,nai83.xml,38,1,0,FAT,291,433,CHI
0,2,1,35,1.466337069,37,2,not,"('CHI', 'FAT')",Providence,nai83.xml,38,1,0,FAT,291,433,CHI
0,1,5,56,1.438480114,57,1,have,"('FAT', 'CHI')",Providence,nai83.xml,62,5,0,CHI,721,399,FAT
0,1,5,56,1.438480114,57,1,of,"('FAT', 'CHI')",Providence,nai83.xml,62,5,0,CHI,721,399,FAT
2,3,6,51,1.435084525,54,3,to,"('FAT', 'CHI')",Providence,nai83.xml,62,8,2,CHI,721,399,FAT
0,8,6,288,1.420427367,296,8,all,"('MOT', 'CHI')",Providence,nai83.xml,302,6,0,CHI,3074,2922,MOT
0,8,6,288,1.420427367,296,8,one,"('MOT', 'CHI')",Providence,nai83.xml,302,6,0,CHI,3074,2922,MOT
0,5,10,287,1.406913648,292,5,with,"('MOT', 'CHI')",Providence,nai83.xml,302,10,0,CHI,3074,2922,MOT
1,7,15,279,1.386294361,286,7,gonna,"('MOT', 'CHI')",Providence,nai83.xml,302,16,1,CHI,3074,2922,MOT
0,3,2,57,1.354545663,60,3,like,"('FAT', 'CHI')",Providence,nai83.xml,62,2,0,CHI,721,399,FAT
1,5,22,274,1.320866556,279,5,see,"('MOT', 'CHI')",Providence,nai83.xml,302,23,1,CHI,3074,2922,MOT
0,7,8,287,1.30833282,294,7,go,"('MOT', 'CHI')",Providence,nai83.xml,302,8,0,CHI,3074,2922,MOT
0,1,3,34,1.30833282,35,1,my,"('CHI', 'FAT')",Providence,nai83.xml,38,3,0,FAT,291,433,CHI
0,1,1,19,1.299282984,20,1,go,"('FAT', 'MOT')",Providence,nai83.xml,21,1,0,MOT,167,124,FAT
0,1,1,19,1.299282984,20,1,yeah,"('FAT', 'MOT')",Providence,nai83.xml,21,1,0,MOT,167,124,FAT
0,1,1,19,1.299282984,20,1,for,"('FAT', 'MOT')",Providence,nai83.xml,21,1,0,MOT,167,124,FAT
0,1,1,19,1.299282984,20,1,not,"('FAT', 'MOT')",Providence,nai83.xml,21,1,0,MOT,167,124,FAT
0,1,1,19,1.299282984,20,1,there,"('MOT', 'FAT')",Providence,nai83.xml,21,1,0,FAT,150,162,MOT
0,1,1,19,1.299282984,20,1,at,"('MOT', 'FAT')",Providence,nai83.xml,21,1,0,FAT,150,162,MOT
0,1,1,19,1.299282984,20,1,and,"('MOT', 'FAT')",Providence,nai83.xml,21,1,0,FAT,150,162,MOT
0,1,6,55,1.287854288,56,1,gonna,"('FAT', 'CHI')",Providence,nai83.xml,62,6,0,CHI,721,399,FAT
0,6,1,68,1.286210903,74,6,on,"('CHI', 'MOT')",Providence,nai83.xml,75,1,0,MOT,674,746,CHI
0,7,9,286,1.209638542,293,7,want,"('MOT', 'CHI')",Providence,nai83.xml,302,9,0,CHI,3074,2922,MOT
0,2,2,34,1.15267951,36,2,think,"('CHI', 'FAT')",Providence,nai83.xml,38,2,0,FAT,291,433,CHI
1,3,6,52,1.15267951,55,3,do,"('FAT', 'CHI')",Providence,nai83.xml,62,7,1,CHI,721,399,FAT
3,3,11,45,1.139434283,48,3,a,"('FAT', 'CHI')",Providence,nai83.xml,62,14,3,CHI,721,399,FAT
3,9,4,59,1.134979933,68,9,a,"('CHI', 'MOT')",Providence,nai83.xml,75,7,3,MOT,674,746,CHI
0,3,3,56,1.115141591,59,3,for,"('FAT', 'CHI')",Providence,nai83.xml,62,3,0,CHI,721,399,FAT
0,3,3,56,1.115141591,59,3,what,"('FAT', 'CHI')",Providence,nai83.xml,62,3,0,CHI,721,399,FAT
2,5,2,29,1.098612289,34,5,it,"('CHI', 'FAT')",Providence,nai83.xml,38,4,2,FAT,291,433,CHI
1,13,11,277,1.091786324,290,13,on,"('MOT', 'CHI')",Providence,nai83.xml,302,12,1,CHI,3074,2922,MOT
0,4,3,68,1.085189268,72,4,my,"('CHI', 'MOT')",Providence,nai83.xml,75,3,0,MOT,674,746,CHI
0,4,3,68,1.085189268,72,4,at,"('CHI', 'MOT')",Providence,nai83.xml,75,3,0,MOT,674,746,CHI
0,4,3,68,1.085189268,72,4,not,"('CHI', 'MOT')",Providence,nai83.xml,75,3,0,MOT,674,746,CHI
1,5,5,64,1.084626047,69,5,want,"('CHI', 'MOT')",Providence,nai83.xml,75,6,1,MOT,674,746,CHI
8,17,35,242,1.064710737,259,17,to,"('MOT', 'CHI')",Providence,nai83.xml,302,43,8,CHI,3074,2922,MOT
6,35,12,249,1.022650748,284,35,we,"('MOT', 'CHI')",Providence,nai83.xml,302,18,6,CHI,3074,2922,MOT
2,3,5,28,1.011600912,31,3,and,"('CHI', 'FAT')",Providence,nai83.xml,38,7,2,FAT,291,433,CHI
1,10,2,62,0.989879089,72,10,oh,"('CHI', 'MOT')",Providence,nai83.xml,75,3,1,MOT,674,746,CHI
4,13,30,255,0.985283603,268,13,have,"('MOT', 'CHI')",Providence,nai83.xml,302,34,4,CHI,3074,2922,MOT
0,1,2,18,0.965080896,19,1,in,"('FAT', 'MOT')",Providence,nai83.xml,21,2,0,MOT,167,124,FAT
0,1,2,18,0.965080896,19,1,look,"('MOT', 'FAT')",Providence,nai83.xml,21,2,0,FAT,150,162,MOT
5,21,22,254,0.957438692,275,21,in,"('MOT', 'CHI')",Providence,nai83.xml,302,27,5,CHI,3074,2922,MOT
1,3,8,50,0.916290732,53,3,we,"('FAT', 'CHI')",Providence,nai83.xml,62,9,1,CHI,721,399,FAT
0,2,3,33,0.902867712,35,2,is,"('CHI', 'FAT')",Providence,nai83.xml,38,3,0,FAT,291,433,CHI
0,2,1,18,0.893817876,20,2,you,"('FAT', 'MOT')",Providence,nai83.xml,21,1,0,MOT,167,124,FAT
0,2,1,18,0.893817876,20,2,what,"('FAT', 'MOT')",Providence,nai83.xml,21,1,0,MOT,167,124,FAT
0,2,1,18,0.893817876,20,2,is,"('FAT', 'MOT')",Providence,nai83.xml,21,1,0,MOT,167,124,FAT
0,2,1,18,0.893817876,20,2,to,"('FAT', 'MOT')",Providence,nai83.xml,21,1,0,MOT,167,124,FAT
0,2,1,18,0.893817876,20,2,it,"('MOT', 'FAT')",Providence,nai83.xml,21,1,0,FAT,150,162,MOT
0,3,2,33,0.864997437,36,3,that,"('CHI', 'FAT')",Providence,nai83.xml,38,2,0,FAT,291,433,CHI
0,13,7,282,0.857450232,295,13,yeah,"('MOT', 'CHI')",Providence,nai83.xml,302,7,0,CHI,3074,2922,MOT
4,5,5,24,0.853770375,29,5,the,"('CHI', 'FAT')",Providence,nai83.xml,38,9,4,FAT,291,433,CHI
0,7,2,66,0.851752211,73,7,can,"('CHI', 'MOT')",Providence,nai83.xml,75,2,0,MOT,674,746,CHI
0,2,8,65,0.832909123,67,2,we,"('CHI', 'MOT')",Providence,nai83.xml,75,8,0,MOT,674,746,CHI
2,12,24,264,0.829079535,276,12,do,"('MOT', 'CHI')",Providence,nai83.xml,302,26,2,CHI,3074,2922,MOT
9,36,22,235,0.804631414,271,36,it,"('MOT', 'CHI')",Providence,nai83.xml,302,31,9,CHI,3074,2922,MOT
0,1,6,31,0.753771802,32,1,yeah,"('CHI', 'FAT')",Providence,nai83.xml,38,6,0,FAT,291,433,CHI
0,1,6,31,0.753771802,32,1,this,"('CHI', 'FAT')",Providence,nai83.xml,38,6,0,FAT,291,433,CHI
0,12,9,281,0.724130726,293,12,for,"('MOT', 'CHI')",Providence,nai83.xml,302,9,0,CHI,3074,2922,MOT
0,5,3,54,0.709676483,59,5,it,"('FAT', 'CHI')",Providence,nai83.xml,62,3,0,CHI,721,399,FAT
0,5,4,66,0.706940503,71,5,in,"('CHI', 'MOT')",Providence,nai83.xml,75,4,0,MOT,674,746,CHI
0,4,4,54,0.693147181,58,4,is,"('FAT', 'CHI')",Providence,nai83.xml,62,4,0,CHI,721,399,FAT
1,15,16,270,0.635601695,285,15,this,"('MOT', 'CHI')",Providence,nai83.xml,302,17,1,CHI,3074,2922,MOT
0,3,34,265,0.628608659,268,3,oh,"('MOT', 'CHI')",Providence,nai83.xml,302,34,0,CHI,3074,2922,MOT
0,6,1,31,0.619039208,37,6,oh,"('CHI', 'FAT')",Providence,nai83.xml,38,1,0,FAT,291,433,CHI
0,3,1,17,0.606135804,20,3,the,"('MOT', 'FAT')",Providence,nai83.xml,21,1,0,FAT,150,162,MOT
0,4,6,65,0.573800423,69,4,yeah,"('CHI', 'MOT')",Providence,nai83.xml,75,6,0,MOT,674,746,CHI
5,11,11,48,0.527354926,59,11,the,"('CHI', 'MOT')",Providence,nai83.xml,75,16,5,MOT,674,746,CHI
0,2,11,62,0.526093096,64,2,and,"('CHI', 'MOT')",Providence,nai83.xml,75,11,0,MOT,674,746,CHI
0,4,5,53,0.522189382,57,4,and,"('FAT', 'CHI')",Providence,nai83.xml,62,5,0,CHI,721,399,FAT
0,5,4,53,0.510825624,58,5,yeah,"('FAT', 'CHI')",Providence,nai83.xml,62,4,0,CHI,721,399,FAT
0,17,8,277,0.497402603,294,17,put,"('MOT', 'CHI')",Providence,nai83.xml,302,8,0,CHI,3074,2922,MOT
0,1,8,29,0.470003629,30,1,no,"('CHI', 'FAT')",Providence,nai83.xml,38,8,0,FAT,291,433,CHI
3,7,5,23,0.470003629,30,7,you,"('CHI', 'FAT')",Providence,nai83.xml,38,8,3,FAT,291,433,CHI
0,5,2,31,0.459532329,36,5,to,"('CHI', 'FAT')",Providence,nai83.xml,38,2,0,FAT,291,433,CHI
0,1,4,16,0.459532329,17,1,we,"('FAT', 'MOT')",Providence,nai83.xml,21,4,0,MOT,167,124,FAT
1,11,1,25,0.459532329,36,11,a,"('CHI', 'FAT')",Providence,nai83.xml,38,2,1,FAT,291,433,CHI
20,55,38,189,0.430157721,244,55,the,"('MOT', 'CHI')",Providence,nai83.xml,302,58,20,CHI,3074,2922,MOT
1,15,2,44,0.42199441,59,15,no,"('FAT', 'CHI')",Providence,nai83.xml,62,3,1,CHI,721,399,FAT
0,9,17,276,0.412458144,285,9,of,"('MOT', 'CHI')",Providence,nai83.xml,302,17,0,CHI,3074,2922,MOT
0,4,1,16,0.382992252,20,4,that,"('MOT', 'FAT')",Providence,nai83.xml,21,1,0,FAT,150,162,MOT
1,7,9,58,0.333491608,65,7,to,"('CHI', 'MOT')",Providence,nai83.xml,75,10,1,MOT,674,746,CHI
1,9,7,58,0.322083499,67,9,it,"('CHI', 'MOT')",Providence,nai83.xml,75,8,1,MOT,674,746,CHI
0,3,2,16,0.271933715,19,3,it,"('FAT', 'MOT')",Providence,nai83.xml,21,2,0,MOT,167,124,FAT
0,3,2,16,0.271933715,19,3,is,"('MOT', 'FAT')",Providence,nai83.xml,21,2,0,FAT,150,162,MOT
0,3,2,16,0.271933715,19,3,to,"('MOT', 'FAT')",Providence,nai83.xml,21,2,0,FAT,150,162,MOT
1,7,4,26,0.223143551,33,7,we,"('CHI', 'FAT')",Providence,nai83.xml,38,5,1,FAT,291,433,CHI
0,5,1,15,0.200670695,20,5,oh,"('MOT', 'FAT')",Providence,nai83.xml,21,1,0,FAT,150,162,MOT
3,24,31,244,0.182321557,268,24,a,"('MOT', 'CHI')",Providence,nai83.xml,302,34,3,CHI,3074,2922,MOT
13,28,73,188,0.178919748,216,28,you,"('MOT', 'CHI')",Providence,nai83.xml,302,86,13,CHI,3074,2922,MOT
0,8,5,62,0.133531393,70,8,is,"('CHI', 'MOT')",Providence,nai83.xml,75,5,0,MOT,674,746,CHI
1,20,21,260,0.112477983,280,20,is,"('MOT', 'CHI')",Providence,nai83.xml,302,22,1,CHI,3074,2922,MOT
1,8,8,45,0.105360516,53,8,the,"('FAT', 'CHI')",Providence,nai83.xml,62,9,1,CHI,721,399,FAT
0,6,7,62,0.105360516,68,6,like,"('CHI', 'MOT')",Providence,nai83.xml,75,7,0,MOT,674,746,CHI
1,5,3,12,0.054067221,17,5,you,"('MOT', 'FAT')",Providence,nai83.xml,21,4,1,FAT,150,162,MOT
0,9,5,61,0.028170877,70,9,this,"('CHI', 'MOT')",Providence,nai83.xml,75,5,0,MOT,674,746,CHI
3,16,10,46,0.003913899,62,16,you,"('CHI', 'MOT')",Providence,nai83.xml,75,13,3,MOT,674,746,CHI
0,3,3,15,0,18,3,the,"('FAT', 'MOT')",Providence,nai83.xml,21,3,0,MOT,167,124,FAT
0,3,15,57,-0.09237332,60,3,no,"('CHI', 'MOT')",Providence,nai83.xml,75,15,0,MOT,674,746,CHI
1,12,9,53,-0.152016207,65,12,that,"('CHI', 'MOT')",Providence,nai83.xml,75,10,1,MOT,674,746,CHI
0,2,5,14,-0.15415068,16,2,a,"('FAT', 'MOT')",Providence,nai83.xml,21,5,0,MOT,167,124,FAT
3,28,41,230,-0.248961234,258,28,that,"('MOT', 'CHI')",Providence,nai83.xml,302,44,3,CHI,3074,2922,MOT
1,9,11,41,-0.297251523,50,9,you,"('FAT', 'CHI')",Providence,nai83.xml,62,12,1,CHI,721,399,FAT
2,81,11,208,-0.342833893,289,81,no,"('MOT', 'CHI')",Providence,nai83.xml,302,13,2,CHI,3074,2922,MOT
0,7,2,12,-0.421213465,19,7,a,"('MOT', 'FAT')",Providence,nai83.xml,21,2,0,FAT,150,162,MOT
0,16,33,253,-0.786442585,269,16,what,"('MOT', 'CHI')",Providence,nai83.xml,302,33,0,CHI,3074,2922,MOT
0,33,26,243,-1.230943921,276,33,and,"('MOT', 'CHI')",Providence,nai83.xml,302,26,0,CHI,3074,2922,MOT
1,0,2,36,2.721295428,36,0,they,"('FAT', 'MOT')",Providence,vio01.xml,39,3,1,MOT,369,466,FAT
0,1,1,37,1.897119985,38,1,go,"('FAT', 'MOT')",Providence,vio01.xml,39,1,0,MOT,369,466,FAT
0,1,1,37,1.897119985,38,1,there,"('FAT', 'MOT')",Providence,vio01.xml,39,1,0,MOT,369,466,FAT
0,1,1,37,1.897119985,38,1,put,"('FAT', 'MOT')",Providence,vio01.xml,39,1,0,MOT,369,466,FAT
0,1,1,37,1.897119985,38,1,at,"('FAT', 'MOT')",Providence,vio01.xml,39,1,0,MOT,369,466,FAT
1,2,1,35,1.871802177,37,2,up,"('FAT', 'MOT')",Providence,vio01.xml,39,2,1,MOT,369,466,FAT
1,1,3,34,1.819158443,35,1,think,"('FAT', 'MOT')",Providence,vio01.xml,39,4,1,MOT,369,466,FAT
1,4,0,34,1.673976434,38,4,we,"('FAT', 'MOT')",Providence,vio01.xml,39,1,1,MOT,369,466,FAT
0,1,2,36,1.584120104,37,1,like,"('FAT', 'MOT')",Providence,vio01.xml,39,2,0,MOT,369,466,FAT
0,1,2,36,1.584120104,37,1,look,"('FAT', 'MOT')",Providence,vio01.xml,39,2,0,MOT,369,466,FAT
0,1,2,36,1.584120104,37,1,little,"('FAT', 'MOT')",Providence,vio01.xml,39,2,0,MOT,369,466,FAT
0,1,2,36,1.584120104,37,1,that,"('FAT', 'MOT')",Providence,vio01.xml,39,2,0,MOT,369,466,FAT
0,1,2,36,1.584120104,37,1,one,"('FAT', 'MOT')",Providence,vio01.xml,39,2,0,MOT,369,466,FAT
0,1,2,36,1.584120104,37,1,on,"('FAT', 'MOT')",Providence,vio01.xml,39,2,0,MOT,369,466,FAT
1,3,1,34,1.584120104,37,3,get,"('FAT', 'MOT')",Providence,vio01.xml,39,2,1,MOT,369,466,FAT
0,2,1,36,1.491654877,38,2,have,"('FAT', 'MOT')",Providence,vio01.xml,39,1,0,MOT,369,466,FAT
0,2,1,36,1.491654877,38,2,with,"('FAT', 'MOT')",Providence,vio01.xml,39,1,0,MOT,369,466,FAT
0,2,1,36,1.491654877,38,2,can,"('FAT', 'MOT')",Providence,vio01.xml,39,1,0,MOT,369,466,FAT
1,4,1,33,1.360976553,37,4,what,"('FAT', 'MOT')",Providence,vio01.xml,39,2,1,MOT,369,466,FAT
0,1,3,35,1.335001067,36,1,of,"('FAT', 'MOT')",Providence,vio01.xml,39,3,0,MOT,369,466,FAT
1,3,2,33,1.335001067,36,3,in,"('FAT', 'MOT')",Providence,vio01.xml,39,3,1,MOT,369,466,FAT
1,1,0,7,1.203972804,8,1,what,"('MOT', 'FAT')",Providence,vio01.xml,9,1,1,FAT,36,70,MOT
1,4,2,32,1.111857515,36,4,oh,"('FAT', 'MOT')",Providence,vio01.xml,39,3,1,MOT,369,466,FAT
0,4,1,34,0.980829253,38,4,gonna,"('FAT', 'MOT')",Providence,vio01.xml,39,1,0,MOT,369,466,FAT
0,2,3,34,0.929535959,36,2,and,"('FAT', 'MOT')",Providence,vio01.xml,39,3,0,MOT,369,466,FAT
0,3,2,34,0.890972924,37,3,want,"('FAT', 'MOT')",Providence,vio01.xml,39,2,0,MOT,369,466,FAT
0,3,2,34,0.890972924,37,3,this,"('FAT', 'MOT')",Providence,vio01.xml,39,2,0,MOT,369,466,FAT
0,3,2,34,0.890972924,37,3,some,"('FAT', 'MOT')",Providence,vio01.xml,39,2,0,MOT,369,466,FAT
1,2,7,29,0.78845736,31,2,a,"('FAT', 'MOT')",Providence,vio01.xml,39,8,1,MOT,369,466,FAT
0,4,1,26,0.757685702,30,4,go,"('CHI', 'MOT')",Providence,vio01.xml,31,1,0,MOT,159,1331,CHI
0,3,3,33,0.641853886,36,3,for,"('FAT', 'MOT')",Providence,vio01.xml,39,3,0,MOT,369,466,FAT
1,4,5,29,0.559615788,33,4,yeah,"('FAT', 'MOT')",Providence,vio01.xml,39,6,1,MOT,369,466,FAT
0,1,1,7,0.510825624,8,1,but,"('MOT', 'FAT')",Providence,vio01.xml,9,1,0,FAT,36,70,MOT
0,4,3,32,0.418710335,36,4,to,"('FAT', 'MOT')",Providence,vio01.xml,39,3,0,MOT,369,466,FAT
0,3,5,31,0.251314428,34,3,it,"('FAT', 'MOT')",Providence,vio01.xml,39,5,0,MOT,369,466,FAT
5,10,6,18,0.230112221,28,10,you,"('FAT', 'MOT')",Providence,vio01.xml,39,11,5,MOT,369,466,FAT
0,6,3,30,0.082238098,36,6,my,"('FAT', 'MOT')",Providence,vio01.xml,39,3,0,MOT,369,466,FAT
0,5,5,29,-0.15415068,34,5,the,"('FAT', 'MOT')",Providence,vio01.xml,39,5,0,MOT,369,466,FAT
0,2,2,5,-0.287682072,7,2,the,"('MOT', 'FAT')",Providence,vio01.xml,9,2,0,FAT,36,70,MOT
1,0,0,8,1.897119985,8,0,yeah,"('FAT', 'MOT')",Providence,vio02.xml,9,1,1,MOT,92,82,FAT
2,0,0,6,1.791759469,6,0,can,"('MOT', 'FAT')",Providence,vio02.xml,8,2,2,FAT,94,85,MOT
1,0,1,8,1.609437912,8,0,see,"('MOT', 'BRO')",Providence,vio02.xml,10,2,1,BRO,75,85,MOT
1,0,0,3,1.203972804,3,0,this,"('FAT', 'BRO')",Providence,vio02.xml,4,1,1,BRO,91,32,FAT
1,1,0,6,1.098612289,7,1,a,"('MOT', 'FAT')",Providence,vio02.xml,8,1,1,FAT,94,85,MOT
4,0,2,2,0.916290732,2,0,you,"('MOT', 'FAT')",Providence,vio02.xml,8,6,4,FAT,94,85,MOT
1,1,1,5,0.693147181,6,1,it,"('MOT', 'FAT')",Providence,vio02.xml,8,2,1,FAT,94,85,MOT
0,1,1,8,0.606135804,9,1,oh,"('MOT', 'BRO')",Providence,vio02.xml,10,1,0,BRO,75,85,MOT
0,1,1,8,0.606135804,9,1,what,"('MOT', 'BRO')",Providence,vio02.xml,10,1,0,BRO,75,85,MOT
0,1,1,8,0.606135804,9,1,at,"('MOT', 'BRO')",Providence,vio02.xml,10,1,0,BRO,75,85,MOT
1,1,2,6,0.587786665,7,1,a,"('MOT', 'BRO')",Providence,vio02.xml,10,3,1,BRO,75,85,MOT
1,1,0,2,0.510825624,3,1,you,"('BRO', 'FAT')",Providence,vio02.xml,4,1,1,FAT,22,34,BRO
0,1,1,7,0.510825624,8,1,oh,"('FAT', 'MOT')",Providence,vio02.xml,9,1,0,MOT,92,82,FAT
0,1,1,7,0.510825624,8,1,go,"('FAT', 'MOT')",Providence,vio02.xml,9,1,0,MOT,92,82,FAT
0,1,1,7,0.510825624,8,1,with,"('FAT', 'MOT')",Providence,vio02.xml,9,1,0,MOT,92,82,FAT
0,1,1,7,0.510825624,8,1,are,"('FAT', 'MOT')",Providence,vio02.xml,9,1,0,MOT,92,82,FAT
0,1,1,6,0.405465108,7,1,no,"('MOT', 'FAT')",Providence,vio02.xml,8,1,0,FAT,94,85,MOT
0,1,1,6,0.405465108,7,1,do,"('MOT', 'FAT')",Providence,vio02.xml,8,1,0,FAT,94,85,MOT
0,1,1,6,0.405465108,7,1,to,"('MOT', 'FAT')",Providence,vio02.xml,8,1,0,FAT,94,85,MOT
0,1,2,7,0.223143551,8,1,for,"('MOT', 'BRO')",Providence,vio02.xml,10,2,0,BRO,75,85,MOT
0,2,1,7,0.200670695,9,2,to,"('MOT', 'BRO')",Providence,vio02.xml,10,1,0,BRO,75,85,MOT
2,1,4,3,0.117783036,4,1,you,"('MOT', 'BRO')",Providence,vio02.xml,10,6,2,BRO,75,85,MOT
0,1,2,5,0,6,1,get,"('MOT', 'FAT')",Providence,vio02.xml,8,2,0,FAT,94,85,MOT
0,2,1,5,0,7,2,have,"('MOT', 'FAT')",Providence,vio02.xml,8,1,0,FAT,94,85,MOT
0,2,1,5,0,7,2,that,"('MOT', 'FAT')",Providence,vio02.xml,8,1,0,FAT,94,85,MOT
1,1,4,3,-0.15415068,4,1,you,"('FAT', 'MOT')",Providence,vio02.xml,9,5,1,MOT,92,82,FAT
0,2,2,6,-0.182321557,8,2,have,"('MOT', 'BRO')",Providence,vio02.xml,10,2,0,BRO,75,85,MOT
0,1,1,2,-0.182321557,3,1,up,"('FAT', 'BRO')",Providence,vio02.xml,4,1,0,BRO,91,32,FAT
0,3,1,5,-0.182321557,8,3,in,"('FAT', 'MOT')",Providence,vio02.xml,9,1,0,MOT,92,82,FAT
0,3,1,4,-0.287682072,7,3,and,"('MOT', 'FAT')",Providence,vio02.xml,8,1,0,FAT,94,85,MOT
0,3,2,4,-0.575364145,7,3,the,"('FAT', 'MOT')",Providence,vio02.xml,9,2,0,MOT,92,82,FAT
0,2,1,1,-0.587786665,3,2,a,"('FAT', 'BRO')",Providence,vio02.xml,4,1,0,BRO,91,32,FAT
1,1,0,4,0.84729786,5,1,it,"('BRO', 'MOT')",Providence,vio03.xml,6,1,1,MOT,34,83,BRO
1,0,1,2,0.693147181,2,0,you,"('MOT', 'BRO')",Providence,vio03.xml,4,2,1,BRO,74,36,MOT
1,0,1,2,0.693147181,2,0,do,"('MOT', 'BRO')",Providence,vio03.xml,4,2,1,BRO,74,36,MOT
1,1,0,2,0.510825624,3,1,go,"('FAT', 'MOT')",Providence,vio03.xml,4,1,1,MOT,40,151,FAT
1,1,0,2,0.510825624,3,1,it,"('MOT', 'BRO')",Providence,vio03.xml,4,1,1,BRO,74,36,MOT
3,1,0,0,0.182321557,1,1,you,"('FAT', 'MOT')",Providence,vio03.xml,4,3,3,MOT,40,151,FAT
1,3,0,2,0.15415068,5,3,you,"('BRO', 'MOT')",Providence,vio03.xml,6,1,1,MOT,34,83,BRO
0,1,1,4,0.15415068,5,1,the,"('BRO', 'MOT')",Providence,vio03.xml,6,1,0,MOT,34,83,BRO
0,1,1,2,-0.182321557,3,1,this,"('FAT', 'MOT')",Providence,vio03.xml,4,1,0,MOT,40,151,FAT
0,1,1,2,-0.182321557,3,1,the,"('FAT', 'MOT')",Providence,vio03.xml,4,1,0,MOT,40,151,FAT
0,1,1,2,-0.182321557,3,1,what,"('MOT', 'BRO')",Providence,vio03.xml,4,1,0,BRO,74,36,MOT
0,1,1,2,-0.182321557,3,1,this,"('MOT', 'BRO')",Providence,vio03.xml,4,1,0,BRO,74,36,MOT
0,2,1,1,-0.587786665,3,2,a,"('FAT', 'MOT')",Providence,vio03.xml,4,1,0,MOT,40,151,FAT
0,1,1,0,-0.693147181,1,1,go,"('MOT', 'FAT')",Providence,vio03.xml,2,1,0,FAT,67,14,MOT
0,1,1,0,-0.693147181,1,1,on,"('MOT', 'FAT')",Providence,vio03.xml,2,1,0,FAT,67,14,MOT
0,2,2,110,2.251291799,112,2,up,"('MOT', 'CHI')",Providence,vio06.xml,114,2,0,CHI,2431,378,MOT
0,1,6,107,1.927891644,108,1,oh,"('MOT', 'CHI')",Providence,vio06.xml,114,6,0,CHI,2431,378,MOT
0,2,7,105,1.395511016,107,2,no,"('MOT', 'CHI')",Providence,vio06.xml,114,7,0,CHI,2431,378,MOT
1,0,1,45,3.157000421,45,0,no,"('FAT', 'MOT')",Providence,vio07.xml,47,2,1,MOT,290,428,FAT
1,1,1,44,2.463853241,45,1,she,"('FAT', 'MOT')",Providence,vio07.xml,47,2,1,MOT,290,428,FAT
0,1,1,45,2.079441542,46,1,my,"('FAT', 'MOT')",Providence,vio07.xml,47,1,0,MOT,290,428,FAT
0,1,1,45,2.079441542,46,1,put,"('FAT', 'MOT')",Providence,vio07.xml,47,1,0,MOT,290,428,FAT
0,1,1,45,2.079441542,46,1,can,"('FAT', 'MOT')",Providence,vio07.xml,47,1,0,MOT,290,428,FAT
1,2,2,42,1.813738376,44,2,is,"('FAT', 'MOT')",Providence,vio07.xml,47,3,1,MOT,290,428,FAT
0,1,2,44,1.77070606,45,1,that,"('FAT', 'MOT')",Providence,vio07.xml,47,2,0,MOT,290,428,FAT
1,3,1,42,1.77070606,45,3,do,"('FAT', 'MOT')",Providence,vio07.xml,47,2,1,MOT,290,428,FAT
1,17,2,231,1.714798428,248,17,no,"('CHI', 'MOT')",Providence,vio07.xml,251,3,1,MOT,685,4632,CHI
0,2,1,44,1.673976434,46,2,with,"('FAT', 'MOT')",Providence,vio07.xml,47,1,0,MOT,290,428,FAT
0,2,1,44,1.673976434,46,2,one,"('FAT', 'MOT')",Providence,vio07.xml,47,1,0,MOT,290,428,FAT
1,1,1,17,1.609437912,18,1,that,"('MOT', 'FAT')",Providence,vio07.xml,20,2,1,FAT,222,132,MOT
1,37,0,213,1.48637782,250,37,this,"('CHI', 'MOT')",Providence,vio07.xml,251,1,1,MOT,685,4632,CHI
0,3,1,43,1.386294361,46,3,get,"('FAT', 'MOT')",Providence,vio07.xml,47,1,0,MOT,290,428,FAT
0,3,1,43,1.386294361,46,3,we,"('FAT', 'MOT')",Providence,vio07.xml,47,1,0,MOT,290,428,FAT
0,3,1,43,1.386294361,46,3,of,"('FAT', 'MOT')",Providence,vio07.xml,47,1,0,MOT,290,428,FAT
0,3,1,43,1.386294361,46,3,what,"('FAT', 'MOT')",Providence,vio07.xml,47,1,0,MOT,290,428,FAT
0,3,1,43,1.386294361,46,3,wanna,"('FAT', 'MOT')",Providence,vio07.xml,47,1,0,MOT,290,428,FAT
0,3,1,43,1.386294361,46,3,on,"('FAT', 'MOT')",Providence,vio07.xml,47,1,0,MOT,290,428,FAT
0,2,2,43,1.365240952,45,2,and,"('FAT', 'MOT')",Providence,vio07.xml,47,2,0,MOT,290,428,FAT
0,1,1,18,1.252762968,19,1,all,"('MOT', 'FAT')",Providence,vio07.xml,20,1,0,FAT,222,132,MOT
1,2,1,16,1.203972804,18,2,you,"('MOT', 'FAT')",Providence,vio07.xml,20,2,1,FAT,222,132,MOT
1,1,3,15,1.098612289,16,1,and,"('MOT', 'FAT')",Providence,vio07.xml,20,4,1,FAT,222,132,MOT
1,5,3,38,0.916290732,43,5,the,"('FAT', 'MOT')",Providence,vio07.xml,47,4,1,MOT,290,428,FAT
0,1,2,17,0.916290732,18,1,gonna,"('MOT', 'FAT')",Providence,vio07.xml,20,2,0,FAT,222,132,MOT
0,1,2,17,0.916290732,18,1,go,"('MOT', 'FAT')",Providence,vio07.xml,20,2,0,FAT,222,132,MOT
0,1,2,17,0.916290732,18,1,but,"('MOT', 'FAT')",Providence,vio07.xml,20,2,0,FAT,222,132,MOT
0,1,2,17,0.916290732,18,1,can,"('MOT', 'FAT')",Providence,vio07.xml,20,2,0,FAT,222,132,MOT
0,4,2,41,0.854415328,45,4,oh,"('FAT', 'MOT')",Providence,vio07.xml,47,2,0,MOT,290,428,FAT
1,9,1,36,0.854415328,45,9,yeah,"('FAT', 'MOT')",Providence,vio07.xml,47,2,1,MOT,290,428,FAT
0,3,3,41,0.832909123,44,3,it,"('FAT', 'MOT')",Providence,vio07.xml,47,3,0,MOT,290,428,FAT
0,6,1,40,0.826678573,46,6,gonna,"('FAT', 'MOT')",Providence,vio07.xml,47,1,0,MOT,290,428,FAT
0,1,3,16,0.641853886,17,1,is,"('MOT', 'FAT')",Providence,vio07.xml,20,3,0,FAT,222,132,MOT
0,6,2,39,0.517943092,45,6,to,"('FAT', 'MOT')",Providence,vio07.xml,47,2,0,MOT,290,428,FAT
0,2,2,16,0.510825624,18,2,to,"('MOT', 'FAT')",Providence,vio07.xml,20,2,0,FAT,222,132,MOT
0,3,5,39,0.451985124,42,3,a,"('FAT', 'MOT')",Providence,vio07.xml,47,5,0,MOT,290,428,FAT
0,5,3,12,-0.456758402,17,5,a,"('MOT', 'FAT')",Providence,vio07.xml,20,3,0,FAT,222,132,MOT
0,8,6,33,-0.515466003,41,8,you,"('FAT', 'MOT')",Providence,vio07.xml,47,6,0,MOT,290,428,FAT
1,0,0,8,1.897119985,8,0,is,"('BRO', 'FAT')",Providence,vio08.xml,9,1,1,FAT,56,56,BRO
1,0,2,14,1.85629799,14,0,we,"('MOT', 'FAT')",Providence,vio08.xml,17,3,1,FAT,118,92,MOT
0,1,1,26,1.575536361,27,1,we,"('MOT', 'BRO')",Providence,vio08.xml,28,1,0,BRO,173,168,MOT
0,1,1,26,1.575536361,27,1,put,"('MOT', 'BRO')",Providence,vio08.xml,28,1,0,BRO,173,168,MOT
0,1,1,26,1.575536361,27,1,wanna,"('MOT', 'BRO')",Providence,vio08.xml,28,1,0,BRO,173,168,MOT
1,1,0,10,1.466337069,11,1,a,"('FAT', 'BRO')",Providence,vio08.xml,12,1,1,BRO,90,94,FAT
2,2,2,22,1.466337069,24,2,in,"('MOT', 'BRO')",Providence,vio08.xml,28,4,2,BRO,173,168,MOT
2,1,1,11,1.435084525,12,1,what,"('BRO', 'MOT')",Providence,vio08.xml,15,3,2,MOT,118,210,BRO
1,2,2,23,1.280933845,25,2,it,"('MOT', 'BRO')",Providence,vio08.xml,28,3,1,BRO,173,168,MOT
1,2,2,23,1.280933845,25,2,little,"('MOT', 'BRO')",Providence,vio08.xml,28,3,1,BRO,173,168,MOT
0,1,2,25,1.252762968,26,1,can,"('MOT', 'BRO')",Providence,vio08.xml,28,2,0,BRO,173,168,MOT
0,2,1,25,1.170071253,27,2,there,"('MOT', 'BRO')",Providence,vio08.xml,28,1,0,BRO,173,168,MOT
0,1,1,15,1.098612289,16,1,this,"('MOT', 'FAT')",Providence,vio08.xml,17,1,0,FAT,118,92,MOT
0,1,1,15,1.098612289,16,1,see,"('MOT', 'FAT')",Providence,vio08.xml,17,1,0,FAT,118,92,MOT
0,1,1,15,1.098612289,16,1,no,"('MOT', 'FAT')",Providence,vio08.xml,17,1,0,FAT,118,92,MOT
0,1,1,15,1.098612289,16,1,to,"('MOT', 'FAT')",Providence,vio08.xml,17,1,0,FAT,118,92,MOT
0,1,1,15,1.098612289,16,1,and,"('MOT', 'FAT')",Providence,vio08.xml,17,1,0,FAT,118,92,MOT
1,0,1,4,1.098612289,4,0,yeah,"('FAT', 'MOT')",Providence,vio08.xml,6,2,1,MOT,20,159,FAT
1,2,0,9,1.060871961,11,2,no,"('FAT', 'BRO')",Providence,vio08.xml,12,1,1,BRO,90,94,FAT
0,1,1,13,0.980829253,14,1,make,"('BRO', 'MOT')",Providence,vio08.xml,15,1,0,MOT,118,210,BRO
0,3,1,24,0.88238918,27,3,is,"('MOT', 'BRO')",Providence,vio08.xml,28,1,0,BRO,173,168,MOT
0,3,1,24,0.88238918,27,3,one,"('MOT', 'BRO')",Providence,vio08.xml,28,1,0,BRO,173,168,MOT
0,1,1,10,0.773189888,11,1,go,"('FAT', 'BRO')",Providence,vio08.xml,12,1,0,BRO,90,94,FAT
0,1,1,10,0.773189888,11,1,in,"('FAT', 'BRO')",Providence,vio08.xml,12,1,0,BRO,90,94,FAT
0,1,1,10,0.773189888,11,1,we,"('FAT', 'BRO')",Providence,vio08.xml,12,1,0,BRO,90,94,FAT
0,1,1,10,0.773189888,11,1,think,"('FAT', 'BRO')",Providence,vio08.xml,12,1,0,BRO,90,94,FAT
0,2,1,14,0.693147181,16,2,wanna,"('MOT', 'FAT')",Providence,vio08.xml,17,1,0,FAT,118,92,MOT
0,1,2,12,0.628608659,13,1,we,"('BRO', 'MOT')",Providence,vio08.xml,15,2,0,MOT,118,210,BRO
0,1,2,12,0.628608659,13,1,put,"('BRO', 'MOT')",Providence,vio08.xml,15,2,0,MOT,118,210,BRO
0,1,2,12,0.628608659,13,1,to,"('BRO', 'MOT')",Providence,vio08.xml,15,2,0,MOT,118,210,BRO
1,3,4,20,0.579818495,23,3,the,"('MOT', 'BRO')",Providence,vio08.xml,28,5,1,BRO,173,168,MOT
0,2,1,12,0.575364145,14,2,have,"('BRO', 'MOT')",Providence,vio08.xml,15,1,0,MOT,118,210,BRO
0,2,1,12,0.575364145,14,2,that,"('BRO', 'MOT')",Providence,vio08.xml,15,1,0,MOT,118,210,BRO
0,1,1,7,0.510825624,8,1,it,"('BRO', 'FAT')",Providence,vio08.xml,9,1,0,FAT,56,56,BRO
0,1,1,7,0.510825624,8,1,look,"('BRO', 'FAT')",Providence,vio08.xml,9,1,0,FAT,56,56,BRO
0,1,1,7,0.510825624,8,1,can,"('BRO', 'FAT')",Providence,vio08.xml,9,1,0,FAT,56,56,BRO
0,1,3,13,0.470003629,14,1,make,"('MOT', 'FAT')",Providence,vio08.xml,17,3,0,FAT,118,92,MOT
0,1,2,9,0.405465108,10,1,you,"('FAT', 'BRO')",Providence,vio08.xml,12,2,0,BRO,90,94,FAT
0,1,2,9,0.405465108,10,1,one,"('FAT', 'BRO')",Providence,vio08.xml,12,2,0,BRO,90,94,FAT
0,2,1,9,0.36772478,11,2,the,"('FAT', 'BRO')",Providence,vio08.xml,12,1,0,BRO,90,94,FAT
0,2,4,22,0.36772478,24,2,a,"('MOT', 'BRO')",Providence,vio08.xml,28,4,0,BRO,173,168,MOT
0,3,1,11,0.287682072,14,3,a,"('BRO', 'MOT')",Providence,vio08.xml,15,1,0,MOT,118,210,BRO
0,3,1,11,0.287682072,14,3,the,"('BRO', 'MOT')",Providence,vio08.xml,15,1,0,MOT,118,210,BRO
0,2,2,11,0.223143551,13,2,in,"('BRO', 'MOT')",Providence,vio08.xml,15,2,0,MOT,118,210,BRO
0,2,2,11,0.223143551,13,2,this,"('BRO', 'MOT')",Providence,vio08.xml,15,2,0,MOT,118,210,BRO
0,1,2,6,0.117783036,7,1,we,"('BRO', 'FAT')",Providence,vio08.xml,9,2,0,FAT,56,56,BRO
0,1,2,6,0.117783036,7,1,a,"('BRO', 'FAT')",Providence,vio08.xml,9,2,0,FAT,56,56,BRO
0,3,2,12,0.060624622,15,3,you,"('MOT', 'FAT')",Providence,vio08.xml,17,2,0,FAT,118,92,MOT
0,2,1,3,-0.251314428,5,2,on,"('FAT', 'MOT')",Providence,vio08.xml,6,1,0,MOT,20,159,FAT
0,1,2,3,-0.287682072,4,1,oh,"('FAT', 'MOT')",Providence,vio08.xml,6,2,0,MOT,20,159,FAT
0,3,1,2,-0.538996501,5,3,the,"('FAT', 'MOT')",Providence,vio08.xml,6,1,0,MOT,20,159,FAT
0,3,2,4,-0.575364145,7,3,the,"('BRO', 'FAT')",Providence,vio08.xml,9,2,0,FAT,56,56,BRO
0,4,4,7,-0.836248024,11,4,you,"('BRO', 'MOT')",Providence,vio08.xml,15,4,0,MOT,118,210,BRO
2,0,1,9,1.887069649,9,0,the,"('MOT', 'BRO')",Providence,vio09.xml,12,3,2,BRO,102,49,MOT
0,1,1,21,1.386294361,22,1,yeah,"('BRO', 'MOT')",Providence,vio09.xml,23,1,0,MOT,76,262,BRO
0,1,1,21,1.386294361,22,1,is,"('BRO', 'MOT')",Providence,vio09.xml,23,1,0,MOT,76,262,BRO
0,1,1,21,1.386294361,22,1,can,"('BRO', 'MOT')",Providence,vio09.xml,23,1,0,MOT,76,262,BRO
0,1,2,20,1.056052674,21,1,no,"('BRO', 'MOT')",Providence,vio09.xml,23,2,0,MOT,76,262,BRO
0,2,1,20,0.980829253,22,2,one,"('BRO', 'MOT')",Providence,vio09.xml,23,1,0,MOT,76,262,BRO
1,4,1,17,0.832909123,21,4,a,"('BRO', 'MOT')",Providence,vio09.xml,23,2,1,MOT,76,262,BRO
0,2,16,108,0.729514825,110,2,this,"('MOT', 'CHI')",Providence,vio09.xml,126,16,0,CHI,1702,349,MOT
0,3,1,19,0.693147181,22,3,up,"('BRO', 'MOT')",Providence,vio09.xml,23,1,0,MOT,76,262,BRO
0,4,1,18,0.470003629,22,4,this,"('BRO', 'MOT')",Providence,vio09.xml,23,1,0,MOT,76,262,BRO
1,2,0,3,0.441832752,5,2,the,"('FAT', 'MOT')",Providence,vio09.xml,6,1,1,MOT,33,70,FAT
0,1,1,4,0.15415068,5,1,go,"('FAT', 'MOT')",Providence,vio09.xml,6,1,0,MOT,33,70,FAT
0,1,1,4,0.15415068,5,1,all,"('FAT', 'MOT')",Providence,vio09.xml,6,1,0,MOT,33,70,FAT
0,1,1,4,0.15415068,5,1,to,"('FAT', 'MOT')",Providence,vio09.xml,6,1,0,MOT,33,70,FAT
0,16,9,101,-0.451985124,117,16,there,"('MOT', 'CHI')",Providence,vio09.xml,126,9,0,CHI,1702,349,MOT
0,1,1,75,2.564949357,76,1,did,"('MOT', 'CHI')",Providence,vio10.xml,77,1,0,CHI,2201,339,MOT
1,0,19,57,1.679642171,57,0,it,"('MOT', 'CHI')",Providence,vio10.xml,77,20,1,CHI,2201,339,MOT
1,0,19,57,1.679642171,57,0,is,"('MOT', 'CHI')",Providence,vio10.xml,77,20,1,CHI,2201,339,MOT
3,1,22,51,1.386294361,52,1,this,"('MOT', 'CHI')",Providence,vio10.xml,77,25,3,CHI,2201,339,MOT
1,1,19,56,0.986494991,57,1,that,"('MOT', 'CHI')",Providence,vio10.xml,77,20,1,CHI,2201,339,MOT
0,1,16,60,0.559615788,61,1,do,"('MOT', 'CHI')",Providence,vio10.xml,77,16,0,CHI,2201,339,MOT
1,19,0,317,2.421848514,336,19,and,"('CHI', 'MOT')",Providence,vio11.xml,337,1,1,MOT,1210,3725,CHI
1,31,0,305,1.951844885,336,31,one,"('CHI', 'MOT')",Providence,vio11.xml,337,1,1,MOT,1210,3725,CHI
0,11,2,324,1.948881919,335,11,no,"('CHI', 'MOT')",Providence,vio11.xml,337,2,0,MOT,1210,3725,CHI
1,34,0,302,1.862232726,336,34,that,"('CHI', 'MOT')",Providence,vio11.xml,337,1,1,MOT,1210,3725,CHI
28,27,33,249,1.519577707,276,27,big,"('CHI', 'MOT')",Providence,vio11.xml,337,61,28,MOT,1210,3725,CHI
1,0,3,18,1.897119985,18,0,that,"('MOT', 'FAT')",Providence,vio12.xml,22,4,1,FAT,217,118,MOT
1,1,1,19,1.704748092,20,1,was,"('MOT', 'FAT')",Providence,vio12.xml,22,2,1,FAT,217,118,MOT
0,1,1,20,1.343734747,21,1,look,"('MOT', 'FAT')",Providence,vio12.xml,22,1,0,FAT,217,118,MOT
0,1,1,20,1.343734747,21,1,what,"('MOT', 'FAT')",Providence,vio12.xml,22,1,0,FAT,217,118,MOT
0,1,1,20,1.343734747,21,1,a,"('MOT', 'FAT')",Providence,vio12.xml,22,1,0,FAT,217,118,MOT
0,1,1,20,1.343734747,21,1,see,"('MOT', 'FAT')",Providence,vio12.xml,22,1,0,FAT,217,118,MOT
0,1,1,20,1.343734747,21,1,at,"('MOT', 'FAT')",Providence,vio12.xml,22,1,0,FAT,217,118,MOT
0,1,1,20,1.343734747,21,1,to,"('MOT', 'FAT')",Providence,vio12.xml,22,1,0,FAT,217,118,MOT
1,0,0,3,1.203972804,3,0,oh,"('FAT', 'MOT')",Providence,vio12.xml,4,1,1,MOT,47,144,FAT
1,5,6,83,1.203972804,88,5,go,"('MOT', 'CHI')",Providence,vio12.xml,95,7,1,CHI,1702,400,MOT
1,1,3,17,1.203972804,18,1,yeah,"('MOT', 'FAT')",Providence,vio12.xml,22,4,1,FAT,217,118,MOT
2,3,0,11,1.098612289,14,3,one,"('CHI', 'MOT')",Providence,vio12.xml,16,2,2,MOT,52,167,CHI
0,1,2,19,1.011600912,20,1,gonna,"('MOT', 'FAT')",Providence,vio12.xml,22,2,0,FAT,217,118,MOT
0,1,2,19,1.011600912,20,1,in,"('MOT', 'FAT')",Providence,vio12.xml,22,2,0,FAT,217,118,MOT
0,2,1,19,0.938269639,21,2,but,"('MOT', 'FAT')",Providence,vio12.xml,22,1,0,FAT,217,118,MOT
0,2,1,19,0.938269639,21,2,not,"('MOT', 'FAT')",Providence,vio12.xml,22,1,0,FAT,217,118,MOT
6,5,24,60,0.893107396,65,5,you,"('MOT', 'CHI')",Providence,vio12.xml,95,30,6,CHI,1702,400,MOT
0,1,3,18,0.741937345,19,1,we,"('MOT', 'FAT')",Providence,vio12.xml,22,3,0,FAT,217,118,MOT
0,2,2,18,0.606135804,20,2,the,"('MOT', 'FAT')",Providence,vio12.xml,22,2,0,FAT,217,118,MOT
0,2,2,18,0.606135804,20,2,on,"('MOT', 'FAT')",Providence,vio12.xml,22,2,0,FAT,217,118,MOT
0,3,10,82,0.594707108,85,3,one,"('MOT', 'CHI')",Providence,vio12.xml,95,10,0,CHI,1702,400,MOT
0,2,16,77,0.405465108,79,2,a,"('MOT', 'CHI')",Providence,vio12.xml,95,16,0,CHI,1702,400,MOT
4,9,20,62,0.339215723,71,9,to,"('MOT', 'CHI')",Providence,vio12.xml,95,24,4,CHI,1702,400,MOT
0,2,3,17,0.336472237,19,2,this,"('MOT', 'FAT')",Providence,vio12.xml,22,3,0,FAT,217,118,MOT
2,4,4,12,0.300104592,16,4,it,"('MOT', 'FAT')",Providence,vio12.xml,22,6,2,FAT,217,118,MOT
0,1,1,2,-0.182321557,3,1,have,"('FAT', 'MOT')",Providence,vio12.xml,4,1,0,MOT,47,144,FAT
0,1,1,2,-0.182321557,3,1,this,"('FAT', 'MOT')",Providence,vio12.xml,4,1,0,MOT,47,144,FAT
0,1,1,2,-0.182321557,3,1,one,"('FAT', 'MOT')",Providence,vio12.xml,4,1,0,MOT,47,144,FAT
0,1,1,2,-0.182321557,3,1,to,"('FAT', 'MOT')",Providence,vio12.xml,4,1,0,MOT,47,144,FAT
0,1,1,2,-0.182321557,3,1,on,"('FAT', 'MOT')",Providence,vio12.xml,4,1,0,MOT,47,144,FAT
1,2,1,0,-0.405465108,2,2,the,"('FAT', 'MOT')",Providence,vio12.xml,4,2,1,MOT,47,144,FAT
0,2,1,1,-0.587786665,3,2,you,"('FAT', 'MOT')",Providence,vio12.xml,4,1,0,MOT,47,144,FAT
0,1,2,1,-0.693147181,2,1,yeah,"('FAT', 'MOT')",Providence,vio12.xml,4,2,0,MOT,47,144,FAT
2,0,7,196,3.988984047,196,0,up,"('MOT', 'CHI')",Providence,vio13.xml,205,9,2,CHI,2699,756,MOT
1,3,14,187,1.731134847,190,3,one,"('MOT', 'CHI')",Providence,vio13.xml,205,15,1,CHI,2699,756,MOT
0,1,15,189,1.731134847,190,1,go,"('MOT', 'CHI')",Providence,vio13.xml,205,15,0,CHI,2699,756,MOT
0,1,19,185,1.498772345,186,1,do,"('MOT', 'CHI')",Providence,vio13.xml,205,19,0,CHI,2699,756,MOT
0,1,37,167,0.77908961,168,1,this,"('MOT', 'CHI')",Providence,vio13.xml,205,37,0,CHI,2699,756,MOT
0,2,48,155,0.058268908,157,2,a,"('MOT', 'CHI')",Providence,vio13.xml,205,48,0,CHI,2699,756,MOT
1,0,9,126,3.060270795,126,0,there,"('MOT', 'CHI')",Providence,vio14.xml,136,10,1,CHI,2131,573,MOT
3,0,32,101,2.410105437,101,0,the,"('MOT', 'CHI')",Providence,vio14.xml,136,35,3,CHI,2131,573,MOT
0,4,2,130,1.916922612,134,4,no,"('MOT', 'CHI')",Providence,vio14.xml,136,2,0,CHI,2131,573,MOT
1,1,19,115,1.679642171,116,1,in,"('MOT', 'CHI')",Providence,vio14.xml,136,20,1,CHI,2131,573,MOT
0,2,8,126,1.466337069,128,2,want,"('MOT', 'CHI')",Providence,vio14.xml,136,8,0,CHI,2131,573,MOT
0,1,20,115,0.986494991,116,1,this,"('MOT', 'CHI')",Providence,vio14.xml,136,20,0,CHI,2131,573,MOT
0,1,1,4,0.15415068,5,1,yeah,"('CHI', 'MOT')",Providence,vio14.xml,6,1,0,MOT,33,43,CHI
0,18,8,110,-0.379489622,128,18,yeah,"('MOT', 'CHI')",Providence,vio14.xml,136,8,0,CHI,2131,573,MOT
1,0,2,178,4.276666119,178,0,some,"('MOT', 'CHI')",Providence,vio15.xml,181,3,1,CHI,1096,803,MOT
3,1,3,174,3.789855371,175,1,of,"('MOT', 'CHI')",Providence,vio15.xml,181,6,3,CHI,1096,803,MOT
1,0,8,172,3.454307207,172,0,and,"('MOT', 'CHI')",Providence,vio15.xml,181,9,1,CHI,1096,803,MOT
2,0,15,164,3.266161098,164,0,see,"('MOT', 'CHI')",Providence,vio15.xml,181,17,2,CHI,1096,803,MOT
1,0,14,166,2.983897816,166,0,it,"('MOT', 'CHI')",Providence,vio15.xml,181,15,1,CHI,1096,803,MOT
5,3,7,166,2.908071335,169,3,big,"('MOT', 'CHI')",Providence,vio15.xml,181,12,5,CHI,1096,803,MOT
0,1,3,177,2.890371758,178,1,are,"('MOT', 'CHI')",Providence,vio15.xml,181,3,0,CHI,1096,803,MOT
1,2,4,174,2.830408293,176,2,up,"('MOT', 'CHI')",Providence,vio15.xml,181,5,1,CHI,1096,803,MOT
1,0,21,159,2.596497715,159,0,you,"('MOT', 'CHI')",Providence,vio15.xml,181,22,1,CHI,1096,803,MOT
0,1,1,77,2.590267165,78,1,go,"('CHI', 'MOT')",Providence,vio15.xml,79,1,0,MOT,367,686,CHI
0,1,1,77,2.590267165,78,1,no,"('CHI', 'MOT')",Providence,vio15.xml,79,1,0,MOT,367,686,CHI
5,3,13,160,2.515678308,163,3,one,"('MOT', 'CHI')",Providence,vio15.xml,181,18,5,CHI,1096,803,MOT
1,1,12,167,2.427748236,168,1,at,"('MOT', 'CHI')",Providence,vio15.xml,181,13,1,CHI,1096,803,MOT
1,3,5,172,2.40356101,175,3,in,"('MOT', 'CHI')",Providence,vio15.xml,181,6,1,CHI,1096,803,MOT
3,1,25,152,2.335374916,153,1,is,"('MOT', 'CHI')",Providence,vio15.xml,181,28,3,CHI,1096,803,MOT
1,3,1,74,2.290006311,77,3,yeah,"('CHI', 'MOT')",Providence,vio15.xml,79,2,1,MOT,367,686,CHI
0,4,2,175,2.202764758,179,4,no,"('MOT', 'CHI')",Providence,vio15.xml,181,2,0,CHI,1096,803,MOT
1,2,12,166,2.022283128,168,2,look,"('MOT', 'CHI')",Providence,vio15.xml,181,13,1,CHI,1096,803,MOT
1,0,0,6,1.673976434,6,0,want,"('BRO', 'MOT')",Providence,vio15.xml,7,1,1,MOT,36,57,BRO
1,9,0,69,1.673976434,78,9,in,"('CHI', 'MOT')",Providence,vio15.xml,79,1,1,MOT,367,686,CHI
0,2,9,170,1.662547738,172,2,yeah,"('MOT', 'CHI')",Providence,vio15.xml,181,9,0,CHI,1096,803,MOT
1,0,0,5,1.540445041,5,0,to,"('MOT', 'FAT')",Providence,vio15.xml,6,1,1,FAT,53,33,MOT
0,5,1,73,1.491654877,78,5,one,"('CHI', 'MOT')",Providence,vio15.xml,79,1,0,MOT,367,686,CHI
1,3,16,161,1.474401629,164,3,a,"('MOT', 'CHI')",Providence,vio15.xml,181,17,1,CHI,1096,803,MOT
5,4,39,133,1.288154093,137,4,this,"('MOT', 'CHI')",Providence,vio15.xml,181,44,5,CHI,1096,803,MOT
0,2,5,72,1.286210903,74,2,there,"('CHI', 'MOT')",Providence,vio15.xml,79,5,0,MOT,367,686,CHI
1,10,2,66,1.042522822,76,10,that,"('CHI', 'MOT')",Providence,vio15.xml,79,3,1,MOT,367,686,CHI
1,11,2,65,0.955511445,76,11,this,"('CHI', 'MOT')",Providence,vio15.xml,79,3,1,MOT,367,686,CHI
0,8,6,167,0.899483614,175,8,there,"('MOT', 'CHI')",Providence,vio15.xml,181,6,0,CHI,1096,803,MOT
0,10,1,68,0.885519073,78,10,a,"('CHI', 'MOT')",Providence,vio15.xml,79,1,0,MOT,367,686,CHI
1,19,1,58,0.680568398,77,19,the,"('CHI', 'MOT')",Providence,vio15.xml,79,2,1,MOT,367,686,CHI
1,1,1,3,0.405465108,4,1,she,"('MOT', 'BRO')",Providence,vio15.xml,6,2,1,BRO,87,43,MOT
2,2,0,2,0.405465108,4,2,wanna,"('MOT', 'BRO')",Providence,vio15.xml,6,2,2,BRO,87,43,MOT
1,12,6,60,0.235038339,72,12,is,"('CHI', 'MOT')",Providence,vio15.xml,79,7,1,MOT,367,686,CHI
0,1,1,4,0.15415068,5,1,a,"('MOT', 'BRO')",Providence,vio15.xml,6,1,0,BRO,87,43,MOT
0,1,1,4,0.15415068,5,1,my,"('MOT', 'FAT')",Providence,vio15.xml,6,1,0,FAT,53,33,MOT
0,3,31,147,0.141078598,150,3,what,"('MOT', 'CHI')",Providence,vio15.xml,181,31,0,CHI,1096,803,MOT
0,2,1,6,0.105360516,8,2,you,"('FAT', 'MOT')",Providence,vio15.xml,9,1,0,MOT,36,72,FAT
2,1,2,1,0,2,1,do,"('MOT', 'BRO')",Providence,vio15.xml,6,4,2,BRO,87,43,MOT
0,2,1,4,-0.117783036,6,2,you,"('BRO', 'MOT')",Providence,vio15.xml,7,1,0,MOT,36,57,BRO
1,0,4,1,-0.15415068,1,0,you,"('MOT', 'BRO')",Providence,vio15.xml,6,5,1,BRO,87,43,MOT
0,2,1,3,-0.251314428,5,2,you,"('MOT', 'FAT')",Providence,vio15.xml,6,1,0,FAT,53,33,MOT
1,4,0,179,3.205452805,183,4,little,"('CHI', 'MOT')",Providence,vio16.xml,184,1,1,MOT,842,1620,CHI
1,5,0,178,3.023131248,183,5,in,"('CHI', 'MOT')",Providence,vio16.xml,184,1,1,MOT,842,1620,CHI
0,1,1,72,2.525728644,73,1,no,"('MOT', 'CHI')",Providence,vio16.xml,74,1,0,CHI,614,283,MOT
0,4,1,179,2.512305624,183,4,there,"('CHI', 'MOT')",Providence,vio16.xml,184,1,0,MOT,842,1620,CHI
1,0,1,22,2.48490665,22,0,a,"('MOT', 'BRO')",Providence,vio16.xml,24,2,1,BRO,267,86,MOT
2,9,1,172,2.396075436,181,9,see,"('CHI', 'MOT')",Providence,vio16.xml,184,3,2,MOT,842,1620,CHI
0,2,4,178,2.313634929,180,2,no,"('CHI', 'MOT')",Providence,vio16.xml,184,4,0,MOT,842,1620,CHI
2,11,1,170,2.213753879,181,11,he,"('CHI', 'MOT')",Providence,vio16.xml,184,3,2,MOT,842,1620,CHI
0,2,1,71,2.120263536,73,2,there,"('MOT', 'CHI')",Providence,vio16.xml,74,1,0,CHI,614,283,MOT
1,0,0,8,1.897119985,8,0,she,"('BRO', 'MOT')",Providence,vio16.xml,9,1,1,MOT,31,63,BRO
1,0,0,8,1.897119985,8,0,one,"('BRO', 'MOT')",Providence,vio16.xml,9,1,1,MOT,31,63,BRO
0,6,2,176,1.882731247,182,6,like,"('CHI', 'MOT')",Providence,vio16.xml,184,2,0,MOT,842,1620,CHI
0,5,3,176,1.808288771,181,5,go,"('CHI', 'MOT')",Providence,vio16.xml,184,3,0,MOT,842,1620,CHI
2,20,1,161,1.654138091,181,20,it,"('CHI', 'MOT')",Providence,vio16.xml,184,3,2,MOT,842,1620,CHI
2,28,0,154,1.559957855,182,28,a,"('CHI', 'MOT')",Providence,vio16.xml,184,2,2,MOT,842,1620,CHI
0,1,1,22,1.427116356,23,1,gonna,"('MOT', 'BRO')",Providence,vio16.xml,24,1,0,BRO,267,86,MOT
0,1,1,22,1.427116356,23,1,can,"('MOT', 'BRO')",Providence,vio16.xml,24,1,0,BRO,267,86,MOT
0,2,4,68,1.386294361,70,2,yeah,"('MOT', 'CHI')",Providence,vio16.xml,74,4,0,CHI,614,283,MOT
0,16,1,167,1.288530192,183,16,did,"('CHI', 'MOT')",Providence,vio16.xml,184,1,0,MOT,842,1620,CHI
0,13,2,169,1.189584067,182,13,that,"('CHI', 'MOT')",Providence,vio16.xml,184,2,0,MOT,842,1620,CHI
0,18,1,165,1.177304557,183,18,and,"('CHI', 'MOT')",Providence,vio16.xml,184,1,0,MOT,842,1620,CHI
0,1,1,16,1.15267951,17,1,what,"('MOT', 'FAT')",Providence,vio16.xml,18,1,0,FAT,119,71,MOT
0,1,1,16,1.15267951,17,1,a,"('MOT', 'FAT')",Providence,vio16.xml,18,1,0,FAT,119,71,MOT
0,2,6,66,1.070441412,68,2,a,"('MOT', 'CHI')",Providence,vio16.xml,74,6,0,CHI,614,283,MOT
1,1,1,8,1.011600912,9,1,you,"('FAT', 'MOT')",Providence,vio16.xml,11,2,1,MOT,41,70,FAT
0,1,10,63,1.011600912,64,1,that,"('MOT', 'CHI')",Providence,vio16.xml,74,10,0,CHI,614,283,MOT
2,51,0,131,0.976009967,182,51,the,"('CHI', 'MOT')",Providence,vio16.xml,184,2,2,MOT,842,1620,CHI
1,3,10,60,0.916290732,63,3,one,"('MOT', 'CHI')",Providence,vio16.xml,74,11,1,CHI,614,283,MOT
1,10,10,163,0.895088524,173,10,yeah,"('CHI', 'MOT')",Providence,vio16.xml,184,11,1,MOT,842,1620,CHI
3,17,11,153,0.870828358,170,17,one,"('CHI', 'MOT')",Providence,vio16.xml,184,14,3,MOT,842,1620,CHI
0,1,3,20,0.832909123,21,1,there,"('MOT', 'BRO')",Providence,vio16.xml,24,3,0,BRO,267,86,MOT
0,1,3,20,0.832909123,21,1,that,"('MOT', 'BRO')",Providence,vio16.xml,24,3,0,BRO,267,86,MOT
0,1,2,15,0.810930216,16,1,that,"('MOT', 'FAT')",Providence,vio16.xml,18,2,0,FAT,119,71,MOT
0,1,1,9,0.693147181,10,1,yeah,"('FAT', 'MOT')",Providence,vio16.xml,11,1,0,MOT,41,70,FAT
0,1,1,9,0.693147181,10,1,the,"('FAT', 'MOT')",Providence,vio16.xml,11,1,0,MOT,41,70,FAT
0,20,3,161,0.555525803,181,20,is,"('CHI', 'MOT')",Providence,vio16.xml,184,3,0,MOT,842,1620,CHI
0,1,1,7,0.510825624,8,1,oh,"('BRO', 'MOT')",Providence,vio16.xml,9,1,0,MOT,31,63,BRO
0,1,5,18,0.405465108,19,1,this,"('MOT', 'BRO')",Providence,vio16.xml,24,5,0,BRO,267,86,MOT
1,1,6,10,0.36772478,11,1,you,"('MOT', 'FAT')",Providence,vio16.xml,18,7,1,FAT,119,71,MOT
2,30,9,143,0.264461701,173,30,this,"('CHI', 'MOT')",Providence,vio16.xml,184,11,2,MOT,842,1620,CHI
0,2,1,7,0.200670695,9,2,this,"('BRO', 'CHI')",Providence,vio16.xml,10,1,0,CHI,29,38,BRO
0,4,9,61,0.197359434,65,4,this,"('MOT', 'CHI')",Providence,vio16.xml,74,9,0,CHI,614,283,MOT
0,1,7,16,0.054067221,17,1,the,"('MOT', 'BRO')",Providence,vio16.xml,24,7,0,BRO,267,86,MOT
0,1,4,208,2.866951484,209,1,up,"('MOT', 'CHI')",Providence,vio17.xml,213,4,0,CHI,2351,1051,MOT
0,1,5,207,2.708050201,208,1,with,"('MOT', 'CHI')",Providence,vio17.xml,213,5,0,CHI,2351,1051,MOT
1,0,28,184,2.48490665,184,0,it,"('MOT', 'CHI')",Providence,vio17.xml,213,29,1,CHI,2351,1051,MOT
1,1,14,197,2.465104022,198,1,put,"('MOT', 'CHI')",Providence,vio17.xml,213,15,1,CHI,2351,1051,MOT
0,2,4,207,2.461486376,209,2,no,"('MOT', 'CHI')",Providence,vio17.xml,213,4,0,CHI,2351,1051,MOT
0,1,7,205,2.447166322,206,1,there,"('MOT', 'CHI')",Providence,vio17.xml,213,7,0,CHI,2351,1051,MOT
0,1,8,204,2.33698652,205,1,some,"('MOT', 'CHI')",Providence,vio17.xml,213,8,0,CHI,2351,1051,MOT
0,1,10,202,2.144956149,203,1,we,"('MOT', 'CHI')",Providence,vio17.xml,213,10,0,CHI,2351,1051,MOT
0,2,7,204,2.041701214,206,2,did,"('MOT', 'CHI')",Providence,vio17.xml,213,7,0,CHI,2351,1051,MOT
3,3,20,187,2.038619547,190,3,at,"('MOT', 'CHI')",Providence,vio17.xml,213,23,3,CHI,2351,1051,MOT
2,3,16,192,1.999789383,195,3,is,"('MOT', 'CHI')",Providence,vio17.xml,213,18,2,CHI,2351,1051,MOT
0,2,8,203,1.931521412,205,2,do,"('MOT', 'CHI')",Providence,vio17.xml,213,8,0,CHI,2351,1051,MOT
0,3,6,204,1.876598349,207,3,my,"('MOT', 'CHI')",Providence,vio17.xml,213,6,0,CHI,2351,1051,MOT
4,6,16,187,1.845484869,193,6,like,"('MOT', 'CHI')",Providence,vio17.xml,213,20,4,CHI,2351,1051,MOT
0,2,9,202,1.831368607,204,2,in,"('MOT', 'CHI')",Providence,vio17.xml,213,9,0,CHI,2351,1051,MOT
0,2,9,202,1.831368607,204,2,where,"('MOT', 'CHI')",Providence,vio17.xml,213,9,0,CHI,2351,1051,MOT
0,3,7,203,1.754019141,206,3,want,"('MOT', 'CHI')",Providence,vio17.xml,213,7,0,CHI,2351,1051,MOT
1,9,5,198,1.653454798,207,9,go,"('MOT', 'CHI')",Providence,vio17.xml,213,6,1,CHI,2351,1051,MOT
0,1,17,195,1.650680871,196,1,what,"('MOT', 'CHI')",Providence,vio17.xml,213,17,0,CHI,2351,1051,MOT
5,5,32,171,1.518221904,176,5,look,"('MOT', 'CHI')",Providence,vio17.xml,213,37,5,CHI,2351,1051,MOT
2,6,15,190,1.496530191,196,6,on,"('MOT', 'CHI')",Providence,vio17.xml,213,17,2,CHI,2351,1051,MOT
0,3,11,199,1.366876275,202,3,have,"('MOT', 'CHI')",Providence,vio17.xml,213,11,0,CHI,2351,1051,MOT
1,4,22,186,1.122328815,190,4,one,"('MOT', 'CHI')",Providence,vio17.xml,213,23,1,CHI,2351,1051,MOT
3,9,25,176,0.913620503,185,9,a,"('MOT', 'CHI')",Providence,vio17.xml,213,28,3,CHI,2351,1051,MOT
0,9,8,196,0.727548607,205,9,yeah,"('MOT', 'CHI')",Providence,vio17.xml,213,8,0,CHI,2351,1051,MOT
3,8,39,163,0.558171744,171,8,that,"('MOT', 'CHI')",Providence,vio17.xml,213,42,3,CHI,2351,1051,MOT
4,17,25,167,0.510825624,184,17,this,"('MOT', 'CHI')",Providence,vio17.xml,213,29,4,CHI,2351,1051,MOT
3,8,48,154,0.318644298,162,8,you,"('MOT', 'CHI')",Providence,vio17.xml,213,51,3,CHI,2351,1051,MOT
0,4,45,164,-0.323787077,168,4,the,"('MOT', 'CHI')",Providence,vio17.xml,213,45,0,CHI,2351,1051,MOT
1,0,4,203,4.070247011,203,0,not,"('MOT', 'CHI')",Providence,vio18.xml,208,5,1,CHI,2988,1075,MOT
1,0,6,201,3.809128582,201,0,put,"('MOT', 'CHI')",Providence,vio18.xml,208,7,1,CHI,2988,1075,MOT
1,0,8,199,3.598556816,199,0,where,"('MOT', 'CHI')",Providence,vio18.xml,208,9,1,CHI,2988,1075,MOT
1,0,11,196,3.342356882,196,0,he,"('MOT', 'CHI')",Providence,vio18.xml,208,12,1,CHI,2988,1075,MOT
1,1,7,199,3.005682604,200,1,want,"('MOT', 'CHI')",Providence,vio18.xml,208,8,1,CHI,2988,1075,MOT
1,1,8,198,2.905409635,199,1,big,"('MOT', 'CHI')",Providence,vio18.xml,208,9,1,CHI,2988,1075,MOT
0,1,4,203,2.842969519,204,1,have,"('MOT', 'CHI')",Providence,vio18.xml,208,4,0,CHI,2988,1075,MOT
1,2,6,199,2.710516294,201,2,get,"('MOT', 'CHI')",Providence,vio18.xml,208,7,1,CHI,2988,1075,MOT
1,4,3,200,2.619825968,204,4,my,"('MOT', 'CHI')",Providence,vio18.xml,208,4,1,CHI,2988,1075,MOT
0,1,9,198,2.212262455,199,1,gonna,"('MOT', 'CHI')",Providence,vio18.xml,208,9,0,CHI,2988,1075,MOT
0,1,9,198,2.212262455,199,1,we,"('MOT', 'CHI')",Providence,vio18.xml,208,9,0,CHI,2988,1075,MOT
0,1,10,197,2.120263536,198,1,some,"('MOT', 'CHI')",Providence,vio18.xml,208,10,0,CHI,2988,1075,MOT
1,4,7,196,2.089391873,200,4,little,"('MOT', 'CHI')",Providence,vio18.xml,208,8,1,CHI,2988,1075,MOT
0,1,11,196,2.035208287,197,1,see,"('MOT', 'CHI')",Providence,vio18.xml,208,11,0,CHI,2988,1075,MOT
3,2,27,176,2.014903021,178,2,that,"('MOT', 'CHI')",Providence,vio18.xml,208,30,3,CHI,2988,1075,MOT
0,3,5,200,1.990805469,203,3,up,"('MOT', 'CHI')",Providence,vio18.xml,208,5,0,CHI,2988,1075,MOT
1,2,15,190,1.972021293,192,2,do,"('MOT', 'CHI')",Providence,vio18.xml,208,16,1,CHI,2988,1075,MOT
5,6,16,181,1.952102119,187,6,like,"('MOT', 'CHI')",Providence,vio18.xml,208,21,5,CHI,2988,1075,MOT
0,1,13,194,1.882006347,195,1,of,"('MOT', 'CHI')",Providence,vio18.xml,208,13,0,CHI,2988,1075,MOT
0,3,6,199,1.852384091,202,3,did,"('MOT', 'CHI')",Providence,vio18.xml,208,6,0,CHI,2988,1075,MOT
0,1,15,192,1.746639034,193,1,all,"('MOT', 'CHI')",Providence,vio18.xml,208,15,0,CHI,2988,1075,MOT
0,2,11,195,1.629743179,197,2,are,"('MOT', 'CHI')",Providence,vio18.xml,208,11,0,CHI,2988,1075,MOT
1,3,16,188,1.625104029,191,3,to,"('MOT', 'CHI')",Providence,vio18.xml,208,17,1,CHI,2988,1075,MOT
2,3,25,178,1.55450825,181,3,in,"('MOT', 'CHI')",Providence,vio18.xml,208,27,2,CHI,2988,1075,MOT
1,0,0,5,1.540445041,5,0,is,"('BRO', 'MOT')",Providence,vio18.xml,6,1,1,MOT,40,58,BRO
1,0,0,5,1.540445041,5,0,do,"('BRO', 'MOT')",Providence,vio18.xml,6,1,1,MOT,40,58,BRO
0,6,5,197,1.431189681,203,6,oh,"('MOT', 'CHI')",Providence,vio18.xml,208,5,0,CHI,2988,1075,MOT
1,14,5,188,1.223775432,202,14,no,"('MOT', 'CHI')",Providence,vio18.xml,208,6,1,CHI,2988,1075,MOT
1,4,20,183,1.189962067,187,4,and,"('MOT', 'CHI')",Providence,vio18.xml,208,21,1,CHI,2988,1075,MOT
1,10,9,188,1.108662625,198,10,yeah,"('MOT', 'CHI')",Providence,vio18.xml,208,10,1,CHI,2988,1075,MOT
1,6,16,185,1.065488241,191,6,look,"('MOT', 'CHI')",Providence,vio18.xml,208,17,1,CHI,2988,1075,MOT
1,4,23,180,1.051359404,184,4,what,"('MOT', 'CHI')",Providence,vio18.xml,208,24,1,CHI,2988,1075,MOT
4,13,19,172,0.982613375,185,13,it,"('MOT', 'CHI')",Providence,vio18.xml,208,23,4,CHI,2988,1075,MOT
0,5,11,192,0.936595998,197,5,on,"('MOT', 'CHI')",Providence,vio18.xml,208,11,0,CHI,2988,1075,MOT
2,10,17,179,0.908468006,189,10,one,"('MOT', 'CHI')",Providence,vio18.xml,208,19,2,CHI,2988,1075,MOT
1,1,0,4,0.84729786,5,1,it,"('BRO', 'MOT')",Providence,vio18.xml,6,1,1,MOT,40,58,BRO
0,4,15,189,0.830348302,193,4,at,"('MOT', 'CHI')",Providence,vio18.xml,208,15,0,CHI,2988,1075,MOT
4,16,22,166,0.658955816,182,16,this,"('MOT', 'CHI')",Providence,vio18.xml,208,26,4,CHI,2988,1075,MOT
5,15,30,158,0.573038808,173,15,a,"('MOT', 'CHI')",Providence,vio18.xml,208,35,5,CHI,2988,1075,MOT
0,7,13,188,0.495711986,195,7,there,"('MOT', 'CHI')",Providence,vio18.xml,208,13,0,CHI,2988,1075,MOT
5,14,46,143,0.182321557,157,14,the,"('MOT', 'CHI')",Providence,vio18.xml,208,51,5,CHI,2988,1075,MOT
0,1,1,4,0.15415068,5,1,for,"('BRO', 'MOT')",Providence,vio18.xml,6,1,0,MOT,40,58,BRO
0,1,1,4,0.15415068,5,1,and,"('BRO', 'MOT')",Providence,vio18.xml,6,1,0,MOT,40,58,BRO
1,14,20,173,0.091349779,187,14,is,"('MOT', 'CHI')",Providence,vio18.xml,208,21,1,CHI,2988,1075,MOT
1,2,1,2,0,4,2,you,"('BRO', 'MOT')",Providence,vio18.xml,6,2,1,MOT,40,58,BRO
0,4,41,163,-0.240739313,167,4,you,"('MOT', 'CHI')",Providence,vio18.xml,208,41,0,CHI,2988,1075,MOT
0,2,1,3,-0.251314428,5,2,yeah,"('BRO', 'MOT')",Providence,vio18.xml,6,1,0,MOT,40,58,BRO
1,4,0,235,3.469893913,239,4,get,"('CHI', 'MOT')",Providence,vio19.xml,240,1,1,MOT,1055,3093,CHI
3,5,3,229,2.978925155,234,5,at,"('CHI', 'MOT')",Providence,vio19.xml,240,6,3,MOT,1055,3093,CHI
1,6,1,232,2.841581594,238,6,little,"('CHI', 'MOT')",Providence,vio19.xml,240,2,1,MOT,1055,3093,CHI
3,5,6,226,2.647678073,231,5,no,"('CHI', 'MOT')",Providence,vio19.xml,240,9,3,MOT,1055,3093,CHI
0,5,1,234,2.594425176,239,5,all,"('CHI', 'MOT')",Providence,vio19.xml,240,1,0,MOT,1055,3093,CHI
0,5,1,234,2.594425176,239,5,where,"('CHI', 'MOT')",Providence,vio19.xml,240,1,0,MOT,1055,3093,CHI
0,5,1,234,2.594425176,239,5,think,"('CHI', 'MOT')",Providence,vio19.xml,240,1,0,MOT,1055,3093,CHI
3,8,3,226,2.573460047,234,8,look,"('CHI', 'MOT')",Providence,vio19.xml,240,6,3,MOT,1055,3093,CHI
0,4,2,234,2.48490665,238,4,big,"('CHI', 'MOT')",Providence,vio19.xml,240,2,0,MOT,1055,3093,CHI
1,0,0,11,2.159484249,11,0,put,"('MOT', 'CHI')",Providence,vio19.xml,12,1,1,CHI,113,46,MOT
0,9,1,230,2.083599552,239,9,with,"('CHI', 'MOT')",Providence,vio19.xml,240,1,0,MOT,1055,3093,CHI
0,9,1,230,2.083599552,239,9,up,"('CHI', 'MOT')",Providence,vio19.xml,240,1,0,MOT,1055,3093,CHI
1,0,0,9,1.992430165,9,0,yeah,"('CHI', 'FAT')",Providence,vio19.xml,10,1,1,FAT,26,40,CHI
1,1,1,24,1.909542505,25,1,that,"('MOT', 'FAT')",Providence,vio19.xml,27,2,1,FAT,175,183,MOT
1,0,1,10,1.791759469,10,0,you,"('MOT', 'CHI')",Providence,vio19.xml,12,2,1,CHI,113,46,MOT
4,21,3,212,1.780756396,233,21,one,"('CHI', 'MOT')",Providence,vio19.xml,240,7,4,MOT,1055,3093,CHI
0,10,2,228,1.696449289,238,10,go,"('CHI', 'MOT')",Providence,vio19.xml,240,2,0,MOT,1055,3093,CHI
1,32,0,207,1.582824264,239,32,is,"('CHI', 'MOT')",Providence,vio19.xml,240,1,1,MOT,1055,3093,CHI
1,19,2,218,1.564440547,237,19,on,"('CHI', 'MOT')",Providence,vio19.xml,240,3,1,MOT,1055,3093,CHI
0,1,1,25,1.540445041,26,1,make,"('MOT', 'FAT')",Providence,vio19.xml,27,1,0,FAT,175,183,MOT
0,1,1,25,1.540445041,26,1,what,"('MOT', 'FAT')",Providence,vio19.xml,27,1,0,FAT,175,183,MOT
0,1,1,25,1.540445041,26,1,think,"('MOT', 'FAT')",Providence,vio19.xml,27,1,0,FAT,175,183,MOT
0,1,1,25,1.540445041,26,1,not,"('MOT', 'FAT')",Providence,vio19.xml,27,1,0,FAT,175,183,MOT
0,13,2,225,1.455287233,238,13,like,"('CHI', 'MOT')",Providence,vio19.xml,240,2,0,MOT,1055,3093,CHI
1,22,3,214,1.238164169,236,22,put,"('CHI', 'MOT')",Providence,vio19.xml,240,4,1,MOT,1055,3093,CHI
0,1,2,24,1.216395324,25,1,have,"('MOT', 'FAT')",Providence,vio19.xml,27,2,0,FAT,175,183,MOT
0,1,2,24,1.216395324,25,1,on,"('MOT', 'FAT')",Providence,vio19.xml,27,2,0,FAT,175,183,MOT
2,28,4,206,1.115706722,234,28,in,"('CHI', 'MOT')",Providence,vio19.xml,240,6,2,MOT,1055,3093,CHI
0,9,6,225,1.08180517,234,9,want,"('CHI', 'MOT')",Providence,vio19.xml,240,6,0,MOT,1055,3093,CHI
4,24,10,202,1.047318994,226,24,this,"('CHI', 'MOT')",Providence,vio19.xml,240,14,4,MOT,1055,3093,CHI
0,12,5,223,0.957200635,235,12,there,"('CHI', 'MOT')",Providence,vio19.xml,240,5,0,MOT,1055,3093,CHI
1,0,4,7,0.944461609,7,0,it,"('MOT', 'CHI')",Providence,vio19.xml,12,5,1,CHI,113,46,MOT
1,25,5,209,0.819440906,234,25,to,"('CHI', 'MOT')",Providence,vio19.xml,240,6,1,MOT,1055,3093,CHI
0,14,5,221,0.814099791,235,14,my,"('CHI', 'MOT')",Providence,vio19.xml,240,5,0,MOT,1055,3093,CHI
0,1,1,10,0.773189888,11,1,is,"('FAT', 'MOT')",Providence,vio19.xml,12,1,0,MOT,63,87,FAT
0,1,4,22,0.733969175,23,1,we,"('MOT', 'FAT')",Providence,vio19.xml,27,4,0,FAT,175,183,MOT
0,28,2,210,0.727048732,238,28,and,"('CHI', 'MOT')",Providence,vio19.xml,240,2,0,MOT,1055,3093,CHI
0,29,2,209,0.693147181,238,29,that,"('CHI', 'MOT')",Providence,vio19.xml,240,2,0,MOT,1055,3093,CHI
0,4,1,22,0.624154309,26,4,to,"('MOT', 'FAT')",Providence,vio19.xml,27,1,0,FAT,175,183,MOT
3,28,12,197,0.610735205,225,28,a,"('CHI', 'MOT')",Providence,vio19.xml,240,15,3,MOT,1055,3093,CHI
0,1,1,8,0.606135804,9,1,this,"('CHI', 'FAT')",Providence,vio19.xml,10,1,0,FAT,26,40,CHI
1,4,3,19,0.510825624,23,4,and,"('MOT', 'FAT')",Providence,vio19.xml,27,4,1,FAT,175,183,MOT
3,50,6,181,0.507611909,231,50,the,"('CHI', 'MOT')",Providence,vio19.xml,240,9,3,MOT,1055,3093,CHI
0,1,2,9,0.405465108,10,1,what,"('MOT', 'CHI')",Providence,vio19.xml,12,2,0,CHI,113,46,MOT
0,1,2,9,0.405465108,10,1,oh,"('MOT', 'FRI')",Providence,vio19.xml,12,2,0,FRI,158,31,MOT
0,1,2,9,0.405465108,10,1,it,"('MOT', 'FRI')",Providence,vio19.xml,12,2,0,FRI,158,31,MOT
0,2,1,9,0.36772478,11,2,yeah,"('FAT', 'MOT')",Providence,vio19.xml,12,1,0,MOT,63,87,FAT
0,2,1,9,0.36772478,11,2,have,"('FAT', 'MOT')",Providence,vio19.xml,12,1,0,MOT,63,87,FAT
0,34,3,203,0.311677578,237,34,it,"('CHI', 'MOT')",Providence,vio19.xml,240,3,0,MOT,1055,3093,CHI
0,4,2,21,0.300104592,25,4,a,"('MOT', 'FAT')",Providence,vio19.xml,27,2,0,FAT,175,183,MOT
1,18,15,206,0.278871443,224,18,yeah,"('CHI', 'MOT')",Providence,vio19.xml,240,16,1,MOT,1055,3093,CHI
0,1,1,4,0.15415068,5,1,the,"('FAT', 'CHI')",Providence,vio19.xml,6,1,0,CHI,21,28,FAT
1,4,5,17,0.139761942,21,4,you,"('MOT', 'FAT')",Providence,vio19.xml,27,6,1,FAT,175,183,MOT
0,1,3,8,0.09531018,9,1,is,"('MOT', 'CHI')",Providence,vio19.xml,12,3,0,CHI,113,46,MOT
0,1,3,8,0.09531018,9,1,yeah,"('MOT', 'FRI')",Providence,vio19.xml,12,3,0,FRI,158,31,MOT
0,1,3,8,0.09531018,9,1,is,"('MOT', 'FRI')",Providence,vio19.xml,12,3,0,FRI,158,31,MOT
0,2,2,8,0,10,2,a,"('FAT', 'MOT')",Providence,vio19.xml,12,2,0,MOT,63,87,FAT
0,71,2,167,-0.182321557,238,71,you,"('CHI', 'MOT')",Providence,vio19.xml,240,2,0,MOT,1055,3093,CHI
0,4,4,19,-0.182321557,23,4,the,"('MOT', 'FAT')",Providence,vio19.xml,27,4,0,FAT,175,183,MOT
0,2,5,5,-0.84729786,7,2,you,"('FAT', 'MOT')",Providence,vio19.xml,12,5,0,MOT,63,87,FAT
1,0,4,177,3.934622837,177,0,no,"('MOT', 'CHI')",Providence,vio20.xml,182,5,1,CHI,1978,779,MOT
1,0,5,176,3.795489189,176,0,did,"('MOT', 'CHI')",Providence,vio20.xml,182,6,1,CHI,1978,779,MOT
1,0,6,175,3.672072336,175,0,in,"('MOT', 'CHI')",Providence,vio20.xml,182,7,1,CHI,1978,779,MOT
1,0,7,174,3.561046083,174,0,see,"('MOT', 'CHI')",Providence,vio20.xml,182,8,1,CHI,1978,779,MOT
0,1,1,180,3.417726684,181,1,but,"('MOT', 'CHI')",Providence,vio20.xml,182,1,0,CHI,1978,779,MOT
1,0,10,171,3.281489418,171,0,we,"('MOT', 'CHI')",Providence,vio20.xml,182,11,1,CHI,1978,779,MOT
0,1,3,178,2.895911938,179,1,my,"('MOT', 'CHI')",Providence,vio20.xml,182,3,0,CHI,1978,779,MOT
1,0,16,165,2.866702014,165,0,do,"('MOT', 'CHI')",Providence,vio20.xml,182,17,1,CHI,1978,779,MOT
3,4,4,171,2.755781604,175,4,make,"('MOT', 'CHI')",Providence,vio20.xml,182,7,3,CHI,1978,779,MOT
0,1,5,176,2.548328476,177,1,they,"('MOT', 'CHI')",Providence,vio20.xml,182,5,0,CHI,1978,779,MOT
0,1,6,175,2.409194828,176,1,at,"('MOT', 'CHI')",Providence,vio20.xml,182,6,0,CHI,1978,779,MOT
1,1,13,167,2.363209715,168,1,one,"('MOT', 'CHI')",Providence,vio20.xml,182,14,1,CHI,1978,779,MOT
0,1,7,174,2.285777975,175,1,get,"('MOT', 'CHI')",Providence,vio20.xml,182,7,0,CHI,1978,779,MOT
0,2,6,174,2.00372972,176,2,on,"('MOT', 'CHI')",Providence,vio20.xml,182,6,0,CHI,1978,779,MOT
1,0,0,9,1.992430165,9,0,they,"('MOT', 'FAT')",Providence,vio20.xml,10,1,1,FAT,97,58,MOT
0,1,10,171,1.981001469,172,1,to,"('MOT', 'CHI')",Providence,vio20.xml,182,10,0,CHI,1978,779,MOT
0,1,10,171,1.981001469,172,1,and,"('MOT', 'CHI')",Providence,vio20.xml,182,10,0,CHI,1978,779,MOT
2,3,2,36,1.634130525,39,3,this,"('CHI', 'MOT')",Providence,vio20.xml,43,4,2,MOT,162,658,CHI
0,2,1,40,1.586965057,42,2,want,"('CHI', 'MOT')",Providence,vio20.xml,43,1,0,MOT,162,658,CHI
0,2,10,170,1.575536361,172,2,like,"('MOT', 'CHI')",Providence,vio20.xml,182,10,0,CHI,1978,779,MOT
0,6,4,172,1.455287233,178,6,want,"('MOT', 'CHI')",Providence,vio20.xml,182,4,0,CHI,1978,779,MOT
0,1,20,161,1.315676794,162,1,it,"('MOT', 'CHI')",Providence,vio20.xml,182,20,0,CHI,1978,779,MOT
0,3,1,39,1.299282984,42,3,of,"('CHI', 'MOT')",Providence,vio20.xml,43,1,0,MOT,162,658,CHI
0,1,4,38,1.228665417,39,1,yeah,"('CHI', 'MOT')",Providence,vio20.xml,43,4,0,MOT,162,658,CHI
0,1,22,159,1.216395324,160,1,this,"('MOT', 'CHI')",Providence,vio20.xml,182,22,0,CHI,1978,779,MOT
1,4,2,36,1.211940974,40,4,that,"('CHI', 'MOT')",Providence,vio20.xml,43,3,1,MOT,162,658,CHI
8,10,30,134,1.094056472,144,10,a,"('MOT', 'CHI')",Providence,vio20.xml,182,38,8,CHI,1978,779,MOT
1,2,31,148,1.092054888,150,2,is,"('MOT', 'CHI')",Providence,vio20.xml,182,32,1,CHI,1978,779,MOT
0,3,2,38,0.988611393,41,3,one,"('CHI', 'MOT')",Providence,vio20.xml,43,2,0,MOT,162,658,CHI
0,9,5,168,0.938890564,177,9,there,"('MOT', 'CHI')",Providence,vio20.xml,182,5,0,CHI,1978,779,MOT
0,3,16,163,0.84729786,166,3,that,"('MOT', 'CHI')",Providence,vio20.xml,182,16,0,CHI,1978,779,MOT
5,8,35,134,0.826678573,142,8,the,"('MOT', 'CHI')",Providence,vio20.xml,182,40,5,CHI,1978,779,MOT
1,0,4,5,0.693147181,5,0,you,"('MOT', 'FAT')",Providence,vio20.xml,10,5,1,FAT,97,58,MOT
0,1,1,8,0.606135804,9,1,have,"('MOT', 'FAT')",Providence,vio20.xml,10,1,0,FAT,97,58,MOT
0,1,1,8,0.606135804,9,1,for,"('MOT', 'FAT')",Providence,vio20.xml,10,1,0,FAT,97,58,MOT
0,1,1,8,0.606135804,9,1,a,"('MOT', 'FAT')",Providence,vio20.xml,10,1,0,FAT,97,58,MOT
0,1,1,8,0.606135804,9,1,one,"('MOT', 'FAT')",Providence,vio20.xml,10,1,0,FAT,97,58,MOT
0,1,1,8,0.606135804,9,1,the,"('MOT', 'FAT')",Providence,vio20.xml,10,1,0,FAT,97,58,MOT
0,1,1,8,0.606135804,9,1,on,"('MOT', 'FAT')",Providence,vio20.xml,10,1,0,FAT,97,58,MOT
0,8,1,34,0.488352768,42,8,my,"('CHI', 'MOT')",Providence,vio20.xml,43,1,0,MOT,162,658,CHI
0,6,2,35,0.428995606,41,6,a,"('CHI', 'MOT')",Providence,vio20.xml,43,2,0,MOT,162,658,CHI
0,11,9,162,0.281984051,173,11,yeah,"('MOT', 'CHI')",Providence,vio20.xml,182,9,0,CHI,1978,779,MOT
0,1,2,7,0.223143551,8,1,it,"('MOT', 'FAT')",Providence,vio20.xml,10,2,0,FAT,97,58,MOT
0,1,2,7,0.223143551,8,1,is,"('MOT', 'FAT')",Providence,vio20.xml,10,2,0,FAT,97,58,MOT
0,12,1,30,0.120627988,42,12,and,"('CHI', 'MOT')",Providence,vio20.xml,43,1,0,MOT,162,658,CHI
0,1,1,2,-0.182321557,3,1,have,"('FAT', 'MOT')",Providence,vio20.xml,4,1,0,MOT,20,51,FAT
0,1,1,2,-0.182321557,3,1,that,"('FAT', 'MOT')",Providence,vio20.xml,4,1,0,MOT,20,51,FAT
0,3,41,138,-0.184649847,141,3,you,"('MOT', 'CHI')",Providence,vio20.xml,182,41,0,CHI,1978,779,MOT
0,9,4,30,-0.380772496,39,9,is,"('CHI', 'MOT')",Providence,vio20.xml,43,4,0,MOT,162,658,CHI
0,1,1,191,3.47609869,192,1,want,"('CHI', 'MOT')",Providence,vio21.xml,193,1,0,MOT,1188,1466,CHI
0,1,1,191,3.47609869,192,1,we,"('CHI', 'MOT')",Providence,vio21.xml,193,1,0,MOT,1188,1466,CHI
0,1,1,191,3.47609869,192,1,of,"('CHI', 'MOT')",Providence,vio21.xml,193,1,0,MOT,1188,1466,CHI
0,1,2,190,3.183248647,191,1,go,"('CHI', 'MOT')",Providence,vio21.xml,193,2,0,MOT,1188,1466,CHI
2,7,0,184,2.895566575,191,7,to,"('CHI', 'MOT')",Providence,vio21.xml,193,2,2,MOT,1188,1466,CHI
0,3,1,189,2.782951509,192,3,up,"('CHI', 'MOT')",Providence,vio21.xml,193,1,0,MOT,1188,1466,CHI
0,3,1,189,2.782951509,192,3,no,"('CHI', 'MOT')",Providence,vio21.xml,193,1,0,MOT,1188,1466,CHI
0,3,1,189,2.782951509,192,3,put,"('CHI', 'MOT')",Providence,vio21.xml,193,1,0,MOT,1188,1466,CHI
1,0,0,21,2.730029108,21,0,wanna,"('CHI', 'FAT')",Providence,vio21.xml,22,1,1,FAT,120,155,CHI
1,0,0,21,2.730029108,21,0,on,"('CHI', 'FAT')",Providence,vio21.xml,22,1,1,FAT,120,155,CHI
6,6,5,176,2.6499864,182,6,on,"('CHI', 'MOT')",Providence,vio21.xml,193,11,6,MOT,1188,1466,CHI
0,4,1,188,2.559807958,192,4,little,"('CHI', 'MOT')",Providence,vio21.xml,193,1,0,MOT,1188,1466,CHI
1,10,0,182,2.464497778,192,10,are,"('CHI', 'MOT')",Providence,vio21.xml,193,1,1,MOT,1188,1466,CHI
1,1,0,31,2.427748236,32,1,some,"('FAT', 'CHI')",Providence,vio21.xml,33,1,1,CHI,301,149,FAT
0,5,1,187,2.377486401,192,5,get,"('CHI', 'MOT')",Providence,vio21.xml,193,1,0,MOT,1188,1466,CHI
1,0,3,29,2.335374916,29,0,of,"('FAT', 'CHI')",Providence,vio21.xml,33,4,1,CHI,301,149,FAT
1,0,3,29,2.335374916,29,0,little,"('FAT', 'CHI')",Providence,vio21.xml,33,4,1,CHI,301,149,FAT
1,0,0,13,2.302585093,13,0,she,"('MOT', 'FAT')",Providence,vio21.xml,14,1,1,FAT,109,112,MOT
0,4,2,187,2.266957915,191,4,wanna,"('CHI', 'MOT')",Providence,vio21.xml,193,2,0,MOT,1188,1466,CHI
0,6,1,186,2.223335721,192,6,for,"('CHI', 'MOT')",Providence,vio21.xml,193,1,0,MOT,1188,1466,CHI
0,6,1,186,2.223335721,192,6,with,"('CHI', 'MOT')",Providence,vio21.xml,193,1,0,MOT,1188,1466,CHI
0,5,2,186,2.084636359,191,5,have,"('CHI', 'MOT')",Providence,vio21.xml,193,2,0,MOT,1188,1466,CHI
0,5,2,186,2.084636359,191,5,there,"('CHI', 'MOT')",Providence,vio21.xml,193,2,0,MOT,1188,1466,CHI
1,1,1,29,2.079441542,30,1,for,"('FAT', 'MOT')",Providence,vio21.xml,32,2,1,MOT,275,200,FAT
1,1,0,20,2.036881927,21,1,up,"('CHI', 'FAT')",Providence,vio21.xml,22,1,1,FAT,120,155,CHI
1,1,2,29,1.85629799,30,1,a,"('FAT', 'CHI')",Providence,vio21.xml,33,3,1,CHI,301,149,FAT
1,1,2,28,1.824549292,29,1,a,"('FAT', 'MOT')",Providence,vio21.xml,32,3,1,MOT,275,200,FAT
1,6,6,180,1.786454417,186,6,my,"('CHI', 'MOT')",Providence,vio21.xml,193,7,1,MOT,1188,1466,CHI
0,1,1,31,1.734601055,32,1,want,"('FAT', 'CHI')",Providence,vio21.xml,33,1,0,CHI,301,149,FAT
0,1,1,30,1.704748092,31,1,oh,"('FAT', 'MOT')",Providence,vio21.xml,32,1,0,MOT,275,200,FAT
2,20,1,170,1.702147311,190,20,a,"('CHI', 'MOT')",Providence,vio21.xml,193,3,2,MOT,1188,1466,CHI
1,1,0,12,1.609437912,13,1,oh,"('MOT', 'FAT')",Providence,vio21.xml,14,1,1,FAT,109,112,MOT
3,22,2,166,1.551914068,188,22,it,"('CHI', 'MOT')",Providence,vio21.xml,193,5,3,MOT,1188,1466,CHI
2,11,6,174,1.542229163,185,11,in,"('CHI', 'MOT')",Providence,vio21.xml,193,8,2,MOT,1188,1466,CHI
5,15,9,164,1.445079056,179,15,the,"('CHI', 'MOT')",Providence,vio21.xml,193,14,5,MOT,1188,1466,CHI
0,15,1,177,1.396657148,192,15,do,"('CHI', 'MOT')",Providence,vio21.xml,193,1,0,MOT,1188,1466,CHI
0,1,2,29,1.386294361,30,1,at,"('FAT', 'MOT')",Providence,vio21.xml,32,2,0,MOT,275,200,FAT
0,7,4,182,1.381072417,189,7,all,"('CHI', 'MOT')",Providence,vio21.xml,193,4,0,MOT,1188,1466,CHI
0,1,1,20,1.343734747,21,1,little,"('CHI', 'FAT')",Providence,vio21.xml,22,1,0,FAT,120,155,CHI
0,1,1,20,1.343734747,21,1,one,"('CHI', 'FAT')",Providence,vio21.xml,22,1,0,FAT,120,155,CHI
0,2,1,30,1.329135947,32,2,in,"('FAT', 'CHI')",Providence,vio21.xml,33,1,0,CHI,301,149,FAT
0,2,1,29,1.299282984,31,2,gonna,"('FAT', 'MOT')",Providence,vio21.xml,32,1,0,MOT,275,200,FAT
0,2,1,29,1.299282984,31,2,want,"('FAT', 'MOT')",Providence,vio21.xml,32,1,0,MOT,275,200,FAT
0,2,1,29,1.299282984,31,2,go,"('FAT', 'MOT')",Providence,vio21.xml,32,1,0,MOT,275,200,FAT
0,2,1,29,1.299282984,31,2,like,"('FAT', 'MOT')",Providence,vio21.xml,32,1,0,MOT,275,200,FAT
0,2,1,29,1.299282984,31,2,all,"('FAT', 'MOT')",Providence,vio21.xml,32,1,0,MOT,275,200,FAT
0,14,2,177,1.168345627,191,14,and,"('CHI', 'MOT')",Providence,vio21.xml,193,2,0,MOT,1188,1466,CHI
0,1,1,16,1.15267951,17,1,it,"('MOT', 'CHI')",Providence,vio21.xml,18,1,0,CHI,205,106,MOT
0,1,1,16,1.15267951,17,1,we,"('MOT', 'CHI')",Providence,vio21.xml,18,1,0,CHI,205,106,MOT
0,1,1,16,1.15267951,17,1,there,"('MOT', 'CHI')",Providence,vio21.xml,18,1,0,CHI,205,106,MOT
0,1,1,16,1.15267951,17,1,some,"('MOT', 'CHI')",Providence,vio21.xml,18,1,0,CHI,205,106,MOT
0,1,1,16,1.15267951,17,1,put,"('MOT', 'CHI')",Providence,vio21.xml,18,1,0,CHI,205,106,MOT
0,3,1,29,1.041453875,32,3,that,"('FAT', 'CHI')",Providence,vio21.xml,33,1,0,CHI,301,149,FAT
0,3,1,29,1.041453875,32,3,on,"('FAT', 'CHI')",Providence,vio21.xml,33,1,0,CHI,301,149,FAT
0,2,2,28,0.980829253,30,2,get,"('FAT', 'MOT')",Providence,vio21.xml,32,2,0,MOT,275,200,FAT
0,2,1,19,0.938269639,21,2,there,"('CHI', 'FAT')",Providence,vio21.xml,22,1,0,FAT,120,155,CHI
0,2,1,19,0.938269639,21,2,a,"('CHI', 'FAT')",Providence,vio21.xml,22,1,0,FAT,120,155,CHI
0,1,1,12,0.916290732,13,1,there,"('MOT', 'FAT')",Providence,vio21.xml,14,1,0,FAT,109,112,MOT
0,1,1,12,0.916290732,13,1,did,"('MOT', 'FAT')",Providence,vio21.xml,14,1,0,FAT,109,112,MOT
0,1,1,12,0.916290732,13,1,is,"('MOT', 'FAT')",Providence,vio21.xml,14,1,0,FAT,109,112,MOT
0,1,1,12,0.916290732,13,1,and,"('MOT', 'FAT')",Providence,vio21.xml,14,1,0,FAT,109,112,MOT
1,1,8,23,0.860201265,24,1,you,"('FAT', 'CHI')",Providence,vio21.xml,33,9,1,CHI,301,149,FAT
0,1,2,15,0.810930216,16,1,up,"('MOT', 'CHI')",Providence,vio21.xml,18,2,0,CHI,205,106,MOT
0,1,5,27,0.762140052,28,1,it,"('FAT', 'CHI')",Providence,vio21.xml,33,5,0,CHI,301,149,FAT
0,2,3,28,0.757685702,30,2,put,"('FAT', 'CHI')",Providence,vio21.xml,33,3,0,CHI,301,149,FAT
0,2,1,15,0.747214402,17,2,this,"('MOT', 'CHI')",Providence,vio21.xml,18,1,0,CHI,205,106,MOT
4,10,29,150,0.743790913,160,10,yeah,"('CHI', 'MOT')",Providence,vio21.xml,193,33,4,MOT,1188,1466,CHI
0,2,3,27,0.725937003,29,2,that,"('FAT', 'MOT')",Providence,vio21.xml,32,3,0,MOT,275,200,FAT
2,18,10,163,0.724602133,181,18,that,"('CHI', 'MOT')",Providence,vio21.xml,193,12,2,MOT,1188,1466,CHI
2,3,1,8,0.667829373,11,3,the,"('MOT', 'FAT')",Providence,vio21.xml,14,3,2,FAT,109,112,MOT
0,3,1,18,0.650587566,21,3,the,"('CHI', 'FAT')",Providence,vio21.xml,22,1,0,FAT,120,155,CHI
0,1,2,11,0.559615788,12,1,yeah,"('MOT', 'FAT')",Providence,vio21.xml,14,2,0,FAT,109,112,MOT
0,1,2,11,0.559615788,12,1,to,"('MOT', 'FAT')",Providence,vio21.xml,14,2,0,FAT,109,112,MOT
1,17,9,166,0.538224598,183,17,one,"('CHI', 'MOT')",Providence,vio21.xml,193,10,1,MOT,1188,1466,CHI
0,2,1,11,0.510825624,13,2,some,"('MOT', 'FAT')",Providence,vio21.xml,14,1,0,FAT,109,112,MOT
0,2,1,11,0.510825624,13,2,that,"('MOT', 'FAT')",Providence,vio21.xml,14,1,0,FAT,109,112,MOT
0,4,2,27,0.500775288,31,4,this,"('FAT', 'CHI')",Providence,vio21.xml,33,2,0,CHI,301,149,FAT
2,20,13,158,0.413833358,178,20,is,"('CHI', 'MOT')",Providence,vio21.xml,193,15,2,MOT,1188,1466,CHI
0,2,2,14,0.405465108,16,2,yeah,"('MOT', 'CHI')",Providence,vio21.xml,18,2,0,CHI,205,106,MOT
1,2,4,11,0.356674944,13,2,the,"('MOT', 'CHI')",Providence,vio21.xml,18,5,1,CHI,205,106,MOT
5,17,31,140,0.332705754,157,17,this,"('CHI', 'MOT')",Providence,vio21.xml,193,36,5,MOT,1188,1466,CHI
1,2,9,21,0.328504067,23,2,the,"('FAT', 'CHI')",Providence,vio21.xml,33,10,1,CHI,301,149,FAT
0,3,2,17,0.318453731,20,3,in,"('CHI', 'FAT')",Providence,vio21.xml,22,2,0,FAT,120,155,CHI
0,3,2,17,0.318453731,20,3,this,"('CHI', 'FAT')",Providence,vio21.xml,22,2,0,FAT,120,155,CHI
0,1,4,13,0.287682072,14,1,in,"('MOT', 'CHI')",Providence,vio21.xml,18,4,0,CHI,205,106,MOT
3,46,7,137,0.271595935,183,46,you,"('CHI', 'MOT')",Providence,vio21.xml,193,10,3,MOT,1188,1466,CHI
0,2,6,24,0.15415068,26,2,it,"('FAT', 'MOT')",Providence,vio21.xml,32,6,0,MOT,275,200,FAT
0,6,2,24,0.133531393,30,6,you,"('FAT', 'MOT')",Providence,vio21.xml,32,2,0,MOT,275,200,FAT
1,3,10,18,-0.122602322,21,3,the,"('FAT', 'MOT')",Providence,vio21.xml,32,11,1,MOT,275,200,FAT
0,3,6,23,-0.133531393,26,3,to,"('FAT', 'MOT')",Providence,vio21.xml,32,6,0,MOT,275,200,FAT
0,3,3,8,-0.430782916,11,3,you,"('MOT', 'FAT')",Providence,vio21.xml,14,3,0,FAT,109,112,MOT
0,33,8,152,-0.597837001,185,33,what,"('CHI', 'MOT')",Providence,vio21.xml,193,8,0,MOT,1188,1466,CHI
2,1,6,193,3.380994674,194,1,like,"('MOT', 'CHI')",Providence,vio22.xml,202,8,2,CHI,2098,1157,MOT
1,1,6,194,3.085979151,195,1,make,"('MOT', 'CHI')",Providence,vio22.xml,202,7,1,CHI,2098,1157,MOT
1,1,8,192,2.875104286,193,1,no,"('MOT', 'CHI')",Providence,vio22.xml,202,9,1,CHI,2098,1157,MOT
0,2,2,198,2.823361048,200,2,he,"('MOT', 'CHI')",Providence,vio22.xml,202,2,0,CHI,2098,1157,MOT
0,1,4,197,2.813410717,198,1,put,"('MOT', 'CHI')",Providence,vio22.xml,202,4,0,CHI,2098,1157,MOT
0,1,4,197,2.813410717,198,1,can,"('MOT', 'CHI')",Providence,vio22.xml,202,4,0,CHI,2098,1157,MOT
0,1,4,197,2.813410717,198,1,not,"('MOT', 'CHI')",Providence,vio22.xml,202,4,0,CHI,2098,1157,MOT
1,1,10,190,2.697740831,191,1,one,"('MOT', 'CHI')",Providence,vio22.xml,202,11,1,CHI,2098,1157,MOT
1,2,6,193,2.680514043,195,2,at,"('MOT', 'CHI')",Providence,vio22.xml,202,7,1,CHI,2098,1157,MOT
3,3,9,187,2.618438042,190,3,on,"('MOT', 'CHI')",Providence,vio22.xml,202,12,3,CHI,2098,1157,MOT
1,2,7,192,2.570064458,194,2,look,"('MOT', 'CHI')",Providence,vio22.xml,202,8,1,CHI,2098,1157,MOT
0,3,2,197,2.535678975,200,3,up,"('MOT', 'CHI')",Providence,vio22.xml,202,2,0,CHI,2098,1157,MOT
0,3,2,197,2.535678975,200,3,where,"('MOT', 'CHI')",Providence,vio22.xml,202,2,0,CHI,2098,1157,MOT
3,3,11,185,2.47443535,188,3,in,"('MOT', 'CHI')",Providence,vio22.xml,202,14,3,CHI,2098,1157,MOT
3,3,11,185,2.47443535,188,3,we,"('MOT', 'CHI')",Providence,vio22.xml,202,14,3,CHI,2098,1157,MOT
0,1,7,194,2.392831971,195,1,with,"('MOT', 'CHI')",Providence,vio22.xml,202,7,0,CHI,2098,1157,MOT
0,1,10,191,2.089804329,192,1,some,"('MOT', 'CHI')",Providence,vio22.xml,202,10,0,CHI,2098,1157,MOT
1,4,9,188,1.866660777,192,4,want,"('MOT', 'CHI')",Providence,vio22.xml,202,10,1,CHI,2098,1157,MOT
0,1,13,188,1.851076046,189,1,are,"('MOT', 'CHI')",Providence,vio22.xml,202,13,0,CHI,2098,1157,MOT
10,10,25,157,1.518980802,167,10,a,"('MOT', 'CHI')",Providence,vio22.xml,202,35,10,CHI,2098,1157,MOT
3,8,14,177,1.475739421,185,8,this,"('MOT', 'CHI')",Providence,vio22.xml,202,17,3,CHI,2098,1157,MOT
2,4,22,174,1.424034689,178,4,and,"('MOT', 'CHI')",Providence,vio22.xml,202,24,2,CHI,2098,1157,MOT
2,10,9,181,1.398457847,191,10,gonna,"('MOT', 'CHI')",Providence,vio22.xml,202,11,2,CHI,2098,1157,MOT
0,1,22,179,1.332805676,180,1,oh,"('MOT', 'CHI')",Providence,vio22.xml,202,22,0,CHI,2098,1157,MOT
2,3,31,166,1.298633423,169,3,what,"('MOT', 'CHI')",Providence,vio22.xml,202,33,2,CHI,2098,1157,MOT
0,6,6,190,1.26291534,196,6,wanna,"('MOT', 'CHI')",Providence,vio22.xml,202,6,0,CHI,2098,1157,MOT
3,11,13,175,1.247457916,186,11,have,"('MOT', 'CHI')",Providence,vio22.xml,202,16,3,CHI,2098,1157,MOT
0,3,12,187,1.232143681,190,3,for,"('MOT', 'CHI')",Providence,vio22.xml,202,12,0,CHI,2098,1157,MOT
3,9,17,173,1.207602572,182,9,that,"('MOT', 'CHI')",Providence,vio22.xml,202,20,3,CHI,2098,1157,MOT
1,8,11,182,1.114360646,190,8,it,"('MOT', 'CHI')",Providence,vio22.xml,202,12,1,CHI,2098,1157,MOT
0,6,8,188,1.029619417,194,6,there,"('MOT', 'CHI')",Providence,vio22.xml,202,8,0,CHI,2098,1157,MOT
0,8,6,188,1.011600912,196,8,go,"('MOT', 'CHI')",Providence,vio22.xml,202,6,0,CHI,2098,1157,MOT
0,10,7,185,0.688083879,195,10,my,"('MOT', 'CHI')",Providence,vio22.xml,202,7,0,CHI,2098,1157,MOT
1,6,23,172,0.682097344,178,6,the,"('MOT', 'CHI')",Providence,vio22.xml,202,24,1,CHI,2098,1157,MOT
1,19,8,174,0.572519193,193,19,is,"('MOT', 'CHI')",Providence,vio22.xml,202,9,1,CHI,2098,1157,MOT
0,4,24,174,0.3254224,178,4,do,"('MOT', 'CHI')",Providence,vio22.xml,202,24,0,CHI,2098,1157,MOT
0,6,21,175,0.128081788,181,6,to,"('MOT', 'CHI')",Providence,vio22.xml,202,21,0,CHI,2098,1157,MOT
2,25,21,154,-0.179863043,179,25,yeah,"('MOT', 'CHI')",Providence,vio22.xml,202,23,2,CHI,2098,1157,MOT
3,17,63,119,-0.796331417,136,17,you,"('MOT', 'CHI')",Providence,vio22.xml,202,66,3,CHI,2098,1157,MOT
1,0,7,374,4.320151231,374,0,not,"('MOT', 'CHI')",Providence,vio23.xml,382,8,1,CHI,4856,1919,MOT
2,0,23,357,3.686097811,357,0,was,"('MOT', 'CHI')",Providence,vio23.xml,382,25,2,CHI,4856,1919,MOT
1,1,7,373,3.62700405,374,1,big,"('MOT', 'CHI')",Providence,vio23.xml,382,8,1,CHI,4856,1919,MOT
1,0,18,363,3.548522096,363,0,think,"('MOT', 'CHI')",Providence,vio23.xml,382,19,1,CHI,4856,1919,MOT
1,1,8,372,3.529030753,373,1,look,"('MOT', 'CHI')",Providence,vio23.xml,382,9,1,CHI,4856,1919,MOT
2,1,16,363,3.312366168,364,1,they,"('MOT', 'CHI')",Providence,vio23.xml,382,18,2,CHI,4856,1919,MOT
1,0,27,354,3.16688053,354,0,oh,"('MOT', 'CHI')",Providence,vio23.xml,382,28,1,CHI,4856,1919,MOT
2,2,12,366,3.140914283,368,2,at,"('MOT', 'CHI')",Providence,vio23.xml,382,14,2,CHI,4856,1919,MOT
3,1,26,352,3.131277766,353,1,is,"('MOT', 'CHI')",Providence,vio23.xml,382,29,3,CHI,4856,1919,MOT
3,4,9,366,3.056692973,370,4,all,"('MOT', 'CHI')",Providence,vio23.xml,382,12,3,CHI,4856,1919,MOT
0,1,7,374,3.04187343,375,1,some,"('MOT', 'CHI')",Providence,vio23.xml,382,7,0,CHI,4856,1919,MOT
1,1,15,365,3.01771118,366,1,gonna,"('MOT', 'CHI')",Providence,vio23.xml,382,16,1,CHI,4856,1919,MOT
5,5,15,357,2.806111414,362,5,one,"('MOT', 'CHI')",Providence,vio23.xml,382,20,5,CHI,4856,1919,MOT
0,1,12,369,2.586689344,370,1,where,"('MOT', 'CHI')",Providence,vio23.xml,382,12,0,CHI,4856,1919,MOT
0,2,8,372,2.528391762,374,2,up,"('MOT', 'CHI')",Providence,vio23.xml,382,8,0,CHI,4856,1919,MOT
2,3,20,357,2.425908309,360,3,for,"('MOT', 'CHI')",Providence,vio23.xml,382,22,2,CHI,4856,1919,MOT
2,5,13,362,2.384436119,367,5,have,"('MOT', 'CHI')",Providence,vio23.xml,382,15,2,CHI,4856,1919,MOT
0,1,15,366,2.384436119,367,1,but,"('MOT', 'CHI')",Providence,vio23.xml,382,15,0,CHI,4856,1919,MOT
0,5,4,373,2.356652314,378,5,with,"('MOT', 'CHI')",Providence,vio23.xml,382,4,0,CHI,4856,1919,MOT
6,7,24,345,2.270029618,352,7,he,"('MOT', 'CHI')",Providence,vio23.xml,382,30,6,CHI,4856,1919,MOT
1,2,22,357,2.264537025,359,2,we,"('MOT', 'CHI')",Providence,vio23.xml,382,23,1,CHI,4856,1919,MOT
0,4,6,372,2.246014742,376,4,my,"('MOT', 'CHI')",Providence,vio23.xml,382,6,0,CHI,4856,1919,MOT
5,5,30,342,2.24415401,347,5,like,"('MOT', 'CHI')",Providence,vio23.xml,382,35,5,CHI,4856,1919,MOT
5,7,23,347,2.186051277,354,7,did,"('MOT', 'CHI')",Providence,vio23.xml,382,28,5,CHI,4856,1919,MOT
1,2,24,355,2.182020414,357,2,what,"('MOT', 'CHI')",Providence,vio23.xml,382,25,1,CHI,4856,1919,MOT
2,4,21,355,2.15917651,359,4,see,"('MOT', 'CHI')",Providence,vio23.xml,382,23,2,CHI,4856,1919,MOT
1,7,9,365,2.053054787,372,7,want,"('MOT', 'CHI')",Providence,vio23.xml,382,10,1,CHI,4856,1919,MOT
10,6,55,311,2.012483607,317,6,a,"('MOT', 'CHI')",Providence,vio23.xml,382,65,10,CHI,4856,1919,MOT
2,12,8,360,1.973012079,372,12,wanna,"('MOT', 'CHI')",Providence,vio23.xml,382,10,2,CHI,4856,1919,MOT
2,9,12,359,1.936941479,368,9,go,"('MOT', 'CHI')",Providence,vio23.xml,382,14,2,CHI,4856,1919,MOT
0,3,14,365,1.754619922,368,3,get,"('MOT', 'CHI')",Providence,vio23.xml,382,14,0,CHI,4856,1919,MOT
2,10,14,356,1.718428196,366,10,no,"('MOT', 'CHI')",Providence,vio23.xml,382,16,2,CHI,4856,1919,MOT
2,4,34,342,1.703790696,346,4,to,"('MOT', 'CHI')",Providence,vio23.xml,382,36,2,CHI,4856,1919,MOT
0,3,18,361,1.520606699,364,3,of,"('MOT', 'CHI')",Providence,vio23.xml,382,18,0,CHI,4856,1919,MOT
1,7,18,356,1.469080555,363,7,put,"('MOT', 'CHI')",Providence,vio23.xml,382,19,1,CHI,4856,1919,MOT
3,11,23,345,1.449716188,356,11,can,"('MOT', 'CHI')",Providence,vio23.xml,382,26,3,CHI,4856,1919,MOT
5,12,32,333,1.412573246,345,12,and,"('MOT', 'CHI')",Providence,vio23.xml,382,37,5,CHI,4856,1919,MOT
5,12,33,332,1.384369433,344,12,in,"('MOT', 'CHI')",Providence,vio23.xml,382,38,5,CHI,4856,1919,MOT
4,8,43,327,1.340475967,335,8,do,"('MOT', 'CHI')",Providence,vio23.xml,382,47,4,CHI,4856,1919,MOT
3,11,26,342,1.339518296,353,11,on,"('MOT', 'CHI')",Providence,vio23.xml,382,29,3,CHI,4856,1919,MOT
5,21,20,336,1.288202538,357,21,this,"('MOT', 'CHI')",Providence,vio23.xml,382,25,5,CHI,4856,1919,MOT
13,17,55,297,1.255932543,314,17,it,"('MOT', 'CHI')",Providence,vio23.xml,382,68,13,CHI,4856,1919,MOT
22,37,58,265,0.80821651,302,37,the,"('MOT', 'CHI')",Providence,vio23.xml,382,80,22,CHI,4856,1919,MOT
6,9,116,251,0.391387994,260,9,you,"('MOT', 'CHI')",Providence,vio23.xml,382,122,6,CHI,4856,1919,MOT
1,16,31,334,0.197204487,350,16,that,"('MOT', 'CHI')",Providence,vio23.xml,382,32,1,CHI,4856,1919,MOT
0,11,26,345,0.063421826,356,11,there,"('MOT', 'CHI')",Providence,vio23.xml,382,26,0,CHI,4856,1919,MOT
8,90,35,249,-0.288414942,339,90,yeah,"('MOT', 'CHI')",Providence,vio23.xml,382,43,8,CHI,4856,1919,MOT
0,1,1,277,3.843030134,278,1,big,"('MOT', 'CHI')",Providence,vio24.xml,279,1,0,CHI,2576,1651,MOT
1,2,1,275,3.839452313,277,2,up,"('MOT', 'CHI')",Providence,vio24.xml,279,2,1,CHI,2576,1651,MOT
0,1,3,275,3.325036021,276,1,little,"('MOT', 'CHI')",Providence,vio24.xml,279,3,0,CHI,2576,1651,MOT
3,4,4,268,3.192759978,272,4,he,"('MOT', 'CHI')",Providence,vio24.xml,279,7,3,CHI,2576,1651,MOT
7,4,11,257,3.046425388,261,4,make,"('MOT', 'CHI')",Providence,vio24.xml,279,18,7,CHI,2576,1651,MOT
0,2,3,274,2.919570913,276,2,put,"('MOT', 'CHI')",Providence,vio24.xml,279,3,0,CHI,2576,1651,MOT
0,1,6,272,2.844182375,273,1,but,"('MOT', 'CHI')",Providence,vio24.xml,279,6,0,CHI,2576,1651,MOT
0,1,6,272,2.844182375,273,1,can,"('MOT', 'CHI')",Providence,vio24.xml,279,6,0,CHI,2576,1651,MOT
1,3,6,269,2.722756348,272,3,with,"('MOT', 'CHI')",Providence,vio24.xml,279,7,1,CHI,2576,1651,MOT
3,3,13,260,2.689358068,263,3,like,"('MOT', 'CHI')",Providence,vio24.xml,279,16,3,CHI,2576,1651,MOT
0,1,9,269,2.514759613,270,1,where,"('MOT', 'CHI')",Providence,vio24.xml,279,9,0,CHI,2576,1651,MOT
0,2,6,271,2.438717267,273,2,for,"('MOT', 'CHI')",Providence,vio24.xml,279,6,0,CHI,2576,1651,MOT
0,2,7,270,2.31729124,272,2,go,"('MOT', 'CHI')",Providence,vio24.xml,279,7,0,CHI,2576,1651,MOT
0,1,13,265,2.189789599,266,1,do,"('MOT', 'CHI')",Providence,vio24.xml,279,13,0,CHI,2576,1651,MOT
5,10,10,254,2.144147161,264,10,one,"('MOT', 'CHI')",Providence,vio24.xml,279,15,5,CHI,2576,1651,MOT
1,5,8,265,2.109294505,270,5,no,"('MOT', 'CHI')",Providence,vio24.xml,279,9,1,CHI,2576,1651,MOT
2,9,6,262,2.102913898,271,9,some,"('MOT', 'CHI')",Providence,vio24.xml,279,8,2,CHI,2576,1651,MOT
0,4,5,270,2.065052804,274,4,there,"('MOT', 'CHI')",Providence,vio24.xml,279,5,0,CHI,2576,1651,MOT
0,3,7,269,2.029609168,272,3,get,"('MOT', 'CHI')",Providence,vio24.xml,279,7,0,CHI,2576,1651,MOT
1,2,22,254,1.928618652,256,2,this,"('MOT', 'CHI')",Providence,vio24.xml,279,23,1,CHI,2576,1651,MOT
2,6,13,258,1.902985104,264,6,on,"('MOT', 'CHI')",Providence,vio24.xml,279,15,2,CHI,2576,1651,MOT
1,9,6,263,1.806465617,272,9,wanna,"('MOT', 'CHI')",Providence,vio24.xml,279,7,1,CHI,2576,1651,MOT
1,8,7,263,1.802809305,271,8,want,"('MOT', 'CHI')",Providence,vio24.xml,279,8,1,CHI,2576,1651,MOT
1,3,20,255,1.732040235,258,3,look,"('MOT', 'CHI')",Providence,vio24.xml,279,21,1,CHI,2576,1651,MOT
3,9,17,250,1.557187222,259,9,to,"('MOT', 'CHI')",Providence,vio24.xml,279,20,3,CHI,2576,1651,MOT
0,7,6,266,1.457888014,273,7,my,"('MOT', 'CHI')",Providence,vio24.xml,279,6,0,CHI,2576,1651,MOT
11,13,41,214,1.290587277,227,13,the,"('MOT', 'CHI')",Providence,vio24.xml,279,52,11,CHI,2576,1651,MOT
2,13,12,252,1.274214895,265,13,have,"('MOT', 'CHI')",Providence,vio24.xml,279,14,2,CHI,2576,1651,MOT
2,9,18,250,1.26950515,259,9,are,"('MOT', 'CHI')",Providence,vio24.xml,279,20,2,CHI,2576,1651,MOT
0,6,9,264,1.261996644,270,6,they,"('MOT', 'CHI')",Providence,vio24.xml,279,9,0,CHI,2576,1651,MOT
1,5,22,251,1.235471471,256,5,at,"('MOT', 'CHI')",Providence,vio24.xml,279,23,1,CHI,2576,1651,MOT
2,11,16,250,1.190127398,261,11,in,"('MOT', 'CHI')",Providence,vio24.xml,279,18,2,CHI,2576,1651,MOT
1,4,28,246,1.179151151,250,4,we,"('MOT', 'CHI')",Providence,vio24.xml,279,29,1,CHI,2576,1651,MOT
0,6,11,262,1.087562452,268,6,of,"('MOT', 'CHI')",Providence,vio24.xml,279,11,0,CHI,2576,1651,MOT
1,6,22,250,1.081320792,256,6,is,"('MOT', 'CHI')",Providence,vio24.xml,279,23,1,CHI,2576,1651,MOT
6,25,25,223,0.712766967,248,25,a,"('MOT', 'CHI')",Providence,vio24.xml,279,31,6,CHI,2576,1651,MOT
1,7,31,240,0.604798011,247,7,what,"('MOT', 'CHI')",Providence,vio24.xml,279,32,1,CHI,2576,1651,MOT
1,10,28,240,0.390693791,250,10,it,"('MOT', 'CHI')",Providence,vio24.xml,279,29,1,CHI,2576,1651,MOT
1,14,21,243,0.363871211,257,14,and,"('MOT', 'CHI')",Providence,vio24.xml,279,22,1,CHI,2576,1651,MOT
3,17,35,224,0.300104592,241,17,that,"('MOT', 'CHI')",Providence,vio24.xml,279,38,3,CHI,2576,1651,MOT
1,9,47,222,-0.070422464,231,9,you,"('MOT', 'CHI')",Providence,vio24.xml,279,48,1,CHI,2576,1651,MOT
2,43,16,218,-0.109155587,261,43,yeah,"('MOT', 'CHI')",Providence,vio24.xml,279,18,2,CHI,2576,1651,MOT
1,3,1,255,3.481240089,258,3,not,"('CHI', 'MOT')",Providence,vio25.xml,260,2,1,MOT,1490,2535,CHI
0,2,1,257,3.36729583,259,2,they,"('CHI', 'MOT')",Providence,vio25.xml,260,1,0,MOT,1490,2535,CHI
0,2,1,257,3.36729583,259,2,think,"('CHI', 'MOT')",Providence,vio25.xml,260,1,0,MOT,1490,2535,CHI
0,3,1,256,3.079613758,259,3,big,"('CHI', 'MOT')",Providence,vio25.xml,260,1,0,MOT,1490,2535,CHI
1,3,3,253,3.068052935,256,3,with,"('CHI', 'MOT')",Providence,vio25.xml,260,4,1,MOT,1490,2535,CHI
1,11,0,248,2.674148649,259,11,for,"('CHI', 'MOT')",Providence,vio25.xml,260,1,1,MOT,1490,2535,CHI
1,9,1,249,2.564949357,258,9,we,"('CHI', 'MOT')",Providence,vio25.xml,260,2,1,MOT,1490,2535,CHI
0,4,2,254,2.564949357,258,4,have,"('CHI', 'MOT')",Providence,vio25.xml,260,2,0,MOT,1490,2535,CHI
0,6,1,253,2.51999797,259,6,was,"('CHI', 'MOT')",Providence,vio25.xml,260,1,0,MOT,1490,2535,CHI
2,8,3,247,2.504553647,255,8,of,"('CHI', 'MOT')",Providence,vio25.xml,260,5,2,MOT,1490,2535,CHI
2,8,3,247,2.504553647,255,8,make,"('CHI', 'MOT')",Providence,vio25.xml,260,5,2,MOT,1490,2535,CHI
1,0,1,22,2.48490665,22,0,a,"('MOT', 'CHI')",Providence,vio25.xml,24,2,1,CHI,149,117,MOT
2,5,8,245,2.351375257,250,5,no,"('CHI', 'MOT')",Providence,vio25.xml,260,10,2,MOT,1490,2535,CHI
0,8,1,251,2.268683541,259,8,like,"('CHI', 'MOT')",Providence,vio25.xml,260,1,0,MOT,1490,2535,CHI
0,8,1,251,2.268683541,259,8,look,"('CHI', 'MOT')",Providence,vio25.xml,260,1,0,MOT,1490,2535,CHI
0,8,1,251,2.268683541,259,8,at,"('CHI', 'MOT')",Providence,vio25.xml,260,1,0,MOT,1490,2535,CHI
2,8,6,244,2.136136885,252,8,there,"('CHI', 'MOT')",Providence,vio25.xml,260,8,2,MOT,1490,2535,CHI
0,7,2,251,2.094945728,258,7,where,"('CHI', 'MOT')",Providence,vio25.xml,260,2,0,MOT,1490,2535,CHI
0,8,2,250,1.977162693,258,8,get,"('CHI', 'MOT')",Providence,vio25.xml,260,2,0,MOT,1490,2535,CHI
1,11,3,245,1.969440646,256,11,wanna,"('CHI', 'MOT')",Providence,vio25.xml,260,4,1,MOT,1490,2535,CHI
0,14,1,245,1.757857918,259,14,want,"('CHI', 'MOT')",Providence,vio25.xml,260,1,0,MOT,1490,2535,CHI
0,8,3,249,1.750165572,257,8,can,"('CHI', 'MOT')",Providence,vio25.xml,260,3,0,MOT,1490,2535,CHI
0,11,2,247,1.68948062,258,11,oh,"('CHI', 'MOT')",Providence,vio25.xml,260,2,0,MOT,1490,2535,CHI
0,7,4,249,1.681758574,256,7,are,"('CHI', 'MOT')",Providence,vio25.xml,260,4,0,MOT,1490,2535,CHI
1,19,2,238,1.644805056,257,19,gonna,"('CHI', 'MOT')",Providence,vio25.xml,260,3,1,MOT,1490,2535,CHI
0,8,4,248,1.563975538,256,8,go,"('CHI', 'MOT')",Providence,vio25.xml,260,4,0,MOT,1490,2535,CHI
0,10,3,247,1.549494876,257,10,did,"('CHI', 'MOT')",Providence,vio25.xml,260,3,0,MOT,1490,2535,CHI
1,10,8,241,1.430746124,251,10,do,"('CHI', 'MOT')",Providence,vio25.xml,260,9,1,MOT,1490,2535,CHI
0,1,1,22,1.427116356,23,1,in,"('MOT', 'CHI')",Providence,vio25.xml,24,1,0,CHI,149,117,MOT
0,1,1,22,1.427116356,23,1,have,"('MOT', 'CHI')",Providence,vio25.xml,24,1,0,CHI,149,117,MOT
0,5,9,246,1.343734747,251,5,my,"('CHI', 'MOT')",Providence,vio25.xml,260,9,0,MOT,1490,2535,CHI
2,33,2,223,1.33345188,256,33,to,"('CHI', 'MOT')",Providence,vio25.xml,260,4,2,MOT,1490,2535,CHI
0,7,7,246,1.264597426,253,7,put,"('CHI', 'MOT')",Providence,vio25.xml,260,7,0,MOT,1490,2535,CHI
1,12,8,239,1.263692039,251,12,one,"('CHI', 'MOT')",Providence,vio25.xml,260,9,1,MOT,1490,2535,CHI
1,21,4,234,1.205270663,255,21,in,"('CHI', 'MOT')",Providence,vio25.xml,260,5,1,MOT,1490,2535,CHI
0,1,2,21,1.098612289,22,1,to,"('MOT', 'CHI')",Providence,vio25.xml,24,2,0,CHI,149,117,MOT
1,16,7,236,1.094683011,252,16,he,"('CHI', 'MOT')",Providence,vio25.xml,260,8,1,MOT,1490,2535,CHI
0,2,1,21,1.021651248,23,2,this,"('MOT', 'CHI')",Providence,vio25.xml,24,1,0,CHI,149,117,MOT
0,2,1,21,1.021651248,23,2,he,"('MOT', 'CHI')",Providence,vio25.xml,24,1,0,CHI,149,117,MOT
0,2,1,21,1.021651248,23,2,one,"('MOT', 'CHI')",Providence,vio25.xml,24,1,0,CHI,149,117,MOT
0,2,1,21,1.021651248,23,2,the,"('MOT', 'CHI')",Providence,vio25.xml,24,1,0,CHI,149,117,MOT
15,41,16,188,0.980829253,229,41,a,"('CHI', 'MOT')",Providence,vio25.xml,260,31,15,MOT,1490,2535,CHI
0,11,7,242,0.859132318,253,11,on,"('CHI', 'MOT')",Providence,vio25.xml,260,7,0,MOT,1490,2535,CHI
9,43,13,195,0.820980552,238,43,the,"('CHI', 'MOT')",Providence,vio25.xml,260,22,9,MOT,1490,2535,CHI
0,1,2,13,0.693147181,14,1,go,"('MOT', 'FAT')",Providence,vio25.xml,16,2,0,FAT,112,102,MOT
3,27,13,217,0.669049629,244,27,it,"('CHI', 'MOT')",Providence,vio25.xml,260,16,3,MOT,1490,2535,CHI
3,27,14,216,0.610909082,243,27,and,"('CHI', 'MOT')",Providence,vio25.xml,260,17,3,MOT,1490,2535,CHI
1,24,8,227,0.609765572,251,24,is,"('CHI', 'MOT')",Providence,vio25.xml,260,9,1,MOT,1490,2535,CHI
0,1,4,19,0.606135804,20,1,is,"('MOT', 'CHI')",Providence,vio25.xml,24,4,0,CHI,149,117,MOT
0,4,1,19,0.510825624,23,4,yeah,"('MOT', 'CHI')",Providence,vio25.xml,24,1,0,CHI,149,117,MOT
0,2,3,19,0.427444015,21,2,on,"('MOT', 'CHI')",Providence,vio25.xml,24,3,0,CHI,149,117,MOT
0,1,3,12,0.405465108,13,1,a,"('MOT', 'FAT')",Providence,vio25.xml,16,3,0,FAT,112,102,MOT
0,29,4,227,0.360002734,256,29,what,"('CHI', 'MOT')",Providence,vio25.xml,260,4,0,MOT,1490,2535,CHI
0,3,1,12,0.348306694,15,3,to,"('MOT', 'FAT')",Providence,vio25.xml,16,1,0,FAT,112,102,MOT
3,63,7,187,0.271933715,250,63,you,"('CHI', 'MOT')",Providence,vio25.xml,260,10,3,MOT,1490,2535,CHI
0,2,4,18,0.200670695,20,2,that,"('MOT', 'CHI')",Providence,vio25.xml,24,4,0,CHI,149,117,MOT
0,2,1,6,0.105360516,8,2,it,"('FAT', 'MOT')",Providence,vio25.xml,9,1,0,MOT,55,28,FAT
0,18,11,231,0.016064603,249,18,that,"('CHI', 'MOT')",Providence,vio25.xml,260,11,0,MOT,1490,2535,CHI
1,8,45,206,0,214,8,yeah,"('CHI', 'MOT')",Providence,vio25.xml,260,46,1,MOT,1490,2535,CHI
0,24,14,222,-0.478035801,246,24,this,"('CHI', 'MOT')",Providence,vio25.xml,260,14,0,MOT,1490,2535,CHI
0,5,4,15,-0.492476485,20,5,do,"('MOT', 'CHI')",Providence,vio25.xml,24,4,0,CHI,149,117,MOT
0,2,6,8,-0.693147181,10,2,you,"('MOT', 'FAT')",Providence,vio25.xml,16,6,0,FAT,112,102,MOT
1,2,0,242,4.001254139,244,2,not,"('CHI', 'MOT')",Providence,vio26.xml,245,1,1,MOT,1158,2351,CHI
0,3,1,241,3.020424886,244,3,put,"('CHI', 'MOT')",Providence,vio26.xml,245,1,0,MOT,1158,2351,CHI
1,8,0,236,2.90264185,244,8,see,"('CHI', 'MOT')",Providence,vio26.xml,245,1,1,MOT,1158,2351,CHI
0,4,1,240,2.797281335,244,4,some,"('CHI', 'MOT')",Providence,vio26.xml,245,1,0,MOT,1158,2351,CHI
1,4,4,236,2.626736845,240,4,get,"('CHI', 'MOT')",Providence,vio26.xml,245,5,1,MOT,1158,2351,CHI
1,11,0,233,2.614959778,244,11,for,"('CHI', 'MOT')",Providence,vio26.xml,245,1,1,MOT,1158,2351,CHI
0,5,1,239,2.614959778,244,5,she,"('CHI', 'MOT')",Providence,vio26.xml,245,1,0,MOT,1158,2351,CHI
0,5,1,239,2.614959778,244,5,all,"('CHI', 'MOT')",Providence,vio26.xml,245,1,0,MOT,1158,2351,CHI
2,10,1,232,2.588447329,242,10,like,"('CHI', 'MOT')",Providence,vio26.xml,245,3,2,MOT,1158,2351,CHI
0,4,2,239,2.505525937,243,4,there,"('CHI', 'MOT')",Providence,vio26.xml,245,2,0,MOT,1158,2351,CHI
0,6,1,238,2.460809098,244,6,go,"('CHI', 'MOT')",Providence,vio26.xml,245,1,0,MOT,1158,2351,CHI
1,0,0,14,2.367123614,14,0,to,"('MOT', 'FAT')",Providence,vio26.xml,15,1,1,FAT,117,93,MOT
0,7,1,237,2.327277706,244,7,little,"('CHI', 'MOT')",Providence,vio26.xml,245,1,0,MOT,1158,2351,CHI
0,7,1,237,2.327277706,244,7,can,"('CHI', 'MOT')",Providence,vio26.xml,245,1,0,MOT,1158,2351,CHI
0,3,4,238,2.315007613,241,3,wanna,"('CHI', 'MOT')",Providence,vio26.xml,245,4,0,MOT,1158,2351,CHI
1,0,0,12,2.233592222,12,0,that,"('MOT', 'CHI')",Providence,vio26.xml,13,1,1,CHI,105,38,MOT
0,8,1,236,2.20949467,244,8,oh,"('CHI', 'MOT')",Providence,vio26.xml,245,1,0,MOT,1158,2351,CHI
0,8,1,236,2.20949467,244,8,want,"('CHI', 'MOT')",Providence,vio26.xml,245,1,0,MOT,1158,2351,CHI
0,8,1,236,2.20949467,244,8,we,"('CHI', 'MOT')",Providence,vio26.xml,245,1,0,MOT,1158,2351,CHI
0,8,1,236,2.20949467,244,8,are,"('CHI', 'MOT')",Providence,vio26.xml,245,1,0,MOT,1158,2351,CHI
2,0,1,12,2.128231706,12,0,the,"('MOT', 'FAT')",Providence,vio26.xml,15,3,2,FAT,117,93,MOT
0,9,1,235,2.104134154,244,9,with,"('CHI', 'MOT')",Providence,vio26.xml,245,1,0,MOT,1158,2351,CHI
0,9,1,235,2.104134154,244,9,look,"('CHI', 'MOT')",Providence,vio26.xml,245,1,0,MOT,1158,2351,CHI
0,7,2,236,2.035522308,243,7,he,"('CHI', 'MOT')",Providence,vio26.xml,245,2,0,MOT,1158,2351,CHI
1,7,5,232,2.019061031,239,7,no,"('CHI', 'MOT')",Providence,vio26.xml,245,6,1,MOT,1158,2351,CHI
0,8,2,235,1.917739272,243,8,of,"('CHI', 'MOT')",Providence,vio26.xml,245,2,0,MOT,1158,2351,CHI
0,5,4,236,1.909542505,241,5,up,"('CHI', 'MOT')",Providence,vio26.xml,245,4,0,MOT,1158,2351,CHI
1,11,3,230,1.909542505,241,11,have,"('CHI', 'MOT')",Providence,vio26.xml,245,4,1,MOT,1158,2351,CHI
0,6,4,235,1.755391825,241,6,my,"('CHI', 'MOT')",Providence,vio26.xml,245,4,0,MOT,1158,2351,CHI
1,0,1,9,1.704748092,9,0,you,"('FAT', 'MOT')",Providence,vio26.xml,11,2,1,MOT,74,60,FAT
1,1,0,13,1.673976434,14,1,a,"('MOT', 'FAT')",Providence,vio26.xml,15,1,1,FAT,117,93,MOT
1,1,0,13,1.673976434,14,1,do,"('MOT', 'FAT')",Providence,vio26.xml,15,1,1,FAT,117,93,MOT
1,22,1,221,1.672616814,243,22,do,"('CHI', 'MOT')",Providence,vio26.xml,245,2,1,MOT,1158,2351,CHI
1,25,1,218,1.550014492,243,25,to,"('CHI', 'MOT')",Providence,vio26.xml,245,2,1,MOT,1158,2351,CHI
0,14,2,229,1.406913648,243,14,they,"('CHI', 'MOT')",Providence,vio26.xml,245,2,0,MOT,1158,2351,CHI
6,28,6,205,1.399142504,233,28,one,"('CHI', 'MOT')",Providence,vio26.xml,245,12,6,MOT,1158,2351,CHI
1,1,0,9,1.386294361,10,1,no,"('FAT', 'MOT')",Providence,vio26.xml,11,1,1,MOT,74,60,FAT
3,41,1,200,1.349926717,241,41,what,"('CHI', 'MOT')",Providence,vio26.xml,245,4,3,MOT,1158,2351,CHI
3,18,9,215,1.262383566,233,18,in,"('CHI', 'MOT')",Providence,vio26.xml,245,12,3,MOT,1158,2351,CHI
2,25,4,214,1.245871142,239,25,it,"('CHI', 'MOT')",Providence,vio26.xml,245,6,2,MOT,1158,2351,CHI
1,0,3,7,1.098612289,7,0,a,"('FAT', 'MOT')",Providence,vio26.xml,11,4,1,MOT,74,60,FAT
0,1,1,13,0.980829253,14,1,not,"('MOT', 'FAT')",Providence,vio26.xml,15,1,0,FAT,117,93,MOT
0,1,1,12,0.916290732,13,1,you,"('FAT', 'CHI')",Providence,vio26.xml,14,1,0,CHI,53,74,FAT
2,25,8,210,0.823669242,235,25,is,"('CHI', 'MOT')",Providence,vio26.xml,245,10,2,MOT,1158,2351,CHI
0,1,1,9,0.693147181,10,1,oh,"('FAT', 'MOT')",Providence,vio26.xml,11,1,0,MOT,74,60,FAT
0,1,1,9,0.693147181,10,1,in,"('FAT', 'MOT')",Providence,vio26.xml,11,1,0,MOT,74,60,FAT
0,1,1,9,0.693147181,10,1,what,"('FAT', 'MOT')",Providence,vio26.xml,11,1,0,MOT,74,60,FAT
0,1,1,9,0.693147181,10,1,the,"('FAT', 'MOT')",Providence,vio26.xml,11,1,0,MOT,74,60,FAT
0,1,1,9,0.693147181,10,1,to,"('FAT', 'MOT')",Providence,vio26.xml,11,1,0,MOT,74,60,FAT
3,25,13,204,0.680243776,229,25,this,"('CHI', 'MOT')",Providence,vio26.xml,245,16,3,MOT,1158,2351,CHI
1,21,8,215,0.676480128,236,21,and,"('CHI', 'MOT')",Providence,vio26.xml,245,9,1,MOT,1158,2351,CHI
0,20,4,221,0.656779536,241,20,that,"('CHI', 'MOT')",Providence,vio26.xml,245,4,0,MOT,1158,2351,CHI
0,1,2,12,0.628608659,13,1,are,"('MOT', 'FAT')",Providence,vio26.xml,15,2,0,FAT,117,93,MOT
0,18,5,222,0.598588598,240,18,on,"('CHI', 'MOT')",Providence,vio26.xml,245,5,0,MOT,1158,2351,CHI
0,2,1,12,0.575364145,14,2,see,"('MOT', 'FAT')",Providence,vio26.xml,15,1,0,FAT,117,93,MOT
0,1,2,11,0.559615788,12,1,that,"('FAT', 'CHI')",Providence,vio26.xml,14,2,0,CHI,53,74,FAT
4,11,42,188,0.55663516,199,11,yeah,"('CHI', 'MOT')",Providence,vio26.xml,245,46,4,MOT,1158,2351,CHI
3,23,17,202,0.542148095,225,23,a,"('CHI', 'MOT')",Providence,vio26.xml,245,20,3,MOT,1158,2351,CHI
0,2,1,11,0.510825624,13,2,the,"('FAT', 'CHI')",Providence,vio26.xml,14,1,0,CHI,53,74,FAT
0,1,2,10,0.485507816,11,1,yeah,"('MOT', 'CHI')",Providence,vio26.xml,13,2,0,CHI,105,38,MOT
3,53,11,178,0.075760046,231,53,the,"('CHI', 'MOT')",Providence,vio26.xml,245,14,3,MOT,1158,2351,CHI
0,3,1,7,0,10,3,it,"('FAT', 'MOT')",Providence,vio26.xml,11,1,0,MOT,74,60,FAT
0,3,1,7,0,10,3,is,"('FAT', 'MOT')",Providence,vio26.xml,11,1,0,MOT,74,60,FAT
0,3,2,10,-0.064538521,13,3,it,"('MOT', 'FAT')",Providence,vio26.xml,15,2,0,FAT,117,93,MOT
0,1,4,8,-0.087011377,9,1,you,"('MOT', 'CHI')",Providence,vio26.xml,13,4,0,CHI,105,38,MOT
0,1,4,8,-0.087011377,9,1,it,"('MOT', 'CHI')",Providence,vio26.xml,13,4,0,CHI,105,38,MOT
0,1,5,9,-0.15415068,10,1,you,"('MOT', 'FAT')",Providence,vio26.xml,15,5,0,FAT,117,93,MOT
1,47,9,188,-0.194900339,235,47,you,"('CHI', 'MOT')",Providence,vio26.xml,245,10,1,MOT,1158,2351,CHI
0,1,3,2,-0.693147181,3,1,you,"('CHI', 'BRO')",Providence,vio26.xml,6,3,0,BRO,26,42,CHI
1,0,0,89,4.105394398,89,0,at,"('CHI', 'MOT')",Providence,vio27.xml,90,1,1,MOT,607,944,CHI
0,1,2,87,2.420368129,88,1,some,"('CHI', 'MOT')",Providence,vio27.xml,90,2,0,MOT,607,944,CHI
0,1,1,64,2.41293315,65,1,was,"('MOT', 'CHI')",Providence,vio27.xml,66,1,0,CHI,566,323,MOT
1,1,3,61,2.367123614,62,1,put,"('MOT', 'CHI')",Providence,vio27.xml,66,4,1,CHI,566,323,MOT
1,0,0,14,2.367123614,14,0,what,"('MOT', 'FAT')",Providence,vio27.xml,15,1,1,FAT,174,61,MOT
0,1,2,63,2.1102132,64,1,for,"('MOT', 'CHI')",Providence,vio27.xml,66,2,0,CHI,566,323,MOT
1,1,5,59,2.047692843,60,1,one,"('MOT', 'CHI')",Providence,vio27.xml,66,6,1,CHI,566,323,MOT
1,1,5,59,2.047692843,60,1,on,"('MOT', 'CHI')",Providence,vio27.xml,66,6,1,CHI,566,323,MOT
0,3,1,86,2.025952857,89,3,like,"('CHI', 'MOT')",Providence,vio27.xml,90,1,0,MOT,607,944,CHI
0,2,2,86,2.014903021,88,2,of,"('CHI', 'MOT')",Providence,vio27.xml,90,2,0,MOT,607,944,CHI
1,0,1,13,2.014903021,13,0,oh,"('MOT', 'FAT')",Providence,vio27.xml,15,2,1,FAT,174,61,MOT
1,0,1,13,2.014903021,13,0,are,"('MOT', 'FAT')",Providence,vio27.xml,15,2,1,FAT,174,61,MOT
3,5,3,79,1.969440646,84,5,there,"('CHI', 'MOT')",Providence,vio27.xml,90,6,3,MOT,607,944,CHI
2,0,2,11,1.871802177,11,0,it,"('MOT', 'FAT')",Providence,vio27.xml,15,4,2,FAT,174,61,MOT
0,4,1,85,1.802809305,89,4,no,"('CHI', 'MOT')",Providence,vio27.xml,90,1,0,MOT,607,944,CHI
1,2,4,59,1.791759469,61,2,can,"('MOT', 'CHI')",Providence,vio27.xml,66,5,1,CHI,566,323,MOT
0,2,3,85,1.780586169,87,2,my,"('CHI', 'MOT')",Providence,vio27.xml,90,3,0,MOT,607,944,CHI
1,5,2,82,1.780586169,87,5,wanna,"('CHI', 'MOT')",Providence,vio27.xml,90,3,1,MOT,607,944,CHI
0,1,1,32,1.763588592,33,1,of,"('FAT', 'MOT')",Providence,vio27.xml,34,1,0,MOT,147,325,FAT
0,1,1,32,1.763588592,33,1,what,"('FAT', 'MOT')",Providence,vio27.xml,34,1,0,MOT,147,325,FAT
0,1,1,32,1.763588592,33,1,can,"('FAT', 'MOT')",Providence,vio27.xml,34,1,0,MOT,147,325,FAT
1,2,1,30,1.734601055,32,2,she,"('FAT', 'MOT')",Providence,vio27.xml,34,2,1,MOT,147,325,FAT
0,3,2,85,1.727220948,88,3,go,"('CHI', 'MOT')",Providence,vio27.xml,90,2,0,MOT,607,944,CHI
0,3,2,85,1.727220948,88,3,get,"('CHI', 'MOT')",Providence,vio27.xml,90,2,0,MOT,607,944,CHI
0,3,2,85,1.727220948,88,3,have,"('CHI', 'MOT')",Providence,vio27.xml,90,2,0,MOT,607,944,CHI
0,1,4,61,1.673976434,62,1,we,"('MOT', 'CHI')",Providence,vio27.xml,66,4,0,CHI,566,323,MOT
0,1,4,61,1.673976434,62,1,what,"('MOT', 'CHI')",Providence,vio27.xml,66,4,0,CHI,566,323,MOT
1,1,0,13,1.673976434,14,1,they,"('MOT', 'FAT')",Providence,vio27.xml,15,1,1,FAT,174,61,MOT
0,5,1,84,1.620487749,89,5,want,"('CHI', 'MOT')",Providence,vio27.xml,90,1,0,MOT,607,944,CHI
0,5,1,84,1.620487749,89,5,for,"('CHI', 'MOT')",Providence,vio27.xml,90,1,0,MOT,607,944,CHI
6,6,4,50,1.575536361,56,6,the,"('MOT', 'CHI')",Providence,vio27.xml,66,10,6,CHI,566,323,MOT
1,7,2,80,1.492904096,87,7,a,"('CHI', 'MOT')",Providence,vio27.xml,90,3,1,MOT,607,944,CHI
1,7,2,80,1.492904096,87,7,on,"('CHI', 'MOT')",Providence,vio27.xml,90,3,1,MOT,607,944,CHI
0,2,3,61,1.466337069,63,2,no,"('MOT', 'CHI')",Providence,vio27.xml,66,3,0,CHI,566,323,MOT
1,0,3,11,1.466337069,11,0,you,"('MOT', 'FAT')",Providence,vio27.xml,15,4,1,FAT,174,61,MOT
0,1,2,31,1.446918983,32,1,oh,"('FAT', 'MOT')",Providence,vio27.xml,34,2,0,MOT,147,325,FAT
3,11,2,74,1.421385681,85,11,put,"('CHI', 'MOT')",Providence,vio27.xml,90,5,3,MOT,607,944,CHI
1,5,4,80,1.421385681,85,5,one,"('CHI', 'MOT')",Providence,vio27.xml,90,5,1,MOT,607,944,CHI
0,3,2,61,1.41706602,64,3,where,"('MOT', 'CHI')",Providence,vio27.xml,66,2,0,CHI,566,323,MOT
0,3,2,61,1.41706602,64,3,not,"('MOT', 'CHI')",Providence,vio27.xml,66,2,0,CHI,566,323,MOT
1,7,1,57,1.41706602,64,7,in,"('MOT', 'CHI')",Providence,vio27.xml,66,2,1,CHI,566,323,MOT
1,3,5,57,1.354545663,60,3,gonna,"('MOT', 'CHI')",Providence,vio27.xml,66,6,1,CHI,566,323,MOT
3,2,13,48,1.348554033,50,2,you,"('MOT', 'CHI')",Providence,vio27.xml,66,16,3,CHI,566,323,MOT
1,2,8,55,1.274177063,57,2,to,"('MOT', 'CHI')",Providence,vio27.xml,66,9,1,CHI,566,323,MOT
0,4,3,83,1.269760545,87,4,where,"('CHI', 'MOT')",Providence,vio27.xml,90,3,0,MOT,607,944,CHI
0,2,4,60,1.268511325,62,2,is,"('MOT', 'CHI')",Providence,vio27.xml,66,4,0,CHI,566,323,MOT
3,10,4,73,1.233825767,83,10,it,"('CHI', 'MOT')",Providence,vio27.xml,90,7,3,MOT,607,944,CHI
1,4,1,28,1.223775432,32,4,it,"('FAT', 'MOT')",Providence,vio27.xml,34,2,1,MOT,147,325,FAT
0,4,2,60,1.193922468,64,4,get,"('MOT', 'CHI')",Providence,vio27.xml,66,2,0,CHI,566,323,MOT
2,11,3,74,1.133703608,85,11,in,"('CHI', 'MOT')",Providence,vio27.xml,90,5,2,MOT,607,944,CHI
4,5,9,48,1.116961427,53,5,it,"('MOT', 'CHI')",Providence,vio27.xml,66,13,4,CHI,566,323,MOT
0,1,8,57,1.098612289,58,1,a,"('MOT', 'CHI')",Providence,vio27.xml,66,8,0,CHI,566,323,MOT
0,2,5,59,1.098612289,61,2,that,"('MOT', 'CHI')",Providence,vio27.xml,66,5,0,CHI,566,323,MOT
0,3,1,30,1.070441412,33,3,in,"('FAT', 'MOT')",Providence,vio27.xml,34,1,0,MOT,147,325,FAT
0,3,1,30,1.070441412,33,3,but,"('FAT', 'MOT')",Providence,vio27.xml,34,1,0,MOT,147,325,FAT
0,3,1,30,1.070441412,33,3,is,"('FAT', 'MOT')",Providence,vio27.xml,34,1,0,MOT,147,325,FAT
0,7,2,81,1.034073768,88,7,are,"('CHI', 'MOT')",Providence,vio27.xml,90,2,0,MOT,607,944,CHI
0,10,1,79,1.014351945,89,10,that,"('CHI', 'MOT')",Providence,vio27.xml,90,1,0,MOT,607,944,CHI
1,3,8,54,0.986494991,57,3,this,"('MOT', 'CHI')",Providence,vio27.xml,66,9,1,CHI,566,323,MOT
0,1,1,13,0.980829253,14,1,my,"('MOT', 'FAT')",Providence,vio27.xml,15,1,0,FAT,174,61,MOT
0,1,1,13,0.980829253,14,1,one,"('MOT', 'FAT')",Providence,vio27.xml,15,1,0,FAT,174,61,MOT
9,14,8,59,0.967584026,73,14,the,"('CHI', 'MOT')",Providence,vio27.xml,90,17,9,MOT,607,944,CHI
0,2,6,58,0.949080555,60,2,there,"('MOT', 'CHI')",Providence,vio27.xml,66,6,0,CHI,566,323,MOT
0,8,2,80,0.916290732,88,8,all,"('CHI', 'MOT')",Providence,vio27.xml,90,2,0,MOT,607,944,CHI
2,6,2,24,0.826678573,30,6,there,"('FAT', 'MOT')",Providence,vio27.xml,34,4,2,MOT,147,325,FAT
0,3,5,58,0.810930216,61,3,he,"('MOT', 'CHI')",Providence,vio27.xml,66,5,0,CHI,566,323,MOT
0,7,3,80,0.799756916,87,7,do,"('CHI', 'MOT')",Providence,vio27.xml,90,3,0,MOT,607,944,CHI
0,3,2,29,0.753771802,32,3,that,"('FAT', 'MOT')",Providence,vio27.xml,34,2,0,MOT,147,325,FAT
0,8,3,79,0.68197388,87,8,what,"('CHI', 'MOT')",Providence,vio27.xml,90,3,0,MOT,607,944,CHI
0,8,3,79,0.68197388,87,8,can,"('CHI', 'MOT')",Providence,vio27.xml,90,3,0,MOT,607,944,CHI
0,5,1,28,0.664976304,33,5,a,"('FAT', 'MOT')",Providence,vio27.xml,34,1,0,MOT,147,325,FAT
0,7,4,79,0.606135804,86,7,to,"('CHI', 'MOT')",Providence,vio27.xml,90,4,0,MOT,607,944,CHI
0,6,1,27,0.510825624,33,6,the,"('FAT', 'MOT')",Providence,vio27.xml,34,1,0,MOT,147,325,FAT
0,4,9,77,0.411507423,81,4,this,"('CHI', 'MOT')",Providence,vio27.xml,90,9,0,MOT,607,944,CHI
2,13,5,46,0.373204246,59,13,yeah,"('MOT', 'CHI')",Providence,vio27.xml,66,7,2,CHI,566,323,MOT
0,1,3,11,0.336472237,12,1,is,"('MOT', 'FAT')",Providence,vio27.xml,15,3,0,FAT,174,61,MOT
0,8,5,77,0.322773392,85,8,and,"('CHI', 'MOT')",Providence,vio27.xml,90,5,0,MOT,607,944,CHI
0,7,6,77,0.295464213,84,7,is,"('CHI', 'MOT')",Providence,vio27.xml,90,6,0,MOT,607,944,CHI
0,1,2,7,0.223143551,8,1,you,"('CHI', 'FAT')",Providence,vio27.xml,10,2,0,FAT,93,26,CHI
1,27,3,59,0.046520016,86,27,you,"('CHI', 'MOT')",Providence,vio27.xml,90,4,1,MOT,607,944,CHI
0,5,4,25,-0.117783036,30,5,yeah,"('FAT', 'MOT')",Providence,vio27.xml,34,4,0,MOT,147,325,FAT
0,2,4,9,-0.3254224,11,2,yeah,"('MOT', 'FAT')",Providence,vio27.xml,15,4,0,FAT,174,61,MOT
0,9,26,55,-1.445134861,64,9,yeah,"('CHI', 'MOT')",Providence,vio27.xml,90,26,0,MOT,607,944,CHI
1,0,0,251,5.127924381,251,0,was,"('CHI', 'MOT')",Providence,vio28.xml,252,1,1,MOT,1206,2682,CHI
1,3,0,248,3.741630019,251,3,get,"('CHI', 'MOT')",Providence,vio28.xml,252,1,1,MOT,1206,2682,CHI
0,1,1,250,3.741630019,251,1,some,"('CHI', 'MOT')",Providence,vio28.xml,252,1,0,MOT,1206,2682,CHI
0,2,1,249,3.336164911,251,2,my,"('CHI', 'MOT')",Providence,vio28.xml,252,1,0,MOT,1206,2682,CHI
1,3,2,246,3.222867846,249,3,put,"('CHI', 'MOT')",Providence,vio28.xml,252,3,1,MOT,1206,2682,CHI
3,6,3,240,2.874371417,246,6,for,"('CHI', 'MOT')",Providence,vio28.xml,252,6,3,MOT,1206,2682,CHI
0,4,1,247,2.825339288,251,4,did,"('CHI', 'MOT')",Providence,vio28.xml,252,1,0,MOT,1206,2682,CHI
2,10,1,239,2.616732043,249,10,gonna,"('CHI', 'MOT')",Providence,vio28.xml,252,3,2,MOT,1206,2682,CHI
1,0,1,24,2.564949357,24,0,like,"('TOY', 'MOT')",Providence,vio28.xml,26,2,1,MOT,206,139,TOY
1,0,1,24,2.564949357,24,0,a,"('TOY', 'MOT')",Providence,vio28.xml,26,2,1,MOT,206,139,TOY
1,1,0,24,2.197224577,25,1,that,"('TOY', 'MOT')",Providence,vio28.xml,26,1,1,MOT,206,139,TOY
0,9,1,242,2.132192107,251,9,have,"('CHI', 'MOT')",Providence,vio28.xml,252,1,0,MOT,1206,2682,CHI
2,9,5,236,2.108190955,245,9,there,"('CHI', 'MOT')",Providence,vio28.xml,252,7,2,MOT,1206,2682,CHI
1,1,1,23,1.871802177,24,1,in,"('TOY', 'MOT')",Providence,vio28.xml,26,2,1,MOT,206,139,TOY
0,12,1,239,1.869827843,251,12,we,"('CHI', 'MOT')",Providence,vio28.xml,252,1,0,MOT,1206,2682,CHI
1,2,0,23,1.791759469,25,2,go,"('TOY', 'MOT')",Providence,vio28.xml,26,1,1,MOT,206,139,TOY
1,21,1,229,1.745239454,250,21,to,"('CHI', 'MOT')",Providence,vio28.xml,252,2,1,MOT,1206,2682,CHI
1,1,1,16,1.558144618,17,1,you,"('MOT', 'TOY')",Providence,vio28.xml,19,2,1,TOY,147,94,MOT
2,22,3,225,1.53466082,247,22,in,"('CHI', 'MOT')",Providence,vio28.xml,252,5,2,MOT,1206,2682,CHI
0,8,4,240,1.532476871,248,8,no,"('CHI', 'MOT')",Providence,vio28.xml,252,4,0,MOT,1206,2682,CHI
1,21,2,228,1.518119754,249,21,are,"('CHI', 'MOT')",Providence,vio28.xml,252,3,1,MOT,1206,2682,CHI
0,1,1,24,1.504077397,25,1,my,"('TOY', 'MOT')",Providence,vio28.xml,26,1,0,MOT,206,139,TOY
0,1,1,24,1.504077397,25,1,on,"('TOY', 'MOT')",Providence,vio28.xml,26,1,0,MOT,206,139,TOY
0,18,1,233,1.490338221,251,18,go,"('CHI', 'MOT')",Providence,vio28.xml,252,1,0,MOT,1206,2682,CHI
3,26,4,219,1.402621254,245,26,do,"('CHI', 'MOT')",Providence,vio28.xml,252,7,3,MOT,1206,2682,CHI
1,0,0,4,1.386294361,4,0,do,"('BRO', 'MOT')",Providence,vio28.xml,5,1,1,MOT,22,48,BRO
0,13,3,236,1.276957697,249,13,make,"('CHI', 'MOT')",Providence,vio28.xml,252,3,0,MOT,1206,2682,CHI
0,1,1,17,1.203972804,18,1,we,"('MOT', 'TOY')",Providence,vio28.xml,19,1,0,TOY,147,94,MOT
0,1,2,23,1.178654996,24,1,you,"('TOY', 'MOT')",Providence,vio28.xml,26,2,0,MOT,206,139,TOY
0,10,5,237,1.173647475,247,10,he,"('CHI', 'MOT')",Providence,vio28.xml,252,5,0,MOT,1206,2682,CHI
2,33,3,214,1.143794511,247,33,what,"('CHI', 'MOT')",Providence,vio28.xml,252,5,2,MOT,1206,2682,CHI
2,14,12,224,1.098612289,238,14,one,"('CHI', 'MOT')",Providence,vio28.xml,252,14,2,MOT,1206,2682,CHI
1,2,0,9,1.060871961,11,2,go,"('FAT', 'MOT')",Providence,vio28.xml,12,1,1,MOT,95,78,FAT
0,10,7,235,0.914268486,245,10,wanna,"('CHI', 'MOT')",Providence,vio28.xml,252,7,0,MOT,1206,2682,CHI
0,20,3,229,0.871492589,249,20,on,"('CHI', 'MOT')",Providence,vio28.xml,252,3,0,MOT,1206,2682,CHI
13,44,15,180,0.851732457,224,44,the,"('CHI', 'MOT')",Providence,vio28.xml,252,28,13,MOT,1206,2682,CHI
0,2,1,16,0.798507696,18,2,a,"('MOT', 'TOY')",Providence,vio28.xml,19,1,0,TOY,147,94,MOT
0,2,1,16,0.798507696,18,2,my,"('MOT', 'TOY')",Providence,vio28.xml,19,1,0,TOY,147,94,MOT
0,1,1,10,0.773189888,11,1,a,"('FAT', 'MOT')",Providence,vio28.xml,12,1,0,MOT,95,78,FAT
0,1,1,10,0.773189888,11,1,see,"('FAT', 'MOT')",Providence,vio28.xml,12,1,0,MOT,95,78,FAT
0,1,1,10,0.773189888,11,1,wanna,"('FAT', 'MOT')",Providence,vio28.xml,12,1,0,MOT,95,78,FAT
0,2,2,22,0.773189888,24,2,it,"('TOY', 'MOT')",Providence,vio28.xml,26,2,0,MOT,206,139,TOY
0,2,2,22,0.773189888,24,2,to,"('TOY', 'MOT')",Providence,vio28.xml,26,2,0,MOT,206,139,TOY
4,53,5,190,0.723816804,243,53,you,"('CHI', 'MOT')",Providence,vio28.xml,252,9,4,MOT,1206,2682,CHI
12,42,19,179,0.714413452,221,42,a,"('CHI', 'MOT')",Providence,vio28.xml,252,31,12,MOT,1206,2682,CHI
0,1,4,21,0.693147181,22,1,with,"('TOY', 'MOT')",Providence,vio28.xml,26,4,0,MOT,206,139,TOY
0,20,4,228,0.685179011,248,20,like,"('CHI', 'MOT')",Providence,vio28.xml,252,4,0,MOT,1206,2682,CHI
3,24,15,210,0.635518068,234,24,and,"('CHI', 'MOT')",Providence,vio28.xml,252,18,3,MOT,1206,2682,CHI
2,27,10,213,0.616288175,240,27,that,"('CHI', 'MOT')",Providence,vio28.xml,252,12,2,MOT,1206,2682,CHI
0,1,3,15,0.587786665,16,1,that,"('MOT', 'TOY')",Providence,vio28.xml,19,3,0,TOY,147,94,MOT
0,1,3,15,0.587786665,16,1,to,"('MOT', 'TOY')",Providence,vio28.xml,19,3,0,TOY,147,94,MOT
1,27,7,217,0.563689113,244,27,it,"('CHI', 'MOT')",Providence,vio28.xml,252,8,1,MOT,1206,2682,CHI
0,2,2,15,0.459532329,17,2,go,"('MOT', 'TOY')",Providence,vio28.xml,19,2,0,TOY,147,94,MOT
0,2,1,9,0.36772478,11,2,one,"('FAT', 'MOT')",Providence,vio28.xml,12,1,0,MOT,95,78,FAT
2,36,10,204,0.337574773,240,36,is,"('CHI', 'MOT')",Providence,vio28.xml,252,12,2,MOT,1206,2682,CHI
2,30,13,207,0.307875292,237,30,this,"('CHI', 'MOT')",Providence,vio28.xml,252,15,2,MOT,1206,2682,CHI
1,2,7,16,0.287682072,18,2,the,"('TOY', 'MOT')",Providence,vio28.xml,26,8,1,MOT,206,139,TOY
0,1,1,5,0.287682072,6,1,in,"('FAT', 'TOY')",Providence,vio28.xml,7,1,0,TOY,21,55,FAT
0,1,1,5,0.287682072,6,1,the,"('FAT', 'TOY')",Providence,vio28.xml,7,1,0,TOY,21,55,FAT
0,2,3,14,0.182321557,16,2,the,"('MOT', 'TOY')",Providence,vio28.xml,19,3,0,TOY,147,94,MOT
8,17,73,154,0.041303806,171,17,yeah,"('CHI', 'MOT')",Providence,vio28.xml,252,81,8,MOT,1206,2682,CHI
0,1,1,3,0,4,1,it,"('BRO', 'MOT')",Providence,vio28.xml,5,1,0,MOT,22,48,BRO
0,1,1,3,0,4,1,this,"('BRO', 'MOT')",Providence,vio28.xml,5,1,0,MOT,22,48,BRO
0,1,1,3,0,4,1,the,"('BRO', 'MOT')",Providence,vio28.xml,5,1,0,MOT,22,48,BRO
0,2,4,13,-0.057158414,15,2,one,"('MOT', 'TOY')",Providence,vio28.xml,19,4,0,TOY,147,94,MOT
0,7,2,17,-0.207639365,24,7,this,"('TOY', 'MOT')",Providence,vio28.xml,26,2,0,MOT,206,139,TOY
0,2,4,6,-0.587786665,8,2,you,"('FAT', 'MOT')",Providence,vio28.xml,12,4,0,MOT,95,78,FAT
0,2,2,1,-0.875468737,3,2,you,"('BRO', 'MOT')",Providence,vio28.xml,5,2,0,MOT,22,48,BRO
2,0,4,134,3.931825633,134,0,put,"('MOT', 'CHI')",Providence,vio31.xml,140,6,2,CHI,1796,713,MOT
1,1,0,138,3.850147602,139,1,get,"('MOT', 'CHI')",Providence,vio31.xml,140,1,1,CHI,1796,713,MOT
1,0,5,134,3.526360525,134,0,gonna,"('MOT', 'CHI')",Providence,vio31.xml,140,6,1,CHI,1796,713,MOT
0,2,1,260,3.378724526,262,2,up,"('CHI', 'MOT')",Providence,vio31.xml,263,1,0,MOT,1370,2933,CHI
1,1,2,136,3.325036021,137,1,are,"('MOT', 'CHI')",Providence,vio31.xml,140,3,1,CHI,1796,713,MOT
0,3,1,259,3.091042453,262,3,did,"('CHI', 'MOT')",Providence,vio31.xml,263,1,0,MOT,1370,2933,CHI
0,3,1,259,3.091042453,262,3,some,"('CHI', 'MOT')",Providence,vio31.xml,263,1,0,MOT,1370,2933,CHI
0,1,4,258,3.079613758,259,1,get,"('CHI', 'MOT')",Providence,vio31.xml,263,4,0,MOT,1370,2933,CHI
1,0,10,129,3.003395146,129,0,with,"('MOT', 'CHI')",Providence,vio31.xml,140,11,1,CHI,1796,713,MOT
1,6,1,255,2.933096703,261,6,with,"('CHI', 'MOT')",Providence,vio31.xml,263,2,1,MOT,1370,2933,CHI
1,6,1,255,2.933096703,261,6,of,"('CHI', 'MOT')",Providence,vio31.xml,263,2,1,MOT,1370,2933,CHI
0,3,2,258,2.79956531,261,3,big,"('CHI', 'MOT')",Providence,vio31.xml,263,2,0,MOT,1370,2933,CHI
0,1,3,136,2.63188884,137,1,have,"('MOT', 'CHI')",Providence,vio31.xml,140,3,0,CHI,1796,713,MOT
0,1,3,136,2.63188884,137,1,but,"('MOT', 'CHI')",Providence,vio31.xml,140,3,0,CHI,1796,713,MOT
0,1,5,134,2.280923596,135,1,want,"('MOT', 'CHI')",Providence,vio31.xml,140,5,0,CHI,1796,713,MOT
0,8,1,254,2.280112237,262,8,at,"('CHI', 'MOT')",Providence,vio31.xml,263,1,0,MOT,1370,2933,CHI
2,2,10,126,2.228477121,128,2,like,"('MOT', 'CHI')",Providence,vio31.xml,140,12,2,CHI,1796,713,MOT
1,18,0,244,2.226045016,262,18,oh,"('CHI', 'MOT')",Providence,vio31.xml,263,1,1,MOT,1370,2933,CHI
3,4,7,126,2.174751721,130,4,there,"('MOT', 'CHI')",Providence,vio31.xml,140,10,3,CHI,1796,713,MOT
1,1,0,23,2.159484249,24,1,look,"('MOT', 'BRO')",Providence,vio31.xml,25,1,1,BRO,240,120,MOT
1,6,6,250,2.102972039,256,6,put,"('CHI', 'MOT')",Providence,vio31.xml,263,7,1,MOT,1370,2933,CHI
0,10,1,252,2.079441542,262,10,want,"('CHI', 'MOT')",Providence,vio31.xml,263,1,0,MOT,1370,2933,CHI
0,10,1,252,2.079441542,262,10,look,"('CHI', 'MOT')",Providence,vio31.xml,263,1,0,MOT,1370,2933,CHI
1,10,3,249,2.068012846,259,10,there,"('CHI', 'MOT')",Providence,vio31.xml,263,4,1,MOT,1370,2933,CHI
0,2,4,134,2.036881927,136,2,up,"('MOT', 'CHI')",Providence,vio31.xml,140,4,0,CHI,1796,713,MOT
0,1,7,132,2.014903021,133,1,of,"('MOT', 'CHI')",Providence,vio31.xml,140,7,0,CHI,1796,713,MOT
4,9,11,239,1.995100393,248,9,no,"('CHI', 'MOT')",Providence,vio31.xml,263,15,4,MOT,1370,2933,CHI
0,5,4,254,1.981001469,259,5,they,"('CHI', 'MOT')",Providence,vio31.xml,263,4,0,MOT,1370,2933,CHI
4,5,9,122,1.969440646,127,5,in,"('MOT', 'CHI')",Providence,vio31.xml,140,13,4,CHI,1796,713,MOT
2,13,4,244,1.936941479,257,13,go,"('CHI', 'MOT')",Providence,vio31.xml,263,6,2,MOT,1370,2933,CHI
1,2,10,127,1.904782858,129,2,to,"('MOT', 'CHI')",Providence,vio31.xml,140,11,1,CHI,1796,713,MOT
0,1,8,131,1.902107526,132,1,make,"('MOT', 'CHI')",Providence,vio31.xml,140,8,0,CHI,1796,713,MOT
3,12,8,240,1.793729913,252,12,on,"('CHI', 'MOT')",Providence,vio31.xml,263,11,3,MOT,1370,2933,CHI
1,11,1,127,1.763588592,138,11,no,"('MOT', 'CHI')",Providence,vio31.xml,140,2,1,CHI,1796,713,MOT
0,1,10,129,1.704748092,130,1,see,"('MOT', 'CHI')",Providence,vio31.xml,140,10,0,CHI,1796,713,MOT
1,11,5,246,1.685627051,257,11,like,"('CHI', 'MOT')",Providence,vio31.xml,263,6,1,MOT,1370,2933,CHI
0,9,3,251,1.656321498,260,9,are,"('CHI', 'MOT')",Providence,vio31.xml,263,3,0,MOT,1370,2933,CHI
1,19,2,241,1.656321498,260,19,have,"('CHI', 'MOT')",Providence,vio31.xml,263,3,1,MOT,1370,2933,CHI
0,2,7,131,1.609437912,133,2,where,"('MOT', 'CHI')",Providence,vio31.xml,140,7,0,CHI,1796,713,MOT
0,8,4,251,1.575536361,259,8,my,"('CHI', 'MOT')",Providence,vio31.xml,263,4,0,MOT,1370,2933,CHI
0,1,1,26,1.575536361,27,1,with,"('BRO', 'MOT')",Providence,vio31.xml,28,1,0,MOT,187,224,BRO
0,1,1,26,1.575536361,27,1,of,"('BRO', 'MOT')",Providence,vio31.xml,28,1,0,MOT,187,224,BRO
0,1,1,26,1.575536361,27,1,this,"('BRO', 'MOT')",Providence,vio31.xml,28,1,0,MOT,187,224,BRO
0,1,1,26,1.575536361,27,1,is,"('BRO', 'MOT')",Providence,vio31.xml,28,1,0,MOT,187,224,BRO
0,1,1,26,1.575536361,27,1,not,"('BRO', 'MOT')",Providence,vio31.xml,28,1,0,MOT,187,224,BRO
1,0,0,5,1.540445041,5,0,what,"('BRO', 'CHI')",Providence,vio31.xml,6,1,1,CHI,16,37,BRO
4,5,17,114,1.477974773,119,5,on,"('MOT', 'CHI')",Providence,vio31.xml,140,21,4,CHI,1796,713,MOT
0,1,1,23,1.466337069,24,1,in,"('MOT', 'BRO')",Providence,vio31.xml,25,1,0,BRO,240,120,MOT
0,1,1,23,1.466337069,24,1,see,"('MOT', 'BRO')",Providence,vio31.xml,25,1,0,BRO,240,120,MOT
10,8,20,102,1.453433664,110,8,one,"('MOT', 'CHI')",Providence,vio31.xml,140,30,10,CHI,1796,713,MOT
0,20,1,242,1.432814377,262,20,to,"('CHI', 'MOT')",Providence,vio31.xml,263,1,0,MOT,1370,2933,CHI
0,6,7,250,1.409824859,256,6,make,"('CHI', 'MOT')",Providence,vio31.xml,263,7,0,MOT,1370,2933,CHI
0,21,1,241,1.386294361,262,21,we,"('CHI', 'MOT')",Providence,vio31.xml,263,1,0,MOT,1370,2933,CHI
2,14,9,238,1.362946997,252,14,wanna,"('CHI', 'MOT')",Providence,vio31.xml,263,11,2,MOT,1370,2933,CHI
0,3,7,130,1.32175584,133,3,wanna,"('MOT', 'CHI')",Providence,vio31.xml,140,7,0,CHI,1796,713,MOT
0,1,2,25,1.252762968,26,1,no,"('BRO', 'MOT')",Providence,vio31.xml,28,2,0,MOT,187,224,BRO
1,3,1,23,1.252762968,26,3,yeah,"('BRO', 'MOT')",Providence,vio31.xml,28,2,1,MOT,187,224,BRO
8,31,11,213,1.192297773,244,31,it,"('CHI', 'MOT')",Providence,vio31.xml,263,19,8,MOT,1370,2933,CHI
0,2,1,25,1.170071253,27,2,that,"('BRO', 'MOT')",Providence,vio31.xml,28,1,0,MOT,187,224,BRO
1,28,3,231,1.098612289,259,28,see,"('CHI', 'MOT')",Providence,vio31.xml,263,4,1,MOT,1370,2933,CHI
0,2,13,125,1.053149915,127,2,we,"('MOT', 'CHI')",Providence,vio31.xml,140,13,0,CHI,1796,713,MOT
0,11,6,246,0.99247987,257,11,gonna,"('CHI', 'MOT')",Providence,vio31.xml,263,6,0,MOT,1370,2933,CHI
0,3,11,126,0.923953605,129,3,what,"('MOT', 'CHI')",Providence,vio31.xml,140,11,0,CHI,1796,713,MOT
1,1,1,7,0.916290732,8,1,what,"('CHI', 'BRO')",Providence,vio31.xml,10,2,1,BRO,36,71,CHI
1,5,14,120,0.912361454,125,5,go,"('MOT', 'CHI')",Providence,vio31.xml,140,15,1,CHI,1796,713,MOT
1,26,5,231,0.874696835,257,26,do,"('CHI', 'MOT')",Providence,vio31.xml,263,6,1,MOT,1370,2933,CHI
0,13,6,244,0.83832919,257,13,can,"('CHI', 'MOT')",Providence,vio31.xml,263,6,0,MOT,1370,2933,CHI
1,27,5,230,0.83832919,257,27,he,"('CHI', 'MOT')",Providence,vio31.xml,263,6,1,MOT,1370,2933,CHI
1,38,3,221,0.802346473,259,38,that,"('CHI', 'MOT')",Providence,vio31.xml,263,4,1,MOT,1370,2933,CHI
0,3,1,21,0.773189888,24,3,but,"('MOT', 'BRO')",Providence,vio31.xml,25,1,0,BRO,240,120,MOT
3,3,41,93,0.756326082,96,3,you,"('MOT', 'CHI')",Providence,vio31.xml,140,44,3,CHI,1796,713,MOT
3,8,20,109,0.749317452,117,8,it,"('MOT', 'CHI')",Providence,vio31.xml,140,23,3,CHI,1796,713,MOT
0,2,2,21,0.733969175,23,2,can,"('MOT', 'BRO')",Providence,vio31.xml,25,2,0,BRO,240,120,MOT
0,2,2,21,0.733969175,23,2,to,"('MOT', 'BRO')",Providence,vio31.xml,25,2,0,BRO,240,120,MOT
2,26,10,225,0.697107582,251,26,and,"('CHI', 'MOT')",Providence,vio31.xml,263,12,2,MOT,1370,2933,CHI
1,0,0,1,0.693147181,1,0,that,"('BRO', 'NON')",Providence,vio31.xml,2,1,1,NON,16,20,BRO
0,1,4,20,0.650587566,21,1,you,"('MOT', 'BRO')",Providence,vio31.xml,25,4,0,BRO,240,120,MOT
2,4,3,16,0.634306681,20,4,yeah,"('MOT', 'BRO')",Providence,vio31.xml,25,5,2,BRO,240,120,MOT
1,17,12,233,0.624154309,250,17,in,"('CHI', 'MOT')",Providence,vio31.xml,263,13,1,MOT,1370,2933,CHI
0,1,1,8,0.606135804,9,1,in,"('CHI', 'BRO')",Providence,vio31.xml,10,1,0,BRO,36,71,CHI
0,1,1,8,0.606135804,9,1,it,"('CHI', 'BRO')",Providence,vio31.xml,10,1,0,BRO,36,71,CHI
0,2,3,23,0.587786665,25,2,what,"('BRO', 'MOT')",Providence,vio31.xml,28,3,0,MOT,187,224,BRO
4,26,19,214,0.583662948,240,26,one,"('CHI', 'MOT')",Providence,vio31.xml,263,23,4,MOT,1370,2933,CHI
10,13,32,85,0.579818495,98,13,the,"('MOT', 'CHI')",Providence,vio31.xml,140,42,10,CHI,1796,713,MOT
2,5,28,105,0.559615788,110,5,a,"('MOT', 'CHI')",Providence,vio31.xml,140,30,2,CHI,1796,713,MOT
3,54,6,200,0.526243348,254,54,you,"('CHI', 'MOT')",Providence,vio31.xml,263,9,3,MOT,1370,2933,CHI
1,8,14,117,0.506896346,125,8,and,"('MOT', 'CHI')",Providence,vio31.xml,140,15,1,CHI,1796,713,MOT
0,1,5,19,0.451985124,20,1,he,"('MOT', 'BRO')",Providence,vio31.xml,25,5,0,BRO,240,120,MOT
5,34,20,204,0.421213465,238,34,is,"('CHI', 'MOT')",Providence,vio31.xml,263,25,5,MOT,1370,2933,CHI
1,0,1,1,0.405465108,1,0,of,"('NON', 'MOT')",Providence,vio31.xml,3,2,1,MOT,44,21,NON
8,45,22,188,0.362432792,233,45,a,"('CHI', 'MOT')",Providence,vio31.xml,263,30,8,MOT,1370,2933,CHI
0,6,1,21,0.322773392,27,6,you,"('BRO', 'MOT')",Providence,vio31.xml,28,1,0,MOT,187,224,BRO
0,3,3,22,0.300104592,25,3,the,"('BRO', 'MOT')",Providence,vio31.xml,28,3,0,MOT,187,224,BRO
9,47,25,182,0.290282854,229,47,the,"('CHI', 'MOT')",Providence,vio31.xml,263,34,9,MOT,1370,2933,CHI
0,21,7,235,0.264692554,256,21,what,"('CHI', 'MOT')",Providence,vio31.xml,263,7,0,MOT,1370,2933,CHI
0,2,4,19,0.245122458,21,2,like,"('MOT', 'BRO')",Providence,vio31.xml,25,4,0,BRO,240,120,MOT
0,2,4,19,0.245122458,21,2,the,"('MOT', 'BRO')",Providence,vio31.xml,25,4,0,BRO,240,120,MOT
0,3,22,115,0.223143551,118,3,do,"('MOT', 'CHI')",Providence,vio31.xml,140,22,0,CHI,1796,713,MOT
0,2,1,7,0.200670695,9,2,you,"('CHI', 'BRO')",Providence,vio31.xml,10,1,0,BRO,36,71,CHI
0,2,1,7,0.200670695,9,2,the,"('CHI', 'BRO')",Providence,vio31.xml,10,1,0,BRO,36,71,CHI
6,28,37,192,0.174629211,220,28,this,"('CHI', 'MOT')",Providence,vio31.xml,263,43,6,MOT,1370,2933,CHI
0,4,21,115,0.050858417,119,4,that,"('MOT', 'CHI')",Providence,vio31.xml,140,21,0,CHI,1796,713,MOT
2,24,16,98,-0.295714244,122,24,yeah,"('MOT', 'CHI')",Providence,vio31.xml,140,18,2,CHI,1796,713,MOT
0,14,14,112,-0.628608659,126,14,is,"('MOT', 'CHI')",Providence,vio31.xml,140,14,0,CHI,1796,713,MOT
4,30,58,171,-0.670226396,201,30,yeah,"('CHI', 'MOT')",Providence,vio31.xml,263,62,4,MOT,1370,2933,CHI
0,27,25,88,-1.865867441,115,27,this,"('MOT', 'CHI')",Providence,vio31.xml,140,25,0,CHI,1796,713,MOT
1,0,6,309,4.235715515,309,0,want,"('CHI', 'MOT')",Providence,vio32.xml,316,7,1,MOT,1583,4647,CHI
0,1,1,314,3.967142305,315,1,she,"('CHI', 'MOT')",Providence,vio32.xml,316,1,0,MOT,1583,4647,CHI
0,2,1,313,3.561677197,315,2,make,"('CHI', 'MOT')",Providence,vio32.xml,316,1,0,MOT,1583,4647,CHI
1,6,2,307,2.890371758,313,6,little,"('CHI', 'MOT')",Providence,vio32.xml,316,3,1,MOT,1583,4647,CHI
3,5,9,299,2.679062664,304,5,no,"('CHI', 'MOT')",Providence,vio32.xml,316,12,3,MOT,1583,4647,CHI
0,5,2,309,2.577688383,314,5,big,"('CHI', 'MOT')",Providence,vio32.xml,316,2,0,MOT,1583,4647,CHI
0,8,1,307,2.463064908,315,8,but,"('CHI', 'MOT')",Providence,vio32.xml,316,1,0,MOT,1583,4647,CHI
1,13,1,301,2.423537703,314,13,with,"('CHI', 'MOT')",Providence,vio32.xml,316,2,1,MOT,1583,4647,CHI
0,7,2,307,2.290006311,314,7,put,"('CHI', 'MOT')",Providence,vio32.xml,316,2,0,MOT,1583,4647,CHI
0,11,1,304,2.175382835,315,11,for,"('CHI', 'MOT')",Providence,vio32.xml,316,1,0,MOT,1583,4647,CHI
0,11,1,304,2.175382835,315,11,wanna,"('CHI', 'MOT')",Providence,vio32.xml,316,1,0,MOT,1583,4647,CHI
1,12,3,300,2.08583134,312,12,we,"('CHI', 'MOT')",Providence,vio32.xml,316,4,1,MOT,1583,4647,CHI
1,15,2,298,2.063693185,313,15,where,"('CHI', 'MOT')",Providence,vio32.xml,316,3,1,MOT,1583,4647,CHI
1,1,0,16,1.84582669,17,1,it,"('MOT', 'CHI')",Providence,vio32.xml,18,1,1,CHI,126,77,MOT
1,19,2,294,1.840549633,313,19,they,"('CHI', 'MOT')",Providence,vio32.xml,316,3,1,MOT,1583,4647,CHI
0,12,2,302,1.804498495,314,12,look,"('CHI', 'MOT')",Providence,vio32.xml,316,2,0,MOT,1583,4647,CHI
2,0,0,6,1.791759469,6,0,a,"('MOT', 'BRO')",Providence,vio32.xml,8,2,2,BRO,71,22,MOT
3,19,6,288,1.726008092,307,19,he,"('CHI', 'MOT')",Providence,vio32.xml,316,9,3,MOT,1583,4647,CHI
2,2,0,18,1.704748092,20,2,a,"('FAT', 'MOT')",Providence,vio32.xml,22,2,2,MOT,85,297,FAT
1,0,1,9,1.704748092,9,0,that,"('MOT', 'FAT')",Providence,vio32.xml,11,2,1,FAT,165,78,MOT
2,16,6,292,1.699386149,308,16,there,"('CHI', 'MOT')",Providence,vio32.xml,316,8,2,MOT,1583,4647,CHI
0,19,1,296,1.664557212,315,19,did,"('CHI', 'MOT')",Providence,vio32.xml,316,1,0,MOT,1583,4647,CHI
0,11,3,302,1.658228077,313,11,my,"('CHI', 'MOT')",Providence,vio32.xml,316,3,0,MOT,1583,4647,CHI
0,12,3,301,1.578185369,313,12,can,"('CHI', 'MOT')",Providence,vio32.xml,316,3,0,MOT,1583,4647,CHI
0,13,3,300,1.504077397,313,13,up,"('CHI', 'MOT')",Providence,vio32.xml,316,3,0,MOT,1583,4647,CHI
0,7,7,302,1.463126793,309,7,go,"('CHI', 'MOT')",Providence,vio32.xml,316,7,0,MOT,1583,4647,CHI
0,10,5,301,1.402397769,311,10,oh,"('CHI', 'MOT')",Providence,vio32.xml,316,5,0,MOT,1583,4647,CHI
1,0,2,8,1.386294361,8,0,think,"('MOT', 'FAT')",Providence,vio32.xml,11,3,1,FAT,165,78,MOT
1,3,0,18,1.343734747,21,3,that,"('BRO', 'MOT')",Providence,vio32.xml,22,1,1,MOT,93,222,BRO
0,1,1,20,1.343734747,21,1,yeah,"('BRO', 'MOT')",Providence,vio32.xml,22,1,0,MOT,93,222,BRO
0,1,1,20,1.343734747,21,1,you,"('FAT', 'MOT')",Providence,vio32.xml,22,1,0,MOT,85,297,FAT
0,1,1,20,1.343734747,21,1,yeah,"('FAT', 'MOT')",Providence,vio32.xml,22,1,0,MOT,85,297,FAT
0,1,1,20,1.343734747,21,1,not,"('FAT', 'MOT')",Providence,vio32.xml,22,1,0,MOT,85,297,FAT
1,27,4,284,1.161235712,311,27,see,"('CHI', 'MOT')",Providence,vio32.xml,316,5,1,MOT,1583,4647,CHI
0,1,1,16,1.15267951,17,1,is,"('MOT', 'CHI')",Providence,vio32.xml,18,1,0,CHI,126,77,MOT
1,1,0,6,1.098612289,7,1,this,"('BRO', 'CHI')",Providence,vio32.xml,8,1,1,CHI,31,44,BRO
1,1,0,6,1.098612289,7,1,this,"('MOT', 'BRO')",Providence,vio32.xml,8,1,1,BRO,71,22,MOT
2,26,8,280,1.047968556,306,26,like,"('CHI', 'MOT')",Providence,vio32.xml,316,10,2,MOT,1583,4647,CHI
0,1,1,14,1.041453875,15,1,what,"('FAT', 'CHI')",Providence,vio32.xml,16,1,0,CHI,90,70,FAT
0,1,1,14,1.041453875,15,1,all,"('FAT', 'CHI')",Providence,vio32.xml,16,1,0,CHI,90,70,FAT
0,1,1,14,1.041453875,15,1,on,"('FAT', 'CHI')",Providence,vio32.xml,16,1,0,CHI,90,70,FAT
0,1,2,19,1.011600912,20,1,like,"('BRO', 'MOT')",Providence,vio32.xml,22,2,0,MOT,93,222,BRO
0,1,2,19,1.011600912,20,1,look,"('BRO', 'MOT')",Providence,vio32.xml,22,2,0,MOT,93,222,BRO
0,2,1,19,0.938269639,21,2,oh,"('BRO', 'MOT')",Providence,vio32.xml,22,1,0,MOT,93,222,BRO
0,2,1,19,0.938269639,21,2,at,"('BRO', 'MOT')",Providence,vio32.xml,22,1,0,MOT,93,222,BRO
0,2,1,19,0.938269639,21,2,one,"('BRO', 'MOT')",Providence,vio32.xml,22,1,0,MOT,93,222,BRO
0,2,1,19,0.938269639,21,2,there,"('FAT', 'MOT')",Providence,vio32.xml,22,1,0,MOT,85,297,FAT
0,2,1,19,0.938269639,21,2,this,"('FAT', 'MOT')",Providence,vio32.xml,22,1,0,MOT,85,297,FAT
0,2,1,19,0.938269639,21,2,on,"('FAT', 'MOT')",Providence,vio32.xml,22,1,0,MOT,85,297,FAT
9,71,7,229,0.845974233,300,71,you,"('CHI', 'MOT')",Providence,vio32.xml,316,16,9,MOT,1583,4647,CHI
0,1,2,15,0.810930216,16,1,a,"('MOT', 'CHI')",Providence,vio32.xml,18,2,0,CHI,126,77,MOT
0,1,2,15,0.810930216,16,1,the,"('MOT', 'CHI')",Providence,vio32.xml,18,2,0,CHI,126,77,MOT
0,1,2,15,0.810930216,16,1,to,"('MOT', 'CHI')",Providence,vio32.xml,18,2,0,CHI,126,77,MOT
0,1,3,18,0.741937345,19,1,in,"('FAT', 'MOT')",Providence,vio32.xml,22,3,0,MOT,85,297,FAT
0,1,1,9,0.693147181,10,1,like,"('MOT', 'FAT')",Providence,vio32.xml,11,1,0,FAT,165,78,MOT
0,19,6,291,0.667829373,310,19,of,"('CHI', 'MOT')",Providence,vio32.xml,316,6,0,MOT,1583,4647,CHI
0,3,1,18,0.650587566,21,3,do,"('FAT', 'MOT')",Providence,vio32.xml,22,1,0,MOT,85,297,FAT
0,2,1,13,0.635988767,15,2,where,"('FAT', 'CHI')",Providence,vio32.xml,16,1,0,CHI,90,70,FAT
0,2,1,13,0.635988767,15,2,are,"('FAT', 'CHI')",Providence,vio32.xml,16,1,0,CHI,90,70,FAT
0,2,1,13,0.635988767,15,2,big,"('FAT', 'CHI')",Providence,vio32.xml,16,1,0,CHI,90,70,FAT
0,2,2,18,0.606135804,20,2,this,"('BRO', 'MOT')",Providence,vio32.xml,22,2,0,MOT,93,222,BRO
0,2,2,18,0.606135804,20,2,of,"('FAT', 'MOT')",Providence,vio32.xml,22,2,0,MOT,85,297,FAT
1,24,11,280,0.558799128,304,24,it,"('CHI', 'MOT')",Providence,vio32.xml,316,12,1,MOT,1583,4647,CHI
0,1,3,14,0.530628251,15,1,what,"('MOT', 'CHI')",Providence,vio32.xml,18,3,0,CHI,126,77,MOT
4,39,17,256,0.478796381,295,39,one,"('CHI', 'MOT')",Providence,vio32.xml,316,21,4,MOT,1583,4647,CHI
1,31,9,275,0.472604411,306,31,that,"('CHI', 'MOT')",Providence,vio32.xml,316,10,1,MOT,1583,4647,CHI
0,3,1,14,0.459532329,17,3,yeah,"('MOT', 'CHI')",Providence,vio32.xml,18,1,0,CHI,126,77,MOT
12,66,21,217,0.457397857,283,66,a,"('CHI', 'MOT')",Providence,vio32.xml,316,33,12,MOT,1583,4647,CHI
0,4,1,17,0.427444015,21,4,to,"('BRO', 'MOT')",Providence,vio32.xml,22,1,0,MOT,93,222,BRO
0,4,1,17,0.427444015,21,4,is,"('FAT', 'MOT')",Providence,vio32.xml,22,1,0,MOT,85,297,FAT
4,34,22,256,0.398639143,290,34,this,"('CHI', 'MOT')",Providence,vio32.xml,316,26,4,MOT,1583,4647,CHI
4,21,38,253,0.354606691,274,21,yeah,"('CHI', 'MOT')",Providence,vio32.xml,316,42,4,MOT,1583,4647,CHI
0,1,2,8,0.318453731,9,1,there,"('MOT', 'FAT')",Providence,vio32.xml,11,2,0,FAT,165,78,MOT
0,1,2,8,0.318453731,9,1,no,"('MOT', 'FAT')",Providence,vio32.xml,11,2,0,FAT,165,78,MOT
0,1,2,8,0.318453731,9,1,to,"('MOT', 'FAT')",Providence,vio32.xml,11,2,0,FAT,165,78,MOT
0,2,2,12,0.287682072,14,2,it,"('FAT', 'CHI')",Providence,vio32.xml,16,2,0,CHI,90,70,FAT
0,2,2,12,0.287682072,14,2,that,"('FAT', 'CHI')",Providence,vio32.xml,16,2,0,CHI,90,70,FAT
0,2,2,12,0.287682072,14,2,the,"('FAT', 'CHI')",Providence,vio32.xml,16,2,0,CHI,90,70,FAT
0,2,1,8,0.287682072,10,2,go,"('MOT', 'FAT')",Providence,vio32.xml,11,1,0,FAT,165,78,MOT
0,2,1,8,0.287682072,10,2,and,"('MOT', 'FAT')",Providence,vio32.xml,11,1,0,FAT,165,78,MOT
0,5,1,16,0.245122458,21,5,not,"('BRO', 'MOT')",Providence,vio32.xml,22,1,0,MOT,93,222,BRO
0,32,6,278,0.167054085,310,32,do,"('CHI', 'MOT')",Providence,vio32.xml,316,6,0,MOT,1583,4647,CHI
1,1,4,5,0.133531393,6,1,is,"('MOT', 'FAT')",Providence,vio32.xml,11,5,1,FAT,165,78,MOT
0,24,9,283,0.116570179,307,24,are,"('CHI', 'MOT')",Providence,vio32.xml,316,9,0,MOT,1583,4647,CHI
0,2,4,16,0.105360516,18,2,it,"('BRO', 'MOT')",Providence,vio32.xml,22,4,0,MOT,93,222,BRO
0,5,1,12,0.054067221,17,5,this,"('MOT', 'CHI')",Providence,vio32.xml,18,1,0,CHI,126,77,MOT
9,74,25,208,0.050552279,282,74,the,"('CHI', 'MOT')",Providence,vio32.xml,316,34,9,MOT,1583,4647,CHI
0,1,1,3,0,4,1,is,"('CHI', 'BRO')",Providence,vio32.xml,5,1,0,BRO,30,21,CHI
0,7,1,14,-0.042559614,21,7,do,"('BRO', 'MOT')",Providence,vio32.xml,22,1,0,MOT,93,222,BRO
0,32,8,276,-0.062520357,308,32,what,"('CHI', 'MOT')",Providence,vio32.xml,316,8,0,MOT,1583,4647,CHI
3,52,20,241,-0.115898021,293,52,is,"('CHI', 'MOT')",Providence,vio32.xml,316,23,3,MOT,1583,4647,CHI
1,2,4,4,-0.271933715,6,2,you,"('MOT', 'FAT')",Providence,vio32.xml,11,5,1,FAT,165,78,MOT
0,3,3,10,-0.287682072,13,3,is,"('FAT', 'CHI')",Providence,vio32.xml,16,3,0,CHI,90,70,FAT
0,1,4,6,-0.287682072,7,1,what,"('MOT', 'FAT')",Providence,vio32.xml,11,4,0,FAT,165,78,MOT
0,1,4,6,-0.287682072,7,1,do,"('MOT', 'FAT')",Providence,vio32.xml,11,4,0,FAT,165,78,MOT
0,38,9,269,-0.328115642,307,38,in,"('CHI', 'MOT')",Providence,vio32.xml,316,9,0,MOT,1583,4647,CHI
0,5,3,14,-0.356674944,19,5,the,"('FAT', 'MOT')",Providence,vio32.xml,22,3,0,MOT,85,297,FAT
0,40,10,266,-0.468378934,306,40,on,"('CHI', 'MOT')",Providence,vio32.xml,316,10,0,MOT,1583,4647,CHI
0,39,11,266,-0.526981064,305,39,and,"('CHI', 'MOT')",Providence,vio32.xml,316,11,0,MOT,1583,4647,CHI
1,1,3,0,-0.693147181,1,1,this,"('CHI', 'BRO')",Providence,vio32.xml,5,4,1,BRO,30,21,CHI
0,38,16,262,-0.843506387,300,38,to,"('CHI', 'MOT')",Providence,vio32.xml,316,16,0,MOT,1583,4647,CHI
1,1,2,283,4.046553898,284,1,where,"('MOT', 'CHI')",Providence,vio33.xml,287,3,1,CHI,2810,1891,MOT
0,1,5,281,3.009916909,282,1,was,"('MOT', 'CHI')",Providence,vio33.xml,287,5,0,CHI,2810,1891,MOT
0,1,5,281,3.009916909,282,1,did,"('MOT', 'CHI')",Providence,vio33.xml,287,5,0,CHI,2810,1891,MOT
0,4,1,282,2.954910279,286,4,big,"('MOT', 'CHI')",Providence,vio33.xml,287,1,0,CHI,2810,1891,MOT
5,6,7,269,2.830809497,275,6,little,"('MOT', 'CHI')",Providence,vio33.xml,287,12,5,CHI,2810,1891,MOT
1,3,6,277,2.751535313,280,3,they,"('MOT', 'CHI')",Providence,vio33.xml,287,7,1,CHI,2810,1891,MOT
0,3,3,281,2.660259537,284,3,with,"('MOT', 'CHI')",Providence,vio33.xml,287,3,0,CHI,2810,1891,MOT
1,2,13,271,2.438717267,273,2,for,"('MOT', 'CHI')",Providence,vio33.xml,287,14,1,CHI,2810,1891,MOT
1,4,8,274,2.320603598,278,4,at,"('MOT', 'CHI')",Providence,vio33.xml,287,9,1,CHI,2810,1891,MOT
1,3,11,272,2.291812996,275,3,all,"('MOT', 'CHI')",Providence,vio33.xml,287,12,1,CHI,2810,1891,MOT
1,2,16,268,2.255897979,270,2,can,"('MOT', 'CHI')",Providence,vio33.xml,287,17,1,CHI,2810,1891,MOT
0,4,4,279,2.251291799,283,4,some,"('MOT', 'CHI')",Providence,vio33.xml,287,4,0,CHI,2810,1891,MOT
4,9,9,265,2.219203484,274,9,like,"('MOT', 'CHI')",Providence,vio33.xml,287,13,4,CHI,2810,1891,MOT
0,3,6,278,2.179710995,281,3,but,"('MOT', 'CHI')",Providence,vio33.xml,287,6,0,CHI,2810,1891,MOT
1,4,10,272,2.146381024,276,4,look,"('MOT', 'CHI')",Providence,vio33.xml,287,11,1,CHI,2810,1891,MOT
0,2,11,274,1.964059468,276,2,wanna,"('MOT', 'CHI')",Providence,vio33.xml,287,11,0,CHI,2810,1891,MOT
0,3,8,276,1.949475215,279,3,have,"('MOT', 'CHI')",Providence,vio33.xml,287,8,0,CHI,2810,1891,MOT
0,3,8,276,1.949475215,279,3,up,"('MOT', 'CHI')",Providence,vio33.xml,287,8,0,CHI,2810,1891,MOT
0,1,20,266,1.810521746,267,1,get,"('MOT', 'CHI')",Providence,vio33.xml,287,20,0,CHI,2810,1891,MOT
0,6,5,276,1.75715394,282,6,my,"('MOT', 'CHI')",Providence,vio33.xml,287,5,0,CHI,2810,1891,MOT
0,5,7,275,1.652923024,280,5,not,"('MOT', 'CHI')",Providence,vio33.xml,287,7,0,CHI,2810,1891,MOT
1,4,18,264,1.637608789,268,4,we,"('MOT', 'CHI')",Providence,vio33.xml,287,19,1,CHI,2810,1891,MOT
1,5,15,266,1.620487749,271,5,put,"('MOT', 'CHI')",Providence,vio33.xml,287,16,1,CHI,2810,1891,MOT
2,10,12,263,1.544899391,273,10,there,"('MOT', 'CHI')",Providence,vio33.xml,287,14,2,CHI,2810,1891,MOT
0,4,10,273,1.53686722,277,4,of,"('MOT', 'CHI')",Providence,vio33.xml,287,10,0,CHI,2810,1891,MOT
0,7,7,273,1.365240952,280,7,make,"('MOT', 'CHI')",Providence,vio33.xml,287,7,0,CHI,2810,1891,MOT
0,5,11,271,1.270912287,276,5,no,"('MOT', 'CHI')",Providence,vio33.xml,287,11,0,CHI,2810,1891,MOT
2,8,21,256,1.266008195,264,8,want,"('MOT', 'CHI')",Providence,vio33.xml,287,23,2,CHI,2810,1891,MOT
0,8,7,272,1.247457916,280,8,go,"('MOT', 'CHI')",Providence,vio33.xml,287,7,0,CHI,2810,1891,MOT
2,7,25,253,1.220219421,260,7,oh,"('MOT', 'CHI')",Providence,vio33.xml,287,27,2,CHI,2810,1891,MOT
2,9,20,256,1.205222024,265,9,to,"('MOT', 'CHI')",Providence,vio33.xml,287,22,2,CHI,2810,1891,MOT
6,12,33,236,1.188849643,248,12,one,"('MOT', 'CHI')",Providence,vio33.xml,287,39,6,CHI,2810,1891,MOT
1,7,18,261,1.16760516,268,7,on,"('MOT', 'CHI')",Providence,vio33.xml,287,19,1,CHI,2810,1891,MOT
0,4,17,266,1.051925175,270,4,gonna,"('MOT', 'CHI')",Providence,vio33.xml,287,17,0,CHI,2810,1891,MOT
10,28,23,226,1.020428826,254,28,it,"('MOT', 'CHI')",Providence,vio33.xml,287,33,10,CHI,2810,1891,MOT
1,6,26,254,0.948285705,260,6,and,"('MOT', 'CHI')",Providence,vio33.xml,287,27,1,CHI,2810,1891,MOT
10,30,27,220,0.82977551,250,30,is,"('MOT', 'CHI')",Providence,vio33.xml,287,37,10,CHI,2810,1891,MOT
0,8,12,267,0.787735599,275,8,are,"('MOT', 'CHI')",Providence,vio33.xml,287,12,0,CHI,2810,1891,MOT
5,26,23,233,0.659245629,259,26,a,"('MOT', 'CHI')",Providence,vio33.xml,287,28,5,CHI,2810,1891,MOT
4,19,29,235,0.603535022,254,19,that,"('MOT', 'CHI')",Providence,vio33.xml,287,33,4,CHI,2810,1891,MOT
1,12,20,254,0.583690588,266,12,do,"('MOT', 'CHI')",Providence,vio33.xml,287,21,1,CHI,2810,1891,MOT
2,15,25,245,0.52707224,260,15,what,"('MOT', 'CHI')",Providence,vio33.xml,287,27,2,CHI,2810,1891,MOT
1,7,36,243,0.47957308,250,7,see,"('MOT', 'CHI')",Providence,vio33.xml,287,37,1,CHI,2810,1891,MOT
8,21,63,195,0.200217746,216,21,you,"('MOT', 'CHI')",Providence,vio33.xml,287,71,8,CHI,2810,1891,MOT
6,36,34,211,0.114775515,247,36,this,"('MOT', 'CHI')",Providence,vio33.xml,287,40,6,CHI,2810,1891,MOT
0,10,20,257,0.105773653,267,10,in,"('MOT', 'CHI')",Providence,vio33.xml,287,20,0,CHI,2810,1891,MOT
11,33,59,184,0.070951736,217,33,the,"('MOT', 'CHI')",Providence,vio33.xml,287,70,11,CHI,2810,1891,MOT
2,25,29,231,-0.103032226,256,25,yeah,"('MOT', 'CHI')",Providence,vio33.xml,287,31,2,CHI,2810,1891,MOT
1,4,0,168,3.144152279,172,4,like,"('CHI', 'MOT')",Providence,vio34.xml,173,1,1,MOT,1663,1773,CHI
0,1,2,170,3.073850053,171,1,big,"('CHI', 'MOT')",Providence,vio34.xml,173,2,0,MOT,1663,1773,CHI
0,1,2,170,3.073850053,171,1,not,"('CHI', 'MOT')",Providence,vio34.xml,173,2,0,MOT,1663,1773,CHI
0,4,1,168,2.451005098,172,4,want,"('CHI', 'MOT')",Providence,vio34.xml,173,1,0,MOT,1663,1773,CHI
0,3,2,168,2.380702872,171,3,some,"('CHI', 'MOT')",Providence,vio34.xml,173,2,0,MOT,1663,1773,CHI
0,5,1,167,2.268683541,172,5,gonna,"('CHI', 'MOT')",Providence,vio34.xml,173,1,0,MOT,1663,1773,CHI
1,0,0,11,2.159484249,11,0,we,"('FAT', 'MOT')",Providence,vio34.xml,12,1,1,MOT,62,51,FAT
1,0,0,11,2.159484249,11,0,think,"('FAT', 'MOT')",Providence,vio34.xml,12,1,1,MOT,62,51,FAT
2,5,6,160,2.122261539,165,5,we,"('CHI', 'MOT')",Providence,vio34.xml,173,8,2,MOT,1663,1773,CHI
1,7,3,162,1.963609726,169,7,for,"('CHI', 'MOT')",Providence,vio34.xml,173,4,1,MOT,1663,1773,CHI
0,4,3,166,1.928618652,170,4,but,"('CHI', 'MOT')",Providence,vio34.xml,173,3,0,MOT,1663,1773,CHI
0,6,2,165,1.821087084,171,6,look,"('CHI', 'MOT')",Providence,vio34.xml,173,2,0,MOT,1663,1773,CHI
0,6,2,165,1.821087084,171,6,all,"('CHI', 'MOT')",Providence,vio34.xml,173,2,0,MOT,1663,1773,CHI
0,6,2,165,1.821087084,171,6,think,"('CHI', 'MOT')",Providence,vio34.xml,173,2,0,MOT,1663,1773,CHI
0,9,1,163,1.757857918,172,9,see,"('CHI', 'MOT')",Providence,vio34.xml,173,1,0,MOT,1663,1773,CHI
0,9,1,163,1.757857918,172,9,at,"('CHI', 'MOT')",Providence,vio34.xml,173,1,0,MOT,1663,1773,CHI
0,5,3,165,1.746297095,170,5,little,"('CHI', 'MOT')",Providence,vio34.xml,173,3,0,MOT,1663,1773,CHI
0,4,4,165,1.740466175,169,4,they,"('CHI', 'MOT')",Providence,vio34.xml,173,4,0,MOT,1663,1773,CHI
2,6,9,156,1.68761921,162,6,my,"('CHI', 'MOT')",Providence,vio34.xml,173,11,2,MOT,1663,1773,CHI
0,6,3,164,1.592146415,170,6,did,"('CHI', 'MOT')",Providence,vio34.xml,173,3,0,MOT,1663,1773,CHI
0,4,5,164,1.580450376,168,4,was,"('CHI', 'MOT')",Providence,vio34.xml,173,5,0,MOT,1663,1773,CHI
0,5,4,164,1.558144618,169,5,no,"('CHI', 'MOT')",Providence,vio34.xml,173,4,0,MOT,1663,1773,CHI
1,0,0,5,1.540445041,5,0,yeah,"('MOT', 'FAT')",Providence,vio34.xml,6,1,1,FAT,26,26,MOT
1,0,2,9,1.481604541,9,0,the,"('FAT', 'MOT')",Providence,vio34.xml,12,3,1,MOT,62,51,FAT
1,12,3,157,1.47810191,169,12,are,"('CHI', 'MOT')",Providence,vio34.xml,173,4,1,MOT,1663,1773,CHI
0,10,2,161,1.369101961,171,10,put,"('CHI', 'MOT')",Providence,vio34.xml,173,2,0,MOT,1663,1773,CHI
0,8,3,162,1.340831987,170,8,get,"('CHI', 'MOT')",Providence,vio34.xml,173,3,0,MOT,1663,1773,CHI
0,9,3,161,1.235471471,170,9,there,"('CHI', 'MOT')",Providence,vio34.xml,173,3,0,MOT,1663,1773,CHI
1,5,14,153,1.143348183,158,5,yeah,"('CHI', 'MOT')",Providence,vio34.xml,173,15,1,MOT,1663,1773,CHI
0,5,7,161,1.134979933,166,5,have,"('CHI', 'MOT')",Providence,vio34.xml,173,7,0,MOT,1663,1773,CHI
0,7,5,161,1.110446746,168,7,can,"('CHI', 'MOT')",Providence,vio34.xml,173,5,0,MOT,1663,1773,CHI
0,6,6,161,1.104547024,167,6,with,"('CHI', 'MOT')",Providence,vio34.xml,173,6,0,MOT,1663,1773,CHI
1,1,1,9,1.098612289,10,1,yeah,"('FAT', 'MOT')",Providence,vio34.xml,12,2,1,MOT,62,51,FAT
2,13,8,150,1.080593783,163,13,in,"('CHI', 'MOT')",Providence,vio34.xml,173,10,2,MOT,1663,1773,CHI
0,10,4,159,0.952008814,169,10,of,"('CHI', 'MOT')",Providence,vio34.xml,173,4,0,MOT,1663,1773,CHI
1,8,11,153,0.950615474,161,8,one,"('CHI', 'MOT')",Providence,vio34.xml,173,12,1,MOT,1663,1773,CHI
0,1,1,10,0.773189888,11,1,that,"('FAT', 'MOT')",Providence,vio34.xml,12,1,0,MOT,62,51,FAT
0,1,1,10,0.773189888,11,1,to,"('FAT', 'MOT')",Providence,vio34.xml,12,1,0,MOT,62,51,FAT
0,8,7,158,0.729514825,166,8,he,"('CHI', 'MOT')",Providence,vio34.xml,173,7,0,MOT,1663,1773,CHI
1,11,11,150,0.662933402,161,11,do,"('CHI', 'MOT')",Providence,vio34.xml,173,12,1,MOT,1663,1773,CHI
0,13,5,155,0.550830958,168,13,oh,"('CHI', 'MOT')",Providence,vio34.xml,173,5,0,MOT,1663,1773,CHI
1,12,12,148,0.507743957,160,12,what,"('CHI', 'MOT')",Providence,vio34.xml,173,13,1,MOT,1663,1773,CHI
2,21,10,140,0.462262707,161,21,it,"('CHI', 'MOT')",Providence,vio34.xml,173,12,2,MOT,1663,1773,CHI
0,17,4,152,0.459532329,169,17,up,"('CHI', 'MOT')",Providence,vio34.xml,173,4,0,MOT,1663,1773,CHI
7,36,13,117,0.420906293,153,36,you,"('CHI', 'MOT')",Providence,vio34.xml,173,20,7,MOT,1663,1773,CHI
0,1,1,6,0.405465108,7,1,what,"('CHI', 'FAT')",Providence,vio34.xml,8,1,0,FAT,53,32,CHI
0,1,1,6,0.405465108,7,1,what,"('FAT', 'CHI')",Providence,vio34.xml,8,1,0,CHI,44,19,FAT
0,1,2,9,0.405465108,10,1,oh,"('FAT', 'MOT')",Providence,vio34.xml,12,2,0,MOT,62,51,FAT
3,20,16,134,0.347105493,154,20,that,"('CHI', 'MOT')",Providence,vio34.xml,173,19,3,MOT,1663,1773,CHI
7,25,27,114,0.186585956,139,25,the,"('CHI', 'MOT')",Providence,vio34.xml,173,34,7,MOT,1663,1773,CHI
0,12,9,152,0.149143158,164,12,go,"('CHI', 'MOT')",Providence,vio34.xml,173,9,0,MOT,1663,1773,CHI
2,10,30,131,0.137201122,141,10,this,"('CHI', 'MOT')",Providence,vio34.xml,173,32,2,MOT,1663,1773,CHI
1,13,17,142,0.114603383,155,13,and,"('CHI', 'MOT')",Providence,vio34.xml,173,18,1,MOT,1663,1773,CHI
0,16,7,150,0.093526058,166,16,on,"('CHI', 'MOT')",Providence,vio34.xml,173,7,0,MOT,1663,1773,CHI
0,15,10,148,-0.151549898,163,15,to,"('CHI', 'MOT')",Providence,vio34.xml,173,10,0,MOT,1663,1773,CHI
0,13,18,142,-0.578543798,155,13,is,"('CHI', 'MOT')",Providence,vio34.xml,173,18,0,MOT,1663,1773,CHI
0,1,1,0,-0.693147181,1,1,in,"('BRO', 'FAT')",Providence,vio34.xml,2,1,0,FAT,8,8,BRO
0,1,1,0,-0.693147181,1,1,the,"('BRO', 'FAT')",Providence,vio34.xml,2,1,0,FAT,8,8,BRO
0,21,13,139,-0.711496319,160,21,a,"('CHI', 'MOT')",Providence,vio34.xml,173,13,0,MOT,1663,1773,CHI
0,1,1,140,3.171085161,141,1,was,"('CHI', 'MOT')",Providence,vio35.xml,142,1,0,MOT,747,1793,CHI
0,1,1,140,3.171085161,141,1,they,"('CHI', 'MOT')",Providence,vio35.xml,142,1,0,MOT,747,1793,CHI
1,0,2,57,3.161246712,57,0,get,"('MOT', 'BRO')",Providence,vio35.xml,60,3,1,BRO,676,345,MOT
1,1,0,58,3.012261576,59,1,go,"('MOT', 'BRO')",Providence,vio35.xml,60,1,1,BRO,676,345,MOT
0,1,2,139,2.876385516,140,1,my,"('CHI', 'MOT')",Providence,vio35.xml,142,2,0,MOT,747,1793,CHI
2,0,0,21,2.847812143,21,0,think,"('MOT', 'CHI')",Providence,vio35.xml,23,2,2,CHI,212,94,MOT
1,0,4,55,2.790288299,55,0,and,"('MOT', 'BRO')",Providence,vio35.xml,60,5,1,BRO,676,345,MOT
0,3,1,138,2.47793798,141,3,no,"('CHI', 'MOT')",Providence,vio35.xml,142,1,0,MOT,747,1793,CHI
1,0,1,21,2.442347035,21,0,for,"('MOT', 'CHI')",Providence,vio35.xml,23,2,1,CHI,212,94,MOT
1,8,0,133,2.360154945,141,8,oh,"('CHI', 'MOT')",Providence,vio35.xml,142,1,1,MOT,747,1793,CHI
1,0,8,51,2.265543821,51,0,one,"('MOT', 'BRO')",Providence,vio35.xml,60,9,1,BRO,676,345,MOT
0,4,1,137,2.254794429,141,4,of,"('CHI', 'MOT')",Providence,vio35.xml,142,1,0,MOT,747,1793,CHI
1,7,1,133,2.183238335,140,7,little,"('CHI', 'MOT')",Providence,vio35.xml,142,2,1,MOT,747,1793,CHI
1,0,2,20,2.174751721,20,0,no,"('MOT', 'CHI')",Providence,vio35.xml,23,3,1,CHI,212,94,MOT
1,10,0,131,2.159484249,141,10,like,"('CHI', 'MOT')",Providence,vio35.xml,142,1,1,MOT,747,1793,CHI
1,0,9,50,2.159484249,50,0,that,"('MOT', 'BRO')",Providence,vio35.xml,60,10,1,BRO,676,345,MOT
0,1,6,135,2.154664963,136,1,up,"('CHI', 'MOT')",Providence,vio35.xml,142,6,0,MOT,747,1793,CHI
2,0,3,18,2.148434413,18,0,on,"('MOT', 'CHI')",Providence,vio35.xml,23,5,2,CHI,212,94,MOT
0,1,1,46,2.100060829,47,1,want,"('BRO', 'MOT')",Providence,vio35.xml,48,1,0,MOT,223,543,BRO
0,1,1,46,2.100060829,47,1,up,"('BRO', 'MOT')",Providence,vio35.xml,48,1,0,MOT,223,543,BRO
0,1,1,46,2.100060829,47,1,my,"('BRO', 'MOT')",Providence,vio35.xml,48,1,0,MOT,223,543,BRO
0,5,1,136,2.072472872,141,5,get,"('CHI', 'MOT')",Providence,vio35.xml,142,1,0,MOT,747,1793,CHI
1,4,4,133,2.072273052,137,4,wanna,"('CHI', 'MOT')",Providence,vio35.xml,142,5,1,MOT,747,1793,CHI
1,8,1,132,2.0654553,140,8,to,"('CHI', 'MOT')",Providence,vio35.xml,142,2,1,MOT,747,1793,CHI
0,1,2,57,2.014903021,58,1,was,"('MOT', 'BRO')",Providence,vio35.xml,60,2,0,BRO,676,345,MOT
0,1,2,57,2.014903021,58,1,see,"('MOT', 'BRO')",Providence,vio35.xml,60,2,0,BRO,676,345,MOT
0,4,2,136,1.960094784,140,4,some,"('CHI', 'MOT')",Providence,vio35.xml,142,2,0,MOT,747,1793,CHI
1,4,0,43,1.876917278,47,4,some,"('BRO', 'MOT')",Providence,vio35.xml,48,1,1,MOT,223,543,BRO
1,2,2,43,1.835244581,45,2,it,"('BRO', 'MOT')",Providence,vio35.xml,48,3,1,MOT,223,543,BRO
0,1,2,45,1.791759469,46,1,no,"('BRO', 'MOT')",Providence,vio35.xml,48,2,0,MOT,223,543,BRO
0,7,1,134,1.7847908,141,7,he,"('CHI', 'MOT')",Providence,vio35.xml,142,1,0,MOT,747,1793,CHI
0,7,1,134,1.7847908,141,7,think,"('CHI', 'MOT')",Providence,vio35.xml,142,1,0,MOT,747,1793,CHI
0,1,3,56,1.774952351,57,1,at,"('MOT', 'BRO')",Providence,vio35.xml,60,3,0,BRO,676,345,MOT
0,1,3,56,1.774952351,57,1,do,"('MOT', 'BRO')",Providence,vio35.xml,60,3,0,BRO,676,345,MOT
1,3,2,54,1.774952351,57,3,what,"('MOT', 'BRO')",Providence,vio35.xml,60,3,1,BRO,676,345,MOT
0,2,1,45,1.694595721,47,2,did,"('BRO', 'MOT')",Providence,vio35.xml,48,1,0,MOT,223,543,BRO
1,10,2,129,1.634573886,139,10,with,"('CHI', 'MOT')",Providence,vio35.xml,142,3,1,MOT,747,1793,CHI
0,3,1,56,1.625967214,59,3,are,"('MOT', 'BRO')",Providence,vio35.xml,60,1,0,BRO,676,345,MOT
2,13,2,125,1.609437912,138,13,for,"('CHI', 'MOT')",Providence,vio35.xml,142,4,2,MOT,747,1793,CHI
0,1,4,55,1.575536361,56,1,but,"('MOT', 'BRO')",Providence,vio35.xml,60,4,0,BRO,676,345,MOT
0,1,4,55,1.575536361,56,1,put,"('MOT', 'BRO')",Providence,vio35.xml,60,4,0,BRO,676,345,MOT
0,9,1,132,1.561647249,141,9,there,"('CHI', 'MOT')",Providence,vio35.xml,142,1,0,MOT,747,1793,CHI
1,1,0,10,1.466337069,11,1,the,"('CHI', 'BRO')",Providence,vio35.xml,12,1,1,BRO,53,47,CHI
2,11,4,125,1.461517782,136,11,put,"('CHI', 'MOT')",Providence,vio35.xml,142,6,2,MOT,747,1793,CHI
0,3,1,44,1.406913648,47,3,get,"('BRO', 'MOT')",Providence,vio35.xml,48,1,0,MOT,223,543,BRO
0,1,5,54,1.403993938,55,1,for,"('MOT', 'BRO')",Providence,vio35.xml,60,5,0,BRO,676,345,MOT
0,1,5,54,1.403993938,55,1,on,"('MOT', 'BRO')",Providence,vio35.xml,60,5,0,BRO,676,345,MOT
0,2,2,44,1.386294361,46,2,gonna,"('BRO', 'MOT')",Providence,vio35.xml,48,2,0,MOT,223,543,BRO
0,9,2,131,1.266947603,140,9,on,"('CHI', 'MOT')",Providence,vio35.xml,142,2,0,MOT,747,1793,CHI
1,1,3,18,1.252762968,19,1,the,"('MOT', 'CHI')",Providence,vio35.xml,23,4,1,CHI,212,94,MOT
3,4,7,46,1.243193517,50,4,a,"('MOT', 'BRO')",Providence,vio35.xml,60,10,3,BRO,676,345,MOT
0,4,1,43,1.183770097,47,4,is,"('BRO', 'MOT')",Providence,vio35.xml,48,1,0,MOT,223,543,BRO
0,4,1,43,1.183770097,47,4,put,"('BRO', 'MOT')",Providence,vio35.xml,48,1,0,MOT,223,543,BRO
0,2,4,54,1.170071253,56,2,like,"('MOT', 'BRO')",Providence,vio35.xml,60,4,0,BRO,676,345,MOT
0,2,4,54,1.170071253,56,2,look,"('MOT', 'BRO')",Providence,vio35.xml,60,4,0,BRO,676,345,MOT
1,3,4,40,1.16760516,43,3,oh,"('BRO', 'MOT')",Providence,vio35.xml,48,5,1,MOT,223,543,BRO
2,12,6,122,1.143732724,134,12,gonna,"('CHI', 'MOT')",Providence,vio35.xml,142,8,2,MOT,747,1793,CHI
1,14,3,124,1.134979933,138,14,can,"('CHI', 'MOT')",Providence,vio35.xml,142,4,1,MOT,747,1793,CHI
1,12,4,125,1.116761607,137,12,in,"('CHI', 'MOT')",Providence,vio35.xml,142,5,1,MOT,747,1793,CHI
0,3,2,43,1.098612289,46,3,what,"('BRO', 'MOT')",Providence,vio35.xml,48,2,0,MOT,223,543,BRO
1,7,1,39,1.098612289,46,7,this,"('BRO', 'MOT')",Providence,vio35.xml,48,2,1,MOT,223,543,BRO
0,11,2,129,1.084626047,140,11,do,"('CHI', 'MOT')",Providence,vio35.xml,142,2,0,MOT,747,1793,CHI
0,6,1,53,1.066351426,59,6,no,"('MOT', 'BRO')",Providence,vio35.xml,60,1,0,BRO,676,345,MOT
1,19,2,120,1.036736885,139,19,what,"('CHI', 'MOT')",Providence,vio35.xml,142,3,1,MOT,747,1793,CHI
3,15,7,117,1.026638789,132,15,and,"('CHI', 'MOT')",Providence,vio35.xml,142,10,3,MOT,747,1793,CHI
0,5,1,42,1.00144854,47,5,we,"('BRO', 'MOT')",Providence,vio35.xml,48,1,0,MOT,223,543,BRO
0,5,1,42,1.00144854,47,5,of,"('BRO', 'MOT')",Providence,vio35.xml,48,1,0,MOT,223,543,BRO
0,2,5,53,0.99852883,55,2,we,"('MOT', 'BRO')",Providence,vio35.xml,60,5,0,BRO,676,345,MOT
1,0,0,2,0.980829253,2,0,you,"('MOT', 'FAT')",Providence,vio35.xml,3,1,1,FAT,49,15,MOT
0,18,1,123,0.919793362,141,18,that,"('CHI', 'MOT')",Providence,vio35.xml,142,1,0,MOT,747,1793,CHI
1,2,8,37,0.910211686,39,2,yeah,"('BRO', 'MOT')",Providence,vio35.xml,48,9,1,MOT,223,543,BRO
4,22,6,110,0.886876847,132,22,this,"('CHI', 'MOT')",Providence,vio35.xml,142,10,4,MOT,747,1793,CHI
0,1,9,50,0.87924946,51,1,in,"('MOT', 'BRO')",Providence,vio35.xml,60,9,0,BRO,676,345,MOT
0,4,2,42,0.875468737,46,4,have,"('BRO', 'MOT')",Providence,vio35.xml,48,2,0,MOT,223,543,BRO
0,3,3,42,0.854415328,45,3,go,"('BRO', 'MOT')",Providence,vio35.xml,48,3,0,MOT,223,543,BRO
0,2,6,52,0.84729786,54,2,to,"('MOT', 'BRO')",Providence,vio35.xml,60,6,0,BRO,676,345,MOT
1,6,3,38,0.784118959,44,6,make,"('BRO', 'MOT')",Providence,vio35.xml,48,4,1,MOT,223,543,BRO
0,12,3,127,0.77437262,139,12,one,"('CHI', 'MOT')",Providence,vio35.xml,142,3,0,MOT,747,1793,CHI
0,1,10,49,0.773189888,50,1,is,"('MOT', 'BRO')",Providence,vio35.xml,60,10,0,BRO,676,345,MOT
2,16,7,117,0.77277845,133,16,is,"('CHI', 'MOT')",Providence,vio35.xml,142,9,2,MOT,747,1793,CHI
5,20,11,106,0.708895538,126,20,it,"('CHI', 'MOT')",Providence,vio35.xml,142,16,5,MOT,747,1793,CHI
0,1,1,9,0.693147181,10,1,in,"('BRO', 'CHI')",Providence,vio35.xml,11,1,0,CHI,78,67,BRO
0,1,1,9,0.693147181,10,1,this,"('BRO', 'CHI')",Providence,vio35.xml,11,1,0,CHI,78,67,BRO
0,1,1,9,0.693147181,10,1,that,"('BRO', 'CHI')",Providence,vio35.xml,11,1,0,CHI,78,67,BRO
0,5,2,41,0.693147181,46,5,can,"('BRO', 'MOT')",Providence,vio35.xml,48,2,0,MOT,223,543,BRO
0,5,2,41,0.693147181,46,5,to,"('BRO', 'MOT')",Providence,vio35.xml,48,2,0,MOT,223,543,BRO
2,2,5,14,0.693147181,16,2,a,"('MOT', 'CHI')",Providence,vio35.xml,23,7,2,CHI,212,94,MOT
1,9,3,47,0.659245629,56,9,yeah,"('MOT', 'BRO')",Providence,vio35.xml,60,4,1,BRO,676,345,MOT
0,1,4,18,0.559615788,19,1,you,"('MOT', 'CHI')",Providence,vio35.xml,23,4,0,CHI,212,94,MOT
0,1,4,18,0.559615788,19,1,this,"('MOT', 'CHI')",Providence,vio35.xml,23,4,0,CHI,212,94,MOT
3,9,5,31,0.518793793,40,9,the,"('BRO', 'MOT')",Providence,vio35.xml,48,8,3,MOT,223,543,BRO
0,9,1,38,0.490622916,47,9,for,"('BRO', 'MOT')",Providence,vio35.xml,48,1,0,MOT,223,543,BRO
2,31,4,105,0.480688529,136,31,the,"('CHI', 'MOT')",Providence,vio35.xml,142,6,2,MOT,747,1793,CHI
12,34,14,82,0.44808141,116,34,a,"('CHI', 'MOT')",Providence,vio35.xml,142,26,12,MOT,747,1793,CHI
0,3,7,50,0.423814247,53,3,gonna,"('MOT', 'BRO')",Providence,vio35.xml,60,7,0,BRO,676,345,MOT
0,3,7,50,0.423814247,53,3,it,"('MOT', 'BRO')",Providence,vio35.xml,60,7,0,BRO,676,345,MOT
0,3,7,50,0.423814247,53,3,make,"('MOT', 'BRO')",Providence,vio35.xml,60,7,0,BRO,676,345,MOT
1,26,4,111,0.385874099,137,26,you,"('CHI', 'MOT')",Providence,vio35.xml,142,5,1,MOT,747,1793,CHI
1,5,9,45,0.36772478,50,5,this,"('MOT', 'BRO')",Providence,vio35.xml,60,10,1,BRO,676,345,MOT
0,1,5,17,0.356674944,18,1,to,"('MOT', 'CHI')",Providence,vio35.xml,23,5,0,CHI,212,94,MOT
0,1,2,8,0.318453731,9,1,it,"('BRO', 'CHI')",Providence,vio35.xml,11,2,0,CHI,78,67,BRO
0,11,1,36,0.30830136,47,11,do,"('BRO', 'MOT')",Providence,vio35.xml,48,1,0,MOT,223,543,BRO
0,2,1,8,0.287682072,10,2,is,"('BRO', 'CHI')",Providence,vio35.xml,11,1,0,CHI,78,67,BRO
0,1,6,16,0.171850257,17,1,it,"('MOT', 'CHI')",Providence,vio35.xml,23,6,0,CHI,212,94,MOT
0,1,3,8,0.09531018,9,1,a,"('CHI', 'BRO')",Providence,vio35.xml,12,3,0,BRO,53,47,CHI
3,26,13,100,0.052116001,126,26,make,"('CHI', 'MOT')",Providence,vio35.xml,142,16,3,MOT,747,1793,CHI
4,7,18,31,0.040821995,38,7,the,"('MOT', 'BRO')",Providence,vio35.xml,60,22,4,BRO,676,345,MOT
0,12,2,34,-0.080042708,46,12,you,"('BRO', 'MOT')",Providence,vio35.xml,48,2,0,MOT,223,543,BRO
0,3,12,45,-0.113328685,48,3,oh,"('MOT', 'BRO')",Providence,vio35.xml,60,12,0,BRO,676,345,MOT
0,20,6,116,-0.196710294,136,20,we,"('CHI', 'MOT')",Providence,vio35.xml,142,6,0,MOT,747,1793,CHI
0,9,4,35,-0.265703166,44,9,a,"('BRO', 'MOT')",Providence,vio35.xml,48,4,0,MOT,223,543,BRO
1,18,15,108,-0.289633293,126,18,yeah,"('CHI', 'MOT')",Providence,vio35.xml,142,16,1,MOT,747,1793,CHI
0,4,13,43,-0.425667815,47,4,you,"('MOT', 'BRO')",Providence,vio35.xml,60,13,0,BRO,676,345,MOT
0,4,2,5,-0.597837001,9,4,the,"('BRO', 'CHI')",Providence,vio35.xml,11,2,0,CHI,78,67,BRO
3,1,5,220,3.797733859,221,1,up,"('MOT', 'CHI')",Providence,vio36.xml,229,8,3,CHI,2275,1632,MOT
0,1,2,226,3.354280462,227,1,did,"('MOT', 'CHI')",Providence,vio36.xml,229,2,0,CHI,2275,1632,MOT
1,2,3,223,3.22772544,225,2,all,"('MOT', 'CHI')",Providence,vio36.xml,229,4,1,CHI,2275,1632,MOT
0,1,4,224,2.940043368,225,1,get,"('MOT', 'CHI')",Providence,vio36.xml,229,4,0,CHI,2275,1632,MOT
0,1,4,224,2.940043368,225,1,big,"('MOT', 'CHI')",Providence,vio36.xml,229,4,0,CHI,2275,1632,MOT
2,3,5,219,2.926739402,222,3,have,"('MOT', 'CHI')",Providence,vio36.xml,229,7,2,CHI,2275,1632,MOT
0,1,5,223,2.78147767,224,1,put,"('MOT', 'CHI')",Providence,vio36.xml,229,5,0,CHI,2275,1632,MOT
0,4,1,224,2.730029108,228,4,want,"('MOT', 'CHI')",Providence,vio36.xml,229,1,0,CHI,2275,1632,MOT
0,2,3,224,2.721295428,226,2,was,"('MOT', 'CHI')",Providence,vio36.xml,229,3,0,CHI,2275,1632,MOT
0,1,7,221,2.521274294,222,1,there,"('MOT', 'CHI')",Providence,vio36.xml,229,7,0,CHI,2275,1632,MOT
0,4,2,223,2.43798973,227,4,we,"('MOT', 'CHI')",Providence,vio36.xml,229,2,0,CHI,2275,1632,MOT
1,1,0,27,2.302585093,28,1,is,"('CHI', 'MOT')",Providence,vio36.xml,29,1,1,MOT,143,420,CHI
1,4,6,218,2.298130743,222,4,with,"('MOT', 'CHI')",Providence,vio36.xml,229,7,1,CHI,2275,1632,MOT
0,2,6,221,2.238046572,223,2,look,"('MOT', 'CHI')",Providence,vio36.xml,229,6,0,CHI,2275,1632,MOT
2,3,15,209,2.133854963,212,3,on,"('MOT', 'CHI')",Providence,vio36.xml,229,17,2,CHI,2275,1632,MOT
0,2,7,220,2.115809186,222,2,think,"('MOT', 'CHI')",Providence,vio36.xml,229,7,0,CHI,2275,1632,MOT
1,1,1,30,2.1102132,31,1,of,"('MOT', 'FAT')",Providence,vio36.xml,33,2,1,FAT,313,222,MOT
1,1,1,30,2.1102132,31,1,to,"('MOT', 'FAT')",Providence,vio36.xml,33,2,1,FAT,313,222,MOT
6,10,9,204,2.09007994,214,10,do,"('MOT', 'CHI')",Providence,vio36.xml,229,15,6,CHI,2275,1632,MOT
0,1,12,216,2.05686722,217,1,oh,"('MOT', 'CHI')",Providence,vio36.xml,229,12,0,CHI,2275,1632,MOT
6,10,10,203,2.028281146,213,10,my,"('MOT', 'CHI')",Providence,vio36.xml,229,16,6,CHI,2275,1632,MOT
2,7,7,213,2.023952856,220,7,are,"('MOT', 'CHI')",Providence,vio36.xml,229,9,2,CHI,2275,1632,MOT
1,1,1,26,1.981001469,27,1,go,"('CHI', 'MOT')",Providence,vio36.xml,29,2,1,MOT,143,420,CHI
0,3,6,220,1.950364499,223,3,no,"('MOT', 'CHI')",Providence,vio36.xml,229,6,0,CHI,2275,1632,MOT
0,3,6,220,1.950364499,223,3,he,"('MOT', 'CHI')",Providence,vio36.xml,229,6,0,CHI,2275,1632,MOT
1,3,13,212,1.914161451,215,3,in,"('MOT', 'CHI')",Providence,vio36.xml,229,14,1,CHI,2275,1632,MOT
1,3,14,211,1.848917883,214,3,see,"('MOT', 'CHI')",Providence,vio36.xml,229,15,1,CHI,2275,1632,MOT
0,1,1,31,1.734601055,32,1,make,"('MOT', 'FAT')",Providence,vio36.xml,33,1,0,FAT,313,222,MOT
0,1,1,31,1.734601055,32,1,she,"('MOT', 'FAT')",Providence,vio36.xml,33,1,0,FAT,313,222,MOT
0,1,1,31,1.734601055,32,1,my,"('MOT', 'FAT')",Providence,vio36.xml,33,1,0,FAT,313,222,MOT
0,1,1,31,1.734601055,32,1,no,"('MOT', 'FAT')",Providence,vio36.xml,33,1,0,FAT,313,222,MOT
0,1,1,31,1.734601055,32,1,at,"('MOT', 'FAT')",Providence,vio36.xml,33,1,0,FAT,313,222,MOT
0,3,8,218,1.718292317,221,3,but,"('MOT', 'CHI')",Providence,vio36.xml,229,8,0,CHI,2275,1632,MOT
0,5,5,219,1.682865381,224,5,go,"('MOT', 'CHI')",Providence,vio36.xml,229,5,0,CHI,2275,1632,MOT
1,1,3,28,1.642227735,29,1,what,"('MOT', 'FAT')",Providence,vio36.xml,33,4,1,FAT,313,222,MOT
0,1,1,27,1.609437912,28,1,with,"('CHI', 'MOT')",Providence,vio36.xml,29,1,0,MOT,143,420,CHI
0,1,1,27,1.609437912,28,1,my,"('CHI', 'MOT')",Providence,vio36.xml,29,1,0,MOT,143,420,CHI
0,1,1,27,1.609437912,28,1,one,"('CHI', 'MOT')",Providence,vio36.xml,29,1,0,MOT,143,420,CHI
0,3,10,216,1.526961691,219,3,what,"('MOT', 'CHI')",Providence,vio36.xml,229,10,0,CHI,2275,1632,MOT
0,4,8,217,1.495148766,221,4,can,"('MOT', 'CHI')",Providence,vio36.xml,229,8,0,CHI,2275,1632,MOT
0,1,2,30,1.41706602,31,1,was,"('MOT', 'FAT')",Providence,vio36.xml,33,2,0,FAT,313,222,MOT
1,8,9,211,1.409178655,219,8,little,"('MOT', 'CHI')",Providence,vio36.xml,229,10,1,CHI,2275,1632,MOT
1,4,0,24,1.386294361,28,4,what,"('CHI', 'MOT')",Providence,vio36.xml,29,1,1,MOT,143,420,CHI
1,0,0,4,1.386294361,4,0,with,"('MOT', 'BRO')",Providence,vio36.xml,5,1,1,BRO,72,33,MOT
1,6,13,209,1.354545663,215,6,gonna,"('MOT', 'CHI')",Providence,vio36.xml,229,14,1,CHI,2275,1632,MOT
0,1,1,20,1.343734747,21,1,for,"('FAT', 'CHI')",Providence,vio36.xml,22,1,0,CHI,200,107,FAT
0,1,1,20,1.343734747,21,1,with,"('FAT', 'CHI')",Providence,vio36.xml,22,1,0,CHI,200,107,FAT
0,1,1,20,1.343734747,21,1,little,"('FAT', 'CHI')",Providence,vio36.xml,22,1,0,CHI,200,107,FAT
0,1,1,20,1.343734747,21,1,my,"('FAT', 'CHI')",Providence,vio36.xml,22,1,0,CHI,200,107,FAT
0,1,1,20,1.343734747,21,1,is,"('FAT', 'CHI')",Providence,vio36.xml,22,1,0,CHI,200,107,FAT
0,2,1,30,1.329135947,32,2,in,"('MOT', 'FAT')",Providence,vio36.xml,33,1,0,FAT,313,222,MOT
0,4,10,215,1.303818139,219,4,for,"('MOT', 'CHI')",Providence,vio36.xml,229,10,0,CHI,2275,1632,MOT
0,4,11,214,1.219240276,218,4,like,"('MOT', 'CHI')",Providence,vio36.xml,229,11,0,CHI,2275,1632,MOT
1,1,0,7,1.203972804,8,1,he,"('FAT', 'MOT')",Providence,vio36.xml,9,1,1,MOT,56,64,FAT
0,2,1,26,1.203972804,28,2,we,"('CHI', 'MOT')",Providence,vio36.xml,29,1,0,MOT,143,420,CHI
0,2,1,26,1.203972804,28,2,make,"('CHI', 'MOT')",Providence,vio36.xml,29,1,0,MOT,143,420,CHI
0,1,3,29,1.16315081,30,1,there,"('MOT', 'FAT')",Providence,vio36.xml,33,3,0,FAT,313,222,MOT
0,1,3,29,1.16315081,30,1,did,"('MOT', 'FAT')",Providence,vio36.xml,33,3,0,FAT,313,222,MOT
0,1,3,29,1.16315081,30,1,he,"('MOT', 'FAT')",Providence,vio36.xml,33,3,0,FAT,313,222,MOT
5,18,14,192,1.159384327,210,18,yeah,"('MOT', 'CHI')",Providence,vio36.xml,229,19,5,CHI,2275,1632,MOT
5,10,30,184,1.061060943,194,10,it,"('MOT', 'CHI')",Providence,vio36.xml,229,35,5,CHI,2275,1632,MOT
0,1,2,19,1.011600912,20,1,can,"('FAT', 'CHI')",Providence,vio36.xml,22,2,0,CHI,200,107,FAT
0,1,2,19,1.011600912,20,1,that,"('FAT', 'CHI')",Providence,vio36.xml,22,2,0,CHI,200,107,FAT
0,1,2,19,1.011600912,20,1,the,"('FAT', 'CHI')",Providence,vio36.xml,22,2,0,CHI,200,107,FAT
0,2,2,29,1.011600912,31,2,for,"('MOT', 'FAT')",Providence,vio36.xml,33,2,0,FAT,313,222,MOT
0,2,2,29,1.011600912,31,2,is,"('MOT', 'FAT')",Providence,vio36.xml,33,2,0,FAT,313,222,MOT
0,2,2,29,1.011600912,31,2,where,"('MOT', 'FAT')",Providence,vio36.xml,33,2,0,FAT,313,222,MOT
12,15,40,162,0.990762394,177,15,you,"('MOT', 'CHI')",Providence,vio36.xml,229,52,12,CHI,2275,1632,MOT
0,6,10,213,0.967345903,219,6,of,"('MOT', 'CHI')",Providence,vio36.xml,229,10,0,CHI,2275,1632,MOT
3,13,18,195,0.958850346,208,13,one,"('MOT', 'CHI')",Providence,vio36.xml,229,21,3,CHI,2275,1632,MOT
1,4,28,196,0.957989761,200,4,that,"('MOT', 'CHI')",Providence,vio36.xml,229,29,1,CHI,2275,1632,MOT
12,18,35,164,0.943625838,182,18,the,"('MOT', 'CHI')",Providence,vio36.xml,229,47,12,CHI,2275,1632,MOT
0,2,1,19,0.938269639,21,2,go,"('FAT', 'CHI')",Providence,vio36.xml,22,1,0,CHI,200,107,FAT
3,16,15,195,0.918640909,211,16,is,"('MOT', 'CHI')",Providence,vio36.xml,229,18,3,CHI,2275,1632,MOT
0,3,1,25,0.916290732,28,3,there,"('CHI', 'MOT')",Providence,vio36.xml,29,1,0,MOT,143,420,CHI
2,15,14,198,0.806289837,213,15,make,"('MOT', 'CHI')",Providence,vio36.xml,229,16,2,CHI,2275,1632,MOT
8,33,15,173,0.789526308,206,33,a,"('MOT', 'CHI')",Providence,vio36.xml,229,23,8,CHI,2275,1632,MOT
0,2,3,28,0.757685702,30,2,the,"('MOT', 'FAT')",Providence,vio36.xml,33,3,0,FAT,313,222,MOT
0,3,2,28,0.723918839,31,3,we,"('MOT', 'FAT')",Providence,vio36.xml,33,2,0,FAT,313,222,MOT
0,4,1,24,0.693147181,28,4,that,"('CHI', 'MOT')",Providence,vio36.xml,29,1,0,MOT,143,420,CHI
0,4,1,24,0.693147181,28,4,do,"('CHI', 'MOT')",Providence,vio36.xml,29,1,0,MOT,143,420,CHI
2,16,16,195,0.630958837,211,16,to,"('MOT', 'CHI')",Providence,vio36.xml,229,18,2,CHI,2275,1632,MOT
0,2,2,18,0.606135804,20,2,you,"('FAT', 'CHI')",Providence,vio36.xml,22,2,0,CHI,200,107,FAT
0,2,2,18,0.606135804,20,2,it,"('FAT', 'CHI')",Providence,vio36.xml,22,2,0,CHI,200,107,FAT
0,2,4,27,0.543615447,29,2,oh,"('MOT', 'FAT')",Providence,vio36.xml,33,4,0,FAT,313,222,MOT
0,5,1,23,0.510825624,28,5,and,"('CHI', 'MOT')",Providence,vio36.xml,29,1,0,MOT,143,420,CHI
0,1,4,17,0.510825624,18,1,have,"('FAT', 'CHI')",Providence,vio36.xml,22,4,0,CHI,200,107,FAT
0,1,1,7,0.510825624,8,1,you,"('FAT', 'MOT')",Providence,vio36.xml,9,1,0,MOT,56,64,FAT
0,1,1,7,0.510825624,8,1,no,"('FAT', 'MOT')",Providence,vio36.xml,9,1,0,MOT,56,64,FAT
2,2,10,19,0.496436886,21,2,you,"('MOT', 'FAT')",Providence,vio36.xml,33,12,2,FAT,313,222,MOT
1,3,6,23,0.441832752,26,3,that,"('MOT', 'FAT')",Providence,vio36.xml,33,7,1,FAT,313,222,MOT
1,4,4,20,0.395895657,24,4,this,"('CHI', 'MOT')",Providence,vio36.xml,29,5,1,MOT,143,420,CHI
3,28,15,183,0.384558423,211,28,this,"('MOT', 'CHI')",Providence,vio36.xml,229,18,3,CHI,2275,1632,MOT
2,15,23,189,0.358062869,204,15,and,"('MOT', 'CHI')",Providence,vio36.xml,229,25,2,CHI,2275,1632,MOT
0,2,3,17,0.336472237,19,2,to,"('FAT', 'CHI')",Providence,vio36.xml,22,3,0,CHI,200,107,FAT
1,1,1,2,0.223143551,3,1,a,"('BRO', 'FAT')",Providence,vio36.xml,5,2,1,FAT,27,38,BRO
0,2,5,22,0.2135741,24,2,yeah,"('CHI', 'MOT')",Providence,vio36.xml,29,5,0,MOT,143,420,CHI
0,3,1,9,0.15415068,12,3,and,"('CHI', 'FAT')",Providence,vio36.xml,13,1,0,FAT,46,129,CHI
1,8,3,21,0.138150338,29,8,it,"('MOT', 'FAT')",Providence,vio36.xml,33,4,1,FAT,313,222,MOT
0,1,2,6,0.117783036,7,1,is,"('FAT', 'MOT')",Providence,vio36.xml,9,2,0,MOT,56,64,FAT
0,2,1,6,0.105360516,8,2,yeah,"('FAT', 'MOT')",Providence,vio36.xml,9,1,0,MOT,56,64,FAT
0,1,1,3,0,4,1,go,"('BRO', 'FAT')",Providence,vio36.xml,5,1,0,FAT,27,38,BRO
0,1,1,3,0,4,1,up,"('BRO', 'FAT')",Providence,vio36.xml,5,1,0,FAT,27,38,BRO
0,1,1,3,0,4,1,it,"('MOT', 'BRO')",Providence,vio36.xml,5,1,0,BRO,72,33,MOT
0,1,1,3,0,4,1,that,"('MOT', 'BRO')",Providence,vio36.xml,5,1,0,BRO,72,33,MOT
0,6,3,24,-0.089612159,30,6,yeah,"('MOT', 'FAT')",Providence,vio36.xml,33,3,0,FAT,313,222,MOT
0,3,4,15,-0.182321557,18,3,a,"('FAT', 'CHI')",Providence,vio36.xml,22,4,0,CHI,200,107,FAT
0,4,6,19,-0.470003629,23,4,the,"('CHI', 'MOT')",Providence,vio36.xml,29,6,0,MOT,143,420,CHI
0,8,3,18,-0.47445798,26,8,you,"('CHI', 'MOT')",Providence,vio36.xml,29,3,0,MOT,143,420,CHI
0,6,5,22,-0.490622916,28,6,a,"('MOT', 'FAT')",Providence,vio36.xml,33,5,0,FAT,313,222,MOT
1,0,1,110,4.025351691,110,0,where,"('MOT', 'CHI')",Providence,vio37.xml,112,2,1,CHI,2305,548,MOT
1,0,2,109,3.793239469,109,0,look,"('MOT', 'CHI')",Providence,vio37.xml,112,3,1,CHI,2305,548,MOT
3,0,5,104,3.747148362,104,0,he,"('MOT', 'CHI')",Providence,vio37.xml,112,8,3,CHI,2305,548,MOT
1,0,4,107,3.438584914,107,0,we,"('MOT', 'CHI')",Providence,vio37.xml,112,5,1,CHI,2305,548,MOT
2,0,0,34,3.295836866,34,0,there,"('MOT', 'FAT')",Providence,vio37.xml,36,2,2,FAT,227,364,MOT
1,0,6,105,3.168751438,105,0,think,"('MOT', 'CHI')",Providence,vio37.xml,112,7,1,CHI,2305,548,MOT
1,1,2,108,3.100092289,109,1,have,"('MOT', 'CHI')",Providence,vio37.xml,112,3,1,CHI,2305,548,MOT
2,0,0,25,3.008154794,25,0,want,"('CHI', 'FAT')",Providence,vio37.xml,27,2,2,FAT,168,277,CHI
0,1,1,110,2.935628349,111,1,make,"('MOT', 'CHI')",Providence,vio37.xml,112,1,0,CHI,2305,548,MOT
2,1,5,104,2.881069365,105,1,do,"('MOT', 'CHI')",Providence,vio37.xml,112,7,2,CHI,2305,548,MOT
0,1,2,109,2.63905733,110,1,was,"('MOT', 'CHI')",Providence,vio37.xml,112,2,0,CHI,2305,548,MOT
1,2,0,53,2.538973871,55,2,was,"('CHI', 'MOT')",Providence,vio37.xml,56,1,1,MOT,318,1113,CHI
1,1,0,35,2.538973871,36,1,up,"('FAT', 'MOT')",Providence,vio37.xml,37,1,1,MOT,290,450,FAT
1,0,13,98,2.525728644,98,0,and,"('MOT', 'CHI')",Providence,vio37.xml,112,14,1,CHI,2305,548,MOT
2,2,5,103,2.475604257,105,2,some,"('MOT', 'CHI')",Providence,vio37.xml,112,7,2,CHI,2305,548,MOT
1,1,8,102,2.256065077,103,1,wanna,"('MOT', 'CHI')",Providence,vio37.xml,112,9,1,CHI,2305,548,MOT
0,1,1,54,2.251291799,55,1,he,"('CHI', 'MOT')",Providence,vio37.xml,56,1,0,MOT,318,1113,CHI
0,2,2,108,2.233592222,110,2,go,"('MOT', 'CHI')",Providence,vio37.xml,112,2,0,CHI,2305,548,MOT
1,1,1,34,2.224623552,35,1,for,"('FAT', 'MOT')",Providence,vio37.xml,37,2,1,MOT,290,450,FAT
0,1,4,107,2.215573716,108,1,put,"('MOT', 'CHI')",Providence,vio37.xml,112,4,0,CHI,2305,548,MOT
1,2,0,34,2.133508763,36,2,in,"('FAT', 'MOT')",Providence,vio37.xml,37,1,1,MOT,290,450,FAT
0,2,3,107,2.00148,109,2,my,"('MOT', 'CHI')",Providence,vio37.xml,112,3,0,CHI,2305,548,MOT
1,1,2,33,1.974081026,34,1,can,"('FAT', 'MOT')",Providence,vio37.xml,37,3,1,MOT,290,450,FAT
1,3,1,51,1.945910149,54,3,and,"('CHI', 'MOT')",Providence,vio37.xml,56,2,1,MOT,318,1113,CHI
1,1,2,32,1.945910149,33,1,did,"('MOT', 'FAT')",Providence,vio37.xml,36,3,1,FAT,227,364,MOT
0,1,6,105,1.909542505,106,1,little,"('MOT', 'CHI')",Providence,vio37.xml,112,6,0,CHI,2305,548,MOT
0,1,1,35,1.84582669,36,1,we,"('FAT', 'MOT')",Providence,vio37.xml,37,1,0,MOT,290,450,FAT
0,1,1,35,1.84582669,36,1,was,"('FAT', 'MOT')",Providence,vio37.xml,37,1,0,MOT,290,450,FAT
0,1,1,35,1.84582669,36,1,but,"('FAT', 'MOT')",Providence,vio37.xml,37,1,0,MOT,290,450,FAT
0,1,1,34,1.819158443,35,1,want,"('MOT', 'FAT')",Providence,vio37.xml,36,1,0,FAT,227,364,MOT
0,1,1,34,1.819158443,35,1,get,"('MOT', 'FAT')",Providence,vio37.xml,36,1,0,FAT,227,364,MOT
0,1,1,34,1.819158443,35,1,what,"('MOT', 'FAT')",Providence,vio37.xml,36,1,0,FAT,227,364,MOT
0,1,1,34,1.819158443,35,1,she,"('MOT', 'FAT')",Providence,vio37.xml,36,1,0,FAT,227,364,MOT
0,1,1,34,1.819158443,35,1,some,"('MOT', 'FAT')",Providence,vio37.xml,36,1,0,FAT,227,364,MOT
0,1,1,34,1.819158443,35,1,can,"('MOT', 'FAT')",Providence,vio37.xml,36,1,0,FAT,227,364,MOT
0,1,1,34,1.819158443,35,1,are,"('MOT', 'FAT')",Providence,vio37.xml,36,1,0,FAT,227,364,MOT
1,2,1,32,1.791759469,34,2,for,"('MOT', 'FAT')",Providence,vio37.xml,36,2,1,FAT,227,364,MOT
2,1,4,29,1.791759469,30,1,is,"('MOT', 'FAT')",Providence,vio37.xml,36,6,2,FAT,227,364,MOT
0,1,7,104,1.782457077,105,1,like,"('MOT', 'CHI')",Providence,vio37.xml,112,7,0,CHI,2305,548,MOT
0,4,2,106,1.722766598,110,4,want,"('MOT', 'CHI')",Providence,vio37.xml,112,2,0,CHI,2305,548,MOT
0,1,8,103,1.667706821,104,1,there,"('MOT', 'CHI')",Providence,vio37.xml,112,8,0,CHI,2305,548,MOT
1,2,11,98,1.580450376,100,2,on,"('MOT', 'CHI')",Providence,vio37.xml,112,12,1,CHI,2305,548,MOT
1,2,2,32,1.568615918,34,2,my,"('FAT', 'MOT')",Providence,vio37.xml,37,3,1,MOT,290,450,FAT
1,3,8,100,1.562917897,103,3,of,"('MOT', 'CHI')",Providence,vio37.xml,112,9,1,CHI,2305,548,MOT
0,3,1,52,1.558144618,55,3,with,"('CHI', 'MOT')",Providence,vio37.xml,56,1,0,MOT,318,1113,CHI
0,3,1,52,1.558144618,55,3,but,"('CHI', 'MOT')",Providence,vio37.xml,56,1,0,MOT,318,1113,CHI
0,3,1,52,1.558144618,55,3,did,"('CHI', 'MOT')",Providence,vio37.xml,56,1,0,MOT,318,1113,CHI
0,3,1,52,1.558144618,55,3,one,"('CHI', 'MOT')",Providence,vio37.xml,56,1,0,MOT,318,1113,CHI
3,2,4,28,1.556193398,30,2,the,"('FAT', 'MOT')",Providence,vio37.xml,37,7,3,MOT,290,450,FAT
2,6,1,47,1.550597412,53,6,in,"('CHI', 'MOT')",Providence,vio37.xml,56,3,2,MOT,318,1113,CHI
0,1,1,25,1.540445041,26,1,yeah,"('CHI', 'FAT')",Providence,vio37.xml,27,1,0,FAT,168,277,CHI
0,1,1,25,1.540445041,26,1,put,"('CHI', 'FAT')",Providence,vio37.xml,27,1,0,FAT,168,277,CHI
0,1,1,25,1.540445041,26,1,are,"('CHI', 'FAT')",Providence,vio37.xml,27,1,0,FAT,168,277,CHI
0,2,2,52,1.540445041,54,2,this,"('CHI', 'MOT')",Providence,vio37.xml,56,2,0,MOT,318,1113,CHI
1,2,2,31,1.540445041,33,2,it,"('MOT', 'FAT')",Providence,vio37.xml,36,3,1,FAT,227,364,MOT
1,2,2,31,1.540445041,33,2,a,"('MOT', 'FAT')",Providence,vio37.xml,36,3,1,FAT,227,364,MOT
0,1,2,34,1.531476371,35,1,with,"('FAT', 'MOT')",Providence,vio37.xml,37,2,0,MOT,290,450,FAT
0,1,2,34,1.531476371,35,1,this,"('FAT', 'MOT')",Providence,vio37.xml,37,2,0,MOT,290,450,FAT
0,1,2,34,1.531476371,35,1,that,"('FAT', 'MOT')",Providence,vio37.xml,37,2,0,MOT,290,450,FAT
0,1,2,34,1.531476371,35,1,one,"('FAT', 'MOT')",Providence,vio37.xml,37,2,0,MOT,290,450,FAT
0,1,2,33,1.504077397,34,1,gonna,"('MOT', 'FAT')",Providence,vio37.xml,36,2,0,FAT,227,364,MOT
0,1,2,33,1.504077397,34,1,of,"('MOT', 'FAT')",Providence,vio37.xml,36,2,0,FAT,227,364,MOT
0,1,2,33,1.504077397,34,1,my,"('MOT', 'FAT')",Providence,vio37.xml,36,2,0,FAT,227,364,MOT
0,2,6,104,1.504077397,106,2,but,"('MOT', 'CHI')",Providence,vio37.xml,112,6,0,CHI,2305,548,MOT
0,2,1,34,1.440361582,36,2,they,"('FAT', 'MOT')",Providence,vio37.xml,37,1,0,MOT,290,450,FAT
0,2,1,34,1.440361582,36,2,think,"('FAT', 'MOT')",Providence,vio37.xml,37,1,0,MOT,290,450,FAT
0,2,1,34,1.440361582,36,2,not,"('FAT', 'MOT')",Providence,vio37.xml,37,1,0,MOT,290,450,FAT
2,2,2,21,1.427116356,23,2,to,"('CHI', 'FAT')",Providence,vio37.xml,27,4,2,FAT,168,277,CHI
0,2,1,33,1.413693335,35,2,see,"('MOT', 'FAT')",Providence,vio37.xml,36,1,0,FAT,227,364,MOT
0,2,1,33,1.413693335,35,2,little,"('MOT', 'FAT')",Providence,vio37.xml,36,1,0,FAT,227,364,MOT
2,6,2,46,1.349926717,52,6,it,"('CHI', 'MOT')",Providence,vio37.xml,56,4,2,MOT,318,1113,CHI
3,4,15,90,1.345472367,94,4,one,"('MOT', 'CHI')",Providence,vio37.xml,112,18,3,CHI,2305,548,MOT
0,4,1,51,1.335001067,55,4,no,"('CHI', 'MOT')",Providence,vio37.xml,56,1,0,MOT,318,1113,CHI
0,4,1,51,1.335001067,55,4,are,"('CHI', 'MOT')",Providence,vio37.xml,56,1,0,MOT,318,1113,CHI
1,5,2,48,1.299282984,53,5,to,"('CHI', 'MOT')",Providence,vio37.xml,56,3,1,MOT,318,1113,CHI
1,6,0,30,1.286210903,36,6,to,"('FAT', 'MOT')",Providence,vio37.xml,37,1,1,MOT,290,450,FAT
1,4,1,30,1.280933845,34,4,to,"('MOT', 'FAT')",Providence,vio37.xml,36,2,1,FAT,227,364,MOT
4,1,42,65,1.264597426,66,1,you,"('MOT', 'CHI')",Providence,vio37.xml,112,46,4,CHI,2305,548,MOT
0,3,2,51,1.252762968,54,3,on,"('CHI', 'MOT')",Providence,vio37.xml,56,2,0,MOT,318,1113,CHI
0,1,3,32,1.252762968,33,1,but,"('MOT', 'FAT')",Providence,vio37.xml,36,3,0,FAT,227,364,MOT
0,3,1,33,1.15267951,36,3,have,"('FAT', 'MOT')",Providence,vio37.xml,37,1,0,MOT,290,450,FAT
0,3,1,33,1.15267951,36,3,and,"('FAT', 'MOT')",Providence,vio37.xml,37,1,0,MOT,290,450,FAT
0,2,1,24,1.134979933,26,2,no,"('CHI', 'FAT')",Providence,vio37.xml,27,1,0,FAT,168,277,CHI
0,2,2,33,1.126011263,35,2,of,"('FAT', 'MOT')",Providence,vio37.xml,37,2,0,MOT,290,450,FAT
1,5,1,30,1.126011263,35,5,a,"('FAT', 'MOT')",Providence,vio37.xml,37,2,1,MOT,290,450,FAT
0,2,2,32,1.098612289,34,2,go,"('MOT', 'FAT')",Providence,vio37.xml,36,2,0,FAT,227,364,MOT
0,2,2,32,1.098612289,34,2,do,"('MOT', 'FAT')",Providence,vio37.xml,36,2,0,FAT,227,364,MOT
0,1,15,96,1.068759326,97,1,see,"('MOT', 'CHI')",Providence,vio37.xml,112,15,0,CHI,2305,548,MOT
1,4,2,29,1.029619417,33,4,that,"('MOT', 'FAT')",Providence,vio37.xml,36,3,1,FAT,227,364,MOT
1,7,2,46,1.011600912,53,7,a,"('CHI', 'MOT')",Providence,vio37.xml,56,3,1,MOT,318,1113,CHI
0,1,1,13,0.980829253,14,1,what,"('FAT', 'CHI')",Providence,vio37.xml,15,1,0,CHI,95,112,FAT
0,1,1,13,0.980829253,14,1,on,"('FAT', 'CHI')",Providence,vio37.xml,15,1,0,CHI,95,112,FAT
0,1,1,13,0.980829253,14,1,and,"('FAT', 'CHI')",Providence,vio37.xml,15,1,0,CHI,95,112,FAT
0,4,1,32,0.929535959,36,4,do,"('FAT', 'MOT')",Providence,vio37.xml,37,1,0,MOT,290,450,FAT
3,3,28,78,0.922333046,81,3,the,"('MOT', 'CHI')",Providence,vio37.xml,112,31,3,CHI,2305,548,MOT
0,1,5,31,0.887303195,32,1,is,"('FAT', 'MOT')",Providence,vio37.xml,37,5,0,MOT,290,450,FAT
0,1,18,93,0.875468737,94,1,in,"('MOT', 'CHI')",Providence,vio37.xml,112,18,0,CHI,2305,548,MOT
1,3,17,91,0.875468737,94,3,that,"('MOT', 'CHI')",Providence,vio37.xml,112,18,1,CHI,2305,548,MOT
1,7,8,96,0.869770716,103,7,what,"('MOT', 'CHI')",Providence,vio37.xml,112,9,1,CHI,2305,548,MOT
0,3,1,23,0.84729786,26,3,there,"('CHI', 'FAT')",Providence,vio37.xml,27,1,0,FAT,168,277,CHI
0,5,2,49,0.84729786,54,5,my,"('CHI', 'MOT')",Providence,vio37.xml,56,2,0,MOT,318,1113,CHI
0,2,3,31,0.84729786,33,2,not,"('MOT', 'FAT')",Providence,vio37.xml,36,3,0,FAT,227,364,MOT
0,3,2,32,0.83832919,35,3,are,"('FAT', 'MOT')",Providence,vio37.xml,37,2,0,MOT,290,450,FAT
2,6,1,18,0.801360765,24,6,it,"('CHI', 'FAT')",Providence,vio37.xml,27,3,2,FAT,168,277,CHI
4,6,4,23,0.794929875,29,6,you,"('FAT', 'MOT')",Providence,vio37.xml,37,8,4,MOT,290,450,FAT
0,4,3,49,0.78845736,53,4,can,"('CHI', 'MOT')",Providence,vio37.xml,56,3,0,MOT,318,1113,CHI
0,4,8,100,0.751416089,104,4,no,"('MOT', 'CHI')",Providence,vio37.xml,112,8,0,CHI,2305,548,MOT
3,10,12,87,0.750305594,97,10,this,"('MOT', 'CHI')",Providence,vio37.xml,112,15,3,CHI,2305,548,MOT
0,5,1,30,0.720546155,35,5,and,"('MOT', 'FAT')",Providence,vio37.xml,36,1,0,FAT,227,364,MOT
2,9,4,41,0.667829373,50,9,the,"('CHI', 'MOT')",Providence,vio37.xml,56,6,2,MOT,318,1113,CHI
1,6,1,19,0.656779536,25,6,the,"('CHI', 'FAT')",Providence,vio37.xml,27,2,1,FAT,168,277,CHI
1,4,4,27,0.634306681,31,4,no,"('MOT', 'FAT')",Providence,vio37.xml,36,5,1,FAT,227,364,MOT
3,6,22,81,0.633183716,87,6,is,"('MOT', 'CHI')",Providence,vio37.xml,112,25,3,CHI,2305,548,MOT
0,4,2,30,0.587786665,34,4,on,"('MOT', 'FAT')",Providence,vio37.xml,36,2,0,FAT,227,364,MOT
2,6,4,25,0.569768159,31,6,it,"('FAT', 'MOT')",Providence,vio37.xml,37,6,2,MOT,290,450,FAT
0,5,8,99,0.569094532,104,5,can,"('MOT', 'CHI')",Providence,vio37.xml,112,8,0,CHI,2305,548,MOT
1,0,3,3,0.510825624,3,0,of,"('TOY', 'MOT')",Providence,vio37.xml,7,4,1,MOT,137,59,TOY
1,6,14,91,0.509143538,97,6,it,"('MOT', 'CHI')",Providence,vio37.xml,112,15,1,CHI,2305,548,MOT
3,15,3,35,0.485507816,50,15,you,"('CHI', 'MOT')",Providence,vio37.xml,56,6,3,MOT,318,1113,CHI
0,2,5,30,0.481838087,32,2,oh,"('FAT', 'MOT')",Providence,vio37.xml,37,5,0,MOT,290,450,FAT
0,2,5,29,0.451985124,31,2,yeah,"('MOT', 'FAT')",Providence,vio37.xml,36,5,0,FAT,227,364,MOT
0,3,14,95,0.446287103,98,3,a,"('MOT', 'CHI')",Providence,vio37.xml,112,14,0,CHI,2305,548,MOT
0,5,1,21,0.441832752,26,5,what,"('CHI', 'FAT')",Providence,vio37.xml,27,1,0,FAT,168,277,CHI
0,3,4,30,0.377294231,33,3,what,"('FAT', 'MOT')",Providence,vio37.xml,37,4,0,MOT,290,450,FAT
0,4,3,29,0.336472237,33,4,oh,"('MOT', 'FAT')",Providence,vio37.xml,36,3,0,FAT,227,364,MOT
0,5,3,29,0.182321557,34,5,yeah,"('FAT', 'MOT')",Providence,vio37.xml,37,3,0,MOT,290,450,FAT
0,4,15,93,0.152468594,97,4,to,"('MOT', 'CHI')",Providence,vio37.xml,112,15,0,CHI,2305,548,MOT
2,7,6,21,0.117783036,28,7,you,"('MOT', 'FAT')",Providence,vio37.xml,36,8,2,FAT,227,364,MOT
0,9,3,44,0.09531018,53,9,is,"('CHI', 'MOT')",Providence,vio37.xml,56,3,0,MOT,318,1113,CHI
0,1,1,1,-0.405465108,2,1,a,"('MOT', 'TOY')",Providence,vio37.xml,3,1,0,TOY,19,20,MOT
0,15,8,89,-0.411734721,104,15,yeah,"('MOT', 'CHI')",Providence,vio37.xml,112,8,0,CHI,2305,548,MOT
0,8,4,24,-0.462623522,32,8,the,"('MOT', 'FAT')",Providence,vio37.xml,36,4,0,FAT,227,364,MOT
0,1,4,2,-0.875468737,3,1,are,"('TOY', 'MOT')",Providence,vio37.xml,7,4,0,MOT,137,59,TOY
1,3,0,194,3.501545355,197,3,where,"('CHI', 'MOT')",Providence,vio38.xml,198,1,1,MOT,1116,3528,CHI
1,5,0,192,3.096080247,197,5,have,"('CHI', 'MOT')",Providence,vio38.xml,198,1,1,MOT,1116,3528,CHI
1,4,2,191,2.757475084,195,4,my,"('CHI', 'MOT')",Providence,vio38.xml,198,3,1,MOT,1116,3528,CHI
2,0,3,32,2.679062664,32,0,up,"('MOT', 'CHI')",Providence,vio38.xml,37,5,2,CHI,724,215,MOT
1,0,2,34,2.667228207,34,0,it,"('MOT', 'CHI')",Providence,vio38.xml,37,3,1,CHI,724,215,MOT
0,4,1,193,2.585254624,197,4,get,"('CHI', 'MOT')",Providence,vio38.xml,198,1,0,MOT,1116,3528,CHI
0,4,1,193,2.585254624,197,4,with,"('CHI', 'MOT')",Providence,vio38.xml,198,1,0,MOT,1116,3528,CHI
0,4,1,193,2.585254624,197,4,make,"('CHI', 'MOT')",Providence,vio38.xml,198,1,0,MOT,1116,3528,CHI
0,4,1,193,2.585254624,197,4,up,"('CHI', 'MOT')",Providence,vio38.xml,198,1,0,MOT,1116,3528,CHI
0,4,1,193,2.585254624,197,4,think,"('CHI', 'MOT')",Providence,vio38.xml,198,1,0,MOT,1116,3528,CHI
1,5,2,190,2.575153528,195,5,are,"('CHI', 'MOT')",Providence,vio38.xml,198,3,1,MOT,1116,3528,CHI
0,2,3,193,2.575153528,195,2,on,"('CHI', 'MOT')",Providence,vio38.xml,198,3,0,MOT,1116,3528,CHI
1,0,3,33,2.456735773,33,0,all,"('MOT', 'CHI')",Providence,vio38.xml,37,4,1,CHI,724,215,MOT
0,5,1,192,2.402933067,197,5,little,"('CHI', 'MOT')",Providence,vio38.xml,198,1,0,MOT,1116,3528,CHI
0,5,1,192,2.402933067,197,5,can,"('CHI', 'MOT')",Providence,vio38.xml,198,1,0,MOT,1116,3528,CHI
0,3,3,192,2.287471455,195,3,want,"('CHI', 'MOT')",Providence,vio38.xml,198,3,0,MOT,1116,3528,CHI
0,6,1,191,2.248782387,197,6,all,"('CHI', 'MOT')",Providence,vio38.xml,198,1,0,MOT,1116,3528,CHI
0,7,1,190,2.115250994,197,7,some,"('CHI', 'MOT')",Providence,vio38.xml,198,1,0,MOT,1116,3528,CHI
0,5,2,191,2.1102132,196,5,not,"('CHI', 'MOT')",Providence,vio38.xml,198,2,0,MOT,1116,3528,CHI
0,2,6,190,2.089804329,192,2,no,"('CHI', 'MOT')",Providence,vio38.xml,198,6,0,MOT,1116,3528,CHI
0,4,3,191,2.064327904,195,4,but,"('CHI', 'MOT')",Providence,vio38.xml,198,3,0,MOT,1116,3528,CHI
0,6,2,190,1.956062521,196,6,there,"('CHI', 'MOT')",Providence,vio38.xml,198,2,0,MOT,1116,3528,CHI
1,0,0,8,1.897119985,8,0,and,"('MOT', 'FAT')",Providence,vio38.xml,9,1,1,FAT,94,31,MOT
0,5,3,190,1.882006347,195,5,he,"('CHI', 'MOT')",Providence,vio38.xml,198,3,0,MOT,1116,3528,CHI
0,1,1,35,1.84582669,36,1,oh,"('MOT', 'CHI')",Providence,vio38.xml,37,1,0,CHI,724,215,MOT
0,7,2,189,1.822531128,196,7,oh,"('CHI', 'MOT')",Providence,vio38.xml,198,2,0,MOT,1116,3528,CHI
0,10,1,187,1.796797263,197,10,for,"('CHI', 'MOT')",Providence,vio38.xml,198,1,0,MOT,1116,3528,CHI
0,11,1,186,1.709785886,197,11,they,"('CHI', 'MOT')",Providence,vio38.xml,198,1,0,MOT,1116,3528,CHI
1,1,4,31,1.580450376,32,1,is,"('MOT', 'CHI')",Providence,vio38.xml,37,5,1,CHI,724,215,MOT
0,13,1,184,1.555635206,197,13,do,"('CHI', 'MOT')",Providence,vio38.xml,198,1,0,MOT,1116,3528,CHI
0,1,2,34,1.531476371,35,1,he,"('MOT', 'CHI')",Providence,vio38.xml,37,2,0,CHI,724,215,MOT
0,8,3,187,1.476541239,195,8,big,"('CHI', 'MOT')",Providence,vio38.xml,198,3,0,MOT,1116,3528,CHI
0,2,1,34,1.440361582,36,2,what,"('MOT', 'CHI')",Providence,vio38.xml,37,1,0,CHI,724,215,MOT
1,1,5,30,1.41706602,31,1,to,"('MOT', 'CHI')",Providence,vio38.xml,37,6,1,CHI,724,215,MOT
2,15,5,176,1.391489178,191,15,it,"('CHI', 'MOT')",Providence,vio38.xml,198,7,2,MOT,1116,3528,CHI
3,1,9,24,1.349926717,25,1,the,"('MOT', 'CHI')",Providence,vio38.xml,37,12,3,CHI,724,215,MOT
0,8,4,186,1.289130613,194,8,go,"('CHI', 'MOT')",Providence,vio38.xml,198,4,0,MOT,1116,3528,CHI
0,1,3,33,1.280933845,34,1,of,"('MOT', 'CHI')",Providence,vio38.xml,37,3,0,CHI,724,215,MOT
0,1,3,33,1.280933845,34,1,there,"('MOT', 'CHI')",Providence,vio38.xml,37,3,0,CHI,724,215,MOT
0,1,3,33,1.280933845,34,1,that,"('MOT', 'CHI')",Providence,vio38.xml,37,3,0,CHI,724,215,MOT
2,24,3,169,1.206825873,193,24,like,"('CHI', 'MOT')",Providence,vio38.xml,198,5,2,MOT,1116,3528,CHI
1,1,7,28,1.131402111,29,1,and,"('MOT', 'CHI')",Providence,vio38.xml,37,8,1,CHI,724,215,MOT
0,7,6,185,1.108975076,192,7,to,"('CHI', 'MOT')",Providence,vio38.xml,198,6,0,MOT,1116,3528,CHI
0,1,4,32,1.070441412,33,1,little,"('MOT', 'CHI')",Providence,vio38.xml,37,4,0,CHI,724,215,MOT
1,19,4,174,1.024504317,193,19,of,"('CHI', 'MOT')",Providence,vio38.xml,198,5,1,MOT,1116,3528,CHI
1,0,0,2,0.980829253,2,0,this,"('MOT', 'BRO')",Providence,vio38.xml,3,1,1,BRO,71,21,MOT
5,29,8,156,0.913620503,185,29,that,"('CHI', 'MOT')",Providence,vio38.xml,198,13,5,MOT,1116,3528,CHI
0,2,3,32,0.875468737,34,2,put,"('MOT', 'CHI')",Providence,vio38.xml,37,3,0,CHI,724,215,MOT
2,21,7,168,0.861947991,189,21,is,"('CHI', 'MOT')",Providence,vio38.xml,198,9,2,MOT,1116,3528,CHI
2,15,11,170,0.849081982,185,15,what,"('CHI', 'MOT')",Providence,vio38.xml,198,13,2,MOT,1116,3528,CHI
1,0,3,5,0.84729786,5,0,you,"('MOT', 'FAT')",Providence,vio38.xml,9,4,1,FAT,94,31,MOT
1,24,4,169,0.801360765,193,24,we,"('CHI', 'MOT')",Providence,vio38.xml,198,5,1,MOT,1116,3528,CHI
0,14,4,180,0.778304989,194,14,at,"('CHI', 'MOT')",Providence,vio38.xml,198,4,0,MOT,1116,3528,CHI
0,5,1,31,0.747214402,36,5,yeah,"('MOT', 'CHI')",Providence,vio38.xml,37,1,0,CHI,724,215,MOT
0,15,4,179,0.713766468,194,15,in,"('CHI', 'MOT')",Providence,vio38.xml,198,4,0,MOT,1116,3528,CHI
6,36,11,145,0.60003941,181,36,the,"('CHI', 'MOT')",Providence,vio38.xml,198,17,6,MOT,1116,3528,CHI
0,17,4,177,0.595983432,194,17,look,"('CHI', 'MOT')",Providence,vio38.xml,198,4,0,MOT,1116,3528,CHI
0,1,1,7,0.510825624,8,1,they,"('MOT', 'FAT')",Providence,vio38.xml,9,1,0,FAT,94,31,MOT
0,1,1,7,0.510825624,8,1,that,"('MOT', 'FAT')",Providence,vio38.xml,9,1,0,FAT,94,31,MOT
10,38,19,131,0.442009979,169,38,one,"('CHI', 'MOT')",Providence,vio38.xml,198,29,10,MOT,1116,3528,CHI
0,4,3,30,0.364643114,34,4,this,"('MOT', 'CHI')",Providence,vio38.xml,37,3,0,CHI,724,215,MOT
0,2,7,28,0.169899037,30,2,in,"('MOT', 'CHI')",Providence,vio38.xml,37,7,0,CHI,724,215,MOT
0,1,1,4,0.15415068,5,1,to,"('FAT', 'MOT')",Providence,vio38.xml,6,1,0,MOT,29,45,FAT
0,2,1,6,0.105360516,8,2,are,"('MOT', 'FAT')",Providence,vio38.xml,9,1,0,FAT,94,31,MOT
0,2,8,27,0.032789823,29,2,a,"('MOT', 'CHI')",Providence,vio38.xml,37,8,0,CHI,724,215,MOT
1,9,30,158,0.023953241,167,9,yeah,"('CHI', 'MOT')",Providence,vio38.xml,198,31,1,MOT,1116,3528,CHI
1,22,14,161,-0.055204554,183,22,and,"('CHI', 'MOT')",Providence,vio38.xml,198,15,1,MOT,1116,3528,CHI
5,38,24,131,-0.164125825,169,38,this,"('CHI', 'MOT')",Providence,vio38.xml,198,29,5,MOT,1116,3528,CHI
0,2,1,3,-0.251314428,5,2,it,"('FAT', 'MOT')",Providence,vio38.xml,6,1,0,MOT,29,45,FAT
0,2,2,5,-0.287682072,7,2,yeah,"('MOT', 'FAT')",Providence,vio38.xml,9,2,0,FAT,94,31,MOT
0,1,1,1,-0.405465108,2,1,for,"('MOT', 'BRO')",Providence,vio38.xml,3,1,0,BRO,71,21,MOT
0,1,1,1,-0.405465108,2,1,no,"('MOT', 'BRO')",Providence,vio38.xml,3,1,0,BRO,71,21,MOT
0,1,1,1,-0.405465108,2,1,to,"('MOT', 'BRO')",Providence,vio38.xml,3,1,0,BRO,71,21,MOT
0,1,1,1,-0.405465108,2,1,and,"('MOT', 'BRO')",Providence,vio38.xml,3,1,0,BRO,71,21,MOT
0,44,5,149,-0.47957308,193,44,you,"('CHI', 'MOT')",Providence,vio38.xml,198,5,0,MOT,1116,3528,CHI
0,6,6,25,-0.528844129,31,6,one,"('MOT', 'CHI')",Providence,vio38.xml,37,6,0,CHI,724,215,MOT
1,41,14,142,-0.657379957,183,41,a,"('CHI', 'MOT')",Providence,vio38.xml,198,15,1,MOT,1116,3528,CHI
1,0,1,51,3.277144733,51,0,are,"('BRO', 'MOT')",Providence,vio39.xml,53,2,1,MOT,275,727,BRO
1,1,0,51,2.890371758,52,1,she,"('BRO', 'MOT')",Providence,vio39.xml,53,1,1,MOT,275,727,BRO
0,2,1,146,2.813410717,148,2,not,"('CHI', 'MOT')",Providence,vio39.xml,149,1,0,MOT,729,1978,CHI
1,0,0,21,2.730029108,21,0,in,"('UNI', 'MOT')",Providence,vio39.xml,22,1,1,MOT,82,326,UNI
1,1,1,50,2.583997552,51,1,make,"('BRO', 'MOT')",Providence,vio39.xml,53,2,1,MOT,275,727,BRO
0,3,1,145,2.525728644,148,3,get,"('CHI', 'MOT')",Providence,vio39.xml,149,1,0,MOT,729,1978,CHI
1,7,0,141,2.525728644,148,7,big,"('CHI', 'MOT')",Providence,vio39.xml,149,1,1,MOT,729,1978,CHI
1,0,3,35,2.512305624,35,0,we,"('MOT', 'BRO')",Providence,vio39.xml,39,4,1,BRO,543,188,MOT
0,4,1,144,2.302585093,148,4,make,"('CHI', 'MOT')",Providence,vio39.xml,149,1,0,MOT,729,1978,CHI
2,11,0,136,2.231357584,147,11,little,"('CHI', 'MOT')",Providence,vio39.xml,149,2,2,MOT,729,1978,CHI
0,1,6,142,2.20414502,143,1,where,"('CHI', 'MOT')",Providence,vio39.xml,149,6,0,MOT,729,1978,CHI
0,1,1,51,2.197224577,52,1,little,"('BRO', 'MOT')",Providence,vio39.xml,53,1,0,MOT,275,727,BRO
1,2,1,49,2.178532444,51,2,can,"('BRO', 'MOT')",Providence,vio39.xml,53,2,1,MOT,275,727,BRO
1,1,2,41,2.174751721,42,1,one,"('MOT', 'CHI')",Providence,vio39.xml,45,3,1,CHI,726,181,MOT
1,0,0,11,2.159484249,11,0,put,"('BRO', 'CHI')",Providence,vio39.xml,12,1,1,CHI,60,85,BRO
1,5,3,140,2.100060829,145,5,on,"('CHI', 'MOT')",Providence,vio39.xml,149,4,1,MOT,729,1978,CHI
1,0,6,32,2.022283128,32,0,this,"('MOT', 'BRO')",Providence,vio39.xml,39,7,1,BRO,543,188,MOT
1,9,1,138,2.008214032,147,9,of,"('CHI', 'MOT')",Providence,vio39.xml,149,2,1,MOT,729,1978,CHI
0,1,1,37,1.897119985,38,1,all,"('MOT', 'BRO')",Providence,vio39.xml,39,1,0,BRO,543,188,MOT
0,1,1,37,1.897119985,38,1,my,"('MOT', 'BRO')",Providence,vio39.xml,39,1,0,BRO,543,188,MOT
0,1,1,37,1.897119985,38,1,think,"('MOT', 'BRO')",Providence,vio39.xml,39,1,0,BRO,543,188,MOT
0,1,2,50,1.890850372,51,1,my,"('BRO', 'MOT')",Providence,vio39.xml,53,2,0,MOT,275,727,BRO
1,3,1,48,1.890850372,51,3,there,"('BRO', 'MOT')",Providence,vio39.xml,53,2,1,MOT,275,727,BRO
4,9,5,131,1.864784604,140,9,one,"('CHI', 'MOT')",Providence,vio39.xml,149,9,4,MOT,729,1978,CHI
0,7,1,141,1.832581464,148,7,but,"('CHI', 'MOT')",Providence,vio39.xml,149,1,0,MOT,729,1978,CHI
0,7,1,141,1.832581464,148,7,wanna,"('CHI', 'MOT')",Providence,vio39.xml,149,1,0,MOT,729,1978,CHI
0,5,2,142,1.825892476,147,5,there,"('CHI', 'MOT')",Providence,vio39.xml,149,2,0,MOT,729,1978,CHI
0,5,2,142,1.825892476,147,5,are,"('CHI', 'MOT')",Providence,vio39.xml,149,2,0,MOT,729,1978,CHI
2,2,2,33,1.819158443,35,2,a,"('MOT', 'BRO')",Providence,vio39.xml,39,4,2,BRO,543,188,MOT
1,1,3,34,1.819158443,35,1,do,"('MOT', 'BRO')",Providence,vio39.xml,39,4,1,BRO,543,188,MOT
0,2,1,50,1.791759469,52,2,look,"('BRO', 'MOT')",Providence,vio39.xml,53,1,0,MOT,275,727,BRO
0,2,1,50,1.791759469,52,2,he,"('BRO', 'MOT')",Providence,vio39.xml,53,1,0,MOT,275,727,BRO
0,2,1,50,1.791759469,52,2,on,"('BRO', 'MOT')",Providence,vio39.xml,53,1,0,MOT,275,727,BRO
1,4,7,137,1.743968805,141,4,have,"('CHI', 'MOT')",Providence,vio39.xml,149,8,1,MOT,729,1978,CHI
0,1,2,42,1.727220948,43,1,look,"('MOT', 'CHI')",Providence,vio39.xml,45,2,0,CHI,726,181,MOT
1,10,2,136,1.683026269,146,10,he,"('CHI', 'MOT')",Providence,vio39.xml,149,3,1,MOT,729,1978,CHI
1,10,2,136,1.683026269,146,10,and,"('CHI', 'MOT')",Providence,vio39.xml,149,3,1,MOT,729,1978,CHI
0,1,3,49,1.648658626,50,1,no,"('BRO', 'MOT')",Providence,vio39.xml,53,3,0,MOT,275,727,BRO
1,3,2,47,1.648658626,50,3,go,"('BRO', 'MOT')",Providence,vio39.xml,53,3,1,MOT,275,727,BRO
1,6,5,137,1.644529232,143,6,want,"('CHI', 'MOT')",Providence,vio39.xml,149,6,1,MOT,729,1978,CHI
1,1,4,33,1.637608789,34,1,go,"('MOT', 'BRO')",Providence,vio39.xml,39,5,1,BRO,543,188,MOT
1,1,5,38,1.634130525,39,1,he,"('MOT', 'CHI')",Providence,vio39.xml,45,6,1,CHI,726,181,MOT
1,2,0,19,1.631416819,21,2,a,"('UNI', 'MOT')",Providence,vio39.xml,22,1,1,MOT,82,326,UNI
1,0,1,8,1.609437912,8,0,yeah,"('FAT', 'MOT')",Providence,vio39.xml,10,2,1,MOT,56,153,FAT
0,5,3,141,1.596014892,146,5,no,"('CHI', 'MOT')",Providence,vio39.xml,149,3,0,MOT,729,1978,CHI
0,5,3,141,1.596014892,146,5,some,"('CHI', 'MOT')",Providence,vio39.xml,149,3,0,MOT,729,1978,CHI
0,1,2,36,1.584120104,37,1,in,"('MOT', 'BRO')",Providence,vio39.xml,39,2,0,BRO,543,188,MOT
0,1,2,36,1.584120104,37,1,was,"('MOT', 'BRO')",Providence,vio39.xml,39,2,0,BRO,543,188,MOT
0,3,1,49,1.504077397,52,3,like,"('BRO', 'MOT')",Providence,vio39.xml,53,1,0,MOT,275,727,BRO
0,3,1,49,1.504077397,52,3,put,"('BRO', 'MOT')",Providence,vio39.xml,53,1,0,MOT,275,727,BRO
0,2,1,36,1.491654877,38,2,she,"('MOT', 'BRO')",Providence,vio39.xml,39,1,0,BRO,543,188,MOT
0,2,2,49,1.485385264,51,2,it,"('BRO', 'MOT')",Providence,vio39.xml,53,2,0,MOT,275,727,BRO
0,1,3,41,1.481604541,42,1,like,"('MOT', 'CHI')",Providence,vio39.xml,45,3,0,CHI,726,181,MOT
0,1,3,41,1.481604541,42,1,but,"('MOT', 'CHI')",Providence,vio39.xml,45,3,0,CHI,726,181,MOT
0,1,3,41,1.481604541,42,1,put,"('MOT', 'CHI')",Providence,vio39.xml,45,3,0,CHI,726,181,MOT
0,1,3,41,1.481604541,42,1,do,"('MOT', 'CHI')",Providence,vio39.xml,45,3,0,CHI,726,181,MOT
1,1,0,10,1.466337069,11,1,up,"('BRO', 'CHI')",Providence,vio39.xml,12,1,1,CHI,60,85,BRO
0,8,2,139,1.420427367,147,8,like,"('CHI', 'MOT')",Providence,vio39.xml,149,2,0,MOT,729,1978,CHI
0,1,3,35,1.335001067,36,1,of,"('MOT', 'BRO')",Providence,vio39.xml,39,3,0,BRO,543,188,MOT
0,9,2,138,1.315066852,147,9,what,"('CHI', 'MOT')",Providence,vio39.xml,149,2,0,MOT,729,1978,CHI
0,7,3,139,1.30833282,146,7,do,"('CHI', 'MOT')",Providence,vio39.xml,149,3,0,MOT,729,1978,CHI
0,4,1,48,1.280933845,52,4,of,"('BRO', 'MOT')",Providence,vio39.xml,53,1,0,MOT,275,727,BRO
0,5,5,139,1.245937003,144,5,look,"('CHI', 'MOT')",Providence,vio39.xml,149,5,0,MOT,729,1978,CHI
0,3,2,48,1.197703191,51,3,but,"('BRO', 'MOT')",Providence,vio39.xml,53,2,0,MOT,275,727,BRO
2,18,3,126,1.191869782,144,18,it,"('CHI', 'MOT')",Providence,vio39.xml,149,5,2,MOT,729,1978,CHI
0,8,3,138,1.190549784,146,8,oh,"('CHI', 'MOT')",Providence,vio39.xml,149,3,0,MOT,729,1978,CHI
1,0,2,6,1.16315081,6,0,yeah,"('CHI', 'BRO')",Providence,vio39.xml,9,3,1,BRO,30,54,CHI
0,1,4,34,1.126011263,35,1,want,"('MOT', 'BRO')",Providence,vio39.xml,39,4,0,BRO,543,188,MOT
0,1,4,34,1.126011263,35,1,for,"('MOT', 'BRO')",Providence,vio39.xml,39,4,0,BRO,543,188,MOT
1,1,9,34,1.126011263,35,1,a,"('MOT', 'CHI')",Providence,vio39.xml,45,10,1,CHI,726,181,MOT
0,5,1,47,1.098612289,52,5,in,"('BRO', 'MOT')",Providence,vio39.xml,53,1,0,MOT,275,727,BRO
0,5,1,47,1.098612289,52,5,what,"('BRO', 'MOT')",Providence,vio39.xml,53,1,0,MOT,275,727,BRO
0,5,1,47,1.098612289,52,5,do,"('BRO', 'MOT')",Providence,vio39.xml,53,1,0,MOT,275,727,BRO
0,5,1,47,1.098612289,52,5,not,"('BRO', 'MOT')",Providence,vio39.xml,53,1,0,MOT,275,727,BRO
0,1,5,39,1.098612289,40,1,go,"('MOT', 'CHI')",Providence,vio39.xml,45,5,0,CHI,726,181,MOT
0,2,3,40,1.076139433,42,2,up,"('MOT', 'CHI')",Providence,vio39.xml,45,3,0,CHI,726,181,MOT
2,10,1,40,1.042522822,50,10,you,"('BRO', 'MOT')",Providence,vio39.xml,53,3,2,MOT,275,727,BRO
0,17,1,131,1.021651248,148,17,can,"('CHI', 'MOT')",Providence,vio39.xml,149,1,0,MOT,729,1978,CHI
0,4,1,34,0.980829253,38,4,make,"('MOT', 'BRO')",Providence,vio39.xml,39,1,0,BRO,543,188,MOT
0,4,1,34,0.980829253,38,4,can,"('MOT', 'BRO')",Providence,vio39.xml,39,1,0,BRO,543,188,MOT
0,6,1,46,0.944461609,52,6,oh,"('BRO', 'MOT')",Providence,vio39.xml,53,1,0,MOT,275,727,BRO
0,1,6,38,0.940983344,39,1,is,"('MOT', 'CHI')",Providence,vio39.xml,45,6,0,CHI,726,181,MOT
0,1,6,38,0.940983344,39,1,can,"('MOT', 'CHI')",Providence,vio39.xml,45,6,0,CHI,726,181,MOT
0,2,1,19,0.938269639,21,2,what,"('UNI', 'MOT')",Providence,vio39.xml,22,1,0,MOT,82,326,UNI
0,2,1,19,0.938269639,21,2,but,"('UNI', 'MOT')",Providence,vio39.xml,22,1,0,MOT,82,326,UNI
0,2,4,39,0.870828358,41,2,on,"('MOT', 'CHI')",Providence,vio39.xml,45,4,0,CHI,726,181,MOT
1,25,2,121,0.822825004,146,25,that,"('CHI', 'MOT')",Providence,vio39.xml,149,3,1,MOT,729,1978,CHI
1,1,12,31,0.818310324,32,1,this,"('MOT', 'CHI')",Providence,vio39.xml,45,13,1,CHI,726,181,MOT
2,3,0,7,0.810930216,10,3,the,"('BRO', 'CHI')",Providence,vio39.xml,12,2,2,CHI,60,85,BRO
0,1,1,10,0.773189888,11,1,in,"('BRO', 'CHI')",Providence,vio39.xml,12,1,0,CHI,60,85,BRO
0,1,1,10,0.773189888,11,1,of,"('BRO', 'CHI')",Providence,vio39.xml,12,1,0,CHI,60,85,BRO
0,1,1,10,0.773189888,11,1,little,"('BRO', 'CHI')",Providence,vio39.xml,12,1,0,CHI,60,85,BRO
6,22,11,110,0.763816754,132,22,the,"('CHI', 'MOT')",Providence,vio39.xml,149,17,6,MOT,729,1978,CHI
0,2,5,38,0.693147181,40,2,have,"('MOT', 'CHI')",Providence,vio39.xml,45,5,0,CHI,726,181,MOT
0,3,1,18,0.650587566,21,3,oh,"('UNI', 'MOT')",Providence,vio39.xml,22,1,0,MOT,82,326,UNI
0,15,3,131,0.615185639,146,15,put,"('CHI', 'MOT')",Providence,vio39.xml,149,3,0,MOT,729,1978,CHI
0,1,1,8,0.606135804,9,1,in,"('FAT', 'MOT')",Providence,vio39.xml,10,1,0,MOT,56,153,FAT
0,1,1,8,0.606135804,9,1,it,"('FAT', 'MOT')",Providence,vio39.xml,10,1,0,MOT,56,153,FAT
0,1,1,8,0.606135804,9,1,a,"('FAT', 'MOT')",Providence,vio39.xml,10,1,0,MOT,56,153,FAT
0,1,1,8,0.606135804,9,1,is,"('FAT', 'MOT')",Providence,vio39.xml,10,1,0,MOT,56,153,FAT
0,9,1,43,0.587786665,52,9,we,"('BRO', 'MOT')",Providence,vio39.xml,53,1,0,MOT,275,727,BRO
0,2,6,37,0.535518236,39,2,it,"('MOT', 'CHI')",Providence,vio39.xml,45,6,0,CHI,726,181,MOT
1,9,3,40,0.530628251,49,9,this,"('BRO', 'MOT')",Providence,vio39.xml,53,4,1,MOT,275,727,BRO
1,3,7,28,0.500775288,31,3,the,"('MOT', 'BRO')",Providence,vio39.xml,39,8,1,BRO,543,188,MOT
0,17,3,129,0.497402603,146,17,gonna,"('CHI', 'MOT')",Providence,vio39.xml,149,3,0,MOT,729,1978,CHI
0,17,3,129,0.497402603,146,17,we,"('CHI', 'MOT')",Providence,vio39.xml,149,3,0,MOT,729,1978,CHI
0,4,3,32,0.418710335,36,4,is,"('MOT', 'BRO')",Providence,vio39.xml,39,3,0,BRO,543,188,MOT
0,1,2,9,0.405465108,10,1,a,"('BRO', 'CHI')",Providence,vio39.xml,12,2,0,CHI,60,85,BRO
0,1,1,6,0.405465108,7,1,you,"('MOT', 'FAT')",Providence,vio39.xml,8,1,0,FAT,179,26,MOT
0,1,1,6,0.405465108,7,1,of,"('MOT', 'FAT')",Providence,vio39.xml,8,1,0,FAT,179,26,MOT
5,22,16,106,0.388305488,128,22,this,"('CHI', 'MOT')",Providence,vio39.xml,149,21,5,MOT,729,1978,CHI
0,5,3,37,0.382992252,42,5,what,"('MOT', 'CHI')",Providence,vio39.xml,45,3,0,CHI,726,181,MOT
0,2,6,31,0.377294231,33,2,it,"('MOT', 'BRO')",Providence,vio39.xml,39,6,0,BRO,543,188,MOT
3,29,8,109,0.361790045,138,29,a,"('CHI', 'MOT')",Providence,vio39.xml,149,11,3,MOT,729,1978,CHI
0,5,4,44,0.348306694,49,5,is,"('BRO', 'MOT')",Providence,vio39.xml,53,4,0,MOT,275,727,BRO
0,3,2,17,0.318453731,20,3,the,"('UNI', 'MOT')",Providence,vio39.xml,22,2,0,MOT,82,326,UNI
0,7,3,43,0.262364264,50,7,a,"('BRO', 'MOT')",Providence,vio39.xml,53,3,0,MOT,275,727,BRO
0,1,10,28,0.255933374,29,1,yeah,"('MOT', 'BRO')",Providence,vio39.xml,39,10,0,BRO,543,188,MOT
0,9,9,131,0.255346692,140,9,up,"('CHI', 'MOT')",Providence,vio39.xml,149,9,0,MOT,729,1978,CHI
2,33,6,108,0.232511301,141,33,you,"('CHI', 'MOT')",Providence,vio39.xml,149,8,2,MOT,729,1978,CHI
0,1,2,7,0.223143551,8,1,can,"('FAT', 'MOT')",Providence,vio39.xml,10,2,0,MOT,56,153,FAT
0,1,12,32,0.223143551,33,1,you,"('MOT', 'CHI')",Providence,vio39.xml,45,12,0,CHI,726,181,MOT
0,4,4,31,0.209720531,35,4,no,"('MOT', 'BRO')",Providence,vio39.xml,39,4,0,BRO,543,188,MOT
1,4,8,26,0.151549898,30,4,you,"('MOT', 'BRO')",Providence,vio39.xml,39,9,1,BRO,543,188,MOT
0,8,3,42,0.144581229,50,8,and,"('BRO', 'MOT')",Providence,vio39.xml,53,3,0,MOT,275,727,BRO
0,13,7,129,0.133531393,142,13,go,"('CHI', 'MOT')",Providence,vio39.xml,149,7,0,MOT,729,1978,CHI
0,3,7,35,0.105360516,38,3,that,"('MOT', 'CHI')",Providence,vio39.xml,45,7,0,CHI,726,181,MOT
1,17,11,120,0.098192026,137,17,to,"('CHI', 'MOT')",Providence,vio39.xml,149,12,1,MOT,729,1978,CHI
0,2,8,29,0.09531018,31,2,to,"('MOT', 'BRO')",Providence,vio39.xml,39,8,0,BRO,543,188,MOT
0,4,2,16,0.09531018,20,4,and,"('UNI', 'MOT')",Providence,vio39.xml,22,2,0,MOT,82,326,UNI
0,3,1,8,0.080042708,11,3,to,"('BRO', 'CHI')",Providence,vio39.xml,12,1,0,CHI,60,85,BRO
2,10,8,33,0.022472856,43,10,the,"('BRO', 'MOT')",Providence,vio39.xml,53,10,2,MOT,275,727,BRO
0,8,3,34,-0.022472856,42,8,yeah,"('MOT', 'CHI')",Providence,vio39.xml,45,3,0,CHI,726,181,MOT
0,3,8,34,-0.025317808,37,3,to,"('MOT', 'CHI')",Providence,vio39.xml,45,8,0,CHI,726,181,MOT
0,10,3,40,-0.056089467,50,10,that,"('BRO', 'MOT')",Providence,vio39.xml,53,3,0,MOT,275,727,BRO
2,12,29,106,-0.175352887,118,12,yeah,"('CHI', 'MOT')",Providence,vio39.xml,149,31,2,MOT,729,1978,CHI
0,15,9,125,-0.214656937,140,15,is,"('CHI', 'MOT')",Providence,vio39.xml,149,9,0,MOT,729,1978,CHI
0,8,5,40,-0.231111721,48,8,one,"('BRO', 'MOT')",Providence,vio39.xml,53,5,0,MOT,275,727,BRO
0,4,8,33,-0.248461359,37,4,the,"('MOT', 'CHI')",Providence,vio39.xml,45,8,0,CHI,726,181,MOT
0,10,4,39,-0.257829109,49,10,to,"('BRO', 'MOT')",Providence,vio39.xml,53,4,0,MOT,275,727,BRO
0,4,1,5,-0.310154928,9,4,the,"('FAT', 'MOT')",Providence,vio39.xml,10,1,0,MOT,56,153,FAT
0,1,3,4,-0.356674944,5,1,the,"('MOT', 'FAT')",Providence,vio39.xml,8,3,0,FAT,179,26,MOT
0,1,4,5,-0.405465108,6,1,you,"('FAT', 'MOT')",Providence,vio39.xml,10,4,0,MOT,56,153,FAT
0,1,1,220,3.615412302,221,1,big,"('MOT', 'CHI')",Providence,vio40.xml,222,1,0,CHI,1918,1482,MOT
0,1,2,219,3.32323584,220,1,make,"('MOT', 'CHI')",Providence,vio40.xml,222,2,0,CHI,1918,1482,MOT
0,1,2,219,3.32323584,220,1,she,"('MOT', 'CHI')",Providence,vio40.xml,222,2,0,CHI,1918,1482,MOT
0,1,2,219,3.32323584,220,1,at,"('MOT', 'CHI')",Providence,vio40.xml,222,2,0,CHI,1918,1482,MOT
0,1,2,219,3.32323584,220,1,where,"('MOT', 'CHI')",Providence,vio40.xml,222,2,0,CHI,1918,1482,MOT
1,3,2,216,3.095577609,219,3,but,"('MOT', 'CHI')",Providence,vio40.xml,222,3,1,CHI,1918,1482,MOT
1,1,8,212,2.972742755,213,1,they,"('MOT', 'CHI')",Providence,vio40.xml,222,9,1,CHI,1918,1482,MOT
0,1,4,217,2.908720897,218,1,gonna,"('MOT', 'CHI')",Providence,vio40.xml,222,4,0,CHI,1918,1482,MOT
2,3,6,211,2.785011242,214,3,no,"('MOT', 'CHI')",Providence,vio40.xml,222,8,2,CHI,1918,1482,MOT
0,1,5,216,2.7500144,217,1,all,"('MOT', 'CHI')",Providence,vio40.xml,222,5,0,CHI,1918,1482,MOT
1,5,2,214,2.6901125,219,5,not,"('MOT', 'CHI')",Providence,vio40.xml,222,3,1,CHI,1918,1482,MOT
0,2,4,216,2.503255788,218,2,have,"('MOT', 'CHI')",Providence,vio40.xml,222,4,0,CHI,1918,1482,MOT
1,0,0,15,2.427748236,15,0,can,"('CHI', 'BRO')",Providence,vio40.xml,16,1,1,BRO,56,107,CHI
2,0,2,20,2.397895273,20,0,see,"('BRO', 'CHI')",Providence,vio40.xml,24,4,2,CHI,106,157,BRO
0,1,8,213,2.379546134,214,1,some,"('MOT', 'CHI')",Providence,vio40.xml,222,8,0,CHI,1918,1482,MOT
1,3,7,211,2.379546134,214,3,oh,"('MOT', 'CHI')",Providence,vio40.xml,222,8,1,CHI,1918,1482,MOT
0,2,5,215,2.344549292,217,2,get,"('MOT', 'CHI')",Providence,vio40.xml,222,5,0,CHI,1918,1482,MOT
1,0,0,13,2.302585093,13,0,do,"('MOT', 'BRO')",Providence,vio40.xml,14,1,1,BRO,61,63,MOT
0,3,4,215,2.215573716,218,3,was,"('MOT', 'CHI')",Providence,vio40.xml,222,4,0,CHI,1918,1482,MOT
0,2,6,214,2.206441232,216,2,wanna,"('MOT', 'CHI')",Providence,vio40.xml,222,6,0,CHI,1918,1482,MOT
1,5,6,210,2.084060488,215,5,like,"('MOT', 'CHI')",Providence,vio40.xml,222,7,1,CHI,1918,1482,MOT
0,6,2,214,2.070472872,220,6,on,"('MOT', 'CHI')",Providence,vio40.xml,222,2,0,CHI,1918,1482,MOT
0,3,5,214,2.05686722,217,3,with,"('MOT', 'CHI')",Providence,vio40.xml,222,5,0,CHI,1918,1482,MOT
0,3,5,214,2.05686722,217,3,look,"('MOT', 'CHI')",Providence,vio40.xml,222,5,0,CHI,1918,1482,MOT
1,0,1,13,2.014903021,13,0,a,"('BRO', 'MOT')",Providence,vio40.xml,15,2,1,MOT,86,79,BRO
1,0,1,12,1.945910149,12,0,one,"('MOT', 'BRO')",Providence,vio40.xml,14,2,1,BRO,61,63,MOT
0,3,6,213,1.91875916,216,3,go,"('MOT', 'CHI')",Providence,vio40.xml,222,6,0,CHI,1918,1482,MOT
0,2,10,210,1.782457077,212,2,want,"('MOT', 'CHI')",Providence,vio40.xml,222,10,0,CHI,1918,1482,MOT
0,2,10,210,1.782457077,212,2,for,"('MOT', 'CHI')",Providence,vio40.xml,222,10,0,CHI,1918,1482,MOT
1,3,15,203,1.754019141,206,3,are,"('MOT', 'CHI')",Providence,vio40.xml,222,16,1,CHI,1918,1482,MOT
1,1,0,14,1.734601055,15,1,in,"('CHI', 'BRO')",Providence,vio40.xml,16,1,1,BRO,56,107,CHI
3,7,14,198,1.695132634,205,7,a,"('MOT', 'CHI')",Providence,vio40.xml,222,17,3,CHI,1918,1482,MOT
1,1,0,13,1.673976434,14,1,is,"('BRO', 'MOT')",Providence,vio40.xml,15,1,1,MOT,86,79,BRO
1,3,20,198,1.484564583,201,3,what,"('MOT', 'CHI')",Providence,vio40.xml,222,21,1,CHI,1918,1482,MOT
0,2,14,206,1.47590652,208,2,see,"('MOT', 'CHI')",Providence,vio40.xml,222,14,0,CHI,1918,1482,MOT
0,1,1,22,1.427116356,23,1,in,"('BRO', 'CHI')",Providence,vio40.xml,24,1,0,CHI,106,157,BRO
0,1,1,22,1.427116356,23,1,yeah,"('BRO', 'CHI')",Providence,vio40.xml,24,1,0,CHI,106,157,BRO
0,1,1,22,1.427116356,23,1,a,"('BRO', 'CHI')",Providence,vio40.xml,24,1,0,CHI,106,157,BRO
3,11,12,196,1.410508619,207,11,in,"('MOT', 'CHI')",Providence,vio40.xml,222,15,3,CHI,1918,1482,MOT
1,0,0,4,1.386294361,4,0,a,"('FAT', 'BRO')",Providence,vio40.xml,5,1,1,BRO,28,40,FAT
0,5,8,209,1.280933845,214,5,up,"('MOT', 'CHI')",Providence,vio40.xml,222,8,0,CHI,1918,1482,MOT
0,8,5,209,1.245937003,217,8,my,"('MOT', 'CHI')",Providence,vio40.xml,222,5,0,CHI,1918,1482,MOT
1,5,17,199,1.233531607,204,5,to,"('MOT', 'CHI')",Providence,vio40.xml,222,18,1,CHI,1918,1482,MOT
0,1,1,17,1.203972804,18,1,for,"('CHI', 'MOT')",Providence,vio40.xml,19,1,0,MOT,120,135,CHI
0,1,1,17,1.203972804,18,1,little,"('CHI', 'MOT')",Providence,vio40.xml,19,1,0,MOT,120,135,CHI
0,1,1,17,1.203972804,18,1,some,"('CHI', 'MOT')",Providence,vio40.xml,19,1,0,MOT,120,135,CHI
0,1,1,17,1.203972804,18,1,on,"('CHI', 'MOT')",Providence,vio40.xml,19,1,0,MOT,120,135,CHI
1,2,1,15,1.15267951,17,2,one,"('CHI', 'MOT')",Providence,vio40.xml,19,2,1,MOT,120,135,CHI
0,6,8,208,1.126783166,214,6,of,"('MOT', 'CHI')",Providence,vio40.xml,222,8,0,CHI,1918,1482,MOT
0,1,2,21,1.098612289,22,1,can,"('BRO', 'CHI')",Providence,vio40.xml,24,2,0,CHI,106,157,BRO
1,10,10,201,1.091594716,211,10,put,"('MOT', 'CHI')",Providence,vio40.xml,222,11,1,CHI,1918,1482,MOT
0,1,1,14,1.041453875,15,1,he,"('CHI', 'BRO')",Providence,vio40.xml,16,1,0,BRO,56,107,CHI
1,3,0,12,1.041453875,15,3,the,"('CHI', 'BRO')",Providence,vio40.xml,16,1,1,BRO,56,107,CHI
1,9,12,200,1.03437002,209,9,there,"('MOT', 'CHI')",Providence,vio40.xml,222,13,1,CHI,1918,1482,MOT
0,2,1,21,1.021651248,23,2,is,"('BRO', 'CHI')",Providence,vio40.xml,24,1,0,CHI,106,157,BRO
0,1,1,13,0.980829253,14,1,to,"('BRO', 'MOT')",Providence,vio40.xml,15,1,0,MOT,86,79,BRO
4,15,18,185,0.967063057,200,15,this,"('MOT', 'CHI')",Providence,vio40.xml,222,22,4,CHI,1918,1482,MOT
0,1,2,16,0.864997437,17,1,yeah,"('CHI', 'MOT')",Providence,vio40.xml,19,2,0,MOT,120,135,CHI
0,2,1,16,0.798507696,18,2,do,"('CHI', 'MOT')",Providence,vio40.xml,19,1,0,MOT,120,135,CHI
0,6,12,204,0.771618796,210,6,can,"('MOT', 'CHI')",Providence,vio40.xml,222,12,0,CHI,1918,1482,MOT
0,3,1,20,0.733969175,23,3,look,"('BRO', 'CHI')",Providence,vio40.xml,24,1,0,CHI,106,157,BRO
3,6,45,168,0.698845202,174,6,you,"('MOT', 'CHI')",Providence,vio40.xml,222,48,3,CHI,1918,1482,MOT
3,4,3,14,0.693147181,18,4,the,"('BRO', 'CHI')",Providence,vio40.xml,24,6,3,CHI,106,157,BRO
0,6,14,202,0.628608659,208,6,we,"('MOT', 'CHI')",Providence,vio40.xml,222,14,0,CHI,1918,1482,MOT
0,1,2,12,0.628608659,13,1,the,"('BRO', 'MOT')",Providence,vio40.xml,15,2,0,MOT,86,79,BRO
1,3,2,13,0.587786665,16,3,you,"('CHI', 'MOT')",Providence,vio40.xml,19,3,1,MOT,120,135,CHI
0,6,15,201,0.563210759,207,6,do,"('MOT', 'CHI')",Providence,vio40.xml,222,15,0,CHI,1918,1482,MOT
0,1,2,11,0.559615788,12,1,yeah,"('MOT', 'BRO')",Providence,vio40.xml,14,2,0,BRO,61,63,MOT
1,11,18,192,0.486728072,203,11,is,"('MOT', 'CHI')",Providence,vio40.xml,222,19,1,CHI,1918,1482,MOT
0,2,2,15,0.459532329,17,2,see,"('CHI', 'MOT')",Providence,vio40.xml,19,2,0,MOT,120,135,CHI
4,23,21,174,0.428852041,197,23,it,"('MOT', 'CHI')",Providence,vio40.xml,222,25,4,CHI,1918,1482,MOT
2,18,18,184,0.38125085,202,18,the,"('MOT', 'CHI')",Providence,vio40.xml,222,20,2,CHI,1918,1482,MOT
1,4,2,12,0.364643114,16,4,the,"('CHI', 'MOT')",Providence,vio40.xml,19,3,1,MOT,120,135,CHI
0,5,22,195,0.338454398,200,5,one,"('MOT', 'CHI')",Providence,vio40.xml,222,22,0,CHI,1918,1482,MOT
0,3,1,11,0.287682072,14,3,yeah,"('BRO', 'MOT')",Providence,vio40.xml,15,1,0,MOT,86,79,BRO
0,1,1,5,0.287682072,6,1,what,"('FAT', 'CHI')",Providence,vio40.xml,7,1,0,CHI,40,45,FAT
2,18,21,181,0.238602393,199,18,and,"('MOT', 'CHI')",Providence,vio40.xml,222,23,2,CHI,1918,1482,MOT
3,36,16,167,0.05386399,203,36,yeah,"('MOT', 'CHI')",Providence,vio40.xml,222,19,3,CHI,1918,1482,MOT
0,1,1,3,0,4,1,in,"('FAT', 'BRO')",Providence,vio40.xml,5,1,0,BRO,28,40,FAT
0,1,1,3,0,4,1,on,"('FAT', 'BRO')",Providence,vio40.xml,5,1,0,BRO,28,40,FAT
0,6,27,189,-0.03000225,195,6,that,"('MOT', 'CHI')",Providence,vio40.xml,222,27,0,CHI,1918,1482,MOT
0,1,2,4,-0.133531393,5,1,you,"('FAT', 'CHI')",Providence,vio40.xml,7,2,0,CHI,40,45,FAT
0,1,1,1,-0.405465108,2,1,some,"('CHI', 'FAT')",Providence,vio40.xml,3,1,0,FAT,28,11,CHI
1,0,0,60,3.721669277,60,0,make,"('BRO', 'MOT')",Providence,vio41.xml,61,1,1,MOT,312,579,BRO
1,0,0,60,3.721669277,60,0,at,"('BRO', 'MOT')",Providence,vio41.xml,61,1,1,MOT,312,579,BRO
2,0,0,49,3.64414356,49,0,they,"('MOT', 'BRO')",Providence,vio41.xml,51,2,2,BRO,335,312,MOT
1,1,0,102,3.555348061,103,1,no,"('CHI', 'MOT')",Providence,vio41.xml,104,1,1,MOT,677,853,CHI
1,0,0,50,3.54577861,50,0,see,"('MOT', 'BRO')",Providence,vio41.xml,51,1,1,BRO,335,312,MOT
1,1,0,59,3.028522096,60,1,she,"('BRO', 'MOT')",Providence,vio41.xml,61,1,1,MOT,312,579,BRO
1,1,2,100,3.025291076,101,1,little,"('CHI', 'MOT')",Providence,vio41.xml,104,3,1,MOT,677,853,CHI
0,1,1,117,2.995732274,118,1,not,"('MOT', 'CHI')",Providence,vio41.xml,119,1,0,CHI,1182,838,MOT
2,2,2,113,2.970414466,115,2,one,"('MOT', 'CHI')",Providence,vio41.xml,119,4,2,CHI,1182,838,MOT
0,1,1,102,2.862200881,103,1,have,"('CHI', 'MOT')",Providence,vio41.xml,104,1,0,MOT,677,853,CHI
0,1,1,102,2.862200881,103,1,up,"('CHI', 'MOT')",Providence,vio41.xml,104,1,0,MOT,677,853,CHI
6,0,2,23,2.862200881,23,0,go,"('BRO', 'CHI')",Providence,vio41.xml,31,8,6,CHI,157,185,BRO
1,2,1,100,2.85263143,102,2,some,"('CHI', 'MOT')",Providence,vio41.xml,104,2,1,MOT,677,853,CHI
1,1,0,49,2.85263143,50,1,go,"('MOT', 'BRO')",Providence,vio41.xml,51,1,1,BRO,335,312,MOT
1,0,3,47,2.793208009,47,0,this,"('MOT', 'BRO')",Providence,vio41.xml,51,4,1,BRO,335,312,MOT
2,1,1,47,2.708050201,48,1,one,"('MOT', 'BRO')",Providence,vio41.xml,51,3,2,BRO,335,312,MOT
0,1,2,116,2.699681951,117,1,little,"('MOT', 'CHI')",Providence,vio41.xml,119,2,0,CHI,1182,838,MOT
1,1,1,48,2.545531272,49,1,can,"('MOT', 'BRO')",Providence,vio41.xml,51,2,1,BRO,335,312,MOT
0,1,3,115,2.468099531,116,1,like,"('MOT', 'CHI')",Providence,vio41.xml,119,3,0,CHI,1182,838,MOT
0,1,3,115,2.468099531,116,1,get,"('MOT', 'CHI')",Providence,vio41.xml,119,3,0,CHI,1182,838,MOT
0,1,3,115,2.468099531,116,1,he,"('MOT', 'CHI')",Providence,vio41.xml,119,3,0,CHI,1182,838,MOT
0,2,1,101,2.456735773,103,2,did,"('CHI', 'MOT')",Providence,vio41.xml,104,1,0,MOT,677,853,CHI
0,2,1,101,2.456735773,103,2,where,"('CHI', 'MOT')",Providence,vio41.xml,104,1,0,MOT,677,853,CHI
3,0,4,24,2.447166322,24,0,we,"('BRO', 'CHI')",Providence,vio41.xml,31,7,3,CHI,157,185,BRO
1,2,0,48,2.447166322,50,2,look,"('MOT', 'BRO')",Providence,vio41.xml,51,1,1,BRO,335,312,MOT
1,2,0,48,2.447166322,50,2,are,"('MOT', 'BRO')",Providence,vio41.xml,51,1,1,BRO,335,312,MOT
1,2,3,98,2.427748236,100,2,want,"('CHI', 'MOT')",Providence,vio41.xml,104,4,1,MOT,677,853,CHI
0,1,1,59,2.335374916,60,1,go,"('BRO', 'MOT')",Providence,vio41.xml,61,1,0,MOT,312,579,BRO
0,1,1,59,2.335374916,60,1,my,"('BRO', 'MOT')",Providence,vio41.xml,61,1,0,MOT,312,579,BRO
1,1,2,47,2.302585093,48,1,a,"('MOT', 'BRO')",Providence,vio41.xml,51,3,1,BRO,335,312,MOT
0,1,4,114,2.277267285,115,1,all,"('MOT', 'CHI')",Providence,vio41.xml,119,4,0,CHI,1182,838,MOT
1,2,4,97,2.26374526,99,2,to,"('CHI', 'MOT')",Providence,vio41.xml,104,5,1,MOT,677,853,CHI
0,3,1,100,2.1690537,103,3,he,"('CHI', 'MOT')",Providence,vio41.xml,104,1,0,MOT,677,853,CHI
0,2,2,100,2.159484249,102,2,are,"('CHI', 'MOT')",Providence,vio41.xml,104,2,0,MOT,677,853,CHI
0,1,1,49,2.159484249,50,1,like,"('MOT', 'BRO')",Providence,vio41.xml,51,1,0,BRO,335,312,MOT
0,1,1,49,2.159484249,50,1,have,"('MOT', 'BRO')",Providence,vio41.xml,51,1,0,BRO,335,312,MOT
0,1,1,49,2.159484249,50,1,with,"('MOT', 'BRO')",Providence,vio41.xml,51,1,0,BRO,335,312,MOT
0,1,1,49,2.159484249,50,1,of,"('MOT', 'BRO')",Providence,vio41.xml,51,1,0,BRO,335,312,MOT
1,2,1,47,2.140066163,49,2,on,"('MOT', 'BRO')",Providence,vio41.xml,51,2,1,BRO,335,312,MOT
0,1,5,113,2.114532861,114,1,for,"('MOT', 'CHI')",Providence,vio41.xml,119,5,0,CHI,1182,838,MOT
0,1,5,113,2.114532861,114,1,look,"('MOT', 'CHI')",Providence,vio41.xml,119,5,0,CHI,1182,838,MOT
0,1,5,113,2.114532861,114,1,did,"('MOT', 'CHI')",Providence,vio41.xml,119,5,0,CHI,1182,838,MOT
0,1,2,58,2.031432322,59,1,was,"('BRO', 'MOT')",Providence,vio41.xml,61,2,0,MOT,312,579,BRO
1,2,7,109,2.019337618,111,2,on,"('MOT', 'CHI')",Providence,vio41.xml,119,8,1,CHI,1182,838,MOT
0,1,5,98,1.976063187,99,1,get,"('CHI', 'MOT')",Providence,vio41.xml,104,5,0,MOT,677,853,CHI
2,2,1,31,1.945910149,33,2,we,"('CHI', 'BRO')",Providence,vio41.xml,36,3,2,BRO,382,178,CHI
0,4,1,99,1.945910149,103,4,of,"('CHI', 'MOT')",Providence,vio41.xml,104,1,0,MOT,677,853,CHI
0,4,1,99,1.945910149,103,4,all,"('CHI', 'MOT')",Providence,vio41.xml,104,1,0,MOT,677,853,CHI
0,2,1,58,1.929909808,60,2,some,"('BRO', 'MOT')",Providence,vio41.xml,61,1,0,MOT,312,579,BRO
0,2,1,58,1.929909808,60,2,do,"('BRO', 'MOT')",Providence,vio41.xml,61,1,0,MOT,312,579,BRO
0,2,1,58,1.929909808,60,2,not,"('BRO', 'MOT')",Providence,vio41.xml,61,1,0,MOT,312,579,BRO
0,2,3,99,1.926678787,101,2,oh,"('CHI', 'MOT')",Providence,vio41.xml,104,3,0,MOT,677,853,CHI
7,4,12,81,1.89138931,85,4,go,"('CHI', 'MOT')",Providence,vio41.xml,104,19,7,MOT,677,853,CHI
0,2,4,113,1.871802177,115,2,of,"('MOT', 'CHI')",Providence,vio41.xml,119,4,0,CHI,1182,838,MOT
0,1,2,48,1.852384091,49,1,she,"('MOT', 'BRO')",Providence,vio41.xml,51,2,0,BRO,335,312,MOT
5,5,8,86,1.824549292,91,5,we,"('CHI', 'MOT')",Providence,vio41.xml,104,13,5,MOT,677,853,CHI
0,1,1,34,1.819158443,35,1,in,"('CHI', 'BRO')",Providence,vio41.xml,36,1,0,BRO,382,178,CHI
0,1,1,34,1.819158443,35,1,get,"('CHI', 'BRO')",Providence,vio41.xml,36,1,0,BRO,382,178,CHI
0,1,1,34,1.819158443,35,1,what,"('CHI', 'BRO')",Providence,vio41.xml,36,1,0,BRO,382,178,CHI
0,1,1,34,1.819158443,35,1,up,"('CHI', 'BRO')",Providence,vio41.xml,36,1,0,BRO,382,178,CHI
0,1,1,34,1.819158443,35,1,no,"('CHI', 'BRO')",Providence,vio41.xml,36,1,0,BRO,382,178,CHI
1,4,1,55,1.808288771,59,4,yeah,"('BRO', 'MOT')",Providence,vio41.xml,61,2,1,MOT,312,579,BRO
0,1,3,57,1.791759469,58,1,but,"('BRO', 'MOT')",Providence,vio41.xml,61,3,0,MOT,312,579,BRO
0,4,2,113,1.78339122,117,4,they,"('MOT', 'CHI')",Providence,vio41.xml,119,2,0,CHI,1182,838,MOT
1,6,0,54,1.775759128,60,6,gonna,"('BRO', 'MOT')",Providence,vio41.xml,61,1,1,MOT,312,579,BRO
0,3,3,113,1.774952351,116,3,there,"('MOT', 'CHI')",Providence,vio41.xml,119,3,0,CHI,1182,838,MOT
0,2,1,48,1.754019141,50,2,at,"('MOT', 'BRO')",Providence,vio41.xml,51,1,0,BRO,335,312,MOT
0,2,1,48,1.754019141,50,2,do,"('MOT', 'BRO')",Providence,vio41.xml,51,1,0,BRO,335,312,MOT
0,2,1,48,1.754019141,50,2,to,"('MOT', 'BRO')",Providence,vio41.xml,51,1,0,BRO,335,312,MOT
1,4,4,95,1.752919636,99,4,on,"('CHI', 'MOT')",Providence,vio41.xml,104,5,1,MOT,677,853,CHI
1,4,5,109,1.749199855,113,4,my,"('MOT', 'CHI')",Providence,vio41.xml,119,6,1,CHI,1182,838,MOT
0,2,2,57,1.625967214,59,2,in,"('BRO', 'MOT')",Providence,vio41.xml,61,2,0,MOT,312,579,BRO
0,2,2,57,1.625967214,59,2,get,"('BRO', 'MOT')",Providence,vio41.xml,61,2,0,MOT,312,579,BRO
0,6,1,97,1.609437912,103,6,look,"('CHI', 'MOT')",Providence,vio41.xml,104,1,0,MOT,677,853,CHI
2,8,3,91,1.570598079,99,8,and,"('CHI', 'MOT')",Providence,vio41.xml,104,5,2,MOT,677,853,CHI
0,2,5,97,1.570598079,99,2,my,"('CHI', 'MOT')",Providence,vio41.xml,104,5,0,MOT,677,853,CHI
0,8,1,110,1.491654877,118,8,no,"('MOT', 'CHI')",Providence,vio41.xml,119,1,0,CHI,1182,838,MOT
0,7,1,96,1.47590652,103,7,for,"('CHI', 'MOT')",Providence,vio41.xml,104,1,0,MOT,677,853,CHI
0,7,1,96,1.47590652,103,7,at,"('CHI', 'MOT')",Providence,vio41.xml,104,1,0,MOT,677,853,CHI
1,6,1,53,1.471816535,59,6,and,"('BRO', 'MOT')",Providence,vio41.xml,61,2,1,MOT,312,579,BRO
1,10,2,106,1.45649862,116,10,want,"('MOT', 'CHI')",Providence,vio41.xml,119,3,1,CHI,1182,838,MOT
0,2,2,47,1.446918983,49,2,but,"('MOT', 'BRO')",Providence,vio41.xml,51,2,0,BRO,335,312,MOT
0,2,7,110,1.440361582,112,2,are,"('MOT', 'CHI')",Providence,vio41.xml,119,7,0,CHI,1182,838,MOT
0,4,1,56,1.419084184,60,4,oh,"('BRO', 'MOT')",Providence,vio41.xml,61,1,0,MOT,312,579,BRO
0,4,1,56,1.419084184,60,4,there,"('BRO', 'MOT')",Providence,vio41.xml,61,1,0,MOT,312,579,BRO
1,6,4,93,1.416447399,99,6,is,"('CHI', 'MOT')",Providence,vio41.xml,104,5,1,MOT,677,853,CHI
1,6,4,93,1.416447399,99,6,that,"('CHI', 'MOT')",Providence,vio41.xml,104,5,1,MOT,677,853,CHI
0,2,1,33,1.413693335,35,2,but,"('CHI', 'BRO')",Providence,vio41.xml,36,1,0,BRO,382,178,CHI
0,2,3,56,1.386294361,58,2,that,"('BRO', 'MOT')",Providence,vio41.xml,61,3,0,MOT,312,579,BRO
3,2,5,26,1.386294361,28,2,go,"('CHI', 'BRO')",Providence,vio41.xml,36,8,3,BRO,382,178,CHI
0,8,1,95,1.358123484,103,8,can,"('CHI', 'MOT')",Providence,vio41.xml,104,1,0,MOT,677,853,CHI
0,1,2,28,1.354545663,29,1,it,"('BRO', 'CHI')",Providence,vio41.xml,31,2,0,CHI,157,185,BRO
0,1,2,28,1.354545663,29,1,for,"('BRO', 'CHI')",Providence,vio41.xml,31,2,0,CHI,157,185,BRO
0,3,2,56,1.338285142,59,3,one,"('BRO', 'MOT')",Providence,vio41.xml,61,2,0,MOT,312,579,BRO
2,6,7,89,1.329517845,95,6,do,"('CHI', 'MOT')",Providence,vio41.xml,104,9,2,MOT,677,853,CHI
0,1,3,32,1.252762968,33,1,one,"('CHI', 'BRO')",Providence,vio41.xml,36,3,0,BRO,382,178,CHI
2,4,12,86,1.238374231,90,4,this,"('CHI', 'MOT')",Providence,vio41.xml,104,14,2,MOT,677,853,CHI
0,5,1,55,1.236762627,60,5,for,"('BRO', 'MOT')",Providence,vio41.xml,61,1,0,MOT,312,579,BRO
2,6,8,88,1.232143681,94,6,like,"('CHI', 'MOT')",Providence,vio41.xml,104,10,2,MOT,677,853,CHI
2,5,3,41,1.232143681,46,5,he,"('MOT', 'BRO')",Providence,vio41.xml,51,5,2,BRO,335,312,MOT
0,1,14,104,1.207092932,105,1,see,"('MOT', 'CHI')",Providence,vio41.xml,119,14,0,CHI,1182,838,MOT
1,5,2,43,1.203972804,48,5,and,"('MOT', 'BRO')",Providence,vio41.xml,51,3,1,BRO,335,312,MOT
1,5,3,52,1.187165686,57,5,look,"('BRO', 'MOT')",Providence,vio41.xml,61,4,1,MOT,312,579,BRO
0,3,2,46,1.15923691,49,3,that,"('MOT', 'BRO')",Providence,vio41.xml,51,2,0,BRO,335,312,MOT
1,12,0,48,1.156719919,60,12,it,"('BRO', 'MOT')",Providence,vio41.xml,61,1,1,MOT,312,579,BRO
2,7,9,101,1.154701755,108,7,this,"('MOT', 'CHI')",Providence,vio41.xml,119,11,2,CHI,1182,838,MOT
0,2,10,107,1.126011263,109,2,can,"('MOT', 'CHI')",Providence,vio41.xml,119,10,0,CHI,1182,838,MOT
0,3,3,55,1.098612289,58,3,this,"('BRO', 'MOT')",Providence,vio41.xml,61,3,0,MOT,312,579,BRO
2,3,7,39,1.098612289,42,3,the,"('MOT', 'BRO')",Providence,vio41.xml,51,9,2,BRO,335,312,MOT
0,6,1,54,1.082611947,60,6,to,"('BRO', 'MOT')",Providence,vio41.xml,61,1,0,MOT,312,579,BRO
0,1,4,31,1.041453875,32,1,it,"('CHI', 'BRO')",Providence,vio41.xml,36,4,0,BRO,382,178,CHI
0,1,4,31,1.041453875,32,1,this,"('CHI', 'BRO')",Providence,vio41.xml,36,4,0,BRO,382,178,CHI
1,8,5,90,1.021651248,98,8,in,"('CHI', 'MOT')",Providence,vio41.xml,104,6,1,MOT,677,853,CHI
3,5,19,92,1.011600912,97,5,it,"('MOT', 'CHI')",Providence,vio41.xml,119,22,3,CHI,1182,838,MOT
0,2,4,45,1.00144854,47,2,what,"('MOT', 'BRO')",Providence,vio41.xml,51,4,0,BRO,335,312,MOT
0,7,3,94,0.945849534,101,7,what,"('CHI', 'MOT')",Providence,vio41.xml,104,3,0,MOT,677,853,CHI
0,6,4,94,0.887303195,100,6,one,"('CHI', 'MOT')",Providence,vio41.xml,104,4,0,MOT,677,853,CHI
1,3,18,97,0.887303195,100,3,that,"('MOT', 'CHI')",Providence,vio41.xml,119,19,1,CHI,1182,838,MOT
0,1,5,30,0.857450232,31,1,to,"('CHI', 'BRO')",Providence,vio41.xml,36,5,0,BRO,382,178,CHI
0,2,3,31,0.84729786,33,2,of,"('CHI', 'BRO')",Providence,vio41.xml,36,3,0,BRO,382,178,CHI
2,10,3,46,0.815249877,56,10,the,"('BRO', 'MOT')",Providence,vio41.xml,61,5,2,MOT,312,579,BRO
1,12,5,101,0.79368841,113,12,we,"('MOT', 'CHI')",Providence,vio41.xml,119,6,1,CHI,1182,838,MOT
0,3,9,92,0.790521345,95,3,yeah,"('CHI', 'MOT')",Providence,vio41.xml,104,9,0,MOT,677,853,CHI
0,4,1,26,0.757685702,30,4,the,"('BRO', 'CHI')",Providence,vio41.xml,31,1,0,CHI,157,185,BRO
0,4,1,26,0.757685702,30,4,on,"('BRO', 'CHI')",Providence,vio41.xml,31,1,0,CHI,157,185,BRO
1,4,6,40,0.715126087,44,4,it,"('MOT', 'BRO')",Providence,vio41.xml,51,7,1,BRO,335,312,MOT
0,4,9,106,0.711165686,110,4,in,"('MOT', 'CHI')",Providence,vio41.xml,119,9,0,CHI,1182,838,MOT
0,1,6,29,0.693147181,30,1,do,"('CHI', 'BRO')",Providence,vio41.xml,36,6,0,BRO,382,178,CHI
1,13,6,99,0.593063722,112,13,go,"('MOT', 'CHI')",Providence,vio41.xml,119,7,1,CHI,1182,838,MOT
1,13,6,99,0.593063722,112,13,yeah,"('MOT', 'CHI')",Providence,vio41.xml,119,7,1,CHI,1182,838,MOT
0,3,3,30,0.559615788,33,3,you,"('CHI', 'BRO')",Providence,vio41.xml,36,3,0,BRO,382,178,CHI
0,3,3,30,0.559615788,33,3,the,"('CHI', 'BRO')",Providence,vio41.xml,36,3,0,BRO,382,178,CHI
5,27,5,67,0.538996501,94,27,you,"('CHI', 'MOT')",Providence,vio41.xml,104,10,5,MOT,677,853,CHI
0,5,4,52,0.494018505,57,5,what,"('BRO', 'MOT')",Providence,vio41.xml,61,4,0,MOT,312,579,BRO
0,8,5,91,0.47198579,99,8,it,"('CHI', 'MOT')",Providence,vio41.xml,104,5,0,MOT,677,853,CHI
0,2,8,41,0.405465108,43,2,you,"('MOT', 'BRO')",Providence,vio41.xml,51,8,0,BRO,335,312,MOT
2,19,6,77,0.385262401,96,19,the,"('CHI', 'MOT')",Providence,vio41.xml,104,8,2,MOT,677,853,CHI
0,3,16,100,0.377294231,103,3,a,"('MOT', 'CHI')",Providence,vio41.xml,119,16,0,CHI,1182,838,MOT
3,10,8,40,0.374693449,50,10,a,"('BRO', 'MOT')",Providence,vio41.xml,61,11,3,MOT,312,579,BRO
0,14,1,46,0.320471895,60,14,you,"('BRO', 'MOT')",Providence,vio41.xml,61,1,0,MOT,312,579,BRO
3,7,28,81,0.310154928,88,7,you,"('MOT', 'CHI')",Providence,vio41.xml,119,31,3,CHI,1182,838,MOT
0,2,6,28,0.287682072,30,2,and,"('CHI', 'BRO')",Providence,vio41.xml,36,6,0,BRO,382,178,CHI
0,7,9,103,0.241162057,110,7,is,"('MOT', 'CHI')",Providence,vio41.xml,119,9,0,CHI,1182,838,MOT
0,4,6,41,0.161268148,45,4,yeah,"('MOT', 'BRO')",Providence,vio41.xml,51,6,0,BRO,335,312,MOT
0,7,11,101,0.056089467,108,7,and,"('MOT', 'CHI')",Providence,vio41.xml,119,11,0,CHI,1182,838,MOT
1,18,9,91,-0.026668247,109,18,to,"('MOT', 'CHI')",Providence,vio41.xml,119,10,1,CHI,1182,838,MOT
0,12,6,86,-0.039220713,98,12,a,"('CHI', 'MOT')",Providence,vio41.xml,104,6,0,MOT,677,853,CHI
0,11,8,100,-0.060103924,111,11,oh,"('MOT', 'CHI')",Providence,vio41.xml,119,8,0,CHI,1182,838,MOT
0,10,9,100,-0.077291674,110,10,do,"('MOT', 'CHI')",Providence,vio41.xml,119,9,0,CHI,1182,838,MOT
0,7,3,26,-0.133531393,33,7,a,"('CHI', 'BRO')",Providence,vio41.xml,36,3,0,BRO,382,178,CHI
0,10,13,96,-0.423814247,106,10,what,"('MOT', 'CHI')",Providence,vio41.xml,119,13,0,CHI,1182,838,MOT
0,3,9,19,-0.606135804,22,3,a,"('BRO', 'CHI')",Providence,vio41.xml,31,9,0,CHI,157,185,BRO
4,19,33,63,-0.619039208,82,19,the,"('MOT', 'CHI')",Providence,vio41.xml,119,37,4,CHI,1182,838,MOT
1,0,0,122,4.414816457,122,0,he,"('MOT', 'CHI')",Providence,vio42.xml,123,1,1,CHI,1253,568,MOT
2,1,0,120,3.831355102,121,1,she,"('MOT', 'CHI')",Providence,vio42.xml,123,2,2,CHI,1253,568,MOT
1,1,0,121,3.721669277,122,1,did,"('MOT', 'CHI')",Providence,vio42.xml,123,1,1,CHI,1253,568,MOT
1,0,3,119,3.697178257,119,0,at,"('MOT', 'CHI')",Providence,vio42.xml,123,4,1,CHI,1253,568,MOT
1,2,0,93,3.070633582,95,2,want,"('CHI', 'MOT')",Providence,vio42.xml,96,1,1,MOT,429,1323,CHI
1,0,9,113,2.953172659,113,0,it,"('MOT', 'CHI')",Providence,vio42.xml,123,10,1,CHI,1253,568,MOT
1,0,9,113,2.953172659,113,0,of,"('MOT', 'CHI')",Providence,vio42.xml,123,10,1,CHI,1253,568,MOT
0,1,2,120,2.732742814,121,1,no,"('MOT', 'CHI')",Providence,vio42.xml,123,2,0,CHI,1253,568,MOT
1,1,5,116,2.699681951,117,1,look,"('MOT', 'CHI')",Providence,vio42.xml,123,6,1,CHI,1253,568,MOT
0,2,1,120,2.623056988,122,2,but,"('MOT', 'CHI')",Providence,vio42.xml,123,1,0,CHI,1253,568,MOT
0,2,1,93,2.377486401,95,2,was,"('CHI', 'MOT')",Providence,vio42.xml,96,1,0,MOT,429,1323,CHI
0,2,1,93,2.377486401,95,2,all,"('CHI', 'MOT')",Providence,vio42.xml,96,1,0,MOT,429,1323,CHI
0,2,1,93,2.377486401,95,2,he,"('CHI', 'MOT')",Providence,vio42.xml,96,1,0,MOT,429,1323,CHI
1,5,0,90,2.377486401,95,5,gonna,"('CHI', 'MOT')",Providence,vio42.xml,96,1,1,MOT,429,1323,CHI
0,1,4,118,2.310883896,119,1,like,"('MOT', 'CHI')",Providence,vio42.xml,123,4,0,CHI,1253,568,MOT
1,3,3,116,2.310883896,119,3,wanna,"('MOT', 'CHI')",Providence,vio42.xml,123,4,1,CHI,1253,568,MOT
0,1,5,117,2.148434413,118,1,have,"('MOT', 'CHI')",Providence,vio42.xml,123,5,0,CHI,1253,568,MOT
0,1,5,117,2.148434413,118,1,there,"('MOT', 'CHI')",Providence,vio42.xml,123,5,0,CHI,1253,568,MOT
1,5,1,89,2.079441542,94,5,it,"('CHI', 'MOT')",Providence,vio42.xml,96,2,1,MOT,429,1323,CHI
2,4,3,87,2.07586372,91,4,little,"('CHI', 'MOT')",Providence,vio42.xml,96,5,2,MOT,429,1323,CHI
1,2,7,113,2.054123734,115,2,can,"('MOT', 'CHI')",Providence,vio42.xml,123,8,1,CHI,1253,568,MOT
0,3,2,118,2.039595633,121,3,want,"('MOT', 'CHI')",Providence,vio42.xml,123,2,0,CHI,1253,568,MOT
1,4,2,89,2.028148247,93,4,no,"('CHI', 'MOT')",Providence,vio42.xml,96,3,1,MOT,429,1323,CHI
0,1,7,115,1.880312867,116,1,see,"('MOT', 'CHI')",Providence,vio42.xml,123,7,0,CHI,1253,568,MOT
0,4,1,91,1.866660777,95,4,see,"('CHI', 'MOT')",Providence,vio42.xml,96,1,0,MOT,429,1323,CHI
0,3,2,91,1.791759469,94,3,are,"('CHI', 'MOT')",Providence,vio42.xml,96,2,0,MOT,429,1323,CHI
2,7,2,85,1.77070606,92,7,make,"('CHI', 'MOT')",Providence,vio42.xml,96,4,2,MOT,429,1323,CHI
0,2,5,116,1.742969305,118,2,big,"('MOT', 'CHI')",Providence,vio42.xml,123,5,0,CHI,1253,568,MOT
1,6,2,87,1.691676011,93,6,can,"('CHI', 'MOT')",Providence,vio42.xml,96,3,1,MOT,429,1323,CHI
0,5,1,90,1.684339221,95,5,get,"('CHI', 'MOT')",Providence,vio42.xml,96,1,0,MOT,429,1323,CHI
1,11,0,84,1.684339221,95,11,we,"('CHI', 'MOT')",Providence,vio42.xml,96,1,1,MOT,429,1323,CHI
1,8,3,111,1.49995368,119,8,yeah,"('MOT', 'CHI')",Providence,vio42.xml,123,4,1,CHI,1253,568,MOT
1,2,14,106,1.461801914,108,2,is,"('MOT', 'CHI')",Providence,vio42.xml,123,15,1,CHI,1253,568,MOT
0,3,5,115,1.455287233,118,3,are,"('MOT', 'CHI')",Providence,vio42.xml,123,5,0,CHI,1253,568,MOT
0,1,12,110,1.395183309,111,1,that,"('MOT', 'CHI')",Providence,vio42.xml,123,12,0,CHI,1253,568,MOT
0,4,3,89,1.335001067,93,4,is,"('CHI', 'MOT')",Providence,vio42.xml,96,3,0,MOT,429,1323,CHI
0,8,1,87,1.278874112,95,8,there,"('CHI', 'MOT')",Providence,vio42.xml,96,1,0,MOT,429,1323,CHI
3,3,23,94,1.26291534,97,3,the,"('MOT', 'CHI')",Providence,vio42.xml,123,26,3,CHI,1253,568,MOT
0,1,14,108,1.243794299,109,1,and,"('MOT', 'CHI')",Providence,vio42.xml,123,14,0,CHI,1253,568,MOT
0,4,5,114,1.232143681,118,4,they,"('MOT', 'CHI')",Providence,vio42.xml,123,5,0,CHI,1253,568,MOT
0,6,2,88,1.232143681,94,6,what,"('CHI', 'MOT')",Providence,vio42.xml,96,2,0,MOT,429,1323,CHI
1,0,0,3,1.203972804,3,0,yeah,"('FAT', 'MOT')",Providence,vio42.xml,4,1,1,MOT,14,23,FAT
0,9,1,86,1.173513597,95,9,have,"('CHI', 'MOT')",Providence,vio42.xml,96,1,0,MOT,429,1323,CHI
0,2,10,111,1.16141319,113,2,in,"('MOT', 'CHI')",Providence,vio42.xml,123,10,0,CHI,1253,568,MOT
2,8,8,105,1.16141319,113,8,one,"('MOT', 'CHI')",Providence,vio42.xml,123,10,2,CHI,1253,568,MOT
0,7,2,87,1.098612289,94,7,that,"('CHI', 'MOT')",Providence,vio42.xml,96,2,0,MOT,429,1323,CHI
0,2,11,110,1.072636802,112,2,do,"('MOT', 'CHI')",Providence,vio42.xml,123,11,0,CHI,1253,568,MOT
0,11,1,84,0.99119204,95,11,like,"('CHI', 'MOT')",Providence,vio42.xml,96,1,0,MOT,429,1323,CHI
0,8,2,86,0.980829253,94,8,do,"('CHI', 'MOT')",Providence,vio42.xml,96,2,0,MOT,429,1323,CHI
1,17,1,77,0.980829253,94,17,and,"('CHI', 'MOT')",Providence,vio42.xml,96,2,1,MOT,429,1323,CHI
0,4,7,112,0.964022135,116,4,this,"('MOT', 'CHI')",Providence,vio42.xml,123,7,0,CHI,1253,568,MOT
0,7,3,86,0.864997437,93,7,this,"('CHI', 'MOT')",Providence,vio42.xml,96,3,0,MOT,429,1323,CHI
2,4,24,93,0.752089716,97,4,you,"('MOT', 'CHI')",Providence,vio42.xml,123,26,2,CHI,1253,568,MOT
0,7,4,85,0.672093771,92,7,wanna,"('CHI', 'MOT')",Providence,vio42.xml,96,4,0,MOT,429,1323,CHI
0,4,10,109,0.650587566,113,4,to,"('MOT', 'CHI')",Providence,vio42.xml,123,10,0,CHI,1253,568,MOT
0,6,5,85,0.640779195,91,6,one,"('CHI', 'MOT')",Providence,vio42.xml,96,5,0,MOT,429,1323,CHI
0,3,13,107,0.624154309,110,3,what,"('MOT', 'CHI')",Providence,vio42.xml,123,13,0,CHI,1253,568,MOT
1,5,19,98,0.464305608,103,5,a,"('MOT', 'CHI')",Providence,vio42.xml,123,20,1,CHI,1253,568,MOT
0,15,2,79,0.405465108,94,15,to,"('CHI', 'MOT')",Providence,vio42.xml,96,2,0,MOT,429,1323,CHI
1,15,7,73,0.117783036,88,15,the,"('CHI', 'MOT')",Providence,vio42.xml,96,8,1,MOT,429,1323,CHI
0,6,10,80,0.046520016,86,6,yeah,"('CHI', 'MOT')",Providence,vio42.xml,96,10,0,MOT,429,1323,CHI
0,17,4,75,-0.138836445,92,17,you,"('CHI', 'MOT')",Providence,vio42.xml,96,4,0,MOT,429,1323,CHI
0,1,2,3,-0.287682072,4,1,it,"('MOT', 'FAT')",Providence,vio42.xml,6,2,0,FAT,51,24,MOT
0,1,2,3,-0.287682072,4,1,no,"('MOT', 'FAT')",Providence,vio42.xml,6,2,0,FAT,51,24,MOT
0,19,6,71,-0.553385238,90,19,a,"('CHI', 'MOT')",Providence,vio42.xml,96,6,0,MOT,429,1323,CHI
0,1,1,0,-0.693147181,1,1,it,"('CHI', 'FAT')",Providence,vio42.xml,2,1,0,FAT,11,12,CHI
2,0,10,178,3.65251181,178,0,we,"('MOT', 'CHI')",Providence,vio43.xml,190,12,2,CHI,2763,994,MOT
2,2,1,185,3.632309103,187,2,little,"('MOT', 'CHI')",Providence,vio43.xml,190,3,2,CHI,2763,994,MOT
1,1,4,184,3.285198468,185,1,big,"('MOT', 'CHI')",Providence,vio43.xml,190,5,1,CHI,2763,994,MOT
4,1,12,173,3.196402969,174,1,like,"('MOT', 'CHI')",Providence,vio43.xml,190,16,4,CHI,2763,994,MOT
1,0,0,33,3.149882953,33,0,is,"('FAT', 'MOT')",Providence,vio43.xml,34,1,1,MOT,193,297,FAT
1,1,7,181,2.912350665,182,1,all,"('MOT', 'CHI')",Providence,vio43.xml,190,8,1,CHI,2763,994,MOT
1,0,1,32,2.833213344,32,0,gonna,"('FAT', 'MOT')",Providence,vio43.xml,34,2,1,MOT,193,297,FAT
1,0,1,32,2.833213344,32,0,are,"('FAT', 'MOT')",Providence,vio43.xml,34,2,1,MOT,193,297,FAT
0,3,1,186,2.767366778,189,3,where,"('MOT', 'CHI')",Providence,vio43.xml,190,1,0,CHI,2763,994,MOT
0,1,4,185,2.751535313,186,1,he,"('MOT', 'CHI')",Providence,vio43.xml,190,4,0,CHI,2763,994,MOT
1,1,9,179,2.719100037,180,1,for,"('MOT', 'CHI')",Providence,vio43.xml,190,10,1,CHI,2763,994,MOT
1,1,11,177,2.553899521,178,1,can,"('MOT', 'CHI')",Providence,vio43.xml,190,12,1,CHI,2763,994,MOT
1,1,12,176,2.479335605,177,1,wanna,"('MOT', 'CHI')",Providence,vio43.xml,190,13,1,CHI,2763,994,MOT
0,3,2,185,2.47443535,188,3,go,"('MOT', 'CHI')",Providence,vio43.xml,190,2,0,CHI,2763,994,MOT
0,1,1,67,2.456735773,68,1,are,"('CHI', 'MOT')",Providence,vio43.xml,69,1,0,MOT,350,656,CHI
0,1,6,183,2.453157951,184,1,gonna,"('MOT', 'CHI')",Providence,vio43.xml,190,6,0,CHI,2763,994,MOT
0,1,6,183,2.453157951,184,1,are,"('MOT', 'CHI')",Providence,vio43.xml,190,6,0,CHI,2763,994,MOT
1,2,2,64,2.204604685,66,2,at,"('CHI', 'MOT')",Providence,vio43.xml,69,3,1,MOT,350,656,CHI
1,3,1,64,2.154664963,67,3,like,"('CHI', 'MOT')",Providence,vio43.xml,69,2,1,MOT,350,656,CHI
2,3,2,62,2.125251078,65,3,not,"('CHI', 'MOT')",Providence,vio43.xml,69,4,2,MOT,350,656,CHI
1,3,8,178,2.118443699,181,3,have,"('MOT', 'CHI')",Providence,vio43.xml,190,9,1,CHI,2763,994,MOT
1,2,12,175,2.073870497,177,2,it,"('MOT', 'CHI')",Providence,vio43.xml,190,13,1,CHI,2763,994,MOT
3,3,17,167,2.056452023,170,3,a,"('MOT', 'CHI')",Providence,vio43.xml,190,20,3,CHI,2763,994,MOT
0,2,1,66,2.051270665,68,2,in,"('CHI', 'MOT')",Providence,vio43.xml,69,1,0,MOT,350,656,CHI
0,2,1,66,2.051270665,68,2,but,"('CHI', 'MOT')",Providence,vio43.xml,69,1,0,MOT,350,656,CHI
1,2,0,31,2.051270665,33,2,like,"('FAT', 'MOT')",Providence,vio43.xml,34,1,1,MOT,193,297,FAT
1,2,0,31,2.051270665,33,2,have,"('FAT', 'MOT')",Providence,vio43.xml,34,1,1,MOT,193,297,FAT
0,1,10,179,2.025952857,180,1,not,"('MOT', 'CHI')",Providence,vio43.xml,190,10,0,CHI,2763,994,MOT
1,4,1,63,1.931521412,67,4,have,"('CHI', 'MOT')",Providence,vio43.xml,69,2,1,MOT,350,656,CHI
0,1,3,65,1.916922612,66,1,big,"('CHI', 'MOT')",Providence,vio43.xml,69,3,0,MOT,350,656,CHI
1,6,0,62,1.897119985,68,6,wanna,"('CHI', 'MOT')",Providence,vio43.xml,69,1,1,MOT,350,656,CHI
1,6,0,62,1.897119985,68,6,one,"('CHI', 'MOT')",Providence,vio43.xml,69,1,1,MOT,350,656,CHI
1,1,2,30,1.887069649,31,1,do,"('FAT', 'MOT')",Providence,vio43.xml,34,3,1,MOT,193,297,FAT
0,1,13,176,1.786188424,177,1,in,"('MOT', 'CHI')",Providence,vio43.xml,190,13,0,CHI,2763,994,MOT
0,1,1,32,1.763588592,33,1,they,"('FAT', 'MOT')",Providence,vio43.xml,34,1,0,MOT,193,297,FAT
0,1,1,32,1.763588592,33,1,this,"('FAT', 'MOT')",Providence,vio43.xml,34,1,0,MOT,193,297,FAT
0,1,1,32,1.763588592,33,1,some,"('FAT', 'MOT')",Providence,vio43.xml,34,1,0,MOT,193,297,FAT
0,1,1,32,1.763588592,33,1,not,"('FAT', 'MOT')",Providence,vio43.xml,34,1,0,MOT,193,297,FAT
0,1,1,32,1.763588592,33,1,on,"('FAT', 'MOT')",Providence,vio43.xml,34,1,0,MOT,193,297,FAT
0,3,6,181,1.760010771,184,3,at,"('MOT', 'CHI')",Providence,vio43.xml,190,6,0,CHI,2763,994,MOT
4,1,16,48,1.757073911,49,1,no,"('CHI', 'MOT')",Providence,vio43.xml,69,20,4,MOT,350,656,CHI
2,8,0,59,1.749199855,67,8,and,"('CHI', 'MOT')",Providence,vio43.xml,69,2,2,MOT,350,656,CHI
0,2,2,65,1.749199855,67,2,can,"('CHI', 'MOT')",Providence,vio43.xml,69,2,0,MOT,350,656,CHI
1,2,1,30,1.734601055,32,2,can,"('FAT', 'MOT')",Providence,vio43.xml,34,2,1,MOT,193,297,FAT
0,11,1,178,1.66875449,189,11,want,"('MOT', 'CHI')",Providence,vio43.xml,190,1,0,CHI,2763,994,MOT
2,6,2,59,1.56563529,65,6,is,"('CHI', 'MOT')",Providence,vio43.xml,69,4,2,MOT,350,656,CHI
1,1,1,16,1.558144618,17,1,the,"('MOT', 'FAT')",Providence,vio43.xml,19,2,1,FAT,142,96,MOT
3,5,4,57,1.556193398,62,5,this,"('CHI', 'MOT')",Providence,vio43.xml,69,7,3,MOT,350,656,CHI
0,1,5,63,1.550597412,64,1,want,"('CHI', 'MOT')",Providence,vio43.xml,69,5,0,MOT,350,656,CHI
0,4,1,64,1.540445041,68,4,of,"('CHI', 'MOT')",Providence,vio43.xml,69,1,0,MOT,350,656,CHI
0,3,8,179,1.526056303,182,3,there,"('MOT', 'CHI')",Providence,vio43.xml,190,8,0,CHI,2763,994,MOT
0,1,2,31,1.446918983,32,1,get,"('FAT', 'MOT')",Providence,vio43.xml,34,2,0,MOT,193,297,FAT
0,1,2,31,1.446918983,32,1,with,"('FAT', 'MOT')",Providence,vio43.xml,34,2,0,MOT,193,297,FAT
1,0,5,14,1.386294361,14,0,this,"('CHI', 'FAT')",Providence,vio43.xml,20,6,1,FAT,103,94,CHI
0,2,1,31,1.358123484,33,2,make,"('FAT', 'MOT')",Providence,vio43.xml,34,1,0,MOT,193,297,FAT
3,11,1,54,1.314320861,65,11,that,"('CHI', 'MOT')",Providence,vio43.xml,69,4,3,MOT,350,656,CHI
0,1,1,18,1.252762968,19,1,we,"('CHI', 'FAT')",Providence,vio43.xml,20,1,0,FAT,103,94,CHI
0,1,1,18,1.252762968,19,1,what,"('CHI', 'FAT')",Providence,vio43.xml,20,1,0,FAT,103,94,CHI
0,1,1,18,1.252762968,19,1,my,"('CHI', 'FAT')",Providence,vio43.xml,20,1,0,FAT,103,94,CHI
0,1,1,18,1.252762968,19,1,is,"('CHI', 'FAT')",Providence,vio43.xml,20,1,0,FAT,103,94,CHI
0,1,1,17,1.203972804,18,1,of,"('MOT', 'FAT')",Providence,vio43.xml,19,1,0,FAT,142,96,MOT
0,1,1,17,1.203972804,18,1,there,"('MOT', 'FAT')",Providence,vio43.xml,19,1,0,FAT,142,96,MOT
0,1,1,17,1.203972804,18,1,are,"('MOT', 'FAT')",Providence,vio43.xml,19,1,0,FAT,142,96,MOT
0,5,8,177,1.120591195,182,5,look,"('MOT', 'CHI')",Providence,vio43.xml,190,8,0,CHI,2763,994,MOT
0,2,2,30,1.041453875,32,2,oh,"('FAT', 'MOT')",Providence,vio43.xml,34,2,0,MOT,193,297,FAT
6,6,43,135,1.031018998,141,6,you,"('MOT', 'CHI')",Providence,vio43.xml,190,49,6,CHI,2763,994,MOT
2,11,2,54,1.026638789,65,11,we,"('CHI', 'MOT')",Providence,vio43.xml,69,4,2,MOT,350,656,CHI
0,1,4,29,0.980829253,30,1,what,"('FAT', 'MOT')",Providence,vio43.xml,34,4,0,MOT,193,297,FAT
1,7,14,168,0.956642027,175,7,with,"('MOT', 'CHI')",Providence,vio43.xml,190,15,1,CHI,2763,994,MOT
0,1,2,17,0.916290732,18,1,no,"('CHI', 'FAT')",Providence,vio43.xml,20,2,0,FAT,103,94,CHI
0,1,2,17,0.916290732,18,1,at,"('CHI', 'FAT')",Providence,vio43.xml,20,2,0,FAT,103,94,CHI
0,1,2,16,0.864997437,17,1,what,"('MOT', 'FAT')",Providence,vio43.xml,19,2,0,FAT,142,96,MOT
0,2,7,60,0.863046217,62,2,look,"('CHI', 'MOT')",Providence,vio43.xml,69,7,0,MOT,350,656,CHI
7,27,12,144,0.856006188,171,27,this,"('MOT', 'CHI')",Providence,vio43.xml,190,19,7,CHI,2763,994,MOT
2,2,3,12,0.826678573,14,2,you,"('MOT', 'FAT')",Providence,vio43.xml,19,5,2,FAT,142,96,MOT
0,5,3,61,0.818310324,66,5,what,"('CHI', 'MOT')",Providence,vio43.xml,69,3,0,MOT,350,656,CHI
0,2,3,29,0.78845736,31,2,in,"('FAT', 'MOT')",Providence,vio43.xml,34,3,0,MOT,193,297,FAT
0,2,3,29,0.78845736,31,2,to,"('FAT', 'MOT')",Providence,vio43.xml,34,3,0,MOT,193,297,FAT
0,7,2,60,0.768370602,67,7,a,"('CHI', 'MOT')",Providence,vio43.xml,69,2,0,MOT,350,656,CHI
0,3,2,29,0.753771802,32,3,yeah,"('FAT', 'MOT')",Providence,vio43.xml,34,2,0,MOT,193,297,FAT
1,7,5,56,0.708651367,63,7,the,"('CHI', 'MOT')",Providence,vio43.xml,69,6,1,MOT,350,656,CHI
3,9,28,150,0.668606072,159,9,the,"('MOT', 'CHI')",Providence,vio43.xml,190,31,3,CHI,2763,994,MOT
0,4,2,28,0.530628251,32,4,the,"('FAT', 'MOT')",Providence,vio43.xml,34,2,0,MOT,193,297,FAT
0,4,2,28,0.530628251,32,4,and,"('FAT', 'MOT')",Providence,vio43.xml,34,2,0,MOT,193,297,FAT
0,6,4,59,0.467023001,65,6,to,"('CHI', 'MOT')",Providence,vio43.xml,69,4,0,MOT,350,656,CHI
1,14,3,51,0.39803013,65,14,do,"('CHI', 'MOT')",Providence,vio43.xml,69,4,1,MOT,350,656,CHI
1,8,2,23,0.382992252,31,8,it,"('FAT', 'MOT')",Providence,vio43.xml,34,3,1,MOT,193,297,FAT
1,25,7,157,0.347401307,182,25,no,"('MOT', 'CHI')",Providence,vio43.xml,190,8,1,CHI,2763,994,MOT
0,3,4,27,0.287682072,30,3,that,"('FAT', 'MOT')",Providence,vio43.xml,34,4,0,MOT,193,297,FAT
0,8,13,169,0.282111027,177,8,is,"('MOT', 'CHI')",Providence,vio43.xml,190,13,0,CHI,2763,994,MOT
1,10,21,158,0.252996514,168,10,do,"('MOT', 'CHI')",Providence,vio43.xml,190,22,1,CHI,2763,994,MOT
0,9,13,168,0.176750512,177,9,to,"('MOT', 'CHI')",Providence,vio43.xml,190,13,0,CHI,2763,994,MOT
0,3,2,14,0.171850257,17,3,it,"('MOT', 'FAT')",Providence,vio43.xml,19,2,0,FAT,142,96,MOT
0,7,5,57,0.164303051,64,7,it,"('CHI', 'MOT')",Providence,vio43.xml,69,5,0,MOT,350,656,CHI
10,38,26,116,0.146603474,154,38,one,"('MOT', 'CHI')",Providence,vio43.xml,190,36,10,CHI,2763,994,MOT
0,5,8,56,0.048790164,61,5,yeah,"('CHI', 'MOT')",Providence,vio43.xml,69,8,0,MOT,350,656,CHI
0,12,3,54,0.045120435,66,12,make,"('CHI', 'MOT')",Providence,vio43.xml,69,3,0,MOT,350,656,CHI
0,9,16,165,-0.022472856,174,9,that,"('MOT', 'CHI')",Providence,vio43.xml,190,16,0,CHI,2763,994,MOT
0,13,12,165,-0.085157808,178,13,what,"('MOT', 'CHI')",Providence,vio43.xml,190,12,0,CHI,2763,994,MOT
1,30,11,148,-0.186940503,178,30,yeah,"('MOT', 'CHI')",Providence,vio43.xml,190,12,1,CHI,2763,994,MOT
0,22,2,45,-0.287682072,67,22,you,"('CHI', 'MOT')",Providence,vio43.xml,69,2,0,MOT,350,656,CHI
1,16,25,148,-0.360282885,164,16,and,"('MOT', 'CHI')",Providence,vio43.xml,190,26,1,CHI,2763,994,MOT
1,10,6,17,-0.53467684,27,10,you,"('FAT', 'MOT')",Providence,vio43.xml,34,7,1,MOT,193,297,FAT
1,1,0,55,2.961830722,56,1,get,"('CHI', 'MOT')",Providence,vio44.xml,57,1,1,MOT,325,559,CHI
1,1,0,55,2.961830722,56,1,put,"('CHI', 'MOT')",Providence,vio44.xml,57,1,1,MOT,325,559,CHI
4,1,7,86,2.839977744,87,1,one,"('MOT', 'CHI')",Providence,vio44.xml,98,11,4,CHI,1802,787,MOT
0,1,1,96,2.803360381,97,1,have,"('MOT', 'CHI')",Providence,vio44.xml,98,1,0,CHI,1802,787,MOT
0,1,1,96,2.803360381,97,1,all,"('MOT', 'CHI')",Providence,vio44.xml,98,1,0,CHI,1802,787,MOT
2,2,1,52,2.415913778,54,2,we,"('CHI', 'MOT')",Providence,vio44.xml,57,3,2,MOT,325,559,CHI
1,1,6,90,2.335374916,91,1,there,"('MOT', 'CHI')",Providence,vio44.xml,98,7,1,CHI,1802,787,MOT
1,0,14,83,2.302585093,83,0,to,"('MOT', 'CHI')",Providence,vio44.xml,98,15,1,CHI,1802,787,MOT
0,1,3,94,2.272125886,95,1,go,"('MOT', 'CHI')",Providence,vio44.xml,98,3,0,CHI,1802,787,MOT
0,1,3,94,2.272125886,95,1,they,"('MOT', 'CHI')",Providence,vio44.xml,98,3,0,CHI,1802,787,MOT
0,1,3,94,2.272125886,95,1,wanna,"('MOT', 'CHI')",Providence,vio44.xml,98,3,0,CHI,1802,787,MOT
0,1,3,94,2.272125886,95,1,where,"('MOT', 'CHI')",Providence,vio44.xml,98,3,0,CHI,1802,787,MOT
0,1,1,55,2.268683541,56,1,in,"('CHI', 'MOT')",Providence,vio44.xml,57,1,0,MOT,325,559,CHI
0,1,1,55,2.268683541,56,1,but,"('CHI', 'MOT')",Providence,vio44.xml,57,1,0,MOT,325,559,CHI
0,1,1,55,2.268683541,56,1,my,"('CHI', 'MOT')",Providence,vio44.xml,57,1,0,MOT,325,559,CHI
0,1,1,55,2.268683541,56,1,do,"('CHI', 'MOT')",Providence,vio44.xml,57,1,0,MOT,325,559,CHI
1,3,0,53,2.268683541,56,3,make,"('CHI', 'MOT')",Providence,vio44.xml,57,1,1,MOT,325,559,CHI
0,1,4,93,2.079441542,94,1,gonna,"('MOT', 'CHI')",Providence,vio44.xml,98,4,0,CHI,1802,787,MOT
0,1,2,54,1.963609726,55,1,not,"('CHI', 'MOT')",Providence,vio44.xml,57,2,0,MOT,325,559,CHI
0,1,5,92,1.914819562,93,1,little,"('MOT', 'CHI')",Providence,vio44.xml,98,5,0,CHI,1802,787,MOT
0,1,5,92,1.914819562,93,1,he,"('MOT', 'CHI')",Providence,vio44.xml,98,5,0,CHI,1802,787,MOT
0,2,1,54,1.863218433,56,2,to,"('CHI', 'MOT')",Providence,vio44.xml,57,1,0,MOT,325,559,CHI
0,1,6,91,1.77070606,92,1,with,"('MOT', 'CHI')",Providence,vio44.xml,98,6,0,CHI,1802,787,MOT
0,1,6,91,1.77070606,92,1,she,"('MOT', 'CHI')",Providence,vio44.xml,98,6,0,CHI,1802,787,MOT
1,3,2,51,1.722766598,54,3,on,"('CHI', 'MOT')",Providence,vio44.xml,57,3,1,MOT,325,559,CHI
0,2,4,92,1.673976434,94,2,my,"('MOT', 'CHI')",Providence,vio44.xml,98,4,0,CHI,1802,787,MOT
1,7,0,49,1.575536361,56,7,is,"('CHI', 'MOT')",Providence,vio44.xml,57,1,1,MOT,325,559,CHI
0,2,2,53,1.558144618,55,2,like,"('CHI', 'MOT')",Providence,vio44.xml,57,2,0,MOT,325,559,CHI
0,2,5,91,1.509354454,93,2,up,"('MOT', 'CHI')",Providence,vio44.xml,98,5,0,CHI,1802,787,MOT
1,4,2,50,1.499623046,54,4,the,"('CHI', 'MOT')",Providence,vio44.xml,57,3,1,MOT,325,559,CHI
0,4,1,52,1.352392809,56,4,oh,"('CHI', 'MOT')",Providence,vio44.xml,57,1,0,MOT,325,559,CHI
0,1,10,87,1.32175584,88,1,for,"('MOT', 'CHI')",Providence,vio44.xml,98,10,0,CHI,1802,787,MOT
0,3,2,52,1.270462546,55,3,one,"('CHI', 'MOT')",Providence,vio44.xml,57,2,0,MOT,325,559,CHI
2,3,14,79,1.252762968,82,3,and,"('MOT', 'CHI')",Providence,vio44.xml,98,16,2,CHI,1802,787,MOT
0,1,12,85,1.145132304,86,1,that,"('MOT', 'CHI')",Providence,vio44.xml,98,12,0,CHI,1802,787,MOT
1,4,10,83,1.00739628,87,4,can,"('MOT', 'CHI')",Providence,vio44.xml,98,11,1,CHI,1802,787,MOT
0,4,5,89,0.99852883,93,4,look,"('MOT', 'CHI')",Providence,vio44.xml,98,5,0,CHI,1802,787,MOT
1,9,4,84,0.99852883,93,9,not,"('MOT', 'CHI')",Providence,vio44.xml,98,5,1,CHI,1802,787,MOT
1,0,0,2,0.980829253,2,0,yeah,"('FAT', 'CHI')",Providence,vio44.xml,3,1,1,CHI,17,10,FAT
2,7,10,79,0.857450232,86,7,it,"('MOT', 'CHI')",Providence,vio44.xml,98,12,2,CHI,1802,787,MOT
0,3,8,87,0.832909123,90,3,at,"('MOT', 'CHI')",Providence,vio44.xml,98,8,0,CHI,1802,787,MOT
0,4,7,87,0.725937003,91,4,like,"('MOT', 'CHI')",Providence,vio44.xml,98,7,0,CHI,1802,787,MOT
0,6,2,49,0.710846758,55,6,and,"('CHI', 'MOT')",Providence,vio44.xml,57,2,0,MOT,325,559,CHI
0,5,6,87,0.672093771,92,5,no,"('MOT', 'CHI')",Providence,vio44.xml,98,6,0,CHI,1802,787,MOT
1,5,12,80,0.659245629,85,5,the,"('MOT', 'CHI')",Providence,vio44.xml,98,13,1,CHI,1802,787,MOT
0,2,14,82,0.583146285,84,2,what,"('MOT', 'CHI')",Providence,vio44.xml,98,14,0,CHI,1802,787,MOT
0,8,2,47,0.459532329,55,8,that,"('CHI', 'MOT')",Providence,vio44.xml,57,2,0,MOT,325,559,CHI
0,3,12,83,0.451985124,86,3,in,"('MOT', 'CHI')",Providence,vio44.xml,98,12,0,CHI,1802,787,MOT
0,4,5,48,0.433635985,52,4,it,"('CHI', 'MOT')",Providence,vio44.xml,57,5,0,MOT,325,559,CHI
2,17,2,36,0.423814247,53,17,a,"('CHI', 'MOT')",Providence,vio44.xml,57,4,2,MOT,325,559,CHI
2,10,12,74,0.38247559,84,10,this,"('MOT', 'CHI')",Providence,vio44.xml,98,14,2,CHI,1802,787,MOT
0,7,4,46,0.136132174,53,7,can,"('CHI', 'MOT')",Providence,vio44.xml,57,4,0,MOT,325,559,CHI
0,6,5,46,0.097163748,52,6,this,"('CHI', 'MOT')",Providence,vio44.xml,57,5,0,MOT,325,559,CHI
1,17,4,35,-0.15415068,52,17,you,"('CHI', 'MOT')",Providence,vio44.xml,57,5,1,MOT,325,559,CHI
0,1,1,2,-0.182321557,3,1,you,"('FAT', 'MOT')",Providence,vio44.xml,4,1,0,MOT,15,89,FAT
2,9,23,64,-0.182321557,73,9,a,"('MOT', 'CHI')",Providence,vio44.xml,98,25,2,CHI,1802,787,MOT
0,6,14,78,-0.264151575,84,6,is,"('MOT', 'CHI')",Providence,vio44.xml,98,14,0,CHI,1802,787,MOT
0,5,9,43,-0.277631737,48,5,yeah,"('CHI', 'MOT')",Providence,vio44.xml,57,9,0,MOT,325,559,CHI
1,20,9,68,-0.336472237,88,20,yeah,"('MOT', 'CHI')",Providence,vio44.xml,98,10,1,CHI,1802,787,MOT
0,9,11,78,-0.378898081,87,9,on,"('MOT', 'CHI')",Providence,vio44.xml,98,11,0,CHI,1802,787,MOT
0,1,1,1,-0.405465108,2,1,you,"('FAT', 'CHI')",Providence,vio44.xml,3,1,0,CHI,17,10,FAT
0,1,2,1,-0.693147181,2,1,go,"('FAT', 'MOT')",Providence,vio44.xml,4,2,0,MOT,15,89,FAT
0,1,1,0,-0.693147181,1,1,you,"('MOT', 'FAT')",Providence,vio44.xml,2,1,0,FAT,86,11,MOT
0,5,29,64,-0.963066797,69,5,you,"('MOT', 'CHI')",Providence,vio44.xml,98,29,0,CHI,1802,787,MOT
1,0,0,81,4.0133755,81,0,some,"('MOT', 'CHI')",Providence,vio45.xml,82,1,1,CHI,581,380,MOT
2,0,1,79,3.883623531,79,0,in,"('MOT', 'CHI')",Providence,vio45.xml,82,3,2,CHI,581,380,MOT
1,0,1,80,3.713572067,80,0,there,"('MOT', 'CHI')",Providence,vio45.xml,82,2,1,CHI,581,380,MOT
1,0,1,80,3.713572067,80,0,can,"('MOT', 'CHI')",Providence,vio45.xml,82,2,1,CHI,581,380,MOT
1,1,0,80,3.320228319,81,1,my,"('MOT', 'CHI')",Providence,vio45.xml,82,1,1,CHI,581,380,MOT
1,0,3,78,3.283414346,78,0,put,"('MOT', 'CHI')",Providence,vio45.xml,82,4,1,CHI,581,380,MOT
1,2,1,127,3.083437854,129,2,my,"('CHI', 'MOT')",Providence,vio45.xml,131,2,1,MOT,615,949,CHI
1,0,5,76,2.970414466,76,0,of,"('MOT', 'CHI')",Providence,vio45.xml,82,6,1,CHI,581,380,MOT
1,0,0,22,2.772588722,22,0,up,"('MOT', 'FAT')",Providence,vio45.xml,23,1,1,FAT,156,143,MOT
0,2,1,128,2.685577345,130,2,he,"('CHI', 'MOT')",Providence,vio45.xml,131,1,0,MOT,615,949,CHI
0,1,1,81,2.63905733,82,1,want,"('MOT', 'BRO')",Providence,vio45.xml,83,1,0,BRO,583,477,MOT
0,1,1,81,2.63905733,82,1,was,"('MOT', 'BRO')",Providence,vio45.xml,83,1,0,BRO,583,477,MOT
0,1,1,81,2.63905733,82,1,he,"('MOT', 'BRO')",Providence,vio45.xml,83,1,0,BRO,583,477,MOT
0,1,1,80,2.627081139,81,1,look,"('MOT', 'CHI')",Providence,vio45.xml,82,1,0,CHI,581,380,MOT
0,1,1,80,2.627081139,81,1,little,"('MOT', 'CHI')",Providence,vio45.xml,82,1,0,CHI,581,380,MOT
1,1,1,48,2.545531272,49,1,are,"('BRO', 'MOT')",Providence,vio45.xml,51,2,1,MOT,257,416,BRO
0,3,1,127,2.397895273,130,3,put,"('CHI', 'MOT')",Providence,vio45.xml,131,1,0,MOT,615,949,CHI
0,2,2,127,2.390290673,129,2,are,"('CHI', 'MOT')",Providence,vio45.xml,131,2,0,MOT,615,949,CHI
1,2,2,77,2.379546134,79,2,where,"('MOT', 'CHI')",Providence,vio45.xml,82,3,1,CHI,581,380,MOT
0,1,2,80,2.339399066,81,1,get,"('MOT', 'BRO')",Providence,vio45.xml,83,2,0,BRO,583,477,MOT
0,1,2,79,2.327277706,80,1,to,"('MOT', 'CHI')",Providence,vio45.xml,82,2,0,CHI,581,380,MOT
2,1,7,72,2.325057949,73,1,it,"('MOT', 'CHI')",Providence,vio45.xml,82,9,2,CHI,581,380,MOT
0,2,1,80,2.233592222,82,2,they,"('MOT', 'BRO')",Providence,vio45.xml,83,1,0,BRO,583,477,MOT
0,2,1,80,2.233592222,82,2,no,"('MOT', 'BRO')",Providence,vio45.xml,83,1,0,BRO,583,477,MOT
0,2,1,80,2.233592222,82,2,wanna,"('MOT', 'BRO')",Providence,vio45.xml,83,1,0,BRO,583,477,MOT
0,1,1,49,2.159484249,50,1,did,"('BRO', 'MOT')",Providence,vio45.xml,51,1,0,MOT,257,416,BRO
0,1,3,79,2.104134154,80,1,we,"('MOT', 'BRO')",Providence,vio45.xml,83,3,0,BRO,583,477,MOT
0,3,2,126,2.102608601,129,3,like,"('CHI', 'MOT')",Providence,vio45.xml,131,2,0,MOT,615,949,CHI
0,1,3,78,2.091864062,79,1,we,"('MOT', 'CHI')",Providence,vio45.xml,82,3,0,CHI,581,380,MOT
0,1,3,78,2.091864062,79,1,wanna,"('MOT', 'CHI')",Providence,vio45.xml,82,3,0,CHI,581,380,MOT
1,0,0,10,2.079441542,10,0,to,"('FAT', 'BRO')",Providence,vio45.xml,11,1,1,BRO,77,69,FAT
1,0,15,66,2.022283128,66,0,you,"('MOT', 'CHI')",Providence,vio45.xml,82,16,1,CHI,581,380,MOT
1,6,2,122,2.00533357,128,6,in,"('CHI', 'MOT')",Providence,vio45.xml,131,3,1,MOT,615,949,CHI
0,5,1,125,1.992430165,130,5,for,"('CHI', 'MOT')",Providence,vio45.xml,131,1,0,MOT,615,949,CHI
0,2,4,125,1.969440646,127,2,at,"('CHI', 'MOT')",Providence,vio45.xml,131,4,0,MOT,615,949,CHI
1,3,6,121,1.945910149,124,3,gonna,"('CHI', 'MOT')",Providence,vio45.xml,131,7,1,MOT,615,949,CHI
0,3,1,79,1.945910149,82,3,little,"('MOT', 'BRO')",Providence,vio45.xml,83,1,0,BRO,583,477,MOT
0,3,1,78,1.933933958,81,3,go,"('MOT', 'CHI')",Providence,vio45.xml,82,1,0,CHI,581,380,MOT
0,3,1,78,1.933933958,81,3,on,"('MOT', 'CHI')",Providence,vio45.xml,82,1,0,CHI,581,380,MOT
0,2,2,78,1.921812597,80,2,like,"('MOT', 'CHI')",Providence,vio45.xml,82,2,0,CHI,581,380,MOT
0,2,2,78,1.921812597,80,2,up,"('MOT', 'CHI')",Providence,vio45.xml,82,2,0,CHI,581,380,MOT
0,1,2,48,1.852384091,49,1,of,"('BRO', 'MOT')",Providence,vio45.xml,51,2,0,MOT,257,416,BRO
0,1,2,48,1.852384091,49,1,at,"('BRO', 'MOT')",Providence,vio45.xml,51,2,0,MOT,257,416,BRO
0,1,2,48,1.852384091,49,1,he,"('BRO', 'MOT')",Providence,vio45.xml,51,2,0,MOT,257,416,BRO
0,1,2,48,1.852384091,49,1,not,"('BRO', 'MOT')",Providence,vio45.xml,51,2,0,MOT,257,416,BRO
0,2,1,48,1.754019141,50,2,wanna,"('BRO', 'MOT')",Providence,vio45.xml,51,1,0,MOT,257,416,BRO
0,2,1,48,1.754019141,50,2,that,"('BRO', 'MOT')",Providence,vio45.xml,51,1,0,MOT,257,416,BRO
2,3,6,72,1.753538256,75,3,yeah,"('MOT', 'BRO')",Providence,vio45.xml,83,8,2,BRO,583,477,MOT
1,1,1,20,1.749199855,21,1,with,"('MOT', 'FAT')",Providence,vio45.xml,23,2,1,FAT,156,143,MOT
0,1,5,77,1.742969305,78,1,do,"('MOT', 'BRO')",Providence,vio45.xml,83,5,0,BRO,583,477,MOT
0,1,5,76,1.730390523,77,1,gonna,"('MOT', 'CHI')",Providence,vio45.xml,82,5,0,CHI,581,380,MOT
0,4,1,77,1.710790407,81,4,yeah,"('MOT', 'CHI')",Providence,vio45.xml,82,1,0,CHI,581,380,MOT
0,2,3,78,1.698669046,80,2,in,"('MOT', 'BRO')",Providence,vio45.xml,83,3,0,BRO,583,477,MOT
0,2,3,78,1.698669046,80,2,are,"('MOT', 'BRO')",Providence,vio45.xml,83,3,0,BRO,583,477,MOT
0,2,3,77,1.686398954,79,2,want,"('MOT', 'CHI')",Providence,vio45.xml,82,3,0,CHI,581,380,MOT
1,2,0,20,1.673976434,22,2,yeah,"('CHI', 'BRO')",Providence,vio45.xml,23,1,1,BRO,93,101,CHI
1,2,0,20,1.673976434,22,2,the,"('CHI', 'BRO')",Providence,vio45.xml,23,1,1,BRO,93,101,CHI
1,2,0,20,1.673976434,22,2,get,"('MOT', 'FAT')",Providence,vio45.xml,23,1,1,FAT,156,143,MOT
0,3,2,78,1.646251886,81,3,gonna,"('MOT', 'BRO')",Providence,vio45.xml,83,2,0,BRO,583,477,MOT
3,7,7,114,1.634130525,121,7,the,"('CHI', 'MOT')",Providence,vio45.xml,131,10,3,MOT,615,949,CHI
3,10,4,114,1.627456418,124,10,one,"('CHI', 'MOT')",Providence,vio45.xml,131,7,3,MOT,615,949,CHI
0,1,3,47,1.609437912,48,1,we,"('BRO', 'MOT')",Providence,vio45.xml,51,3,0,MOT,257,416,BRO
0,1,6,75,1.584120104,76,1,one,"('MOT', 'CHI')",Providence,vio45.xml,82,6,0,CHI,581,380,MOT
0,6,2,123,1.542992813,129,6,on,"('CHI', 'MOT')",Providence,vio45.xml,131,2,0,MOT,615,949,CHI
0,3,5,123,1.519825754,126,3,can,"('CHI', 'MOT')",Providence,vio45.xml,131,5,0,MOT,615,949,CHI
0,2,4,77,1.504077397,79,2,to,"('MOT', 'BRO')",Providence,vio45.xml,83,4,0,BRO,583,477,MOT
0,9,1,121,1.481604541,130,9,do,"('CHI', 'MOT')",Providence,vio45.xml,131,1,0,MOT,615,949,CHI
0,3,1,47,1.466337069,50,3,oh,"('BRO', 'MOT')",Providence,vio45.xml,51,1,0,MOT,257,416,BRO
0,3,1,47,1.466337069,50,3,with,"('BRO', 'MOT')",Providence,vio45.xml,51,1,0,MOT,257,416,BRO
0,3,1,47,1.466337069,50,3,they,"('BRO', 'MOT')",Providence,vio45.xml,51,1,0,MOT,257,416,BRO
0,3,1,47,1.466337069,50,3,is,"('BRO', 'MOT')",Providence,vio45.xml,51,1,0,MOT,257,416,BRO
0,3,1,47,1.466337069,50,3,to,"('BRO', 'MOT')",Providence,vio45.xml,51,1,0,MOT,257,416,BRO
0,2,2,47,1.446918983,49,2,gonna,"('BRO', 'MOT')",Providence,vio45.xml,51,2,0,MOT,257,416,BRO
0,4,2,77,1.423108334,81,4,have,"('MOT', 'BRO')",Providence,vio45.xml,83,2,0,BRO,583,477,MOT
1,7,2,73,1.410986974,80,7,one,"('MOT', 'BRO')",Providence,vio45.xml,83,3,1,BRO,583,477,MOT
0,7,2,122,1.40946142,129,7,to,"('CHI', 'MOT')",Providence,vio45.xml,131,2,0,MOT,615,949,CHI
0,1,1,21,1.386294361,22,1,what,"('CHI', 'BRO')",Providence,vio45.xml,23,1,0,BRO,93,101,CHI
0,1,1,21,1.386294361,22,1,a,"('CHI', 'BRO')",Providence,vio45.xml,23,1,0,BRO,93,101,CHI
0,6,1,76,1.386294361,82,6,look,"('MOT', 'BRO')",Providence,vio45.xml,83,1,0,BRO,583,477,MOT
0,1,1,21,1.386294361,22,1,what,"('MOT', 'FAT')",Providence,vio45.xml,23,1,0,FAT,156,143,MOT
0,1,1,21,1.386294361,22,1,no,"('MOT', 'FAT')",Providence,vio45.xml,23,1,0,FAT,156,143,MOT
0,1,1,21,1.386294361,22,1,can,"('MOT', 'FAT')",Providence,vio45.xml,23,1,0,FAT,156,143,MOT
0,1,1,21,1.386294361,22,1,wanna,"('MOT', 'FAT')",Providence,vio45.xml,23,1,0,FAT,156,143,MOT
0,1,1,21,1.386294361,22,1,on,"('MOT', 'FAT')",Providence,vio45.xml,23,1,0,FAT,156,143,MOT
1,8,0,42,1.348554033,50,8,what,"('BRO', 'MOT')",Providence,vio45.xml,51,1,1,MOT,257,416,BRO
1,3,7,72,1.348073148,75,3,this,"('MOT', 'BRO')",Providence,vio45.xml,83,8,1,BRO,583,477,MOT
2,3,5,41,1.343734747,44,3,the,"('BRO', 'MOT')",Providence,vio45.xml,51,7,2,MOT,257,416,BRO
1,5,4,73,1.337504197,78,5,a,"('MOT', 'BRO')",Providence,vio45.xml,83,5,1,BRO,583,477,MOT
0,2,5,76,1.337504197,78,2,can,"('MOT', 'BRO')",Providence,vio45.xml,83,5,0,BRO,583,477,MOT
0,2,5,75,1.324925415,77,2,this,"('MOT', 'CHI')",Providence,vio45.xml,82,5,0,CHI,581,380,MOT
1,6,1,43,1.292768303,49,6,this,"('BRO', 'MOT')",Providence,vio45.xml,51,2,1,MOT,257,416,BRO
0,5,4,122,1.276293466,127,5,look,"('CHI', 'MOT')",Providence,vio45.xml,131,4,0,MOT,615,949,CHI
0,5,2,76,1.240786777,81,5,oh,"('MOT', 'BRO')",Providence,vio45.xml,83,2,0,BRO,583,477,MOT
0,1,9,72,1.22644566,73,1,what,"('MOT', 'CHI')",Providence,vio45.xml,82,9,0,CHI,581,380,MOT
0,2,3,46,1.203972804,48,2,no,"('BRO', 'MOT')",Providence,vio45.xml,51,3,0,MOT,257,416,BRO
0,3,4,75,1.203972804,78,3,have,"('MOT', 'CHI')",Providence,vio45.xml,82,4,0,CHI,581,380,MOT
0,1,1,16,1.15267951,17,1,yeah,"('FAT', 'MOT')",Providence,vio45.xml,18,1,0,MOT,90,95,FAT
0,1,1,16,1.15267951,17,1,we,"('FAT', 'MOT')",Providence,vio45.xml,18,1,0,MOT,90,95,FAT
0,1,1,16,1.15267951,17,1,make,"('FAT', 'MOT')",Providence,vio45.xml,18,1,0,MOT,90,95,FAT
1,4,7,71,1.124929597,75,4,that,"('MOT', 'BRO')",Providence,vio45.xml,83,8,1,BRO,583,477,MOT
1,13,3,114,1.122142786,127,13,that,"('CHI', 'MOT')",Providence,vio45.xml,131,4,1,MOT,615,949,CHI
0,1,1,15,1.098612289,16,1,in,"('FAT', 'CHI')",Providence,vio45.xml,17,1,0,CHI,99,84,FAT
0,1,1,15,1.098612289,16,1,have,"('FAT', 'CHI')",Providence,vio45.xml,17,1,0,CHI,99,84,FAT
0,1,1,15,1.098612289,16,1,there,"('FAT', 'CHI')",Providence,vio45.xml,17,1,0,CHI,99,84,FAT
0,1,1,15,1.098612289,16,1,wanna,"('FAT', 'CHI')",Providence,vio45.xml,17,1,0,CHI,99,84,FAT
0,1,1,15,1.098612289,16,1,that,"('FAT', 'CHI')",Providence,vio45.xml,17,1,0,CHI,99,84,FAT
0,6,2,75,1.086636098,81,6,at,"('MOT', 'BRO')",Providence,vio45.xml,83,2,0,BRO,583,477,MOT
0,5,1,45,1.060871961,50,5,have,"('BRO', 'MOT')",Providence,vio45.xml,51,1,0,MOT,257,416,BRO
0,5,1,45,1.060871961,50,5,see,"('BRO', 'MOT')",Providence,vio45.xml,51,1,0,MOT,257,416,BRO
0,5,1,45,1.060871961,50,5,and,"('BRO', 'MOT')",Providence,vio45.xml,51,1,0,MOT,257,416,BRO
0,1,2,20,1.056052674,21,1,my,"('CHI', 'BRO')",Providence,vio45.xml,23,2,0,BRO,93,101,CHI
0,3,5,75,1.049822124,78,3,it,"('MOT', 'BRO')",Providence,vio45.xml,83,5,0,BRO,583,477,MOT
0,3,5,75,1.049822124,78,3,and,"('MOT', 'BRO')",Providence,vio45.xml,83,5,0,BRO,583,477,MOT
8,19,9,95,1.010643516,114,19,a,"('CHI', 'MOT')",Providence,vio45.xml,131,17,8,MOT,615,949,CHI
0,4,4,75,0.993251773,79,4,there,"('MOT', 'BRO')",Providence,vio45.xml,83,4,0,BRO,583,477,MOT
0,4,4,75,0.993251773,79,4,see,"('MOT', 'BRO')",Providence,vio45.xml,83,4,0,BRO,583,477,MOT
0,2,1,20,0.980829253,22,2,and,"('CHI', 'BRO')",Providence,vio45.xml,23,1,0,BRO,93,101,CHI
0,2,1,20,0.980829253,22,2,a,"('MOT', 'FAT')",Providence,vio45.xml,23,1,0,FAT,156,143,MOT
2,12,7,110,0.956049224,122,12,it,"('CHI', 'MOT')",Providence,vio45.xml,131,9,2,MOT,615,949,CHI
0,9,3,119,0.955511445,128,9,and,"('CHI', 'MOT')",Providence,vio45.xml,131,3,0,MOT,615,949,CHI
1,4,0,13,0.929535959,17,4,you,"('FAT', 'MOT')",Providence,vio45.xml,18,1,1,MOT,90,95,FAT
0,3,6,73,0.890972924,76,3,and,"('MOT', 'CHI')",Providence,vio45.xml,82,6,0,CHI,581,380,MOT
0,6,3,74,0.851371186,80,6,what,"('MOT', 'BRO')",Providence,vio45.xml,83,3,0,BRO,583,477,MOT
0,13,2,116,0.849845632,129,13,you,"('CHI', 'MOT')",Providence,vio45.xml,131,2,0,MOT,615,949,CHI
0,1,1,11,0.84729786,12,1,yeah,"('BRO', 'FAT')",Providence,vio45.xml,13,1,0,FAT,51,66,BRO
0,4,5,73,0.814099791,77,4,the,"('MOT', 'CHI')",Providence,vio45.xml,82,5,0,CHI,581,380,MOT
0,1,2,15,0.810930216,16,1,what,"('FAT', 'MOT')",Providence,vio45.xml,18,2,0,MOT,90,95,FAT
0,1,3,19,0.78845736,20,1,that,"('MOT', 'FAT')",Providence,vio45.xml,23,3,0,FAT,156,143,MOT
0,5,2,44,0.753771802,49,5,one,"('BRO', 'MOT')",Providence,vio45.xml,51,2,0,MOT,257,416,BRO
0,1,1,9,0.693147181,10,1,there,"('FAT', 'BRO')",Providence,vio45.xml,11,1,0,BRO,77,69,FAT
0,8,1,42,0.655406853,50,8,it,"('BRO', 'MOT')",Providence,vio45.xml,51,1,0,MOT,257,416,BRO
0,2,2,19,0.650587566,21,2,yeah,"('MOT', 'FAT')",Providence,vio45.xml,23,2,0,FAT,156,143,MOT
1,10,9,111,0.622529613,121,10,yeah,"('CHI', 'MOT')",Providence,vio45.xml,131,10,1,MOT,615,949,CHI
1,13,1,36,0.599621123,49,13,you,"('BRO', 'MOT')",Providence,vio45.xml,51,2,1,MOT,257,416,BRO
2,3,4,14,0.577315365,17,3,you,"('MOT', 'FAT')",Providence,vio45.xml,23,6,2,FAT,156,143,MOT
0,1,1,7,0.510825624,8,1,get,"('CHI', 'FAT')",Providence,vio45.xml,9,1,0,FAT,35,34,CHI
0,1,1,7,0.510825624,8,1,look,"('CHI', 'FAT')",Providence,vio45.xml,9,1,0,FAT,35,34,CHI
0,1,1,7,0.510825624,8,1,this,"('CHI', 'FAT')",Providence,vio45.xml,9,1,0,FAT,35,34,CHI
0,4,8,71,0.431782416,75,4,on,"('MOT', 'BRO')",Providence,vio45.xml,83,8,0,BRO,583,477,MOT
0,13,4,114,0.428995606,127,13,this,"('CHI', 'MOT')",Providence,vio45.xml,131,4,0,MOT,615,949,CHI
1,6,11,64,0.384845821,70,6,is,"('MOT', 'CHI')",Providence,vio45.xml,82,12,1,CHI,581,380,MOT
0,3,2,18,0.362905494,21,3,oh,"('MOT', 'FAT')",Providence,vio45.xml,23,2,0,FAT,156,143,MOT
0,2,2,13,0.348306694,15,2,want,"('FAT', 'CHI')",Providence,vio45.xml,17,2,0,CHI,99,84,FAT
1,15,8,107,0.342944751,122,15,is,"('CHI', 'MOT')",Providence,vio45.xml,131,9,1,MOT,615,949,CHI
0,15,4,112,0.295464213,127,15,make,"('CHI', 'MOT')",Providence,vio45.xml,131,4,0,MOT,615,949,CHI
0,1,23,59,0.21511138,60,1,you,"('MOT', 'BRO')",Providence,vio45.xml,83,23,0,BRO,583,477,MOT
0,14,5,112,0.198069914,126,14,what,"('CHI', 'MOT')",Providence,vio45.xml,131,5,0,MOT,615,949,CHI
0,8,3,40,0.105360516,48,8,a,"('BRO', 'MOT')",Providence,vio45.xml,51,3,0,MOT,257,416,BRO
0,8,6,68,0.080042708,76,8,a,"('MOT', 'CHI')",Providence,vio45.xml,82,6,0,CHI,581,380,MOT
0,1,3,7,0,8,1,you,"('FAT', 'BRO')",Providence,vio45.xml,11,3,0,BRO,77,69,FAT
1,15,7,60,-0.038221213,75,15,the,"('MOT', 'BRO')",Providence,vio45.xml,83,8,1,BRO,583,477,MOT
0,1,3,249,3.226843995,250,1,he,"('MOT', 'CHI')",Providence,vio47.xml,253,3,0,CHI,2932,1396,MOT
1,0,16,236,3.220978875,236,0,gonna,"('MOT', 'CHI')",Providence,vio47.xml,253,17,1,CHI,2932,1396,MOT
0,3,1,249,3.052427617,252,3,at,"('MOT', 'CHI')",Providence,vio47.xml,253,1,0,CHI,2932,1396,MOT
0,2,2,249,3.048482839,251,2,look,"('MOT', 'CHI')",Providence,vio47.xml,253,2,0,CHI,2932,1396,MOT
1,1,9,242,3.016351561,243,1,some,"('MOT', 'CHI')",Providence,vio47.xml,253,10,1,CHI,2932,1396,MOT
0,1,5,247,2.882403588,248,1,was,"('MOT', 'CHI')",Providence,vio47.xml,253,5,0,CHI,2932,1396,MOT
0,2,3,248,2.821378886,250,2,where,"('MOT', 'CHI')",Providence,vio47.xml,253,3,0,CHI,2932,1396,MOT
2,3,8,240,2.728669488,243,3,put,"('MOT', 'CHI')",Providence,vio47.xml,253,10,2,CHI,2932,1396,MOT
0,1,8,244,2.513656063,245,1,with,"('MOT', 'CHI')",Providence,vio47.xml,253,8,0,CHI,2932,1396,MOT
2,4,10,237,2.34317849,241,4,of,"('MOT', 'CHI')",Providence,vio47.xml,253,12,2,CHI,2932,1396,MOT
0,1,10,242,2.32320438,243,1,up,"('MOT', 'CHI')",Providence,vio47.xml,253,10,0,CHI,2932,1396,MOT
0,2,7,244,2.21759188,246,2,wanna,"('MOT', 'CHI')",Providence,vio47.xml,253,7,0,CHI,2932,1396,MOT
4,4,21,224,2.142242443,228,4,have,"('MOT', 'CHI')",Providence,vio47.xml,253,25,4,CHI,2932,1396,MOT
0,2,8,243,2.108190955,245,2,did,"('MOT', 'CHI')",Providence,vio47.xml,253,8,0,CHI,2932,1396,MOT
2,3,18,230,2.080860988,233,3,and,"('MOT', 'CHI')",Providence,vio47.xml,253,20,2,CHI,2932,1396,MOT
1,2,19,231,1.963077953,233,2,see,"('MOT', 'CHI')",Providence,vio47.xml,253,20,1,CHI,2932,1396,MOT
2,2,31,218,1.84732932,220,2,can,"('MOT', 'CHI')",Providence,vio47.xml,253,33,2,CHI,2932,1396,MOT
0,6,4,243,1.787783321,249,6,are,"('MOT', 'CHI')",Providence,vio47.xml,253,4,0,CHI,2932,1396,MOT
1,6,9,237,1.763588592,243,6,no,"('MOT', 'CHI')",Providence,vio47.xml,253,10,1,CHI,2932,1396,MOT
0,2,12,239,1.755391825,241,2,but,"('MOT', 'CHI')",Providence,vio47.xml,253,12,0,CHI,2932,1396,MOT
0,3,9,241,1.721141902,244,3,for,"('MOT', 'CHI')",Providence,vio47.xml,253,9,0,CHI,2932,1396,MOT
4,7,20,222,1.714317543,229,7,this,"('MOT', 'CHI')",Providence,vio47.xml,253,24,4,CHI,2932,1396,MOT
0,2,13,238,1.682275236,240,2,not,"('MOT', 'CHI')",Providence,vio47.xml,253,13,0,CHI,2932,1396,MOT
0,1,20,232,1.67539588,233,1,we,"('MOT', 'CHI')",Providence,vio47.xml,253,20,0,CHI,2932,1396,MOT
6,10,20,217,1.64953237,227,10,one,"('MOT', 'CHI')",Providence,vio47.xml,253,26,6,CHI,2932,1396,MOT
1,4,17,231,1.556037136,235,4,like,"('MOT', 'CHI')",Providence,vio47.xml,253,18,1,CHI,2932,1396,MOT
2,6,20,225,1.425686763,231,6,is,"('MOT', 'CHI')",Providence,vio47.xml,253,22,2,CHI,2932,1396,MOT
4,8,25,216,1.39876113,224,8,do,"('MOT', 'CHI')",Providence,vio47.xml,253,29,4,CHI,2932,1396,MOT
0,3,13,237,1.394593164,240,3,get,"('MOT', 'CHI')",Providence,vio47.xml,253,13,0,CHI,2932,1396,MOT
0,4,12,237,1.244566201,241,4,on,"('MOT', 'CHI')",Providence,vio47.xml,253,12,0,CHI,2932,1396,MOT
3,10,20,220,1.216260635,230,10,to,"('MOT', 'CHI')",Providence,vio47.xml,253,23,3,CHI,2932,1396,MOT
2,6,29,216,1.06784063,222,6,in,"('MOT', 'CHI')",Providence,vio47.xml,253,31,2,CHI,2932,1396,MOT
3,14,17,219,1.046787221,233,14,want,"('MOT', 'CHI')",Providence,vio47.xml,253,20,3,CHI,2932,1396,MOT
5,7,50,191,0.967584026,198,7,it,"('MOT', 'CHI')",Providence,vio47.xml,253,55,5,CHI,2932,1396,MOT
0,11,6,236,0.953104705,247,11,my,"('MOT', 'CHI')",Providence,vio47.xml,253,6,0,CHI,2932,1396,MOT
4,13,29,207,0.817709903,220,13,the,"('MOT', 'CHI')",Providence,vio47.xml,253,33,4,CHI,2932,1396,MOT
0,7,12,234,0.774562572,241,7,go,"('MOT', 'CHI')",Providence,vio47.xml,253,12,0,CHI,2932,1396,MOT
1,6,28,218,0.733784826,224,6,what,"('MOT', 'CHI')",Providence,vio47.xml,253,29,1,CHI,2932,1396,MOT
0,4,21,228,0.710388987,232,4,oh,"('MOT', 'CHI')",Providence,vio47.xml,253,21,0,CHI,2932,1396,MOT
10,10,79,154,0.601128282,164,10,you,"('MOT', 'CHI')",Providence,vio47.xml,253,89,10,CHI,2932,1396,MOT
2,13,24,214,0.561072452,227,13,a,"('MOT', 'CHI')",Providence,vio47.xml,253,26,2,CHI,2932,1396,MOT
0,9,18,226,0.169742775,235,9,yeah,"('MOT', 'CHI')",Providence,vio47.xml,253,18,0,CHI,2932,1396,MOT
1,9,35,208,0.142047658,217,9,that,"('MOT', 'CHI')",Providence,vio47.xml,253,36,1,CHI,2932,1396,MOT
1,9,0,256,2.879198457,265,9,they,"('CHI', 'MOT')",Providence,vio48.xml,266,1,1,MOT,1383,4738,CHI
1,8,1,256,2.693124551,264,8,big,"('CHI', 'MOT')",Providence,vio48.xml,266,2,1,MOT,1383,4738,CHI
0,4,2,260,2.587764035,264,4,was,"('CHI', 'MOT')",Providence,vio48.xml,266,2,0,MOT,1383,4738,CHI
1,0,0,16,2.48490665,16,0,for,"('MOT', 'FAT')",Providence,vio48.xml,17,1,1,FAT,89,176,MOT
1,0,0,16,2.48490665,16,0,is,"('MOT', 'FAT')",Providence,vio48.xml,17,1,1,FAT,89,176,MOT
1,14,0,251,2.473733349,265,14,go,"('CHI', 'MOT')",Providence,vio48.xml,266,1,1,MOT,1383,4738,CHI
0,4,3,259,2.360854001,263,4,where,"('CHI', 'MOT')",Providence,vio48.xml,266,3,0,MOT,1383,4738,CHI
0,8,1,257,2.291411792,265,8,with,"('CHI', 'MOT')",Providence,vio48.xml,266,1,0,MOT,1383,4738,CHI
0,6,2,258,2.251291799,264,6,some,"('CHI', 'MOT')",Providence,vio48.xml,266,2,0,MOT,1383,4738,CHI
1,0,1,15,2.140066163,15,0,oh,"('MOT', 'FAT')",Providence,vio48.xml,17,2,1,FAT,89,176,MOT
2,18,1,245,2.124465223,263,18,oh,"('CHI', 'MOT')",Providence,vio48.xml,266,3,2,MOT,1383,4738,CHI
1,9,4,252,2.016805971,261,9,gonna,"('CHI', 'MOT')",Providence,vio48.xml,266,5,1,MOT,1383,4738,CHI
1,17,1,247,1.99997737,264,17,we,"('CHI', 'MOT')",Providence,vio48.xml,266,2,1,MOT,1383,4738,CHI
0,12,1,253,1.923687012,265,12,wanna,"('CHI', 'MOT')",Providence,vio48.xml,266,1,0,MOT,1383,4738,CHI
0,13,1,252,1.84957904,265,13,not,"('CHI', 'MOT')",Providence,vio48.xml,266,1,0,MOT,1383,4738,CHI
0,14,1,251,1.780586169,265,14,there,"('CHI', 'MOT')",Providence,vio48.xml,266,1,0,MOT,1383,4738,CHI
1,12,4,249,1.754441706,261,12,but,"('CHI', 'MOT')",Providence,vio48.xml,266,5,1,MOT,1383,4738,CHI
0,11,2,253,1.712295298,264,11,my,"('CHI', 'MOT')",Providence,vio48.xml,266,2,0,MOT,1383,4738,CHI
1,15,3,247,1.704748092,262,15,all,"('CHI', 'MOT')",Providence,vio48.xml,266,4,1,MOT,1383,4738,CHI
0,6,5,255,1.680333734,261,6,want,"('CHI', 'MOT')",Providence,vio48.xml,266,5,0,MOT,1383,4738,CHI
0,9,3,254,1.667706821,263,9,did,"('CHI', 'MOT')",Providence,vio48.xml,266,3,0,MOT,1383,4738,CHI
1,19,2,244,1.667706821,263,19,of,"('CHI', 'MOT')",Providence,vio48.xml,266,3,1,MOT,1383,4738,CHI
0,12,2,252,1.63225259,264,12,get,"('CHI', 'MOT')",Providence,vio48.xml,266,2,0,MOT,1383,4738,CHI
1,12,5,248,1.617100785,260,12,think,"('CHI', 'MOT')",Providence,vio48.xml,266,6,1,MOT,1383,4738,CHI
1,8,9,248,1.563975538,256,8,no,"('CHI', 'MOT')",Providence,vio48.xml,266,10,1,MOT,1383,4738,CHI
0,13,2,251,1.558144618,264,13,up,"('CHI', 'MOT')",Providence,vio48.xml,266,2,0,MOT,1383,4738,CHI
1,19,3,243,1.481604541,262,19,are,"('CHI', 'MOT')",Providence,vio48.xml,266,4,1,MOT,1383,4738,CHI
0,10,5,251,1.22834861,261,10,he,"('CHI', 'MOT')",Providence,vio48.xml,266,5,0,MOT,1383,4738,CHI
2,22,7,235,1.122050862,257,22,make,"('CHI', 'MOT')",Providence,vio48.xml,266,9,2,MOT,1383,4738,CHI
0,1,1,15,1.098612289,16,1,what,"('MOT', 'FAT')",Providence,vio48.xml,17,1,0,FAT,89,176,MOT
0,1,1,15,1.098612289,16,1,a,"('MOT', 'FAT')",Providence,vio48.xml,17,1,0,FAT,89,176,MOT
0,1,1,15,1.098612289,16,1,did,"('MOT', 'FAT')",Providence,vio48.xml,17,1,0,FAT,89,176,MOT
0,1,1,15,1.098612289,16,1,can,"('MOT', 'FAT')",Providence,vio48.xml,17,1,0,FAT,89,176,MOT
1,2,1,13,1.041453875,15,2,to,"('MOT', 'FAT')",Providence,vio48.xml,17,2,1,FAT,89,176,MOT
1,0,2,5,1.029619417,5,0,you,"('MOT', 'CHI')",Providence,vio48.xml,8,3,1,CHI,164,33,MOT
1,0,2,5,1.029619417,5,0,the,"('MOT', 'CHI')",Providence,vio48.xml,8,3,1,CHI,164,33,MOT
0,18,3,245,1.025852934,263,18,have,"('CHI', 'MOT')",Providence,vio48.xml,266,3,0,MOT,1383,4738,CHI
4,36,7,219,0.982646727,255,36,like,"('CHI', 'MOT')",Providence,vio48.xml,266,11,4,MOT,1383,4738,CHI
1,24,5,236,0.963174318,260,24,look,"('CHI', 'MOT')",Providence,vio48.xml,266,6,1,MOT,1383,4738,CHI
0,16,4,246,0.95097629,262,16,at,"('CHI', 'MOT')",Providence,vio48.xml,266,4,0,MOT,1383,4738,CHI
1,25,5,235,0.923953605,260,25,can,"('CHI', 'MOT')",Providence,vio48.xml,266,6,1,MOT,1383,4738,CHI
6,25,20,215,0.844546827,240,25,one,"('CHI', 'MOT')",Providence,vio48.xml,266,26,6,MOT,1383,4738,CHI
2,33,6,225,0.830348302,258,33,what,"('CHI', 'MOT')",Providence,vio48.xml,266,8,2,MOT,1383,4738,CHI
6,31,17,212,0.762556632,243,31,it,"('CHI', 'MOT')",Providence,vio48.xml,266,23,6,MOT,1383,4738,CHI
3,40,7,216,0.74077523,256,40,do,"('CHI', 'MOT')",Providence,vio48.xml,266,10,3,MOT,1383,4738,CHI
0,31,2,233,0.731466045,264,31,in,"('CHI', 'MOT')",Providence,vio48.xml,266,2,0,MOT,1383,4738,CHI
6,28,24,208,0.58514909,236,28,is,"('CHI', 'MOT')",Providence,vio48.xml,266,30,6,MOT,1383,4738,CHI
6,57,10,193,0.524524468,250,57,that,"('CHI', 'MOT')",Providence,vio48.xml,266,16,6,MOT,1383,4738,CHI
4,42,12,208,0.487295126,250,42,and,"('CHI', 'MOT')",Providence,vio48.xml,266,16,4,MOT,1383,4738,CHI
0,1,3,13,0.470003629,14,1,that,"('MOT', 'FAT')",Providence,vio48.xml,17,3,0,FAT,89,176,MOT
0,1,1,6,0.405465108,7,1,this,"('MOT', 'CHI')",Providence,vio48.xml,8,1,0,CHI,164,33,MOT
7,42,21,196,0.397682968,238,42,the,"('CHI', 'MOT')",Providence,vio48.xml,266,28,7,MOT,1383,4738,CHI
0,2,2,13,0.348306694,15,2,the,"('MOT', 'FAT')",Providence,vio48.xml,17,2,0,FAT,89,176,MOT
2,6,1,8,0.315852949,14,6,you,"('MOT', 'FAT')",Providence,vio48.xml,17,3,2,FAT,89,176,MOT
1,2,0,2,0.287682072,4,2,you,"('FAT', 'MOT')",Providence,vio48.xml,5,1,1,MOT,15,54,FAT
3,35,17,211,0.225161715,246,35,this,"('CHI', 'MOT')",Providence,vio48.xml,266,20,3,MOT,1383,4738,CHI
0,1,2,5,0,6,1,one,"('MOT', 'CHI')",Providence,vio48.xml,8,2,0,CHI,164,33,MOT
15,78,36,137,-0.18725369,215,78,a,"('CHI', 'MOT')",Providence,vio48.xml,266,51,15,MOT,1383,4738,CHI
3,69,14,180,-0.281186921,249,69,you,"('CHI', 'MOT')",Providence,vio48.xml,266,17,3,MOT,1383,4738,CHI
0,28,10,228,-0.299242895,256,28,yeah,"('CHI', 'MOT')",Providence,vio48.xml,266,10,0,MOT,1383,4738,CHI
0,1,3,4,-0.356674944,5,1,to,"('MOT', 'CHI')",Providence,vio48.xml,8,3,0,CHI,164,33,MOT
0,31,11,224,-0.481609175,255,31,on,"('CHI', 'MOT')",Providence,vio48.xml,266,11,0,MOT,1383,4738,CHI
0,40,9,217,-0.554639278,257,40,to,"('CHI', 'MOT')",Providence,vio48.xml,266,9,0,MOT,1383,4738,CHI
0,1,1,0,-0.693147181,1,1,is,"('CHI', 'FAT')",Providence,vio48.xml,2,1,0,FAT,14,19,CHI
0,1,1,0,-0.693147181,1,1,that,"('CHI', 'FAT')",Providence,vio48.xml,2,1,0,FAT,14,19,CHI
1,3,0,290,3.895215887,293,3,make,"('CHI', 'MOT')",Providence,vio49.xml,294,1,1,MOT,1509,4247,CHI
2,4,3,285,3.216587494,289,4,want,"('CHI', 'MOT')",Providence,vio49.xml,294,5,2,MOT,1509,4247,CHI
1,4,2,287,3.154443965,291,4,big,"('CHI', 'MOT')",Providence,vio49.xml,294,3,1,MOT,1509,4247,CHI
0,6,1,287,2.642452919,293,6,my,"('CHI', 'MOT')",Providence,vio49.xml,294,1,0,MOT,1509,4247,CHI
2,8,4,280,2.491827093,288,8,think,"('CHI', 'MOT')",Providence,vio49.xml,294,6,2,MOT,1509,4247,CHI
0,8,1,285,2.39113849,293,8,have,"('CHI', 'MOT')",Providence,vio49.xml,294,1,0,MOT,1509,4247,CHI
0,8,1,285,2.39113849,293,8,wanna,"('CHI', 'MOT')",Providence,vio49.xml,294,1,0,MOT,1509,4247,CHI
0,6,2,286,2.351375257,292,6,can,"('CHI', 'MOT')",Providence,vio49.xml,294,2,0,MOT,1509,4247,CHI
0,9,1,284,2.285777975,293,9,get,"('CHI', 'MOT')",Providence,vio49.xml,294,1,0,MOT,1509,4247,CHI
0,9,1,284,2.285777975,293,9,up,"('CHI', 'MOT')",Providence,vio49.xml,294,1,0,MOT,1509,4247,CHI
0,10,1,283,2.190467795,293,10,do,"('CHI', 'MOT')",Providence,vio49.xml,294,1,0,MOT,1509,4247,CHI
0,6,3,285,2.124824548,291,6,there,"('CHI', 'MOT')",Providence,vio49.xml,294,3,0,MOT,1509,4247,CHI
1,0,0,9,1.992430165,9,0,do,"('MOT', 'UNI')",Providence,vio49.xml,10,1,1,UNI,71,53,MOT
0,7,3,284,1.991293155,291,7,where,"('CHI', 'MOT')",Providence,vio49.xml,294,3,0,MOT,1509,4247,CHI
0,13,1,280,1.949305738,293,13,go,"('CHI', 'MOT')",Providence,vio49.xml,294,1,0,MOT,1509,4247,CHI
0,10,2,282,1.899390133,292,10,they,"('CHI', 'MOT')",Providence,vio49.xml,294,2,0,MOT,1509,4247,CHI
0,8,3,283,1.873510119,291,8,was,"('CHI', 'MOT')",Providence,vio49.xml,294,3,0,MOT,1509,4247,CHI
1,8,7,278,1.85629799,286,8,no,"('CHI', 'MOT')",Providence,vio49.xml,294,8,1,MOT,1509,4247,CHI
1,0,0,7,1.791759469,7,0,she,"('MOT', 'CHI')",Providence,vio49.xml,8,1,1,CHI,130,30,MOT
0,16,1,277,1.755149724,293,16,on,"('CHI', 'MOT')",Providence,vio49.xml,294,1,0,MOT,1509,4247,CHI
0,10,3,281,1.672839424,291,10,all,"('CHI', 'MOT')",Providence,vio49.xml,294,3,0,MOT,1509,4247,CHI
4,28,5,257,1.503729025,285,28,we,"('CHI', 'MOT')",Providence,vio49.xml,294,9,4,MOT,1509,4247,CHI
1,0,1,6,1.386294361,6,0,go,"('MOT', 'CHI')",Providence,vio49.xml,8,2,1,CHI,130,30,MOT
2,18,8,266,1.325258471,284,18,he,"('CHI', 'MOT')",Providence,vio49.xml,294,10,2,MOT,1509,4247,CHI
1,0,2,7,1.280933845,7,0,you,"('MOT', 'UNI')",Providence,vio49.xml,10,3,1,UNI,71,53,MOT
0,20,2,272,1.252762968,292,20,in,"('CHI', 'MOT')",Providence,vio49.xml,294,2,0,MOT,1509,4247,CHI
0,16,3,275,1.237521353,291,16,like,"('CHI', 'MOT')",Providence,vio49.xml,294,3,0,MOT,1509,4247,CHI
0,16,3,275,1.237521353,291,16,did,"('CHI', 'MOT')",Providence,vio49.xml,294,3,0,MOT,1509,4247,CHI
2,20,8,264,1.225175012,284,20,what,"('CHI', 'MOT')",Providence,vio49.xml,294,10,2,MOT,1509,4247,CHI
1,0,0,3,1.203972804,3,0,for,"('CHI', 'FAT')",Providence,vio49.xml,4,1,1,FAT,20,24,CHI
2,23,7,262,1.182145401,285,23,of,"('CHI', 'MOT')",Providence,vio49.xml,294,9,2,MOT,1509,4247,CHI
0,17,3,274,1.180362939,291,17,see,"('CHI', 'MOT')",Providence,vio49.xml,294,3,0,MOT,1509,4247,CHI
0,9,7,278,1.166617018,287,9,are,"('CHI', 'MOT')",Providence,vio49.xml,294,7,0,MOT,1509,4247,CHI
0,23,2,269,1.119231576,292,23,look,"('CHI', 'MOT')",Providence,vio49.xml,294,2,0,MOT,1509,4247,CHI
2,28,6,258,1.091691846,286,28,it,"('CHI', 'MOT')",Providence,vio49.xml,294,8,2,MOT,1509,4247,CHI
1,0,2,5,1.029619417,5,0,wanna,"('MOT', 'CHI')",Providence,vio49.xml,8,3,1,CHI,130,30,MOT
1,23,6,264,0.984295461,287,23,to,"('CHI', 'MOT')",Providence,vio49.xml,294,7,1,MOT,1509,4247,CHI
0,8,10,276,0.973860584,284,8,not,"('CHI', 'MOT')",Providence,vio49.xml,294,10,0,MOT,1509,4247,CHI
2,41,4,247,0.951382052,288,41,you,"('CHI', 'MOT')",Providence,vio49.xml,294,6,2,MOT,1509,4247,CHI
3,31,9,251,0.930475367,282,31,one,"('CHI', 'MOT')",Providence,vio49.xml,294,12,3,MOT,1509,4247,CHI
0,14,6,274,0.88238918,288,14,but,"('CHI', 'MOT')",Providence,vio49.xml,294,6,0,MOT,1509,4247,CHI
3,26,14,251,0.777230298,277,26,is,"('CHI', 'MOT')",Providence,vio49.xml,294,17,3,MOT,1509,4247,CHI
0,1,1,8,0.606135804,9,1,like,"('MOT', 'UNI')",Providence,vio49.xml,10,1,0,UNI,71,53,MOT
0,1,1,8,0.606135804,9,1,wanna,"('MOT', 'UNI')",Providence,vio49.xml,10,1,0,UNI,71,53,MOT
0,1,1,8,0.606135804,9,1,at,"('MOT', 'UNI')",Providence,vio49.xml,10,1,0,UNI,71,53,MOT
3,29,20,242,0.37569295,271,29,this,"('CHI', 'MOT')",Providence,vio49.xml,294,23,3,MOT,1509,4247,CHI
0,25,6,263,0.332342843,288,25,at,"('CHI', 'MOT')",Providence,vio49.xml,294,6,0,MOT,1509,4247,CHI
1,43,9,241,0.080042708,284,43,and,"('CHI', 'MOT')",Providence,vio49.xml,294,10,1,MOT,1509,4247,CHI
0,1,2,5,0,6,1,the,"('MOT', 'CHI')",Providence,vio49.xml,8,2,0,CHI,130,30,MOT
0,1,2,5,0,6,1,to,"('MOT', 'CHI')",Providence,vio49.xml,8,2,0,CHI,130,30,MOT
0,1,3,6,-0.105360516,7,1,yeah,"('MOT', 'UNI')",Providence,vio49.xml,10,3,0,UNI,71,53,MOT
1,19,31,243,-0.252996514,262,19,yeah,"('CHI', 'MOT')",Providence,vio49.xml,294,32,1,MOT,1509,4247,CHI
0,1,3,4,-0.356674944,5,1,yeah,"('MOT', 'CHI')",Providence,vio49.xml,8,3,0,CHI,130,30,MOT
0,1,1,1,-0.405465108,2,1,it,"('FAT', 'CHI')",Providence,vio49.xml,3,1,0,CHI,15,18,FAT
0,1,1,1,-0.405465108,2,1,see,"('FAT', 'CHI')",Providence,vio49.xml,3,1,0,CHI,15,18,FAT
0,39,9,246,-0.427292511,285,39,that,"('CHI', 'MOT')",Providence,vio49.xml,294,9,0,MOT,1509,4247,CHI
0,1,1,0,-0.693147181,1,1,you,"('MOT', 'FAT')",Providence,vio49.xml,2,1,0,FAT,6,7,MOT
0,41,13,240,-0.800272922,281,41,a,"('CHI', 'MOT')",Providence,vio49.xml,294,13,0,MOT,1509,4247,CHI
1,60,25,208,-1.151509235,268,60,the,"('CHI', 'MOT')",Providence,vio49.xml,294,26,1,MOT,1509,4247,CHI
1,1,1,202,3.936715618,203,1,no,"('CHI', 'MOT')",Providence,vio50.xml,205,2,1,MOT,939,2419,CHI
0,1,1,203,3.5361167,204,1,put,"('CHI', 'MOT')",Providence,vio50.xml,205,1,0,MOT,939,2419,CHI
1,2,4,198,2.95689244,200,2,want,"('CHI', 'MOT')",Providence,vio50.xml,205,5,1,MOT,939,2419,CHI
1,9,0,195,2.619825968,204,9,he,"('CHI', 'MOT')",Providence,vio50.xml,205,1,1,MOT,939,2419,CHI
0,4,1,200,2.619825968,204,4,big,"('CHI', 'MOT')",Providence,vio50.xml,205,1,0,MOT,939,2419,CHI
2,7,2,194,2.540617257,201,7,did,"('CHI', 'MOT')",Providence,vio50.xml,205,4,2,MOT,939,2419,CHI
0,6,1,198,2.283353731,204,6,wanna,"('CHI', 'MOT')",Providence,vio50.xml,205,1,0,MOT,939,2419,CHI
0,7,1,197,2.149822338,204,7,think,"('CHI', 'MOT')",Providence,vio50.xml,205,1,0,MOT,939,2419,CHI
1,9,2,193,2.099244169,202,9,see,"('CHI', 'MOT')",Providence,vio50.xml,205,3,1,MOT,939,2419,CHI
1,8,3,193,2.017369113,201,8,they,"('CHI', 'MOT')",Providence,vio50.xml,205,4,1,MOT,939,2419,CHI
0,9,1,195,1.926678787,204,9,with,"('CHI', 'MOT')",Providence,vio50.xml,205,1,0,MOT,939,2419,CHI
0,7,2,196,1.857274076,203,7,we,"('CHI', 'MOT')",Providence,vio50.xml,205,2,0,MOT,939,2419,CHI
0,6,3,196,1.762771932,202,6,all,"('CHI', 'MOT')",Providence,vio50.xml,205,3,0,MOT,939,2419,CHI
0,7,3,195,1.62924054,202,7,can,"('CHI', 'MOT')",Providence,vio50.xml,205,3,0,MOT,939,2419,CHI
0,6,4,195,1.575536361,201,6,are,"('CHI', 'MOT')",Providence,vio50.xml,205,4,0,MOT,939,2419,CHI
1,13,3,188,1.575536361,201,13,at,"('CHI', 'MOT')",Providence,vio50.xml,205,4,1,MOT,939,2419,CHI
3,14,8,180,1.391409462,194,14,is,"('CHI', 'MOT')",Providence,vio50.xml,205,11,3,MOT,939,2419,CHI
2,13,7,183,1.349926717,196,13,make,"('CHI', 'MOT')",Providence,vio50.xml,205,9,2,MOT,939,2419,CHI
2,15,6,182,1.316743298,197,15,to,"('CHI', 'MOT')",Providence,vio50.xml,205,8,2,MOT,939,2419,CHI
1,11,6,187,1.30933332,198,11,look,"('CHI', 'MOT')",Providence,vio50.xml,205,7,1,MOT,939,2419,CHI
0,12,3,190,1.143732724,202,12,in,"('CHI', 'MOT')",Providence,vio50.xml,205,3,0,MOT,939,2419,CHI
2,21,5,177,1.108662625,198,21,it,"('CHI', 'MOT')",Providence,vio50.xml,205,7,2,MOT,939,2419,CHI
0,13,3,189,1.069624752,202,13,of,"('CHI', 'MOT')",Providence,vio50.xml,205,3,0,MOT,939,2419,CHI
1,0,0,2,0.980829253,2,0,on,"('FAT', 'MOT')",Providence,vio50.xml,3,1,1,MOT,28,63,FAT
1,16,6,182,0.961026626,198,16,do,"('CHI', 'MOT')",Providence,vio50.xml,205,7,1,MOT,939,2419,CHI
5,24,11,165,0.934785315,189,24,one,"('CHI', 'MOT')",Providence,vio50.xml,205,16,5,MOT,939,2419,CHI
2,30,4,169,0.888488451,199,30,you,"('CHI', 'MOT')",Providence,vio50.xml,205,6,2,MOT,939,2419,CHI
2,0,0,1,0.810930216,1,0,you,"('FAT', 'MOT')",Providence,vio50.xml,3,2,2,MOT,28,63,FAT
1,16,8,180,0.750305594,196,16,what,"('CHI', 'MOT')",Providence,vio50.xml,205,9,1,MOT,939,2419,CHI
5,30,12,158,0.660357358,188,30,a,"('CHI', 'MOT')",Providence,vio50.xml,205,17,5,MOT,939,2419,CHI
2,16,14,173,0.627300615,189,16,and,"('CHI', 'MOT')",Providence,vio50.xml,205,16,2,MOT,939,2419,CHI
0,19,4,182,0.525714236,201,19,like,"('CHI', 'MOT')",Providence,vio50.xml,205,4,0,MOT,939,2419,CHI
4,27,14,160,0.523248144,187,27,this,"('CHI', 'MOT')",Providence,vio50.xml,205,18,4,MOT,939,2419,CHI
2,34,13,156,-0.032453745,190,34,the,"('CHI', 'MOT')",Providence,vio50.xml,205,15,2,MOT,939,2419,CHI
3,17,43,142,-0.293874043,159,17,yeah,"('CHI', 'MOT')",Providence,vio50.xml,205,46,3,MOT,939,2419,CHI
0,1,1,1,-0.405465108,2,1,a,"('FAT', 'MOT')",Providence,vio50.xml,3,1,0,MOT,28,63,FAT
0,1,1,1,-0.405465108,2,1,can,"('FAT', 'MOT')",Providence,vio50.xml,3,1,0,MOT,28,63,FAT
0,1,1,1,-0.405465108,2,1,and,"('FAT', 'MOT')",Providence,vio50.xml,3,1,0,MOT,28,63,FAT
0,1,1,1,-0.405465108,2,1,that,"('MOT', 'BRO')",Providence,vio50.xml,3,1,0,BRO,37,15,MOT
0,1,1,1,-0.405465108,2,1,the,"('MOT', 'BRO')",Providence,vio50.xml,3,1,0,BRO,37,15,MOT
0,1,1,1,-0.405465108,2,1,to,"('MOT', 'FAT')",Providence,vio50.xml,3,1,0,FAT,33,21,MOT
0,26,10,169,-0.497539787,195,26,that,"('CHI', 'MOT')",Providence,vio50.xml,205,10,0,MOT,939,2419,CHI
1,2,0,96,3.101092789,98,2,think,"('CHI', 'MOT')",Providence,vio51.xml,99,1,1,MOT,584,2150,CHI
0,1,1,126,3.068052935,127,1,big,"('MOT', 'CHI')",Providence,vio51.xml,128,1,0,CHI,1640,742,MOT
0,1,1,126,3.068052935,127,1,not,"('MOT', 'CHI')",Providence,vio51.xml,128,1,0,CHI,1640,742,MOT
1,2,2,123,2.829284066,125,2,want,"('MOT', 'CHI')",Providence,vio51.xml,128,3,1,CHI,1640,742,MOT
0,1,2,125,2.772588722,126,1,go,"('MOT', 'CHI')",Providence,vio51.xml,128,2,0,CHI,1640,742,MOT
0,1,2,125,2.772588722,126,1,no,"('MOT', 'CHI')",Providence,vio51.xml,128,2,0,CHI,1640,742,MOT
0,1,2,125,2.772588722,126,1,at,"('MOT', 'CHI')",Providence,vio51.xml,128,2,0,CHI,1640,742,MOT
2,2,6,118,2.501435952,120,2,see,"('MOT', 'CHI')",Providence,vio51.xml,128,8,2,CHI,1640,742,MOT
0,2,1,96,2.407945609,98,2,look,"('CHI', 'MOT')",Providence,vio51.xml,99,1,0,MOT,584,2150,CHI
0,2,2,124,2.367123614,126,2,in,"('MOT', 'CHI')",Providence,vio51.xml,128,2,0,CHI,1640,742,MOT
0,2,2,124,2.367123614,126,2,think,"('MOT', 'CHI')",Providence,vio51.xml,128,2,0,CHI,1640,742,MOT
1,0,0,12,2.233592222,12,0,she,"('MOT', 'UNI')",Providence,vio51.xml,13,1,1,UNI,140,84,MOT
0,1,5,122,2.189256408,123,1,look,"('MOT', 'CHI')",Providence,vio51.xml,128,5,0,CHI,1640,742,MOT
0,3,1,95,2.120263536,98,3,want,"('CHI', 'MOT')",Providence,vio51.xml,99,1,0,MOT,584,2150,CHI
0,3,1,95,2.120263536,98,3,where,"('CHI', 'MOT')",Providence,vio51.xml,99,1,0,MOT,584,2150,CHI
1,5,1,92,2.1102132,97,5,no,"('CHI', 'MOT')",Providence,vio51.xml,99,2,1,MOT,584,2150,CHI
1,3,5,119,2.047692843,122,3,wanna,"('MOT', 'CHI')",Providence,vio51.xml,128,6,1,CHI,1640,742,MOT
1,8,0,90,2.002480501,98,8,in,"('CHI', 'MOT')",Providence,vio51.xml,99,1,1,MOT,584,2150,CHI
1,8,0,90,2.002480501,98,8,get,"('CHI', 'MOT')",Providence,vio51.xml,99,1,1,MOT,584,2150,CHI
0,2,4,122,1.945910149,124,2,little,"('MOT', 'CHI')",Providence,vio51.xml,128,4,0,CHI,1640,742,MOT
0,1,7,120,1.921812597,121,1,there,"('MOT', 'CHI')",Providence,vio51.xml,128,7,0,CHI,1640,742,MOT
1,2,9,116,1.897119985,118,2,some,"('MOT', 'CHI')",Providence,vio51.xml,128,10,1,CHI,1640,742,MOT
0,2,3,94,1.876917278,96,2,he,"('CHI', 'MOT')",Providence,vio51.xml,99,3,0,MOT,584,2150,CHI
1,0,1,11,1.871802177,11,0,no,"('MOT', 'UNI')",Providence,vio51.xml,13,2,1,UNI,140,84,MOT
0,1,8,119,1.808288771,120,1,have,"('MOT', 'CHI')",Providence,vio51.xml,128,8,0,CHI,1640,742,MOT
0,3,4,121,1.658228077,124,3,all,"('MOT', 'CHI')",Providence,vio51.xml,128,4,0,CHI,1640,742,MOT
1,2,12,113,1.648658626,115,2,put,"('MOT', 'CHI')",Providence,vio51.xml,128,13,1,CHI,1640,742,MOT
0,1,10,117,1.609437912,118,1,of,"('MOT', 'CHI')",Providence,vio51.xml,128,10,0,CHI,1640,742,MOT
1,2,14,111,1.506253676,113,2,for,"('MOT', 'CHI')",Providence,vio51.xml,128,15,1,CHI,1640,742,MOT
1,2,14,111,1.506253676,113,2,make,"('MOT', 'CHI')",Providence,vio51.xml,128,15,1,CHI,1640,742,MOT
0,7,1,91,1.427116356,98,7,up,"('CHI', 'MOT')",Providence,vio51.xml,99,1,0,MOT,584,2150,CHI
0,5,2,92,1.41706602,97,5,my,"('CHI', 'MOT')",Providence,vio51.xml,99,2,0,MOT,584,2150,CHI
0,2,8,118,1.402823663,120,2,my,"('MOT', 'CHI')",Providence,vio51.xml,128,8,0,CHI,1640,742,MOT
0,3,4,92,1.396657148,95,3,put,"('CHI', 'MOT')",Providence,vio51.xml,99,4,0,MOT,584,2150,CHI
1,6,4,88,1.365675074,94,6,are,"('CHI', 'MOT')",Providence,vio51.xml,99,5,1,MOT,584,2150,CHI
1,3,13,111,1.287854288,114,3,is,"('MOT', 'CHI')",Providence,vio51.xml,128,14,1,CHI,1640,742,MOT
0,4,5,119,1.272965676,123,4,like,"('MOT', 'CHI')",Providence,vio51.xml,128,5,0,CHI,1640,742,MOT
1,10,2,86,1.270781474,96,10,they,"('CHI', 'MOT')",Providence,vio51.xml,99,3,1,MOT,584,2150,CHI
6,8,16,98,1.252762968,106,8,the,"('MOT', 'CHI')",Providence,vio51.xml,128,22,6,CHI,1640,742,MOT
2,5,9,83,1.241713132,88,5,one,"('CHI', 'MOT')",Providence,vio51.xml,99,11,2,MOT,584,2150,CHI
0,3,7,118,1.228665417,121,3,do,"('MOT', 'CHI')",Providence,vio51.xml,128,7,0,CHI,1640,742,MOT
1,3,14,110,1.218571604,113,3,one,"('MOT', 'CHI')",Providence,vio51.xml,128,15,1,CHI,1640,742,MOT
1,4,11,112,1.215336563,116,4,to,"('MOT', 'CHI')",Providence,vio51.xml,128,12,1,CHI,1640,742,MOT
0,3,8,117,1.115141591,120,3,are,"('MOT', 'CHI')",Providence,vio51.xml,128,8,0,CHI,1640,742,MOT
0,1,18,109,1.029619417,110,1,on,"('MOT', 'CHI')",Providence,vio51.xml,128,18,0,CHI,1640,742,MOT
0,6,3,90,1.029619417,96,6,go,"('CHI', 'MOT')",Providence,vio51.xml,99,3,0,MOT,584,2150,CHI
1,13,2,83,1.029619417,96,13,is,"('CHI', 'MOT')",Providence,vio51.xml,99,3,1,MOT,584,2150,CHI
0,11,1,87,1.021651248,98,11,on,"('CHI', 'MOT')",Providence,vio51.xml,99,1,0,MOT,584,2150,CHI
0,3,9,116,1.011600912,119,3,get,"('MOT', 'CHI')",Providence,vio51.xml,128,9,0,CHI,1640,742,MOT
1,8,7,112,0.997358555,120,8,can,"('MOT', 'CHI')",Providence,vio51.xml,128,8,1,CHI,1640,742,MOT
2,16,3,78,0.883836987,94,16,and,"('CHI', 'MOT')",Providence,vio51.xml,99,5,2,MOT,584,2150,CHI
2,24,1,72,0.85526603,96,24,to,"('CHI', 'MOT')",Providence,vio51.xml,99,3,2,MOT,584,2150,CHI
0,1,1,11,0.84729786,12,1,like,"('MOT', 'UNI')",Providence,vio51.xml,13,1,0,UNI,140,84,MOT
0,1,1,11,0.84729786,12,1,for,"('MOT', 'UNI')",Providence,vio51.xml,13,1,0,UNI,140,84,MOT
0,1,1,11,0.84729786,12,1,do,"('MOT', 'UNI')",Providence,vio51.xml,13,1,0,UNI,140,84,MOT
0,1,1,11,0.84729786,12,1,not,"('MOT', 'UNI')",Providence,vio51.xml,13,1,0,UNI,140,84,MOT
0,1,1,11,0.84729786,12,1,and,"('MOT', 'UNI')",Providence,vio51.xml,13,1,0,UNI,140,84,MOT
1,21,1,76,0.810930216,97,21,that,"('CHI', 'MOT')",Providence,vio51.xml,99,2,1,MOT,584,2150,CHI
2,15,4,78,0.800458916,93,15,a,"('CHI', 'MOT')",Providence,vio51.xml,99,6,2,MOT,584,2150,CHI
0,14,1,84,0.798507696,98,14,but,"('CHI', 'MOT')",Providence,vio51.xml,99,1,0,MOT,584,2150,CHI
0,8,3,88,0.778304989,96,8,of,"('CHI', 'MOT')",Providence,vio51.xml,99,3,0,MOT,584,2150,CHI
7,11,23,87,0.733969175,98,11,a,"('MOT', 'CHI')",Providence,vio51.xml,128,30,7,CHI,1640,742,MOT
1,6,13,108,0.7282385,114,6,yeah,"('MOT', 'CHI')",Providence,vio51.xml,128,14,1,CHI,1640,742,MOT
0,11,2,86,0.723918839,97,11,gonna,"('CHI', 'MOT')",Providence,vio51.xml,99,2,0,MOT,584,2150,CHI
1,4,19,104,0.693147181,108,4,gonna,"('MOT', 'CHI')",Providence,vio51.xml,128,20,1,CHI,1640,742,MOT
0,9,3,87,0.672944473,96,9,this,"('CHI', 'MOT')",Providence,vio51.xml,99,3,0,MOT,584,2150,CHI
0,3,13,112,0.667829373,115,3,what,"('MOT', 'CHI')",Providence,vio51.xml,128,13,0,CHI,1640,742,MOT
1,5,18,104,0.566395475,109,5,this,"('MOT', 'CHI')",Providence,vio51.xml,128,19,1,CHI,1640,742,MOT
0,4,12,112,0.522189382,116,4,that,"('MOT', 'CHI')",Providence,vio51.xml,128,12,0,CHI,1640,742,MOT
0,1,2,10,0.485507816,11,1,are,"('MOT', 'UNI')",Providence,vio51.xml,13,2,0,UNI,140,84,MOT
1,2,2,8,0.470003629,10,2,you,"('MOT', 'UNI')",Providence,vio51.xml,13,3,1,UNI,140,84,MOT
0,1,1,6,0.405465108,7,1,see,"('UNI', 'MOT')",Providence,vio51.xml,8,1,0,MOT,48,123,UNI
0,8,6,85,0.277210773,93,8,what,"('CHI', 'MOT')",Providence,vio51.xml,99,6,0,MOT,584,2150,CHI
3,27,6,63,0.177983155,90,27,you,"('CHI', 'MOT')",Providence,vio51.xml,99,9,3,MOT,584,2150,CHI
0,4,17,107,0.173510927,111,4,it,"('MOT', 'CHI')",Providence,vio51.xml,128,17,0,CHI,1640,742,MOT
0,2,2,9,0.080042708,11,2,to,"('MOT', 'UNI')",Providence,vio51.xml,13,2,0,UNI,140,84,MOT
1,22,5,71,0.032088315,93,22,for,"('CHI', 'MOT')",Providence,vio51.xml,99,6,1,MOT,584,2150,CHI
0,18,3,78,0.031090587,96,18,have,"('CHI', 'MOT')",Providence,vio51.xml,99,3,0,MOT,584,2150,CHI
0,2,1,5,0,7,2,at,"('UNI', 'MOT')",Providence,vio51.xml,8,1,0,MOT,48,123,UNI
0,13,5,81,-0.020619287,94,13,can,"('CHI', 'MOT')",Providence,vio51.xml,99,5,0,MOT,584,2150,CHI
3,9,34,82,-0.047252885,91,9,you,"('MOT', 'CHI')",Providence,vio51.xml,128,37,3,CHI,1640,742,MOT
2,23,9,65,-0.144581229,88,23,the,"('CHI', 'MOT')",Providence,vio51.xml,99,11,2,MOT,584,2150,CHI
0,21,4,74,-0.308090944,95,21,we,"('CHI', 'MOT')",Providence,vio51.xml,99,4,0,MOT,584,2150,CHI
0,8,18,102,-0.47445798,110,8,and,"('MOT', 'CHI')",Providence,vio51.xml,128,18,0,CHI,1640,742,MOT
0,4,1,3,-0.510825624,7,4,you,"('UNI', 'MOT')",Providence,vio51.xml,8,1,0,MOT,48,123,UNI
0,29,5,65,-0.782759339,94,29,yeah,"('CHI', 'MOT')",Providence,vio51.xml,99,5,0,MOT,584,2150,CHI
1,0,0,179,4.793031923,179,0,some,"('CHI', 'MOT')",Providence,vio52.xml,180,1,1,MOT,1048,3161,CHI
0,1,1,178,3.406737562,179,1,make,"('CHI', 'MOT')",Providence,vio52.xml,180,1,0,MOT,1048,3161,CHI
1,2,2,175,3.172482785,177,2,not,"('CHI', 'MOT')",Providence,vio52.xml,180,3,1,MOT,1048,3161,CHI
1,0,3,52,2.890371758,52,0,see,"('MOT', 'CHI')",Providence,vio52.xml,56,4,1,CHI,1532,274,MOT
1,3,3,173,2.696876901,176,3,want,"('CHI', 'MOT')",Providence,vio52.xml,180,4,1,MOT,1048,3161,CHI
1,0,0,19,2.63905733,19,0,he,"('MOT', 'BRO')",Providence,vio52.xml,20,1,1,BRO,324,87,MOT
1,8,0,171,2.595807346,179,8,think,"('CHI', 'MOT')",Providence,vio52.xml,180,1,1,MOT,1048,3161,CHI
0,4,1,175,2.49044683,179,4,big,"('CHI', 'MOT')",Providence,vio52.xml,180,1,0,MOT,1048,3161,CHI
1,0,1,19,2.351375257,19,0,can,"('CHI', 'BRO')",Providence,vio52.xml,21,2,1,BRO,169,200,CHI
0,5,1,174,2.308125273,179,5,did,"('CHI', 'MOT')",Providence,vio52.xml,180,1,0,MOT,1048,3161,CHI
0,5,1,174,2.308125273,179,5,she,"('CHI', 'MOT')",Providence,vio52.xml,180,1,0,MOT,1048,3161,CHI
1,8,1,170,2.302585093,178,8,at,"('CHI', 'MOT')",Providence,vio52.xml,180,2,1,MOT,1048,3161,CHI
1,0,1,18,2.302585093,18,0,are,"('MOT', 'BRO')",Providence,vio52.xml,20,2,1,BRO,324,87,MOT
1,3,6,170,2.274414216,173,3,wanna,"('CHI', 'MOT')",Providence,vio52.xml,180,7,1,MOT,1048,3161,CHI
0,1,1,54,2.251291799,55,1,put,"('MOT', 'CHI')",Providence,vio52.xml,56,1,0,CHI,1532,274,MOT
1,9,1,169,2.197224577,178,9,have,"('CHI', 'MOT')",Providence,vio52.xml,180,2,1,MOT,1048,3161,CHI
1,7,2,170,2.191653532,177,7,up,"('CHI', 'MOT')",Providence,vio52.xml,180,3,1,MOT,1048,3161,CHI
1,0,0,11,2.159484249,11,0,big,"('BRO', 'MOT')",Providence,vio52.xml,12,1,1,MOT,52,275,BRO
0,6,1,173,2.153974594,179,6,with,"('CHI', 'MOT')",Providence,vio52.xml,180,1,0,MOT,1048,3161,CHI
1,8,2,169,2.073870497,177,8,he,"('CHI', 'MOT')",Providence,vio52.xml,180,3,1,MOT,1048,3161,CHI
0,5,2,173,2.014903021,178,5,for,"('CHI', 'MOT')",Providence,vio52.xml,180,2,0,MOT,1048,3161,CHI
0,5,2,173,2.014903021,178,5,little,"('CHI', 'MOT')",Providence,vio52.xml,180,2,0,MOT,1048,3161,CHI
1,11,1,167,2.014903021,178,11,there,"('CHI', 'MOT')",Providence,vio52.xml,180,2,1,MOT,1048,3161,CHI
1,1,0,19,1.992430165,20,1,you,"('CHI', 'BRO')",Providence,vio52.xml,21,1,1,BRO,169,200,CHI
0,1,2,53,1.945910149,54,1,go,"('MOT', 'CHI')",Providence,vio52.xml,56,2,0,CHI,1532,274,MOT
0,1,2,53,1.945910149,54,1,all,"('MOT', 'CHI')",Providence,vio52.xml,56,2,0,CHI,1532,274,MOT
0,1,2,53,1.945910149,54,1,where,"('MOT', 'CHI')",Providence,vio52.xml,56,2,0,CHI,1532,274,MOT
0,2,1,53,1.84582669,55,2,wanna,"('MOT', 'CHI')",Providence,vio52.xml,56,1,0,CHI,1532,274,MOT
2,11,3,164,1.843945222,175,11,go,"('CHI', 'MOT')",Providence,vio52.xml,180,5,2,MOT,1048,3161,CHI
0,9,1,170,1.79729965,179,9,get,"('CHI', 'MOT')",Providence,vio52.xml,180,1,0,MOT,1048,3161,CHI
0,9,1,170,1.79729965,179,9,was,"('CHI', 'MOT')",Providence,vio52.xml,180,1,0,MOT,1048,3161,CHI
0,5,3,172,1.786188424,177,5,no,"('CHI', 'MOT')",Providence,vio52.xml,180,3,0,MOT,1048,3161,CHI
0,1,3,52,1.704748092,53,1,my,"('MOT', 'CHI')",Providence,vio52.xml,56,3,0,CHI,1532,274,MOT
0,1,3,52,1.704748092,53,1,can,"('MOT', 'CHI')",Providence,vio52.xml,56,3,0,CHI,1532,274,MOT
1,1,1,18,1.658228077,19,1,that,"('CHI', 'BRO')",Providence,vio52.xml,21,2,1,BRO,169,200,CHI
4,14,5,157,1.656784033,171,14,one,"('CHI', 'MOT')",Providence,vio52.xml,180,9,4,MOT,1048,3161,CHI
0,6,3,171,1.632037744,177,6,look,"('CHI', 'MOT')",Providence,vio52.xml,180,3,0,MOT,1048,3161,CHI
0,9,2,169,1.504077397,178,9,they,"('CHI', 'MOT')",Providence,vio52.xml,180,2,0,MOT,1048,3161,CHI
0,1,4,51,1.504077397,52,1,like,"('MOT', 'CHI')",Providence,vio52.xml,56,4,0,CHI,1532,274,MOT
0,1,4,51,1.504077397,52,1,we,"('MOT', 'CHI')",Providence,vio52.xml,56,4,0,CHI,1532,274,MOT
2,17,3,158,1.438480114,175,17,of,"('CHI', 'MOT')",Providence,vio52.xml,180,5,2,MOT,1048,3161,CHI
0,14,1,165,1.391834541,179,14,like,"('CHI', 'MOT')",Providence,vio52.xml,180,1,0,MOT,1048,3161,CHI
0,8,3,169,1.380723316,177,8,where,"('CHI', 'MOT')",Providence,vio52.xml,180,3,0,MOT,1048,3161,CHI
0,1,5,50,1.331234584,51,1,look,"('MOT', 'CHI')",Providence,vio52.xml,56,5,0,CHI,1532,274,MOT
1,2,6,47,1.329135947,49,2,on,"('MOT', 'CHI')",Providence,vio52.xml,56,7,1,CHI,1532,274,MOT
0,7,4,169,1.310582539,176,7,but,"('CHI', 'MOT')",Providence,vio52.xml,180,4,0,MOT,1048,3161,CHI
0,1,1,19,1.299282984,20,1,one,"('CHI', 'BRO')",Providence,vio52.xml,21,1,0,BRO,169,200,CHI
0,2,3,51,1.299282984,53,2,no,"('MOT', 'CHI')",Providence,vio52.xml,56,3,0,CHI,1532,274,MOT
3,24,3,150,1.25846099,174,24,do,"('CHI', 'MOT')",Providence,vio52.xml,180,6,3,MOT,1048,3161,CHI
0,1,1,18,1.252762968,19,1,oh,"('MOT', 'BRO')",Providence,vio52.xml,20,1,0,BRO,324,87,MOT
0,1,1,18,1.252762968,19,1,was,"('MOT', 'BRO')",Providence,vio52.xml,20,1,0,BRO,324,87,MOT
0,1,1,18,1.252762968,19,1,at,"('MOT', 'BRO')",Providence,vio52.xml,20,1,0,BRO,324,87,MOT
1,0,0,3,1.203972804,3,0,a,"('BRO', 'CHI')",Providence,vio52.xml,4,1,1,CHI,15,16,BRO
2,1,1,8,1.193922468,9,1,a,"('BRO', 'MOT')",Providence,vio52.xml,12,3,2,MOT,52,275,BRO
0,1,6,49,1.178654996,50,1,of,"('MOT', 'CHI')",Providence,vio52.xml,56,6,0,CHI,1532,274,MOT
0,1,6,49,1.178654996,50,1,what,"('MOT', 'CHI')",Providence,vio52.xml,56,6,0,CHI,1532,274,MOT
1,13,5,161,1.145132304,174,13,see,"('CHI', 'MOT')",Providence,vio52.xml,180,6,1,MOT,1048,3161,CHI
0,2,4,50,1.098612289,52,2,with,"('MOT', 'CHI')",Providence,vio52.xml,56,4,0,CHI,1532,274,MOT
1,2,8,45,1.088459917,47,2,and,"('MOT', 'CHI')",Providence,vio52.xml,56,9,1,CHI,1532,274,MOT
3,3,11,39,1.011600912,42,3,the,"('MOT', 'CHI')",Providence,vio52.xml,56,14,3,CHI,1532,274,MOT
2,18,6,154,1.010643516,172,18,is,"('CHI', 'MOT')",Providence,vio52.xml,180,8,2,MOT,1048,3161,CHI
1,8,11,160,0.992663711,168,8,are,"('CHI', 'MOT')",Providence,vio52.xml,180,12,1,MOT,1048,3161,CHI
1,2,2,16,0.980829253,18,2,to,"('CHI', 'BRO')",Providence,vio52.xml,21,3,1,BRO,169,200,CHI
1,2,9,44,0.980829253,46,2,is,"('MOT', 'CHI')",Providence,vio52.xml,56,10,1,CHI,1532,274,MOT
0,16,2,162,0.973449146,178,16,in,"('CHI', 'MOT')",Providence,vio52.xml,180,2,0,MOT,1048,3161,CHI
0,1,2,18,0.965080896,19,1,on,"('CHI', 'BRO')",Providence,vio52.xml,21,2,0,BRO,169,200,CHI
0,1,2,18,0.965080896,19,1,and,"('CHI', 'BRO')",Providence,vio52.xml,21,2,0,BRO,169,200,CHI
0,2,5,49,0.925769476,51,2,but,"('MOT', 'CHI')",Providence,vio52.xml,56,5,0,CHI,1532,274,MOT
2,26,4,148,0.893817876,174,26,what,"('CHI', 'MOT')",Providence,vio52.xml,180,6,2,MOT,1048,3161,CHI
0,7,7,166,0.888119855,173,7,all,"('CHI', 'MOT')",Providence,vio52.xml,180,7,0,MOT,1048,3161,CHI
0,10,5,165,0.832344311,175,10,gonna,"('CHI', 'MOT')",Providence,vio52.xml,180,5,0,MOT,1048,3161,CHI
0,1,9,46,0.800777845,47,1,it,"('MOT', 'CHI')",Providence,vio52.xml,56,9,0,CHI,1532,274,MOT
0,1,9,46,0.800777845,47,1,do,"('MOT', 'CHI')",Providence,vio52.xml,56,9,0,CHI,1532,274,MOT
2,23,6,149,0.777028665,172,23,can,"('CHI', 'MOT')",Providence,vio52.xml,180,8,2,MOT,1048,3161,CHI
0,13,4,163,0.750966751,176,13,put,"('CHI', 'MOT')",Providence,vio52.xml,180,4,0,MOT,1048,3161,CHI
0,17,3,160,0.687576136,177,17,on,"('CHI', 'MOT')",Providence,vio52.xml,180,3,0,MOT,1048,3161,CHI
4,39,5,132,0.67595478,171,39,that,"('CHI', 'MOT')",Providence,vio52.xml,180,9,4,MOT,1048,3161,CHI
0,1,3,16,0.641853886,17,1,one,"('MOT', 'BRO')",Providence,vio52.xml,20,3,0,BRO,324,87,MOT
0,2,7,47,0.635988767,49,2,he,"('MOT', 'CHI')",Providence,vio52.xml,56,7,0,CHI,1532,274,MOT
0,3,1,17,0.606135804,20,3,we,"('CHI', 'BRO')",Providence,vio52.xml,21,1,0,BRO,169,200,CHI
0,3,1,17,0.606135804,20,3,a,"('CHI', 'BRO')",Providence,vio52.xml,21,1,0,BRO,169,200,CHI
0,2,2,17,0.559615788,19,2,is,"('CHI', 'BRO')",Providence,vio52.xml,21,2,0,BRO,169,200,CHI
1,4,0,7,0.550046337,11,4,and,"('BRO', 'MOT')",Providence,vio52.xml,12,1,1,MOT,52,275,BRO
1,2,4,14,0.538996501,16,2,the,"('CHI', 'BRO')",Providence,vio52.xml,21,5,1,BRO,169,200,CHI
7,32,14,127,0.528844129,159,32,the,"('CHI', 'MOT')",Providence,vio52.xml,180,21,7,MOT,1048,3161,CHI
0,2,8,46,0.510825624,48,2,to,"('MOT', 'CHI')",Providence,vio52.xml,56,8,0,CHI,1532,274,MOT
0,3,6,47,0.485507816,50,3,in,"('MOT', 'CHI')",Providence,vio52.xml,56,6,0,CHI,1532,274,MOT
0,1,4,15,0.405465108,16,1,to,"('MOT', 'BRO')",Providence,vio52.xml,20,4,0,BRO,324,87,MOT
2,31,7,140,0.388272708,171,31,it,"('CHI', 'MOT')",Providence,vio52.xml,180,9,2,MOT,1048,3161,CHI
0,4,1,16,0.382992252,20,4,it,"('CHI', 'BRO')",Providence,vio52.xml,21,1,0,BRO,169,200,CHI
0,2,1,9,0.36772478,11,2,with,"('BRO', 'MOT')",Providence,vio52.xml,12,1,0,MOT,52,275,BRO
2,4,14,36,0.336472237,40,4,one,"('MOT', 'CHI')",Providence,vio52.xml,56,16,2,CHI,1532,274,MOT
0,2,3,16,0.287682072,18,2,in,"('CHI', 'BRO')",Providence,vio52.xml,21,3,0,BRO,169,200,CHI
0,2,3,15,0.236388778,17,2,this,"('MOT', 'BRO')",Providence,vio52.xml,20,3,0,BRO,324,87,MOT
0,1,5,14,0.194156014,15,1,like,"('MOT', 'BRO')",Providence,vio52.xml,20,5,0,BRO,324,87,MOT
0,1,5,14,0.194156014,15,1,it,"('MOT', 'BRO')",Providence,vio52.xml,20,5,0,BRO,324,87,MOT
0,9,3,44,0.09531018,53,9,yeah,"('MOT', 'CHI')",Providence,vio52.xml,56,3,0,CHI,1532,274,MOT
0,3,1,8,0.080042708,11,3,that,"('BRO', 'MOT')",Providence,vio52.xml,12,1,0,MOT,52,275,BRO
1,3,5,12,0.060624622,15,3,this,"('CHI', 'BRO')",Providence,vio52.xml,21,6,1,BRO,169,200,CHI
2,15,25,138,0.002152853,153,15,yeah,"('CHI', 'MOT')",Providence,vio52.xml,180,27,2,MOT,1048,3161,CHI
0,3,10,43,0,46,3,this,"('MOT', 'CHI')",Providence,vio52.xml,56,10,0,CHI,1532,274,MOT
0,20,7,153,-0.076961041,173,20,we,"('CHI', 'MOT')",Providence,vio52.xml,180,7,0,MOT,1048,3161,CHI
6,53,15,106,-0.097163748,159,53,you,"('CHI', 'MOT')",Providence,vio52.xml,180,21,6,MOT,1048,3161,CHI
1,24,12,143,-0.10388013,167,24,and,"('CHI', 'MOT')",Providence,vio52.xml,180,13,1,MOT,1048,3161,CHI
0,4,9,43,-0.115512887,47,4,a,"('MOT', 'CHI')",Providence,vio52.xml,56,9,0,CHI,1532,274,MOT
1,23,13,143,-0.133531393,166,23,a,"('CHI', 'MOT')",Providence,vio52.xml,180,14,1,MOT,1048,3161,CHI
0,4,1,7,-0.143100844,11,4,it,"('BRO', 'MOT')",Providence,vio52.xml,12,1,0,MOT,52,275,BRO
0,2,16,38,-0.251314428,40,2,you,"('MOT', 'CHI')",Providence,vio52.xml,56,16,0,CHI,1532,274,MOT
0,2,7,11,-0.587786665,13,2,that,"('MOT', 'BRO')",Providence,vio52.xml,20,7,0,BRO,324,87,MOT
0,25,10,145,-0.595508711,170,25,to,"('CHI', 'MOT')",Providence,vio52.xml,180,10,0,MOT,1048,3161,CHI
0,31,16,133,-1.244119872,164,31,this,"('CHI', 'MOT')",Providence,vio52.xml,180,16,0,MOT,1048,3161,CHI
1,2,1,144,3.205452805,146,2,little,"('CHI', 'MOT')",Providence,vio53.xml,148,2,1,MOT,1224,2287,CHI
0,2,2,144,2.512305624,146,2,he,"('CHI', 'MOT')",Providence,vio53.xml,148,2,0,MOT,1224,2287,CHI
1,5,2,140,2.282382386,145,5,big,"('CHI', 'MOT')",Providence,vio53.xml,148,3,1,MOT,1224,2287,CHI
1,6,2,139,2.128231706,145,6,some,"('CHI', 'MOT')",Providence,vio53.xml,148,3,1,MOT,1224,2287,CHI
1,8,2,137,1.876917278,145,8,go,"('CHI', 'MOT')",Providence,vio53.xml,148,3,1,MOT,1224,2287,CHI
0,5,2,141,1.819158443,146,5,want,"('CHI', 'MOT')",Providence,vio53.xml,148,2,0,MOT,1224,2287,CHI
0,5,2,141,1.819158443,146,5,have,"('CHI', 'MOT')",Providence,vio53.xml,148,2,0,MOT,1224,2287,CHI
0,5,2,141,1.819158443,146,5,where,"('CHI', 'MOT')",Providence,vio53.xml,148,2,0,MOT,1224,2287,CHI
0,3,4,141,1.805552791,144,3,at,"('CHI', 'MOT')",Providence,vio53.xml,148,4,0,MOT,1224,2287,CHI
0,4,3,141,1.771556762,145,4,but,"('CHI', 'MOT')",Providence,vio53.xml,148,3,0,MOT,1224,2287,CHI
0,6,2,140,1.665007764,146,6,look,"('CHI', 'MOT')",Providence,vio53.xml,148,2,0,MOT,1224,2287,CHI
0,3,5,140,1.644529232,143,3,my,"('CHI', 'MOT')",Providence,vio53.xml,148,5,0,MOT,1224,2287,CHI
0,4,4,140,1.58240924,144,4,with,"('CHI', 'MOT')",Providence,vio53.xml,148,4,0,MOT,1224,2287,CHI
0,7,2,139,1.531476371,146,7,for,"('CHI', 'MOT')",Providence,vio53.xml,148,2,0,MOT,1224,2287,CHI
0,3,6,139,1.504077397,142,3,not,"('CHI', 'MOT')",Providence,vio53.xml,148,6,0,MOT,1224,2287,CHI
0,8,2,138,1.413693335,146,8,like,"('CHI', 'MOT')",Providence,vio53.xml,148,2,0,MOT,1224,2287,CHI
4,9,12,123,1.314320861,132,9,yeah,"('CHI', 'MOT')",Providence,vio53.xml,148,16,4,MOT,1224,2287,CHI
1,6,8,133,1.298101649,139,6,make,"('CHI', 'MOT')",Providence,vio53.xml,148,9,1,MOT,1224,2287,CHI
0,6,4,138,1.245937003,144,6,they,"('CHI', 'MOT')",Providence,vio53.xml,148,4,0,MOT,1224,2287,CHI
4,20,4,120,1.218157439,140,20,do,"('CHI', 'MOT')",Providence,vio53.xml,148,8,4,MOT,1224,2287,CHI
0,8,3,137,1.183770097,145,8,wanna,"('CHI', 'MOT')",Providence,vio53.xml,148,3,0,MOT,1224,2287,CHI
2,11,7,128,1.164570256,139,11,all,"('CHI', 'MOT')",Providence,vio53.xml,148,9,2,MOT,1224,2287,CHI
0,8,4,136,0.994622575,144,8,think,"('CHI', 'MOT')",Providence,vio53.xml,148,4,0,MOT,1224,2287,CHI
1,10,7,130,0.948493872,140,10,one,"('CHI', 'MOT')",Providence,vio53.xml,148,8,1,MOT,1224,2287,CHI
0,14,2,132,0.902867712,146,14,are,"('CHI', 'MOT')",Providence,vio53.xml,148,2,0,MOT,1224,2287,CHI
0,20,1,127,0.86081158,147,20,there,"('CHI', 'MOT')",Providence,vio53.xml,148,1,0,MOT,1224,2287,CHI
1,15,5,127,0.810930216,142,15,get,"('CHI', 'MOT')",Providence,vio53.xml,148,6,1,MOT,1224,2287,CHI
0,10,4,134,0.79395188,144,10,of,"('CHI', 'MOT')",Providence,vio53.xml,148,4,0,MOT,1224,2287,CHI
0,13,3,132,0.741937345,145,13,we,"('CHI', 'MOT')",Providence,vio53.xml,148,3,0,MOT,1224,2287,CHI
2,22,5,119,0.728738126,141,22,to,"('CHI', 'MOT')",Providence,vio53.xml,148,7,2,MOT,1224,2287,CHI
1,13,7,127,0.707331816,140,13,can,"('CHI', 'MOT')",Providence,vio53.xml,148,8,1,MOT,1224,2287,CHI
0,14,3,131,0.672944473,145,14,see,"('CHI', 'MOT')",Providence,vio53.xml,148,3,0,MOT,1224,2287,CHI
2,19,7,120,0.653744633,139,19,put,"('CHI', 'MOT')",Providence,vio53.xml,148,9,2,MOT,1224,2287,CHI
1,21,4,122,0.632928321,143,21,is,"('CHI', 'MOT')",Providence,vio53.xml,148,5,1,MOT,1224,2287,CHI
0,10,5,133,0.632928321,143,10,no,"('CHI', 'MOT')",Providence,vio53.xml,148,5,0,MOT,1224,2287,CHI
1,16,6,125,0.625553889,141,16,gonna,"('CHI', 'MOT')",Providence,vio53.xml,148,7,1,MOT,1224,2287,CHI
2,23,8,115,0.377294231,138,23,what,"('CHI', 'MOT')",Providence,vio53.xml,148,10,2,MOT,1224,2287,CHI
1,17,8,122,0.35364004,139,17,in,"('CHI', 'MOT')",Providence,vio53.xml,148,9,1,MOT,1224,2287,CHI
3,24,11,110,0.3074847,134,24,a,"('CHI', 'MOT')",Providence,vio53.xml,148,14,3,MOT,1224,2287,CHI
2,28,8,110,0.188052232,138,28,it,"('CHI', 'MOT')",Providence,vio53.xml,148,10,2,MOT,1224,2287,CHI
4,40,10,94,0.035932009,134,40,you,"('CHI', 'MOT')",Providence,vio53.xml,148,14,4,MOT,1224,2287,CHI
1,20,10,117,0.018149319,137,20,and,"('CHI', 'MOT')",Providence,vio53.xml,148,11,1,MOT,1224,2287,CHI
0,13,8,127,0.014184635,140,13,on,"('CHI', 'MOT')",Providence,vio53.xml,148,8,0,MOT,1224,2287,CHI
0,13,9,126,-0.088192712,139,13,this,"('CHI', 'MOT')",Providence,vio53.xml,148,9,0,MOT,1224,2287,CHI
6,32,21,89,-0.105708887,121,32,the,"('CHI', 'MOT')",Providence,vio53.xml,148,27,6,MOT,1224,2287,CHI
1,25,9,113,-0.108213585,138,25,that,"('CHI', 'MOT')",Providence,vio53.xml,148,10,1,MOT,1224,2287,CHI
2,2,0,155,3.682609841,157,2,put,"('CHI', 'MOT')",Providence,vio54.xml,159,2,2,MOT,1121,2458,CHI
0,1,2,156,2.989462661,157,1,make,"('CHI', 'MOT')",Providence,vio54.xml,159,2,0,MOT,1121,2458,CHI
0,2,1,156,2.877949238,158,2,little,"('CHI', 'MOT')",Providence,vio54.xml,159,1,0,MOT,1121,2458,CHI
1,4,1,153,2.766319109,157,4,was,"('CHI', 'MOT')",Providence,vio54.xml,159,2,1,MOT,1121,2458,CHI
1,6,0,152,2.723798558,158,6,with,"('CHI', 'MOT')",Providence,vio54.xml,159,1,1,MOT,1121,2458,CHI
0,3,2,154,2.29631548,157,3,did,"('CHI', 'MOT')",Providence,vio54.xml,159,2,0,MOT,1121,2458,CHI
1,10,0,148,2.271813434,158,10,on,"('CHI', 'MOT')",Providence,vio54.xml,159,1,1,MOT,1121,2458,CHI
2,6,3,148,2.256647998,154,6,big,"('CHI', 'MOT')",Providence,vio54.xml,159,5,2,MOT,1121,2458,CHI
1,11,0,147,2.184802057,158,11,there,"('CHI', 'MOT')",Providence,vio54.xml,159,1,1,MOT,1121,2458,CHI
0,2,5,152,2.00533357,154,2,look,"('CHI', 'MOT')",Providence,vio54.xml,159,5,0,MOT,1121,2458,CHI
0,7,1,151,1.897119985,158,7,all,"('CHI', 'MOT')",Providence,vio54.xml,159,1,0,MOT,1121,2458,CHI
0,5,2,152,1.890850372,157,5,have,"('CHI', 'MOT')",Providence,vio54.xml,159,2,0,MOT,1121,2458,CHI
0,5,2,152,1.890850372,157,5,he,"('CHI', 'MOT')",Providence,vio54.xml,159,2,0,MOT,1121,2458,CHI
0,3,4,152,1.878191975,155,3,no,"('CHI', 'MOT')",Providence,vio54.xml,159,4,0,MOT,1121,2458,CHI
1,3,0,34,1.871802177,37,3,a,"('ADU', 'MOT')",Providence,vio54.xml,38,1,1,MOT,94,915,ADU
1,4,7,147,1.811562097,151,4,one,"('CHI', 'MOT')",Providence,vio54.xml,159,8,1,MOT,1121,2458,CHI
0,6,2,151,1.736699692,157,6,up,"('CHI', 'MOT')",Providence,vio54.xml,159,2,0,MOT,1121,2458,CHI
0,6,2,151,1.736699692,157,6,wanna,"('CHI', 'MOT')",Providence,vio54.xml,159,2,0,MOT,1121,2458,CHI
0,6,2,151,1.736699692,157,6,at,"('CHI', 'MOT')",Providence,vio54.xml,159,2,0,MOT,1121,2458,CHI
0,9,1,149,1.673976434,158,9,like,"('CHI', 'MOT')",Providence,vio54.xml,159,1,0,MOT,1121,2458,CHI
0,9,1,149,1.673976434,158,9,we,"('CHI', 'MOT')",Providence,vio54.xml,159,1,0,MOT,1121,2458,CHI
0,4,4,151,1.655048424,155,4,want,"('CHI', 'MOT')",Providence,vio54.xml,159,4,0,MOT,1121,2458,CHI
0,10,1,148,1.578666254,158,10,for,"('CHI', 'MOT')",Providence,vio54.xml,159,1,0,MOT,1121,2458,CHI
0,10,1,148,1.578666254,158,10,of,"('CHI', 'MOT')",Providence,vio54.xml,159,1,0,MOT,1121,2458,CHI
0,12,1,146,1.411612169,158,12,see,"('CHI', 'MOT')",Providence,vio54.xml,159,1,0,MOT,1121,2458,CHI
0,9,2,148,1.380024748,157,9,go,"('CHI', 'MOT')",Providence,vio54.xml,159,2,0,MOT,1121,2458,CHI
0,7,3,149,1.373715579,156,7,not,"('CHI', 'MOT')",Providence,vio54.xml,159,3,0,MOT,1121,2458,CHI
1,6,0,31,1.312186389,37,6,she,"('ADU', 'MOT')",Providence,vio54.xml,38,1,1,MOT,94,915,ADU
0,10,2,147,1.284714568,157,10,are,"('CHI', 'MOT')",Providence,vio54.xml,159,2,0,MOT,1121,2458,CHI
0,3,1,34,1.178654996,37,3,was,"('ADU', 'MOT')",Providence,vio54.xml,38,1,0,MOT,94,915,ADU
1,10,6,142,1.134979933,152,10,gonna,"('CHI', 'MOT')",Providence,vio54.xml,159,7,1,MOT,1121,2458,CHI
0,12,2,145,1.117660484,157,12,in,"('CHI', 'MOT')",Providence,vio54.xml,159,2,0,MOT,1121,2458,CHI
1,17,3,138,1.067261759,155,17,oh,"('CHI', 'MOT')",Providence,vio54.xml,159,4,1,MOT,1121,2458,CHI
0,5,8,146,0.936093359,151,5,my,"('CHI', 'MOT')",Providence,vio54.xml,159,8,0,MOT,1121,2458,CHI
4,29,4,122,0.936093359,151,29,the,"('CHI', 'MOT')",Providence,vio54.xml,159,8,4,MOT,1121,2458,CHI
8,26,9,116,0.926762032,142,26,it,"('CHI', 'MOT')",Providence,vio54.xml,159,17,8,MOT,1121,2458,CHI
0,8,5,146,0.906721281,154,8,but,"('CHI', 'MOT')",Providence,vio54.xml,159,5,0,MOT,1121,2458,CHI
0,8,5,146,0.906721281,154,8,think,"('CHI', 'MOT')",Providence,vio54.xml,159,5,0,MOT,1121,2458,CHI
2,16,7,134,0.891384193,150,16,yeah,"('CHI', 'MOT')",Providence,vio54.xml,159,9,2,MOT,1121,2458,CHI
2,15,8,134,0.858396753,149,15,a,"('CHI', 'MOT')",Providence,vio54.xml,159,10,2,MOT,1121,2458,CHI
2,17,7,133,0.834225779,150,17,do,"('CHI', 'MOT')",Providence,vio54.xml,159,9,2,MOT,1121,2458,CHI
1,19,4,135,0.801360765,154,19,and,"('CHI', 'MOT')",Providence,vio54.xml,159,5,1,MOT,1121,2458,CHI
0,17,2,140,0.792238083,157,17,what,"('CHI', 'MOT')",Providence,vio54.xml,159,2,0,MOT,1121,2458,CHI
1,24,4,130,0.578217214,154,24,to,"('CHI', 'MOT')",Providence,vio54.xml,159,5,1,MOT,1121,2458,CHI
0,5,2,31,0.459532329,36,5,is,"('ADU', 'MOT')",Providence,vio54.xml,38,2,0,MOT,94,915,ADU
0,16,4,139,0.431272992,155,16,get,"('CHI', 'MOT')",Providence,vio54.xml,159,4,0,MOT,1121,2458,CHI
1,16,9,133,0.392307024,149,16,is,"('CHI', 'MOT')",Providence,vio54.xml,159,10,1,MOT,1121,2458,CHI
2,36,6,115,0.215547204,151,36,you,"('CHI', 'MOT')",Providence,vio54.xml,159,8,2,MOT,1121,2458,CHI
0,16,6,137,0.130770231,153,16,can,"('CHI', 'MOT')",Providence,vio54.xml,159,6,0,MOT,1121,2458,CHI
0,26,4,129,-0.03135053,155,26,that,"('CHI', 'MOT')",Providence,vio54.xml,159,4,0,MOT,1121,2458,CHI
0,16,13,130,-0.544051271,146,16,this,"('CHI', 'MOT')",Providence,vio54.xml,159,13,0,MOT,1121,2458,CHI
0,26,1,11,-0.730887509,37,26,yeah,"('ADU', 'MOT')",Providence,vio54.xml,38,1,0,MOT,94,915,ADU
0,1,4,154,2.571339156,155,1,look,"('MOT', 'CHI')",Providence,wil01.xml,159,4,0,CHI,3890,427,MOT
2,4,6,147,2.217027205,151,4,up,"('MOT', 'CHI')",Providence,wil01.xml,159,8,2,CHI,3890,427,MOT
1,0,47,111,1.508511994,111,0,that,"('MOT', 'CHI')",Providence,wil01.xml,159,48,1,CHI,3890,427,MOT
4,8,3,63,1.505448199,71,8,up,"('CHI', 'MOT')",Providence,wil01.xml,78,7,4,MOT,220,1253,CHI
1,0,58,100,1.20724613,100,0,the,"('MOT', 'CHI')",Providence,wil01.xml,159,59,1,CHI,3890,427,MOT
4,4,37,114,1.026291627,118,4,a,"('MOT', 'CHI')",Providence,wil01.xml,159,41,4,CHI,3890,427,MOT
1,0,0,2,0.980829253,2,0,he,"('ADU', 'MOT')",Providence,wil01.xml,3,1,1,MOT,16,34,ADU
1,2,1,4,0.287682072,6,2,yeah,"('MOT', 'OPE')",Providence,wil01.xml,8,2,1,OPE,196,32,MOT
0,1,2,5,0,6,1,go,"('MOT', 'OPE')",Providence,wil01.xml,8,2,0,OPE,196,32,MOT
0,2,1,5,0,7,2,no,"('MOT', 'OPE')",Providence,wil01.xml,8,1,0,OPE,196,32,MOT
0,1,1,1,-0.405465108,2,1,oh,"('ADU', 'MOT')",Providence,wil01.xml,3,1,0,MOT,16,34,ADU
3,3,1,229,3.663561646,232,3,my,"('CHI', 'MOT')",Providence,wil02.xml,236,4,3,MOT,642,4833,CHI
5,14,2,215,2.328902401,229,14,no,"('CHI', 'MOT')",Providence,wil02.xml,236,7,5,MOT,642,4833,CHI
3,23,1,209,1.871802177,232,23,oh,"('CHI', 'MOT')",Providence,wil02.xml,236,4,3,MOT,642,4833,CHI
4,34,0,198,1.717651497,232,34,a,"('CHI', 'MOT')",Providence,wil02.xml,236,4,4,MOT,642,4833,CHI
0,16,1,219,1.536234508,235,16,go,"('CHI', 'MOT')",Providence,wil02.xml,236,1,0,MOT,642,4833,CHI
0,32,1,203,0.872940291,235,32,this,"('CHI', 'MOT')",Providence,wil02.xml,236,1,0,MOT,642,4833,CHI
2,0,6,271,4.405498991,271,0,all,"('MOT', 'CHI')",Providence,wil03.xml,279,8,2,CHI,5412,937,MOT
1,0,6,272,4.10905071,272,0,up,"('MOT', 'CHI')",Providence,wil03.xml,279,7,1,CHI,5412,937,MOT
1,0,11,267,3.648801231,267,0,where,"('MOT', 'CHI')",Providence,wil03.xml,279,12,1,CHI,5412,937,MOT
1,0,28,250,2.788589064,250,0,it,"('MOT', 'CHI')",Providence,wil03.xml,279,29,1,CHI,5412,937,MOT
1,0,46,232,2.256647998,232,0,do,"('MOT', 'CHI')",Providence,wil03.xml,279,47,1,CHI,5412,937,MOT
0,1,21,257,1.732040235,258,1,see,"('MOT', 'CHI')",Providence,wil03.xml,279,21,0,CHI,5412,937,MOT
0,1,53,225,0.728865263,226,1,is,"('MOT', 'CHI')",Providence,wil03.xml,279,53,0,CHI,5412,937,MOT
3,12,32,232,0.715758627,244,12,oh,"('MOT', 'CHI')",Providence,wil03.xml,279,35,3,CHI,5412,937,MOT
0,1,54,224,0.706451146,225,1,a,"('MOT', 'CHI')",Providence,wil03.xml,279,54,0,CHI,5412,937,MOT
1,2,94,182,0.245570587,184,2,the,"('MOT', 'CHI')",Providence,wil03.xml,279,95,1,CHI,5412,937,MOT
3,28,26,222,0.114440414,250,28,no,"('MOT', 'CHI')",Providence,wil03.xml,279,29,3,CHI,5412,937,MOT
0,13,60,206,-1.368029013,219,13,what,"('MOT', 'CHI')",Providence,wil03.xml,279,60,0,CHI,5412,937,MOT
2,0,9,271,4.143134726,271,0,have,"('MOT', 'CHI')",Providence,wil04.xml,282,11,2,CHI,5125,853,MOT
2,0,38,242,2.858110896,242,0,a,"('MOT', 'CHI')",Providence,wil04.xml,282,40,2,CHI,5125,853,MOT
0,1,10,271,2.435074276,272,1,are,"('MOT', 'CHI')",Providence,wil04.xml,282,10,0,CHI,5125,853,MOT
4,6,15,257,2.198735152,263,6,see,"('MOT', 'CHI')",Providence,wil04.xml,282,19,4,CHI,5125,853,MOT
1,0,0,6,1.673976434,6,0,like,"('MOT', 'OPE')",Providence,wil04.xml,7,1,1,OPE,98,74,MOT
1,0,0,6,1.673976434,6,0,one,"('MOT', 'OPE')",Providence,wil04.xml,7,1,1,OPE,98,74,MOT
1,3,23,255,1.609437912,258,3,all,"('MOT', 'CHI')",Providence,wil04.xml,282,24,1,CHI,5125,853,MOT
1,0,104,177,1.207704152,177,0,you,"('MOT', 'CHI')",Providence,wil04.xml,282,105,1,CHI,5125,853,MOT
0,6,10,266,1.182311308,272,6,up,"('MOT', 'CHI')",Providence,wil04.xml,282,10,0,CHI,5125,853,MOT
0,10,15,257,0.363602763,267,10,no,"('MOT', 'CHI')",Providence,wil04.xml,282,15,0,CHI,5125,853,MOT
0,1,1,5,0.287682072,6,1,in,"('MOT', 'OPE')",Providence,wil04.xml,7,1,0,OPE,98,74,MOT
0,1,1,5,0.287682072,6,1,can,"('MOT', 'OPE')",Providence,wil04.xml,7,1,0,OPE,98,74,MOT
0,1,1,5,0.287682072,6,1,the,"('MOT', 'OPE')",Providence,wil04.xml,7,1,0,OPE,98,74,MOT
1,1,2,3,0.182321557,4,1,you,"('MOT', 'OPE')",Providence,wil04.xml,7,3,1,OPE,98,74,MOT
0,2,1,4,-0.117783036,6,2,it,"('MOT', 'OPE')",Providence,wil04.xml,7,1,0,OPE,98,74,MOT
0,1,3,426,3.758871826,427,1,up,"('FAT', 'CHI')",Providence,wil05.xml,430,3,0,CHI,4020,1310,FAT
1,0,22,407,3.487986512,407,0,oh,"('FAT', 'CHI')",Providence,wil05.xml,430,23,1,CHI,4020,1310,FAT
2,1,41,386,2.562381962,387,1,this,"('FAT', 'CHI')",Providence,wil05.xml,430,43,2,CHI,4020,1310,FAT
1,2,21,406,2.432638221,408,2,all,"('FAT', 'CHI')",Providence,wil05.xml,430,22,1,CHI,4020,1310,FAT
1,0,81,348,2.120263536,348,0,you,"('FAT', 'CHI')",Providence,wil05.xml,430,82,1,CHI,4020,1310,FAT
1,8,9,412,2.056021267,420,8,see,"('FAT', 'CHI')",Providence,wil05.xml,430,10,1,CHI,4020,1310,FAT
0,1,33,396,1.740466175,397,1,go,"('FAT', 'CHI')",Providence,wil05.xml,430,33,0,CHI,4020,1310,FAT
0,1,40,389,1.540445041,390,1,is,"('FAT', 'CHI')",Providence,wil05.xml,430,40,0,CHI,4020,1310,FAT
0,1,45,384,1.415129911,385,1,it,"('FAT', 'CHI')",Providence,wil05.xml,430,45,0,CHI,4020,1310,FAT
0,1,46,383,1.391489178,384,1,what,"('FAT', 'CHI')",Providence,wil05.xml,430,46,0,CHI,4020,1310,FAT
2,11,33,384,0.986724007,395,11,a,"('FAT', 'CHI')",Providence,wil05.xml,430,35,2,CHI,4020,1310,FAT
1,0,0,1,0.693147181,1,0,all,"('CHI', 'OPE')",Providence,wil05.xml,2,1,1,OPE,17,7,CHI
19,73,36,302,0.5808611,375,73,no,"('FAT', 'CHI')",Providence,wil05.xml,430,55,19,CHI,4020,1310,FAT
0,4,63,363,0.126971462,367,4,that,"('FAT', 'CHI')",Providence,wil05.xml,430,63,0,CHI,4020,1310,FAT
0,1,1,1,-0.405465108,2,1,in,"('FAT', 'OPE')",Providence,wil05.xml,3,1,0,OPE,25,34,FAT
1,6,0,171,2.836010549,177,6,want,"('CHI', 'MOT')",Providence,wil06.xml,178,1,1,MOT,514,4359,CHI
1,9,1,167,2.186051277,176,9,there,"('CHI', 'MOT')",Providence,wil06.xml,178,2,1,MOT,514,4359,CHI
0,6,1,171,2.142863368,177,6,one,"('CHI', 'MOT')",Providence,wil06.xml,178,1,0,MOT,514,4359,CHI
7,13,4,154,2.00533357,167,13,see,"('CHI', 'MOT')",Providence,wil06.xml,178,11,7,MOT,514,4359,CHI
4,19,1,154,1.832581464,173,19,it,"('CHI', 'MOT')",Providence,wil06.xml,178,5,4,MOT,514,4359,CHI
1,22,0,155,1.646426482,177,22,go,"('CHI', 'MOT')",Providence,wil06.xml,178,1,1,MOT,514,4359,CHI
10,9,20,139,1.640209571,148,9,no,"('CHI', 'MOT')",Providence,wil06.xml,178,30,10,MOT,514,4359,CHI
1,26,0,151,1.486083832,177,26,oh,"('CHI', 'MOT')",Providence,wil06.xml,178,1,1,MOT,514,4359,CHI
1,44,0,133,0.975258208,177,44,the,"('CHI', 'MOT')",Providence,wil06.xml,178,1,1,MOT,514,4359,CHI
2,45,1,130,0.836682712,175,45,a,"('CHI', 'MOT')",Providence,wil06.xml,178,3,2,MOT,514,4359,CHI
0,34,1,143,0.533425456,177,34,and,"('CHI', 'MOT')",Providence,wil06.xml,178,1,0,MOT,514,4359,CHI
1,0,8,372,4.219507705,372,0,have,"('MOT', 'CHI')",Providence,wil07.xml,381,9,1,CHI,4828,1670,MOT
2,2,6,371,3.624340933,373,2,all,"('MOT', 'CHI')",Providence,wil07.xml,381,8,2,CHI,4828,1670,MOT
0,1,7,373,3.039217385,374,1,did,"('MOT', 'CHI')",Providence,wil07.xml,381,7,0,CHI,4828,1670,MOT
0,3,5,373,2.602689685,376,3,want,"('MOT', 'CHI')",Providence,wil07.xml,381,5,0,CHI,4828,1670,MOT
0,5,3,373,2.538973871,378,5,my,"('MOT', 'CHI')",Providence,wil07.xml,381,3,0,CHI,4828,1670,MOT
0,2,8,371,2.525728644,373,2,not,"('MOT', 'CHI')",Providence,wil07.xml,381,8,0,CHI,4828,1670,MOT
0,1,14,366,2.445060741,367,1,up,"('MOT', 'CHI')",Providence,wil07.xml,381,14,0,CHI,4828,1670,MOT
2,2,27,350,2.435309709,352,2,and,"('MOT', 'CHI')",Providence,wil07.xml,381,29,2,CHI,4828,1670,MOT
0,1,16,364,2.32184291,365,1,with,"('MOT', 'CHI')",Providence,wil07.xml,381,16,0,CHI,4828,1670,MOT
0,2,12,367,2.178532444,369,2,gonna,"('MOT', 'CHI')",Providence,wil07.xml,381,12,0,CHI,4828,1670,MOT
0,2,13,366,2.106840516,368,2,go,"('MOT', 'CHI')",Providence,wil07.xml,381,13,0,CHI,4828,1670,MOT
0,2,13,366,2.106840516,368,2,wanna,"('MOT', 'CHI')",Providence,wil07.xml,381,13,0,CHI,4828,1670,MOT
4,14,10,353,2.039595633,367,14,where,"('MOT', 'CHI')",Providence,wil07.xml,381,14,4,CHI,4828,1670,MOT
4,8,20,349,2.037439186,357,8,no,"('MOT', 'CHI')",Providence,wil07.xml,381,24,4,CHI,4828,1670,MOT
0,1,29,351,1.742162528,352,1,to,"('MOT', 'CHI')",Providence,wil07.xml,381,29,0,CHI,4828,1670,MOT
1,2,40,338,1.668145513,340,2,do,"('MOT', 'CHI')",Providence,wil07.xml,381,41,1,CHI,4828,1670,MOT
1,1,64,315,1.557358763,316,1,yeah,"('MOT', 'CHI')",Providence,wil07.xml,381,65,1,CHI,4828,1670,MOT
0,2,26,353,1.446918983,355,2,on,"('MOT', 'CHI')",Providence,wil07.xml,381,26,0,CHI,4828,1670,MOT
0,4,20,357,1.193922468,361,4,one,"('MOT', 'CHI')",Providence,wil07.xml,381,20,0,CHI,4828,1670,MOT
8,14,65,294,0.90825856,308,14,a,"('MOT', 'CHI')",Providence,wil07.xml,381,73,8,CHI,4828,1670,MOT
1,3,64,313,0.864211583,316,3,is,"('MOT', 'CHI')",Providence,wil07.xml,381,65,1,CHI,4828,1670,MOT
1,2,98,280,0.628388613,282,2,you,"('MOT', 'CHI')",Providence,wil07.xml,381,99,1,CHI,4828,1670,MOT
0,1,80,300,0.613866378,301,1,that,"('MOT', 'CHI')",Providence,wil07.xml,381,80,0,CHI,4828,1670,MOT
0,8,20,353,0.606135804,361,8,oh,"('MOT', 'CHI')",Providence,wil07.xml,381,20,0,CHI,4828,1670,MOT
0,3,45,333,0.586603933,336,3,this,"('MOT', 'CHI')",Providence,wil07.xml,381,45,0,CHI,4828,1670,MOT
0,2,65,314,0.458746475,316,2,what,"('MOT', 'CHI')",Providence,wil07.xml,381,65,0,CHI,4828,1670,MOT
2,14,41,324,0.412845215,338,14,it,"('MOT', 'CHI')",Providence,wil07.xml,381,43,2,CHI,4828,1670,MOT
1,16,26,338,0.367568737,354,16,see,"('MOT', 'CHI')",Providence,wil07.xml,381,27,1,CHI,4828,1670,MOT
0,3,61,317,0.245122458,320,3,the,"('MOT', 'CHI')",Providence,wil07.xml,381,61,0,CHI,4828,1670,MOT
1,0,1,90,3.828641396,90,0,all,"('MOT', 'CHI')",Providence,wil08.xml,92,2,1,CHI,1121,381,MOT
1,0,5,86,3.091042453,86,0,have,"('MOT', 'CHI')",Providence,wil08.xml,92,6,1,CHI,1121,381,MOT
4,7,3,238,2.84216013,245,7,no,"('CHI', 'MOT')",Providence,wil08.xml,252,7,4,MOT,934,3900,CHI
0,4,1,247,2.825339288,251,4,want,"('CHI', 'MOT')",Providence,wil08.xml,252,1,0,MOT,934,3900,CHI
0,4,1,247,2.825339288,251,4,get,"('CHI', 'MOT')",Providence,wil08.xml,252,1,0,MOT,934,3900,CHI
0,4,1,247,2.825339288,251,4,she,"('CHI', 'MOT')",Providence,wil08.xml,252,1,0,MOT,934,3900,CHI
2,11,0,239,2.756840365,250,11,not,"('CHI', 'MOT')",Providence,wil08.xml,252,2,2,MOT,934,3900,CHI
0,1,1,90,2.740840024,91,1,with,"('MOT', 'CHI')",Providence,wil08.xml,92,1,0,CHI,1121,381,MOT
0,1,1,90,2.740840024,91,1,little,"('MOT', 'CHI')",Providence,wil08.xml,92,1,0,CHI,1121,381,MOT
0,6,1,245,2.488867051,251,6,look,"('CHI', 'MOT')",Providence,wil08.xml,252,1,0,MOT,934,3900,CHI
0,6,1,245,2.488867051,251,6,big,"('CHI', 'MOT')",Providence,wil08.xml,252,1,0,MOT,934,3900,CHI
0,1,2,89,2.442347035,90,1,want,"('MOT', 'CHI')",Providence,wil08.xml,92,2,0,CHI,1121,381,MOT
0,1,2,89,2.442347035,90,1,my,"('MOT', 'CHI')",Providence,wil08.xml,92,2,0,CHI,1121,381,MOT
1,14,0,237,2.41987418,251,14,we,"('CHI', 'MOT')",Providence,wil08.xml,252,1,1,MOT,934,3900,CHI
1,1,0,25,2.233592222,26,1,of,"('MOT', 'TOY')",Providence,wil08.xml,27,1,1,TOY,156,284,MOT
0,1,3,88,2.208274414,89,1,to,"('MOT', 'CHI')",Providence,wil08.xml,92,3,0,CHI,1121,381,MOT
4,15,3,230,2.149012949,245,15,see,"('CHI', 'MOT')",Providence,wil08.xml,252,7,4,MOT,934,3900,CHI
3,24,0,225,2.083433563,249,24,is,"('CHI', 'MOT')",Providence,wil08.xml,252,3,3,MOT,934,3900,CHI
0,11,1,240,1.94987055,251,11,was,"('CHI', 'MOT')",Providence,wil08.xml,252,1,0,MOT,934,3900,CHI
1,17,1,233,1.945910149,250,17,go,"('CHI', 'MOT')",Providence,wil08.xml,252,2,1,MOT,934,3900,CHI
2,1,15,74,1.804831551,75,1,is,"('MOT', 'CHI')",Providence,wil08.xml,92,17,2,CHI,1121,381,MOT
1,20,1,230,1.791759469,250,20,do,"('CHI', 'MOT')",Providence,wil08.xml,252,2,1,MOT,934,3900,CHI
5,19,8,220,1.572773928,239,19,it,"('CHI', 'MOT')",Providence,wil08.xml,252,13,5,MOT,934,3900,CHI
1,0,2,10,1.568615918,10,0,a,"('TOY', 'MOT')",Providence,wil08.xml,13,3,1,MOT,394,66,TOY
0,1,1,25,1.540445041,26,1,at,"('MOT', 'TOY')",Providence,wil08.xml,27,1,0,TOY,156,284,MOT
1,39,0,212,1.439044927,251,39,and,"('CHI', 'MOT')",Providence,wil08.xml,252,1,1,MOT,934,3900,CHI
0,1,2,24,1.216395324,25,1,one,"('MOT', 'TOY')",Providence,wil08.xml,27,2,0,TOY,156,284,MOT
0,1,11,80,1.16074407,81,1,and,"('MOT', 'CHI')",Providence,wil08.xml,92,11,0,CHI,1121,381,MOT
0,2,1,24,1.134979933,26,2,in,"('MOT', 'TOY')",Providence,wil08.xml,27,1,0,TOY,156,284,MOT
0,2,1,24,1.134979933,26,2,with,"('MOT', 'TOY')",Providence,wil08.xml,27,1,0,TOY,156,284,MOT
1,4,8,79,1.128465252,83,4,see,"('MOT', 'CHI')",Providence,wil08.xml,92,9,1,CHI,1121,381,MOT
2,63,0,187,1.082863932,250,63,you,"('CHI', 'MOT')",Providence,wil08.xml,252,2,2,MOT,934,3900,CHI
17,47,10,178,1.076824934,225,47,the,"('CHI', 'MOT')",Providence,wil08.xml,252,27,17,MOT,934,3900,CHI
1,0,4,8,1.049822124,8,0,to,"('TOY', 'MOT')",Providence,wil08.xml,13,5,1,MOT,394,66,TOY
2,5,13,72,0.843087328,77,5,a,"('MOT', 'CHI')",Providence,wil08.xml,92,15,2,CHI,1121,381,MOT
1,1,7,18,0.741937345,19,1,you,"('MOT', 'TOY')",Providence,wil08.xml,27,8,1,TOY,156,284,MOT
2,1,0,2,0.628608659,3,1,you,"('OPE', 'MOT')",Providence,wil08.xml,5,2,2,MOT,19,622,OPE
0,6,5,81,0.596816072,87,6,no,"('MOT', 'CHI')",Providence,wil08.xml,92,5,0,CHI,1121,381,MOT
0,3,2,22,0.523248144,25,3,a,"('MOT', 'TOY')",Providence,wil08.xml,27,2,0,TOY,156,284,MOT
1,5,13,73,0.510825624,78,5,it,"('MOT', 'CHI')",Providence,wil08.xml,92,14,1,CHI,1121,381,MOT
3,6,3,15,0.496436886,21,6,the,"('MOT', 'TOY')",Providence,wil08.xml,27,6,3,TOY,156,284,MOT
0,1,2,10,0.485507816,11,1,on,"('TOY', 'MOT')",Providence,wil08.xml,13,2,0,MOT,394,66,TOY
2,4,22,64,0.47957308,68,4,the,"('MOT', 'CHI')",Providence,wil08.xml,92,24,2,CHI,1121,381,MOT
2,55,5,190,0.385424357,245,55,a,"('CHI', 'MOT')",Providence,wil08.xml,252,7,2,MOT,934,3900,CHI
1,2,0,2,0.287682072,4,2,and,"('MOT', 'NON')",Providence,wil08.xml,5,1,1,NON,93,51,MOT
1,1,1,2,0.223143551,3,1,it,"('MOT', 'NON')",Providence,wil08.xml,5,2,1,NON,93,51,MOT
1,14,0,12,0.218689201,26,14,and,"('MOT', 'TOY')",Providence,wil08.xml,27,1,1,TOY,156,284,MOT
0,1,1,3,0,4,1,at,"('MOT', 'NON')",Providence,wil08.xml,5,1,0,NON,93,51,MOT
0,1,1,3,0,4,1,a,"('OPE', 'MOT')",Providence,wil08.xml,5,1,0,MOT,19,622,OPE
0,1,1,3,0,4,1,see,"('OPE', 'MOT')",Providence,wil08.xml,5,1,0,MOT,19,622,OPE
0,1,1,3,0,4,1,are,"('OPE', 'MOT')",Providence,wil08.xml,5,1,0,MOT,19,622,OPE
0,1,1,2,-0.182321557,3,1,the,"('NON', 'MOT')",Providence,wil08.xml,4,1,0,MOT,61,32,NON
0,4,5,18,-0.377294231,22,4,to,"('MOT', 'TOY')",Providence,wil08.xml,27,5,0,TOY,156,284,MOT
0,2,1,2,-0.405465108,4,2,the,"('MOT', 'NON')",Providence,wil08.xml,5,1,0,NON,93,51,MOT
0,1,2,2,-0.470003629,3,1,that,"('MOT', 'NON')",Providence,wil08.xml,5,2,0,NON,93,51,MOT
0,3,3,7,-0.510825624,10,3,you,"('TOY', 'MOT')",Providence,wil08.xml,13,3,0,MOT,394,66,TOY
0,1,2,1,-0.693147181,2,1,a,"('TOY', 'CHI')",Providence,wil08.xml,4,2,0,CHI,200,12,TOY
1,2,0,54,2.556365614,56,2,no,"('CHI', 'MOT')",Providence,wil09.xml,57,1,1,MOT,192,1825,CHI
1,0,1,13,2.014903021,13,0,for,"('MOT', 'OPE')",Providence,wil09.xml,15,2,1,OPE,237,103,MOT
1,0,2,12,1.722766598,12,0,the,"('MOT', 'OPE')",Providence,wil09.xml,15,3,1,OPE,237,103,MOT
2,12,0,43,1.190419838,55,12,the,"('CHI', 'MOT')",Providence,wil09.xml,57,2,2,MOT,192,1825,CHI
0,1,1,13,0.980829253,14,1,want,"('MOT', 'OPE')",Providence,wil09.xml,15,1,0,OPE,237,103,MOT
0,1,1,13,0.980829253,14,1,like,"('MOT', 'OPE')",Providence,wil09.xml,15,1,0,OPE,237,103,MOT
1,2,1,11,0.916290732,13,2,that,"('MOT', 'OPE')",Providence,wil09.xml,15,2,1,OPE,237,103,MOT
1,6,4,46,0.790310929,52,6,go,"('CHI', 'MOT')",Providence,wil09.xml,57,5,1,MOT,192,1825,CHI
0,1,2,12,0.628608659,13,1,there,"('MOT', 'OPE')",Providence,wil09.xml,15,2,0,OPE,237,103,MOT
0,1,2,12,0.628608659,13,1,some,"('MOT', 'OPE')",Providence,wil09.xml,15,2,0,OPE,237,103,MOT
0,1,2,12,0.628608659,13,1,on,"('MOT', 'OPE')",Providence,wil09.xml,15,2,0,OPE,237,103,MOT
0,1,1,5,0.287682072,6,1,oh,"('CHI', 'OPE')",Providence,wil09.xml,7,1,0,OPE,32,80,CHI
0,2,2,11,0.223143551,13,2,it,"('MOT', 'OPE')",Providence,wil09.xml,15,2,0,OPE,237,103,MOT
3,1,7,4,0.15415068,5,1,you,"('MOT', 'OPE')",Providence,wil09.xml,15,10,3,OPE,237,103,MOT
2,2,1,1,0,3,2,you,"('OPE', 'MOT')",Providence,wil09.xml,6,3,2,MOT,66,31,OPE
0,2,1,4,-0.117783036,6,2,go,"('CHI', 'OPE')",Providence,wil09.xml,7,1,0,OPE,32,80,CHI
0,2,5,8,-0.559615788,10,2,what,"('MOT', 'OPE')",Providence,wil09.xml,15,5,0,OPE,237,103,MOT
0,1,1,0,-0.693147181,1,1,go,"('OPE', 'CHI')",Providence,wil09.xml,2,1,0,CHI,6,9,OPE
1,2,0,130,3.393762403,132,2,get,"('CHI', 'MOT')",Providence,wil10.xml,133,1,1,MOT,458,1573,CHI
1,0,0,25,2.890371758,25,0,is,"('CHI', 'GRA')",Providence,wil10.xml,26,1,1,GRA,70,191,CHI
1,4,0,128,2.882936779,132,4,wanna,"('CHI', 'MOT')",Providence,wil10.xml,133,1,1,MOT,458,1573,CHI
1,1,1,59,2.740840024,60,1,up,"('GRA', 'MOT')",Providence,wil10.xml,62,2,1,MOT,447,1022,GRA
0,2,1,130,2.700615223,132,2,my,"('CHI', 'MOT')",Providence,wil10.xml,133,1,0,MOT,458,1573,CHI
1,0,3,40,2.63905733,40,0,want,"('MOT', 'GRA')",Providence,wil10.xml,44,4,1,GRA,605,290,MOT
1,2,0,59,2.63905733,61,2,there,"('GRA', 'MOT')",Providence,wil10.xml,62,1,1,MOT,447,1022,GRA
1,0,1,24,2.564949357,24,0,it,"('CHI', 'GRA')",Providence,wil10.xml,26,2,1,GRA,70,191,CHI
0,1,1,60,2.351375257,61,1,like,"('GRA', 'MOT')",Providence,wil10.xml,62,1,0,MOT,447,1022,GRA
1,9,0,123,2.189789599,132,9,we,"('CHI', 'MOT')",Providence,wil10.xml,133,1,1,MOT,458,1573,CHI
1,10,0,122,2.094479419,132,10,want,"('CHI', 'MOT')",Providence,wil10.xml,133,1,1,MOT,458,1573,CHI
0,1,6,122,2.055725015,123,1,want,"('MOT', 'CHI')",Providence,wil10.xml,129,6,0,CHI,1948,388,MOT
0,1,2,59,2.047692843,60,1,they,"('GRA', 'MOT')",Providence,wil10.xml,62,2,0,MOT,447,1022,GRA
0,1,1,42,2.014903021,43,1,gonna,"('MOT', 'GRA')",Providence,wil10.xml,44,1,0,GRA,605,290,MOT
0,1,1,42,2.014903021,43,1,we,"('MOT', 'GRA')",Providence,wil10.xml,44,1,0,GRA,605,290,MOT
0,1,1,42,2.014903021,43,1,did,"('MOT', 'GRA')",Providence,wil10.xml,44,1,0,GRA,605,290,MOT
1,0,26,102,1.97024225,102,0,the,"('MOT', 'CHI')",Providence,wil10.xml,129,27,1,CHI,1948,388,MOT
0,2,1,59,1.945910149,61,2,no,"('GRA', 'MOT')",Providence,wil10.xml,62,1,0,MOT,447,1022,GRA
0,2,1,59,1.945910149,61,2,at,"('GRA', 'MOT')",Providence,wil10.xml,62,1,0,MOT,447,1022,GRA
1,1,3,39,1.945910149,40,1,can,"('MOT', 'GRA')",Providence,wil10.xml,44,4,1,GRA,605,290,MOT
1,12,0,120,1.927425334,132,12,are,"('CHI', 'MOT')",Providence,wil10.xml,133,1,1,MOT,458,1573,CHI
1,4,1,56,1.824549292,60,4,think,"('GRA', 'MOT')",Providence,wil10.xml,62,2,1,MOT,447,1022,GRA
0,1,8,120,1.816452082,121,1,there,"('MOT', 'CHI')",Providence,wil10.xml,129,8,0,CHI,1948,388,MOT
2,5,1,54,1.808288771,59,5,on,"('GRA', 'MOT')",Providence,wil10.xml,62,3,2,MOT,447,1022,GRA
1,2,0,23,1.791759469,25,2,what,"('CHI', 'GRA')",Providence,wil10.xml,26,1,1,GRA,70,191,CHI
1,14,0,118,1.784324491,132,14,that,"('CHI', 'MOT')",Providence,wil10.xml,133,1,1,MOT,458,1573,CHI
1,15,0,117,1.71978597,132,15,what,"('CHI', 'MOT')",Providence,wil10.xml,133,1,1,MOT,458,1573,CHI
0,7,1,125,1.71978597,132,7,see,"('CHI', 'MOT')",Providence,wil10.xml,133,1,0,MOT,458,1573,CHI
1,15,0,117,1.71978597,132,15,some,"('CHI', 'MOT')",Providence,wil10.xml,133,1,1,MOT,458,1573,CHI
1,3,1,39,1.704748092,42,3,yeah,"('MOT', 'GRA')",Providence,wil10.xml,44,2,1,GRA,605,290,MOT
0,1,2,41,1.704748092,42,1,go,"('MOT', 'GRA')",Providence,wil10.xml,44,2,0,GRA,605,290,MOT
0,1,2,41,1.704748092,42,1,see,"('MOT', 'GRA')",Providence,wil10.xml,44,2,0,GRA,605,290,MOT
0,1,2,41,1.704748092,42,1,think,"('MOT', 'GRA')",Providence,wil10.xml,44,2,0,GRA,605,290,MOT
0,1,2,41,1.704748092,42,1,on,"('MOT', 'GRA')",Providence,wil10.xml,44,2,0,GRA,605,290,MOT
0,3,1,58,1.658228077,61,3,with,"('GRA', 'MOT')",Providence,wil10.xml,62,1,0,MOT,447,1022,GRA
0,3,1,58,1.658228077,61,3,but,"('GRA', 'MOT')",Providence,wil10.xml,62,1,0,MOT,447,1022,GRA
0,3,1,58,1.658228077,61,3,all,"('GRA', 'MOT')",Providence,wil10.xml,62,1,0,MOT,447,1022,GRA
0,3,1,58,1.658228077,61,3,my,"('GRA', 'MOT')",Providence,wil10.xml,62,1,0,MOT,447,1022,GRA
0,2,2,58,1.642227735,60,2,go,"('GRA', 'MOT')",Providence,wil10.xml,62,2,0,MOT,447,1022,GRA
0,2,2,58,1.642227735,60,2,was,"('GRA', 'MOT')",Providence,wil10.xml,62,2,0,MOT,447,1022,GRA
0,2,1,41,1.609437912,43,2,for,"('MOT', 'GRA')",Providence,wil10.xml,44,1,0,GRA,605,290,MOT
1,1,5,37,1.609437912,38,1,is,"('MOT', 'GRA')",Providence,wil10.xml,44,6,1,GRA,605,290,MOT
0,2,1,41,1.609437912,43,2,put,"('MOT', 'GRA')",Providence,wil10.xml,44,1,0,GRA,605,290,MOT
0,8,1,124,1.602002934,132,8,with,"('CHI', 'MOT')",Providence,wil10.xml,133,1,0,MOT,458,1573,CHI
1,0,0,5,1.540445041,5,0,yeah,"('OPE', 'MOT')",Providence,wil10.xml,6,1,1,MOT,63,74,OPE
1,0,0,5,1.540445041,5,0,it,"('OPE', 'MOT')",Providence,wil10.xml,6,1,1,MOT,63,74,OPE
1,0,0,5,1.540445041,5,0,he,"('OPE', 'MOT')",Providence,wil10.xml,6,1,1,MOT,63,74,OPE
1,0,0,5,1.540445041,5,0,think,"('OPE', 'MOT')",Providence,wil10.xml,6,1,1,MOT,63,74,OPE
1,1,6,36,1.466337069,37,1,what,"('MOT', 'GRA')",Providence,wil10.xml,44,7,1,GRA,605,290,MOT
0,1,3,40,1.458615023,41,1,like,"('MOT', 'GRA')",Providence,wil10.xml,44,3,0,GRA,605,290,MOT
0,4,1,57,1.435084525,61,4,for,"('GRA', 'MOT')",Providence,wil10.xml,62,1,0,MOT,447,1022,GRA
0,4,1,57,1.435084525,61,4,some,"('GRA', 'MOT')",Providence,wil10.xml,62,1,0,MOT,447,1022,GRA
0,3,2,57,1.354545663,60,3,gonna,"('GRA', 'MOT')",Providence,wil10.xml,62,2,0,MOT,447,1022,GRA
0,2,1,30,1.329135947,32,2,it,"('GRA', 'CHI')",Providence,wil10.xml,33,1,0,CHI,168,85,GRA
0,2,2,40,1.299282984,42,2,in,"('MOT', 'GRA')",Providence,wil10.xml,44,2,0,GRA,605,290,MOT
0,2,2,40,1.299282984,42,2,get,"('MOT', 'GRA')",Providence,wil10.xml,44,2,0,GRA,605,290,MOT
0,1,4,39,1.252762968,40,1,of,"('MOT', 'GRA')",Providence,wil10.xml,44,4,0,GRA,605,290,MOT
0,1,4,39,1.252762968,40,1,wanna,"('MOT', 'GRA')",Providence,wil10.xml,44,4,0,GRA,605,290,MOT
0,3,7,119,1.236762627,122,3,no,"('MOT', 'CHI')",Providence,wil10.xml,129,7,0,CHI,1948,388,MOT
2,4,6,50,1.211940974,54,4,yeah,"('GRA', 'MOT')",Providence,wil10.xml,62,8,2,MOT,447,1022,GRA
0,1,3,29,1.16315081,30,1,yeah,"('GRA', 'CHI')",Providence,wil10.xml,33,3,0,CHI,168,85,GRA
0,1,3,29,1.16315081,30,1,what,"('GRA', 'CHI')",Providence,wil10.xml,33,3,0,CHI,168,85,GRA
0,1,3,29,1.16315081,30,1,is,"('GRA', 'CHI')",Providence,wil10.xml,33,3,0,CHI,168,85,GRA
0,2,11,116,1.123930097,118,2,are,"('MOT', 'CHI')",Providence,wil10.xml,129,11,0,CHI,1948,388,MOT
1,2,21,105,1.107828944,107,2,a,"('MOT', 'CHI')",Providence,wil10.xml,129,22,1,CHI,1948,388,MOT
1,13,0,48,1.098612289,61,13,a,"('GRA', 'MOT')",Providence,wil10.xml,62,1,1,MOT,447,1022,GRA
0,1,5,38,1.074514737,39,1,no,"('MOT', 'GRA')",Providence,wil10.xml,44,5,0,GRA,605,290,MOT
1,14,3,115,1.068534833,129,14,yeah,"('CHI', 'MOT')",Providence,wil10.xml,133,4,1,MOT,458,1573,CHI
0,2,3,39,1.053149915,41,2,some,"('MOT', 'GRA')",Providence,wil10.xml,44,3,0,GRA,605,290,MOT
1,6,3,52,1.049822124,58,6,have,"('GRA', 'MOT')",Providence,wil10.xml,62,4,1,MOT,447,1022,GRA
1,6,3,52,1.049822124,58,6,he,"('GRA', 'MOT')",Providence,wil10.xml,62,4,1,MOT,447,1022,GRA
1,10,1,50,1.036091932,60,10,do,"('GRA', 'MOT')",Providence,wil10.xml,62,2,1,MOT,447,1022,GRA
5,2,13,24,1.029619417,26,2,you,"('MOT', 'GRA')",Providence,wil10.xml,44,18,5,GRA,605,290,MOT
3,3,8,30,0.990398704,33,3,it,"('MOT', 'GRA')",Providence,wil10.xml,44,11,3,GRA,605,290,MOT
0,5,2,55,0.949080555,60,5,did,"('GRA', 'MOT')",Providence,wil10.xml,62,2,0,MOT,447,1022,GRA
1,7,3,51,0.916290732,58,7,of,"('GRA', 'MOT')",Providence,wil10.xml,62,4,1,MOT,447,1022,GRA
0,4,3,55,0.891998039,59,4,in,"('GRA', 'MOT')",Providence,wil10.xml,62,3,0,MOT,447,1022,GRA
0,19,1,113,0.803495238,132,19,a,"('CHI', 'MOT')",Providence,wil10.xml,133,1,0,MOT,458,1573,CHI
0,6,2,54,0.794929875,60,6,is,"('GRA', 'MOT')",Providence,wil10.xml,62,2,0,MOT,447,1022,GRA
0,6,2,54,0.794929875,60,6,can,"('GRA', 'MOT')",Providence,wil10.xml,62,2,0,MOT,447,1022,GRA
0,6,2,54,0.794929875,60,6,and,"('GRA', 'MOT')",Providence,wil10.xml,62,2,0,MOT,447,1022,GRA
2,6,4,32,0.762140052,38,6,a,"('MOT', 'GRA')",Providence,wil10.xml,44,6,2,GRA,605,290,MOT
0,4,4,54,0.693147181,58,4,this,"('GRA', 'MOT')",Providence,wil10.xml,62,4,0,MOT,447,1022,GRA
1,0,0,1,0.693147181,1,0,have,"('GRA', 'OPE')",Providence,wil10.xml,2,1,1,OPE,11,8,GRA
2,0,2,2,0.693147181,2,0,you,"('OPE', 'MOT')",Providence,wil10.xml,6,4,2,MOT,63,74,OPE
0,1,25,103,0.674455048,104,1,yeah,"('MOT', 'CHI')",Providence,wil10.xml,129,25,0,CHI,1948,388,MOT
1,3,7,33,0.641853886,36,3,that,"('MOT', 'GRA')",Providence,wil10.xml,44,8,1,GRA,605,290,MOT
1,10,3,48,0.597837001,58,10,it,"('GRA', 'MOT')",Providence,wil10.xml,62,4,1,MOT,447,1022,GRA
0,6,3,53,0.555525803,59,6,oh,"('GRA', 'MOT')",Providence,wil10.xml,62,3,0,MOT,447,1022,GRA
1,15,2,44,0.42199441,59,15,that,"('GRA', 'MOT')",Providence,wil10.xml,62,3,1,MOT,447,1022,GRA
4,16,5,37,0.385662481,53,16,you,"('GRA', 'MOT')",Providence,wil10.xml,62,9,4,MOT,447,1022,GRA
2,2,50,75,0.380463806,77,2,you,"('MOT', 'CHI')",Providence,wil10.xml,129,52,2,CHI,1948,388,MOT
0,2,7,35,0.36772478,37,2,he,"('MOT', 'GRA')",Providence,wil10.xml,44,7,0,GRA,605,290,MOT
1,13,3,45,0.356674944,58,13,to,"('GRA', 'MOT')",Providence,wil10.xml,62,4,1,MOT,447,1022,GRA
0,12,2,48,0.175890666,60,12,what,"('GRA', 'MOT')",Providence,wil10.xml,62,2,0,MOT,447,1022,GRA
0,1,1,4,0.15415068,5,1,do,"('OPE', 'MOT')",Providence,wil10.xml,6,1,0,MOT,63,74,OPE
0,2,1,6,0.105360516,8,2,oh,"('MOT', 'OPE')",Providence,wil10.xml,9,1,0,OPE,71,36,MOT
0,2,1,6,0.105360516,8,2,is,"('MOT', 'OPE')",Providence,wil10.xml,9,1,0,OPE,71,36,MOT
1,8,9,44,0,52,8,the,"('GRA', 'MOT')",Providence,wil10.xml,62,10,1,MOT,447,1022,GRA
0,3,8,33,-0.051293294,36,3,the,"('MOT', 'GRA')",Providence,wil10.xml,44,8,0,GRA,605,290,MOT
0,1,3,5,-0.223143551,6,1,you,"('MOT', 'OPE')",Providence,wil10.xml,9,3,0,OPE,71,36,MOT
0,2,1,3,-0.251314428,5,2,to,"('OPE', 'MOT')",Providence,wil10.xml,6,1,0,MOT,63,74,OPE
1,0,2,162,4.183575696,162,0,of,"('MOT', 'CHI')",Providence,wil11.xml,165,3,1,CHI,2393,646,MOT
1,1,0,83,3.355735008,84,1,up,"('CHI', 'MOT')",Providence,wil11.xml,85,1,1,MOT,293,721,CHI
1,0,15,149,2.820055259,149,0,on,"('MOT', 'CHI')",Providence,wil11.xml,165,16,1,CHI,2393,646,MOT
0,1,3,161,2.797281335,162,1,all,"('MOT', 'CHI')",Providence,wil11.xml,165,3,0,CHI,2393,646,MOT
0,1,1,83,2.662587827,84,1,see,"('CHI', 'MOT')",Providence,wil11.xml,85,1,0,MOT,293,721,CHI
0,1,6,158,2.308815643,159,1,put,"('MOT', 'CHI')",Providence,wil11.xml,165,6,0,CHI,2393,646,MOT
1,5,0,79,2.257122719,84,5,go,"('CHI', 'MOT')",Providence,wil11.xml,85,1,1,MOT,293,721,CHI
0,2,1,82,2.257122719,84,2,no,"('CHI', 'MOT')",Providence,wil11.xml,85,1,0,MOT,293,721,CHI
0,2,1,82,2.257122719,84,2,wanna,"('CHI', 'MOT')",Providence,wil11.xml,85,1,0,MOT,293,721,CHI
2,4,7,152,2.153874136,156,4,up,"('MOT', 'CHI')",Providence,wil11.xml,165,9,2,CHI,2393,646,MOT
0,2,5,158,2.043073898,160,2,where,"('MOT', 'CHI')",Providence,wil11.xml,165,5,0,CHI,2393,646,MOT
1,7,0,77,1.969440646,84,7,a,"('CHI', 'MOT')",Providence,wil11.xml,85,1,1,MOT,293,721,CHI
0,4,1,80,1.746297095,84,4,it,"('CHI', 'MOT')",Providence,wil11.xml,85,1,0,MOT,293,721,CHI
0,3,6,156,1.615668462,159,3,see,"('MOT', 'CHI')",Providence,wil11.xml,165,6,0,CHI,2393,646,MOT
1,0,0,5,1.540445041,5,0,a,"('FAT', 'CHI')",Providence,wil11.xml,6,1,1,CHI,31,29,FAT
1,0,0,5,1.540445041,5,0,it,"('OPE', 'MOT')",Providence,wil11.xml,6,1,1,MOT,48,49,OPE
1,0,0,5,1.540445041,5,0,see,"('OPE', 'MOT')",Providence,wil11.xml,6,1,1,MOT,48,49,OPE
1,0,0,5,1.540445041,5,0,can,"('OPE', 'MOT')",Providence,wil11.xml,6,1,1,MOT,48,49,OPE
1,0,0,5,1.540445041,5,0,that,"('OPE', 'MOT')",Providence,wil11.xml,6,1,1,MOT,48,49,OPE
1,0,0,5,1.540445041,5,0,on,"('OPE', 'MOT')",Providence,wil11.xml,6,1,1,MOT,48,49,OPE
1,0,0,5,1.540445041,5,0,and,"('OPE', 'MOT')",Providence,wil11.xml,6,1,1,MOT,48,49,OPE
0,1,15,149,1.497519996,150,1,can,"('MOT', 'CHI')",Providence,wil11.xml,165,15,0,CHI,2393,646,MOT
0,1,18,146,1.315066852,147,1,the,"('MOT', 'CHI')",Providence,wil11.xml,165,18,0,CHI,2393,646,MOT
0,2,12,151,1.305755499,153,2,wanna,"('MOT', 'CHI')",Providence,wil11.xml,165,12,0,CHI,2393,646,MOT
4,10,13,138,1.277738955,148,10,no,"('MOT', 'CHI')",Providence,wil11.xml,165,17,4,CHI,2393,646,MOT
1,1,1,11,1.252762968,12,1,go,"('OPE', 'CHI')",Providence,wil11.xml,14,2,1,CHI,115,57,OPE
0,2,13,150,1.230290113,152,2,have,"('MOT', 'CHI')",Providence,wil11.xml,165,13,0,CHI,2393,646,MOT
0,1,20,144,1.206242953,145,1,and,"('MOT', 'CHI')",Providence,wil11.xml,165,20,0,CHI,2393,646,MOT
1,7,9,148,1.185044794,155,7,yeah,"('MOT', 'CHI')",Providence,wil11.xml,165,10,1,CHI,2393,646,MOT
0,8,1,76,1.15851043,84,8,the,"('CHI', 'MOT')",Providence,wil11.xml,85,1,0,MOT,293,721,CHI
0,3,12,150,1.018073426,153,3,go,"('MOT', 'CHI')",Providence,wil11.xml,165,12,0,CHI,2393,646,MOT
0,3,12,150,1.018073426,153,3,it,"('MOT', 'CHI')",Providence,wil11.xml,165,12,0,CHI,2393,646,MOT
1,0,0,2,0.980829253,2,0,go,"('CHI', 'OPE')",Providence,wil11.xml,3,1,1,OPE,14,18,CHI
1,0,0,2,0.980829253,2,0,where,"('CHI', 'OPE')",Providence,wil11.xml,3,1,1,OPE,14,18,CHI
1,0,0,2,0.980829253,2,0,in,"('MOT', 'OPE')",Providence,wil11.xml,3,1,1,OPE,39,35,MOT
2,5,27,131,0.8001193,136,5,a,"('MOT', 'CHI')",Providence,wil11.xml,165,29,2,CHI,2393,646,MOT
1,0,2,3,0.693147181,3,0,this,"('OPE', 'MOT')",Providence,wil11.xml,6,3,1,MOT,48,49,OPE
1,1,1,3,0.405465108,4,1,you,"('OPE', 'MOT')",Providence,wil11.xml,6,2,1,MOT,48,49,OPE
1,1,0,1,0.287682072,2,1,that,"('MOT', 'OPE')",Providence,wil11.xml,3,1,1,OPE,39,35,MOT
0,1,3,10,0.262364264,11,1,it,"('OPE', 'CHI')",Providence,wil11.xml,14,3,0,CHI,115,57,OPE
0,1,3,10,0.262364264,11,1,the,"('OPE', 'CHI')",Providence,wil11.xml,14,3,0,CHI,115,57,OPE
0,1,1,4,0.15415068,5,1,go,"('MOT', 'FAT')",Providence,wil11.xml,6,1,0,FAT,108,44,MOT
0,1,1,4,0.15415068,5,1,it,"('MOT', 'FAT')",Providence,wil11.xml,6,1,0,FAT,108,44,MOT
0,1,1,4,0.15415068,5,1,do,"('MOT', 'FAT')",Providence,wil11.xml,6,1,0,FAT,108,44,MOT
0,1,4,9,0,10,1,see,"('OPE', 'CHI')",Providence,wil11.xml,14,4,0,CHI,115,57,OPE
1,1,1,0,-0.287682072,1,1,the,"('MOT', 'OPE')",Providence,wil11.xml,3,2,1,OPE,39,35,MOT
0,19,4,62,-0.368651135,81,19,yeah,"('CHI', 'MOT')",Providence,wil11.xml,85,4,0,MOT,293,721,CHI
0,1,1,1,-0.405465108,2,1,a,"('FAT', 'MOT')",Providence,wil11.xml,3,1,0,MOT,12,32,FAT
0,1,1,1,-0.405465108,2,1,it,"('MOT', 'OPE')",Providence,wil11.xml,3,1,0,OPE,39,35,MOT
0,1,3,2,-0.693147181,3,1,that,"('MOT', 'FAT')",Providence,wil11.xml,6,3,0,FAT,108,44,MOT
1,1,0,148,3.918667548,149,1,up,"('CHI', 'MOT')",Providence,wil12.xml,150,1,1,MOT,484,1886,CHI
0,1,1,222,3.624340933,223,1,my,"('MOT', 'CHI')",Providence,wil12.xml,224,1,0,CHI,2781,759,MOT
1,1,7,215,3.08190997,216,1,there,"('MOT', 'CHI')",Providence,wil12.xml,224,8,1,CHI,2781,759,MOT
0,1,2,147,2.931193752,148,1,want,"('CHI', 'MOT')",Providence,wil12.xml,150,2,0,MOT,484,1886,CHI
1,1,0,42,2.708050201,43,1,no,"('OPE', 'CHI')",Providence,wil12.xml,44,1,1,CHI,322,182,OPE
0,1,6,217,2.621038824,218,1,get,"('MOT', 'CHI')",Providence,wil12.xml,224,6,0,CHI,2781,759,MOT
0,1,7,216,2.498699972,217,1,look,"('MOT', 'CHI')",Providence,wil12.xml,224,7,0,CHI,2781,759,MOT
1,8,0,141,2.414590151,149,8,go,"('CHI', 'MOT')",Providence,wil12.xml,150,1,1,MOT,484,1886,CHI
1,8,0,141,2.414590151,149,8,get,"('CHI', 'MOT')",Providence,wil12.xml,150,1,1,MOT,484,1886,CHI
1,0,1,19,2.351375257,19,0,all,"('CHI', 'OPE')",Providence,wil12.xml,21,2,1,OPE,105,103,CHI
1,0,1,19,2.351375257,19,0,not,"('CHI', 'OPE')",Providence,wil12.xml,21,2,1,OPE,105,103,CHI
1,7,1,141,2.238046572,148,7,see,"('CHI', 'MOT')",Providence,wil12.xml,150,2,1,MOT,484,1886,CHI
0,6,1,143,1.972757399,149,6,there,"('CHI', 'MOT')",Providence,wil12.xml,150,1,0,MOT,484,1886,CHI
0,1,13,210,1.960094784,211,1,want,"('MOT', 'CHI')",Providence,wil12.xml,224,13,0,CHI,2781,759,MOT
1,0,1,11,1.871802177,11,0,is,"('OPE', 'MOT')",Providence,wil12.xml,13,2,1,MOT,87,120,OPE
0,2,10,212,1.791759469,214,2,go,"('MOT', 'CHI')",Providence,wil12.xml,224,10,0,CHI,2781,759,MOT
1,16,0,133,1.778601385,149,16,on,"('CHI', 'MOT')",Providence,wil12.xml,150,1,1,MOT,484,1886,CHI
1,17,0,132,1.721442971,149,17,do,"('CHI', 'MOT')",Providence,wil12.xml,150,1,1,MOT,484,1886,CHI
0,2,11,211,1.707076382,213,2,all,"('MOT', 'CHI')",Providence,wil12.xml,224,11,0,CHI,2781,759,MOT
0,1,2,41,1.704748092,42,1,there,"('OPE', 'CHI')",Providence,wil12.xml,44,2,0,CHI,322,182,OPE
0,1,2,41,1.704748092,42,1,see,"('OPE', 'CHI')",Providence,wil12.xml,44,2,0,CHI,322,182,OPE
0,3,9,212,1.59570772,215,3,one,"('MOT', 'CHI')",Providence,wil12.xml,224,9,0,CHI,2781,759,MOT
0,2,13,209,1.554629676,211,2,oh,"('MOT', 'CHI')",Providence,wil12.xml,224,13,0,CHI,2781,759,MOT
0,10,1,139,1.520772275,149,10,in,"('CHI', 'MOT')",Providence,wil12.xml,150,1,0,MOT,484,1886,CHI
0,6,3,141,1.448598244,147,6,oh,"('CHI', 'MOT')",Providence,wil12.xml,150,3,0,MOT,484,1886,CHI
0,3,7,140,1.393214804,143,3,no,"('CHI', 'MOT')",Providence,wil12.xml,150,7,0,MOT,484,1886,CHI
2,1,1,9,1.280933845,10,1,a,"('OPE', 'MOT')",Providence,wil12.xml,13,3,2,MOT,87,120,OPE
0,1,29,194,1.156069344,195,1,that,"('MOT', 'CHI')",Providence,wil12.xml,224,29,0,CHI,2781,759,MOT
0,15,1,134,1.146078826,149,15,is,"('CHI', 'MOT')",Providence,wil12.xml,150,1,0,MOT,484,1886,CHI
1,33,0,116,1.085454204,149,33,the,"('CHI', 'MOT')",Providence,wil12.xml,150,1,1,MOT,484,1886,CHI
0,4,14,206,0.97455964,210,4,on,"('MOT', 'CHI')",Providence,wil12.xml,224,14,0,CHI,2781,759,MOT
1,13,5,131,0.958254931,144,13,yeah,"('CHI', 'MOT')",Providence,wil12.xml,150,6,1,MOT,484,1886,CHI
0,1,35,188,0.948208335,189,1,a,"('MOT', 'CHI')",Providence,wil12.xml,224,35,0,CHI,2781,759,MOT
2,45,0,103,0.894311825,148,45,you,"('CHI', 'MOT')",Providence,wil12.xml,150,2,2,MOT,484,1886,CHI
0,1,1,11,0.84729786,12,1,it,"('OPE', 'MOT')",Providence,wil12.xml,13,1,0,MOT,87,120,OPE
0,1,1,11,0.84729786,12,1,can,"('OPE', 'MOT')",Providence,wil12.xml,13,1,0,MOT,87,120,OPE
0,3,23,198,0.708035793,201,3,it,"('MOT', 'CHI')",Providence,wil12.xml,224,23,0,CHI,2781,759,MOT
0,25,1,124,0.66057101,149,25,a,"('CHI', 'MOT')",Providence,wil12.xml,150,1,0,MOT,484,1886,CHI
0,7,13,204,0.573800423,211,7,yeah,"('MOT', 'CHI')",Providence,wil12.xml,224,13,0,CHI,2781,759,MOT
0,1,2,10,0.485507816,11,1,that,"('OPE', 'MOT')",Providence,wil12.xml,13,2,0,MOT,87,120,OPE
0,1,55,168,0.405465108,169,1,the,"('MOT', 'CHI')",Providence,wil12.xml,224,55,0,CHI,2781,759,MOT
0,3,5,36,0.381367557,39,3,yeah,"('OPE', 'CHI')",Providence,wil12.xml,44,5,0,CHI,322,182,OPE
0,7,18,199,0.262364264,206,7,no,"('MOT', 'CHI')",Providence,wil12.xml,224,18,0,CHI,2781,759,MOT
0,1,2,6,0.117783036,7,1,it,"('MOT', 'OPE')",Providence,wil12.xml,9,2,0,OPE,89,57,MOT
1,4,2,6,-0.040821995,10,4,you,"('OPE', 'MOT')",Providence,wil12.xml,13,3,1,MOT,87,120,OPE
0,7,1,13,-0.087011377,20,7,the,"('CHI', 'OPE')",Providence,wil12.xml,21,1,0,OPE,105,103,CHI
1,2,3,3,-0.251314428,5,2,you,"('MOT', 'OPE')",Providence,wil12.xml,9,4,1,OPE,89,57,MOT
0,1,91,132,-0.320471895,133,1,you,"('MOT', 'CHI')",Providence,wil12.xml,224,91,0,CHI,2781,759,MOT
0,1,4,4,-0.538996501,5,1,the,"('MOT', 'OPE')",Providence,wil12.xml,9,4,0,OPE,89,57,MOT
2,0,12,130,3.208825489,130,0,go,"('MOT', 'CHI')",Providence,wil13.xml,144,14,2,CHI,2794,563,MOT
1,0,13,130,2.803360381,130,0,we,"('MOT', 'CHI')",Providence,wil13.xml,144,14,1,CHI,2794,563,MOT
0,1,4,139,2.470920408,140,1,look,"('MOT', 'CHI')",Providence,wil13.xml,144,4,0,CHI,2794,563,MOT
0,1,4,139,2.470920408,140,1,all,"('MOT', 'CHI')",Providence,wil13.xml,144,4,0,CHI,2794,563,MOT
0,1,4,139,2.470920408,140,1,my,"('MOT', 'CHI')",Providence,wil13.xml,144,4,0,CHI,2794,563,MOT
0,1,5,138,2.309702561,139,1,little,"('MOT', 'CHI')",Providence,wil13.xml,144,5,0,CHI,2794,563,MOT
2,3,11,128,1.894616855,131,3,see,"('MOT', 'CHI')",Providence,wil13.xml,144,13,2,CHI,2794,563,MOT
1,1,17,125,1.85629799,126,1,do,"('MOT', 'CHI')",Providence,wil13.xml,144,18,1,CHI,2794,563,MOT
0,1,9,134,1.828938472,135,1,have,"('MOT', 'CHI')",Providence,wil13.xml,144,9,0,CHI,2794,563,MOT
0,1,11,132,1.64717824,133,1,what,"('MOT', 'CHI')",Providence,wil13.xml,144,11,0,CHI,2794,563,MOT
2,1,30,111,1.615303032,112,1,it,"('MOT', 'CHI')",Providence,wil13.xml,144,32,2,CHI,2794,563,MOT
1,0,2,10,1.568615918,10,0,a,"('MOT', 'OPE')",Providence,wil13.xml,13,3,1,OPE,147,189,MOT
1,1,0,10,1.466337069,11,1,like,"('CHI', 'MOT')",Providence,wil13.xml,12,1,1,MOT,35,198,CHI
1,1,1,13,1.386294361,14,1,a,"('OPE', 'MOT')",Providence,wil13.xml,16,2,1,MOT,120,294,OPE
2,4,16,122,1.345472367,126,4,oh,"('MOT', 'CHI')",Providence,wil13.xml,144,18,2,CHI,2794,563,MOT
1,3,0,17,1.299282984,20,3,like,"('CHI', 'OPE')",Providence,wil13.xml,21,1,1,OPE,84,219,CHI
1,3,0,17,1.299282984,20,3,it,"('CHI', 'OPE')",Providence,wil13.xml,21,1,1,OPE,84,219,CHI
0,3,8,133,1.238374231,136,3,some,"('MOT', 'CHI')",Providence,wil13.xml,144,8,0,CHI,2794,563,MOT
1,0,54,89,1.160955419,89,0,you,"('MOT', 'CHI')",Providence,wil13.xml,144,55,1,CHI,2794,563,MOT
1,2,0,10,1.134979933,12,2,the,"('MOT', 'OPE')",Providence,wil13.xml,13,1,1,OPE,147,189,MOT
2,2,0,8,1.098612289,10,2,it,"('CHI', 'MOT')",Providence,wil13.xml,12,2,2,MOT,35,198,CHI
2,11,8,123,1.041453875,134,11,no,"('MOT', 'CHI')",Providence,wil13.xml,144,10,2,CHI,2794,563,MOT
0,1,1,14,1.041453875,15,1,see,"('OPE', 'MOT')",Providence,wil13.xml,16,1,0,MOT,120,294,OPE
0,1,1,14,1.041453875,15,1,put,"('OPE', 'MOT')",Providence,wil13.xml,16,1,0,MOT,120,294,OPE
0,2,1,18,0.893817876,20,2,want,"('CHI', 'OPE')",Providence,wil13.xml,21,1,0,OPE,84,219,CHI
0,2,16,126,0.878550404,128,2,yeah,"('MOT', 'CHI')",Providence,wil13.xml,144,16,0,CHI,2794,563,MOT
1,1,2,9,0.875468737,10,1,like,"('MOT', 'OPE')",Providence,wil13.xml,13,3,1,OPE,147,189,MOT
1,1,2,9,0.875468737,10,1,have,"('MOT', 'OPE')",Providence,wil13.xml,13,3,1,OPE,147,189,MOT
0,1,1,11,0.84729786,12,1,we,"('MOT', 'OPE')",Providence,wil13.xml,13,1,0,OPE,147,189,MOT
0,1,1,11,0.84729786,12,1,can,"('MOT', 'OPE')",Providence,wil13.xml,13,1,0,OPE,147,189,MOT
0,1,1,11,0.84729786,12,1,one,"('MOT', 'OPE')",Providence,wil13.xml,13,1,0,OPE,147,189,MOT
0,5,9,130,0.730326184,135,5,want,"('MOT', 'CHI')",Providence,wil13.xml,144,9,0,CHI,2794,563,MOT
0,1,2,13,0.693147181,14,1,want,"('OPE', 'MOT')",Providence,wil13.xml,16,2,0,MOT,120,294,OPE
0,1,2,13,0.693147181,14,1,it,"('OPE', 'MOT')",Providence,wil13.xml,16,2,0,MOT,120,294,OPE
0,2,1,13,0.635988767,15,2,for,"('OPE', 'MOT')",Providence,wil13.xml,16,1,0,MOT,120,294,OPE
0,2,24,118,0.447312218,120,2,that,"('MOT', 'CHI')",Providence,wil13.xml,144,24,0,CHI,2794,563,MOT
0,2,1,10,0.441832752,12,2,oh,"('MOT', 'OPE')",Providence,wil13.xml,13,1,0,OPE,147,189,MOT
0,2,1,10,0.441832752,12,2,want,"('MOT', 'OPE')",Providence,wil13.xml,13,1,0,OPE,147,189,MOT
1,3,34,106,0.405465108,109,3,the,"('MOT', 'CHI')",Providence,wil13.xml,144,35,1,CHI,2794,563,MOT
0,1,3,12,0.405465108,13,1,go,"('OPE', 'MOT')",Providence,wil13.xml,16,3,0,MOT,120,294,OPE
0,3,1,12,0.348306694,15,3,some,"('OPE', 'MOT')",Providence,wil13.xml,16,1,0,MOT,120,294,OPE
0,3,1,12,0.348306694,15,3,that,"('OPE', 'MOT')",Providence,wil13.xml,16,1,0,MOT,120,294,OPE
0,3,1,12,0.348306694,15,3,do,"('OPE', 'MOT')",Providence,wil13.xml,16,1,0,MOT,120,294,OPE
0,3,1,12,0.348306694,15,3,big,"('OPE', 'MOT')",Providence,wil13.xml,16,1,0,MOT,120,294,OPE
0,4,17,123,0.305935513,127,4,this,"('MOT', 'CHI')",Providence,wil13.xml,144,17,0,CHI,2794,563,MOT
0,2,2,12,0.287682072,14,2,with,"('OPE', 'MOT')",Providence,wil13.xml,16,2,0,MOT,120,294,OPE
0,2,2,12,0.287682072,14,2,wanna,"('OPE', 'MOT')",Providence,wil13.xml,16,2,0,MOT,120,294,OPE
0,2,2,12,0.287682072,14,2,he,"('OPE', 'MOT')",Providence,wil13.xml,16,2,0,MOT,120,294,OPE
0,2,2,12,0.287682072,14,2,the,"('OPE', 'MOT')",Providence,wil13.xml,16,2,0,MOT,120,294,OPE
4,6,1,5,0.282566972,11,6,you,"('OPE', 'MOT')",Providence,wil13.xml,16,5,4,MOT,120,294,OPE
0,1,3,9,0.182321557,10,1,some,"('MOT', 'OPE')",Providence,wil13.xml,13,3,0,OPE,147,189,MOT
1,7,23,113,0.159630146,120,7,a,"('MOT', 'CHI')",Providence,wil13.xml,144,24,1,CHI,2794,563,MOT
0,4,1,11,0.125163143,15,4,think,"('OPE', 'MOT')",Providence,wil13.xml,16,1,0,MOT,120,294,OPE
0,2,2,9,0.080042708,11,2,it,"('MOT', 'OPE')",Providence,wil13.xml,13,2,0,OPE,147,189,MOT
0,2,2,9,0.080042708,11,2,to,"('MOT', 'OPE')",Providence,wil13.xml,13,2,0,OPE,147,189,MOT
0,3,3,15,0,18,3,a,"('CHI', 'OPE')",Providence,wil13.xml,21,3,0,OPE,84,219,CHI
0,3,3,15,0,18,3,the,"('CHI', 'OPE')",Providence,wil13.xml,21,3,0,OPE,84,219,CHI
1,3,3,6,-0.087011377,9,3,you,"('MOT', 'OPE')",Providence,wil13.xml,13,4,1,OPE,147,189,MOT
0,3,2,8,-0.207639365,11,3,on,"('MOT', 'OPE')",Providence,wil13.xml,13,2,0,OPE,147,189,MOT
0,3,3,7,-0.510825624,10,3,that,"('MOT', 'OPE')",Providence,wil13.xml,13,3,0,OPE,147,189,MOT
0,1,6,257,2.788092909,258,1,did,"('MOT', 'CHI')",Providence,wil14.xml,264,6,0,CHI,4002,986,MOT
1,0,30,233,2.656225133,233,0,go,"('MOT', 'CHI')",Providence,wil14.xml,264,31,1,CHI,4002,986,MOT
0,1,9,254,2.458033632,255,1,are,"('MOT', 'CHI')",Providence,wil14.xml,264,9,0,CHI,4002,986,MOT
0,2,8,254,2.151762203,256,2,all,"('MOT', 'CHI')",Providence,wil14.xml,264,8,0,CHI,4002,986,MOT
2,3,24,235,1.860752341,238,3,on,"('MOT', 'CHI')",Providence,wil14.xml,264,26,2,CHI,4002,986,MOT
0,1,25,238,1.495812887,239,1,we,"('MOT', 'CHI')",Providence,wil14.xml,264,25,0,CHI,4002,986,MOT
1,0,3,10,1.386294361,10,0,it,"('OPE', 'CHI')",Providence,wil14.xml,14,4,1,CHI,64,44,OPE
0,2,22,240,1.220502106,242,2,want,"('MOT', 'CHI')",Providence,wil14.xml,264,22,0,CHI,4002,986,MOT
0,2,26,236,1.049822124,238,2,wanna,"('MOT', 'CHI')",Providence,wil14.xml,264,26,0,CHI,4002,986,MOT
0,1,1,12,0.916290732,13,1,yeah,"('OPE', 'CHI')",Providence,wil14.xml,14,1,0,CHI,64,44,OPE
0,1,1,12,0.916290732,13,1,a,"('OPE', 'CHI')",Providence,wil14.xml,14,1,0,CHI,64,44,OPE
0,1,1,12,0.916290732,13,1,that,"('OPE', 'CHI')",Providence,wil14.xml,14,1,0,CHI,64,44,OPE
2,4,50,208,0.866166345,212,4,it,"('MOT', 'CHI')",Providence,wil14.xml,264,52,2,CHI,4002,986,MOT
5,35,11,213,0.839329691,248,35,no,"('MOT', 'CHI')",Providence,wil14.xml,264,16,5,CHI,4002,986,MOT
0,2,32,230,0.830348302,232,2,this,"('MOT', 'CHI')",Providence,wil14.xml,264,32,0,CHI,4002,986,MOT
3,6,52,203,0.749191078,209,6,the,"('MOT', 'CHI')",Providence,wil14.xml,264,55,3,CHI,4002,986,MOT
0,2,39,223,0.612765662,225,2,do,"('MOT', 'CHI')",Providence,wil14.xml,264,39,0,CHI,4002,986,MOT
0,5,21,238,0.574004525,243,5,see,"('MOT', 'CHI')",Providence,wil14.xml,264,21,0,CHI,4002,986,MOT
1,10,23,230,0.526093096,240,10,oh,"('MOT', 'CHI')",Providence,wil14.xml,264,24,1,CHI,4002,986,MOT
0,2,1,11,0.510825624,13,2,no,"('OPE', 'CHI')",Providence,wil14.xml,14,1,0,CHI,64,44,OPE
0,5,28,231,0.279313823,236,5,what,"('MOT', 'CHI')",Providence,wil14.xml,264,28,0,CHI,4002,986,MOT
0,1,3,10,0.262364264,11,1,want,"('OPE', 'CHI')",Providence,wil14.xml,14,3,0,CHI,64,44,OPE
0,5,30,229,0.206336433,234,5,is,"('MOT', 'CHI')",Providence,wil14.xml,264,30,0,CHI,4002,986,MOT
0,4,49,211,-0.161366192,215,4,that,"('MOT', 'CHI')",Providence,wil14.xml,264,49,0,CHI,4002,986,MOT
0,6,38,220,-0.205443974,226,6,a,"('MOT', 'CHI')",Providence,wil14.xml,264,38,0,CHI,4002,986,MOT
1,18,32,213,-0.355601407,231,18,yeah,"('MOT', 'CHI')",Providence,wil14.xml,264,33,1,CHI,4002,986,MOT
0,2,91,171,-0.466425808,173,2,you,"('MOT', 'CHI')",Providence,wil14.xml,264,91,0,CHI,4002,986,MOT
1,4,1,209,3.068052935,213,4,put,"('CHI', 'MOT')",Providence,wil15.xml,215,2,1,MOT,715,3070,CHI
1,6,0,208,3.023903151,214,6,up,"('CHI', 'MOT')",Providence,wil15.xml,215,1,1,MOT,715,3070,CHI
2,8,0,205,2.885731378,213,8,go,"('CHI', 'MOT')",Providence,wil15.xml,215,2,2,MOT,715,3070,CHI
2,9,0,204,2.780370863,213,9,some,"('CHI', 'MOT')",Providence,wil15.xml,215,2,2,MOT,715,3070,CHI
2,9,0,204,2.780370863,213,9,one,"('CHI', 'MOT')",Providence,wil15.xml,215,2,2,MOT,715,3070,CHI
0,1,1,88,2.719100037,89,1,my,"('MOT', 'CHI')",Providence,wil15.xml,90,1,0,CHI,1462,263,MOT
1,12,0,202,2.404863942,214,12,get,"('CHI', 'MOT')",Providence,wil15.xml,215,1,1,MOT,715,3070,CHI
0,6,1,208,2.33075597,214,6,and,"('CHI', 'MOT')",Providence,wil15.xml,215,1,0,MOT,715,3070,CHI
2,10,2,201,2.270249712,211,10,want,"('CHI', 'MOT')",Providence,wil15.xml,215,4,2,MOT,715,3070,CHI
7,7,16,185,2.048982334,192,7,no,"('CHI', 'MOT')",Providence,wil15.xml,215,23,7,MOT,715,3070,CHI
0,1,4,85,1.992430165,86,1,see,"('MOT', 'CHI')",Providence,wil15.xml,90,4,0,CHI,1462,263,MOT
0,1,6,83,1.681758574,84,1,yeah,"('MOT', 'CHI')",Providence,wil15.xml,90,6,0,CHI,1462,263,MOT
0,14,1,200,1.568615918,214,14,see,"('CHI', 'MOT')",Providence,wil15.xml,215,1,0,MOT,715,3070,CHI
1,1,0,11,1.540445041,12,1,look,"('OPE', 'MOT')",Providence,wil15.xml,13,1,1,MOT,76,253,OPE
3,25,2,185,1.538873949,210,25,it,"('CHI', 'MOT')",Providence,wil15.xml,215,5,3,MOT,715,3070,CHI
0,6,5,204,1.464765977,210,6,look,"('CHI', 'MOT')",Providence,wil15.xml,215,5,0,MOT,715,3070,CHI
3,21,5,186,1.335001067,207,21,yeah,"('CHI', 'MOT')",Providence,wil15.xml,215,8,3,MOT,715,3070,CHI
0,1,9,80,1.327798154,81,1,go,"('MOT', 'CHI')",Providence,wil15.xml,90,9,0,CHI,1462,263,MOT
0,1,9,80,1.327798154,81,1,it,"('MOT', 'CHI')",Providence,wil15.xml,90,9,0,CHI,1462,263,MOT
0,11,3,201,1.271631453,212,11,oh,"('CHI', 'MOT')",Providence,wil15.xml,215,3,0,MOT,715,3070,CHI
2,2,0,9,1.178654996,11,2,it,"('OPE', 'MOT')",Providence,wil15.xml,13,2,2,MOT,76,253,OPE
0,1,11,78,1.136352617,79,1,a,"('MOT', 'CHI')",Providence,wil15.xml,90,11,0,CHI,1462,263,MOT
3,30,4,178,1.10219011,208,30,a,"('CHI', 'MOT')",Providence,wil15.xml,215,7,3,MOT,715,3070,CHI
1,4,9,76,1.005521866,80,4,oh,"('MOT', 'CHI')",Providence,wil15.xml,90,10,1,CHI,1462,263,MOT
1,0,0,2,0.980829253,2,0,a,"('MOT', 'OPE')",Providence,wil15.xml,3,1,1,OPE,14,24,MOT
0,26,1,188,0.980829253,214,26,do,"('CHI', 'MOT')",Providence,wil15.xml,215,1,0,MOT,715,3070,CHI
1,2,1,9,0.773189888,11,2,for,"('OPE', 'MOT')",Providence,wil15.xml,13,2,1,MOT,76,253,OPE
0,1,18,71,0.615185639,72,1,the,"('MOT', 'CHI')",Providence,wil15.xml,90,18,0,CHI,1462,263,MOT
1,3,1,8,0.485507816,11,3,yeah,"('OPE', 'MOT')",Providence,wil15.xml,13,2,1,MOT,76,253,OPE
0,2,1,10,0.441832752,12,2,what,"('OPE', 'MOT')",Providence,wil15.xml,13,1,0,MOT,76,253,OPE
0,2,1,10,0.441832752,12,2,that,"('OPE', 'MOT')",Providence,wil15.xml,13,1,0,MOT,76,253,OPE
1,5,0,7,0.441832752,12,5,you,"('OPE', 'MOT')",Providence,wil15.xml,13,1,1,MOT,76,253,OPE
6,36,5,43,0.164492034,79,36,no,"('MOT', 'CHI')",Providence,wil15.xml,90,11,6,CHI,1462,263,MOT
0,3,1,9,0.15415068,12,3,a,"('OPE', 'MOT')",Providence,wil15.xml,13,1,0,MOT,76,253,OPE
0,3,1,9,0.15415068,12,3,the,"('OPE', 'MOT')",Providence,wil15.xml,13,1,0,MOT,76,253,OPE
0,68,1,146,0.042559614,214,68,you,"('CHI', 'MOT')",Providence,wil15.xml,215,1,0,MOT,715,3070,CHI
1,1,1,0,-0.287682072,1,1,this,"('MOT', 'OPE')",Providence,wil15.xml,3,2,1,OPE,14,24,MOT
1,0,4,205,4.079955825,205,0,look,"('MOT', 'CHI')",Providence,wil16.xml,210,5,1,CHI,2315,922,MOT
1,2,0,207,3.847780737,209,2,and,"('MOT', 'CHI')",Providence,wil16.xml,210,1,1,CHI,2315,922,MOT
0,1,2,207,3.267665989,208,1,at,"('MOT', 'CHI')",Providence,wil16.xml,210,2,0,CHI,2315,922,MOT
0,1,3,206,3.039749159,207,1,where,"('MOT', 'CHI')",Providence,wil16.xml,210,3,0,CHI,2315,922,MOT
0,1,4,205,2.85263143,206,1,not,"('MOT', 'CHI')",Providence,wil16.xml,210,4,0,CHI,2315,922,MOT
1,1,1,65,2.833213344,66,1,oh,"('CHI', 'MOT')",Providence,wil16.xml,68,2,1,MOT,201,1100,CHI
3,3,7,197,2.823361048,200,3,see,"('MOT', 'CHI')",Providence,wil16.xml,210,10,3,CHI,2315,922,MOT
1,0,26,183,2.546207176,183,0,what,"('MOT', 'CHI')",Providence,wil16.xml,210,27,1,CHI,2315,922,MOT
4,2,3,59,2.456735773,61,2,no,"('CHI', 'MOT')",Providence,wil16.xml,68,7,4,MOT,201,1100,CHI
1,0,32,177,2.325184925,177,0,that,"('MOT', 'CHI')",Providence,wil16.xml,210,33,1,CHI,2315,922,MOT
0,1,9,200,2.222163526,201,1,get,"('MOT', 'CHI')",Providence,wil16.xml,210,9,0,CHI,2315,922,MOT
0,2,7,201,2.027173113,203,2,we,"('MOT', 'CHI')",Providence,wil16.xml,210,7,0,CHI,2315,922,MOT
0,3,6,201,1.862140266,204,3,my,"('MOT', 'CHI')",Providence,wil16.xml,210,6,0,CHI,2315,922,MOT
0,2,10,198,1.724748759,200,2,all,"('MOT', 'CHI')",Providence,wil16.xml,210,10,0,CHI,2315,922,MOT
1,2,20,187,1.711314104,189,2,this,"('MOT', 'CHI')",Providence,wil16.xml,210,21,1,CHI,2315,922,MOT
2,16,5,187,1.391184346,203,16,no,"('MOT', 'CHI')",Providence,wil16.xml,210,7,2,CHI,2315,922,MOT
0,4,10,196,1.213923135,200,4,go,"('MOT', 'CHI')",Providence,wil16.xml,210,10,0,CHI,2315,922,MOT
0,6,1,61,1.189584067,67,6,go,"('CHI', 'MOT')",Providence,wil16.xml,68,1,0,MOT,201,1100,CHI
0,6,1,61,1.189584067,67,6,is,"('CHI', 'MOT')",Providence,wil16.xml,68,1,0,MOT,201,1100,CHI
4,7,29,170,1.162034115,177,7,it,"('MOT', 'CHI')",Providence,wil16.xml,210,33,4,CHI,2315,922,MOT
0,1,27,182,1.159912815,183,1,the,"('MOT', 'CHI')",Providence,wil16.xml,210,27,0,CHI,2315,922,MOT
3,11,2,52,1.129864832,63,11,it,"('CHI', 'MOT')",Providence,wil16.xml,68,5,3,MOT,201,1100,CHI
1,5,18,186,1.119555463,191,5,want,"('MOT', 'CHI')",Providence,wil16.xml,210,19,1,CHI,2315,922,MOT
1,0,0,2,0.980829253,2,0,he,"('FAT', 'MOT')",Providence,wil16.xml,3,1,1,MOT,18,60,FAT
1,0,0,2,0.980829253,2,0,the,"('FAT', 'MOT')",Providence,wil16.xml,3,1,1,MOT,18,60,FAT
0,8,1,59,0.938269639,67,8,this,"('CHI', 'MOT')",Providence,wil16.xml,68,1,0,MOT,201,1100,CHI
2,0,0,1,0.810930216,1,0,have,"('FAT', 'MOT')",Providence,wil16.xml,3,2,2,MOT,18,60,FAT
2,0,0,1,0.810930216,1,0,a,"('FAT', 'MOT')",Providence,wil16.xml,3,2,2,MOT,18,60,FAT
1,4,32,173,0.715747012,177,4,a,"('MOT', 'CHI')",Providence,wil16.xml,210,33,1,CHI,2315,922,MOT
1,0,0,1,0.693147181,1,0,have,"('MOT', 'FAT')",Providence,wil16.xml,2,1,1,FAT,13,8,MOT
1,0,0,1,0.693147181,1,0,a,"('MOT', 'FAT')",Providence,wil16.xml,2,1,1,FAT,13,8,MOT
1,0,2,3,0.693147181,3,0,a,"('FAT', 'CHI')",Providence,wil16.xml,6,3,1,CHI,40,26,FAT
0,7,11,192,0.658914009,199,7,oh,"('MOT', 'CHI')",Providence,wil16.xml,210,11,0,CHI,2315,922,MOT
0,11,1,56,0.650587566,67,11,do,"('CHI', 'MOT')",Providence,wil16.xml,68,1,0,MOT,201,1100,CHI
0,12,1,55,0.570544858,67,12,to,"('CHI', 'MOT')",Providence,wil16.xml,68,1,0,MOT,201,1100,CHI
0,3,28,179,0.427444015,182,3,is,"('MOT', 'CHI')",Providence,wil16.xml,210,28,0,CHI,2315,922,MOT
2,11,9,46,0.126293725,57,11,yeah,"('CHI', 'MOT')",Providence,wil16.xml,68,11,2,MOT,201,1100,CHI
1,14,21,174,0.054067221,188,14,yeah,"('MOT', 'CHI')",Providence,wil16.xml,210,22,1,CHI,2315,922,MOT
0,1,74,135,-0.096626836,136,1,you,"('MOT', 'CHI')",Providence,wil16.xml,210,74,0,CHI,2315,922,MOT
0,1,1,1,-0.405465108,2,1,oh,"('OPE', 'MOT')",Providence,wil16.xml,3,1,0,MOT,11,65,OPE
0,2,1,0,-0.810930216,2,2,it,"('OPE', 'MOT')",Providence,wil16.xml,3,1,0,MOT,11,65,OPE
2,0,9,75,2.877468353,75,0,on,"('MOT', 'CHI')",Providence,wil17.xml,86,11,2,CHI,1639,370,MOT
2,1,4,79,2.732742814,80,1,look,"('MOT', 'CHI')",Providence,wil17.xml,86,6,2,CHI,1639,370,MOT
0,1,3,82,2.140066163,83,1,all,"('MOT', 'CHI')",Providence,wil17.xml,86,3,0,CHI,1639,370,MOT
1,0,15,70,2.079441542,70,0,it,"('MOT', 'CHI')",Providence,wil17.xml,86,16,1,CHI,1639,370,MOT
1,0,15,70,2.079441542,70,0,is,"('MOT', 'CHI')",Providence,wil17.xml,86,16,1,CHI,1639,370,MOT
1,1,10,74,1.778856064,75,1,a,"('MOT', 'CHI')",Providence,wil17.xml,86,11,1,CHI,1639,370,MOT
0,4,1,81,1.757857918,85,4,my,"('MOT', 'CHI')",Providence,wil17.xml,86,1,0,CHI,1639,370,MOT
0,1,6,79,1.634130525,80,1,there,"('MOT', 'CHI')",Providence,wil17.xml,86,6,0,CHI,1639,370,MOT
0,1,8,77,1.386294361,78,1,of,"('MOT', 'CHI')",Providence,wil17.xml,86,8,0,CHI,1639,370,MOT
1,4,6,75,1.280933845,79,4,no,"('MOT', 'CHI')",Providence,wil17.xml,86,7,1,CHI,1639,370,MOT
2,1,24,59,1.200394983,60,1,the,"('MOT', 'CHI')",Providence,wil17.xml,86,26,2,CHI,1639,370,MOT
0,2,10,74,0.773189888,76,2,see,"('MOT', 'CHI')",Providence,wil17.xml,86,10,0,CHI,1639,370,MOT
0,1,18,67,0.559615788,68,1,what,"('MOT', 'CHI')",Providence,wil17.xml,86,18,0,CHI,1639,370,MOT
0,1,20,65,0.435318071,66,1,this,"('MOT', 'CHI')",Providence,wil17.xml,86,20,0,CHI,1639,370,MOT
0,5,7,74,0.405465108,79,5,oh,"('MOT', 'CHI')",Providence,wil17.xml,86,7,0,CHI,1639,370,MOT
0,6,12,68,-0.254234138,74,6,yeah,"('MOT', 'CHI')",Providence,wil17.xml,86,12,0,CHI,1639,370,MOT
1,0,6,393,4.474808368,393,0,are,"('MOT', 'CHI')",Providence,wil18.xml,400,7,1,CHI,4440,1638,MOT
0,1,2,397,3.912023005,398,1,and,"('MOT', 'CHI')",Providence,wil18.xml,400,2,0,CHI,4440,1638,MOT
2,4,5,389,3.270835564,393,4,all,"('MOT', 'CHI')",Providence,wil18.xml,400,7,2,CHI,4440,1638,MOT
2,2,13,383,3.125211349,385,2,one,"('MOT', 'CHI')",Providence,wil18.xml,400,15,2,CHI,4440,1638,MOT
1,0,30,369,3.112841682,369,0,we,"('MOT', 'CHI')",Providence,wil18.xml,400,31,1,CHI,4440,1638,MOT
0,2,4,394,3.096080247,396,2,my,"('MOT', 'CHI')",Providence,wil18.xml,400,4,0,CHI,4440,1638,MOT
1,2,10,387,2.998293094,389,2,he,"('MOT', 'CHI')",Providence,wil18.xml,400,11,1,CHI,4440,1638,MOT
1,2,11,386,2.921624301,388,2,where,"('MOT', 'CHI')",Providence,wil18.xml,400,12,1,CHI,4440,1638,MOT
0,1,12,387,2.633942229,388,1,look,"('MOT', 'CHI')",Providence,wil18.xml,400,12,0,CHI,4440,1638,MOT
1,1,32,366,2.355448583,367,1,do,"('MOT', 'CHI')",Providence,wil18.xml,400,33,1,CHI,4440,1638,MOT
0,1,17,382,2.315657175,383,1,like,"('MOT', 'CHI')",Providence,wil18.xml,400,17,0,CHI,4440,1638,MOT
0,1,19,380,2.210365371,381,1,did,"('MOT', 'CHI')",Providence,wil18.xml,400,19,0,CHI,4440,1638,MOT
0,2,13,385,2.156916854,387,2,there,"('MOT', 'CHI')",Providence,wil18.xml,400,13,0,CHI,4440,1638,MOT
0,1,26,373,1.904237453,374,1,want,"('MOT', 'CHI')",Providence,wil18.xml,400,26,0,CHI,4440,1638,MOT
3,5,35,357,1.802809305,362,5,go,"('MOT', 'CHI')",Providence,wil18.xml,400,38,3,CHI,4440,1638,MOT
0,2,23,375,1.620048092,377,2,in,"('MOT', 'CHI')",Providence,wil18.xml,400,23,0,CHI,4440,1638,MOT
0,1,39,360,1.487683587,361,1,what,"('MOT', 'CHI')",Providence,wil18.xml,400,39,0,CHI,4440,1638,MOT
11,22,53,314,0.982803587,336,22,a,"('MOT', 'CHI')",Providence,wil18.xml,400,64,11,CHI,4440,1638,MOT
0,6,23,371,0.772750231,377,6,see,"('MOT', 'CHI')",Providence,wil18.xml,400,23,0,CHI,4440,1638,MOT
10,20,67,303,0.767750165,323,20,it,"('MOT', 'CHI')",Providence,wil18.xml,400,77,10,CHI,4440,1638,MOT
0,2,57,341,0.667394684,343,2,that,"('MOT', 'CHI')",Providence,wil18.xml,400,57,0,CHI,4440,1638,MOT
2,32,16,350,0.557015006,382,32,no,"('MOT', 'CHI')",Providence,wil18.xml,400,18,2,CHI,4440,1638,MOT
2,12,57,329,0.260519514,341,12,this,"('MOT', 'CHI')",Providence,wil18.xml,400,59,2,CHI,4440,1638,MOT
0,5,46,349,0.211970251,354,5,is,"('MOT', 'CHI')",Providence,wil18.xml,400,46,0,CHI,4440,1638,MOT
0,18,18,364,0.0104713,382,18,make,"('MOT', 'CHI')",Providence,wil18.xml,400,18,0,CHI,4440,1638,MOT
1,4,121,274,-0.101782694,278,4,you,"('MOT', 'CHI')",Providence,wil18.xml,400,122,1,CHI,4440,1638,MOT
1,26,31,342,-0.215547204,368,26,oh,"('MOT', 'CHI')",Providence,wil18.xml,400,32,1,CHI,4440,1638,MOT
0,2,1,3,-0.251314428,5,2,yeah,"('OPE', 'CHI')",Providence,wil18.xml,6,1,0,CHI,31,38,OPE
0,8,52,340,-0.328275469,348,8,the,"('MOT', 'CHI')",Providence,wil18.xml,400,52,0,CHI,4440,1638,MOT
1,42,28,329,-0.58046172,371,42,yeah,"('MOT', 'CHI')",Providence,wil18.xml,400,29,1,CHI,4440,1638,MOT
2,0,3,123,3.981015877,123,0,one,"('MOT', 'CHI')",Providence,wil19.xml,128,5,2,CHI,1576,632,MOT
1,0,7,120,3.194583132,120,0,not,"('MOT', 'CHI')",Providence,wil19.xml,128,8,1,CHI,1576,632,MOT
0,1,1,126,3.068052935,127,1,my,"('MOT', 'CHI')",Providence,wil19.xml,128,1,0,CHI,1576,632,MOT
1,4,0,138,2.954910279,142,4,did,"('CHI', 'MOT')",Providence,wil19.xml,143,1,1,MOT,574,2469,CHI
1,0,12,115,2.747270914,115,0,are,"('MOT', 'CHI')",Providence,wil19.xml,128,13,1,CHI,1576,632,MOT
1,1,8,118,2.397895273,119,1,where,"('MOT', 'CHI')",Providence,wil19.xml,128,9,1,CHI,1576,632,MOT
6,4,9,124,2.370793343,128,4,see,"('CHI', 'MOT')",Providence,wil19.xml,143,15,6,MOT,574,2469,CHI
1,2,5,120,2.335374916,122,2,want,"('MOT', 'CHI')",Providence,wil19.xml,128,6,1,CHI,1576,632,MOT
0,4,1,138,2.261763098,142,4,all,"('CHI', 'MOT')",Providence,wil19.xml,143,1,0,MOT,574,2469,CHI
0,4,1,138,2.261763098,142,4,one,"('CHI', 'MOT')",Providence,wil19.xml,143,1,0,MOT,574,2469,CHI
4,7,3,129,2.260025479,136,7,no,"('CHI', 'MOT')",Providence,wil19.xml,143,7,4,MOT,574,2469,CHI
3,1,18,106,2.249000847,107,1,is,"('MOT', 'CHI')",Providence,wil19.xml,128,21,3,CHI,1576,632,MOT
4,6,6,127,2.083895892,133,6,make,"('CHI', 'MOT')",Providence,wil19.xml,143,10,4,MOT,574,2469,CHI
1,12,0,130,1.999398834,142,12,is,"('CHI', 'MOT')",Providence,wil19.xml,143,1,1,MOT,574,2469,CHI
1,9,1,132,1.967112357,141,9,look,"('CHI', 'MOT')",Providence,wil19.xml,143,2,1,MOT,574,2469,CHI
0,2,4,122,1.945910149,124,2,did,"('MOT', 'CHI')",Providence,wil19.xml,128,4,0,CHI,1576,632,MOT
0,6,1,136,1.925290862,142,6,at,"('CHI', 'MOT')",Providence,wil19.xml,143,1,0,MOT,574,2469,CHI
2,12,1,128,1.880052076,140,12,go,"('CHI', 'MOT')",Providence,wil19.xml,143,3,2,MOT,574,2469,CHI
0,3,3,122,1.848454813,125,3,see,"('MOT', 'CHI')",Providence,wil19.xml,128,3,0,CHI,1576,632,MOT
0,3,3,122,1.848454813,125,3,all,"('MOT', 'CHI')",Providence,wil19.xml,128,3,0,CHI,1576,632,MOT
0,1,8,119,1.808288771,120,1,this,"('MOT', 'CHI')",Providence,wil19.xml,128,8,0,CHI,1576,632,MOT
1,0,1,10,1.791759469,10,0,no,"('OPE', 'CHI')",Providence,wil19.xml,12,2,1,CHI,81,65,OPE
1,0,1,10,1.791759469,10,0,there,"('OPE', 'MOT')",Providence,wil19.xml,12,2,1,MOT,42,108,OPE
0,1,9,118,1.704748092,119,1,go,"('MOT', 'CHI')",Providence,wil19.xml,128,9,0,CHI,1576,632,MOT
0,1,9,118,1.704748092,119,1,a,"('MOT', 'CHI')",Providence,wil19.xml,128,9,0,CHI,1576,632,MOT
0,1,9,118,1.704748092,119,1,wanna,"('MOT', 'CHI')",Providence,wil19.xml,128,9,0,CHI,1576,632,MOT
0,1,9,118,1.704748092,119,1,on,"('MOT', 'CHI')",Providence,wil19.xml,128,9,0,CHI,1576,632,MOT
1,2,14,111,1.506253676,113,2,do,"('MOT', 'CHI')",Providence,wil19.xml,128,15,1,CHI,1576,632,MOT
1,16,1,125,1.436484106,141,16,what,"('CHI', 'MOT')",Providence,wil19.xml,143,2,1,MOT,574,2469,CHI
1,20,1,121,1.225175012,141,20,oh,"('CHI', 'MOT')",Providence,wil19.xml,143,2,1,MOT,574,2469,CHI
3,18,4,118,1.17188449,136,18,it,"('CHI', 'MOT')",Providence,wil19.xml,143,7,3,MOT,574,2469,CHI
2,5,14,107,1.15267951,112,5,it,"('MOT', 'CHI')",Providence,wil19.xml,128,16,2,CHI,1576,632,MOT
0,1,16,111,1.15267951,112,1,the,"('MOT', 'CHI')",Providence,wil19.xml,128,16,0,CHI,1576,632,MOT
0,4,6,118,1.131402111,122,4,no,"('MOT', 'CHI')",Providence,wil19.xml,128,6,0,CHI,1576,632,MOT
1,5,10,112,1.115561847,117,5,what,"('MOT', 'CHI')",Providence,wil19.xml,128,11,1,CHI,1576,632,MOT
2,2,0,8,1.098612289,10,2,you,"('OPE', 'MOT')",Providence,wil19.xml,12,2,2,MOT,42,108,OPE
1,1,1,9,1.098612289,10,1,go,"('OPE', 'MOT')",Providence,wil19.xml,12,2,1,MOT,42,108,OPE
0,11,2,130,1.091643619,141,11,want,"('CHI', 'MOT')",Providence,wil19.xml,143,2,0,MOT,574,2469,CHI
0,4,7,117,1.005521866,121,4,oh,"('MOT', 'CHI')",Providence,wil19.xml,128,7,0,CHI,1576,632,MOT
1,2,0,7,0.893817876,9,2,no,"('CHI', 'OPE')",Providence,wil19.xml,10,1,1,OPE,43,53,CHI
0,1,1,10,0.773189888,11,1,yeah,"('OPE', 'CHI')",Providence,wil19.xml,12,1,0,CHI,81,65,OPE
0,23,1,119,0.693147181,142,23,do,"('CHI', 'MOT')",Providence,wil19.xml,143,1,0,MOT,574,2469,CHI
0,24,1,118,0.652325186,142,24,wanna,"('CHI', 'MOT')",Providence,wil19.xml,143,1,0,MOT,574,2469,CHI
1,4,20,103,0.639562934,107,4,that,"('MOT', 'CHI')",Providence,wil19.xml,128,21,1,CHI,1576,632,MOT
1,1,48,78,0.462623522,79,1,you,"('MOT', 'CHI')",Providence,wil19.xml,128,49,1,CHI,1576,632,MOT
0,6,9,113,0.451985124,119,6,yeah,"('MOT', 'CHI')",Providence,wil19.xml,128,9,0,CHI,1576,632,MOT
0,2,1,9,0.36772478,11,2,no,"('OPE', 'MOT')",Providence,wil19.xml,12,1,0,MOT,42,108,OPE
0,1,1,5,0.287682072,6,1,you,"('MOT', 'OPE')",Providence,wil19.xml,7,1,0,OPE,48,33,MOT
0,1,1,5,0.287682072,6,1,a,"('MOT', 'OPE')",Providence,wil19.xml,7,1,0,OPE,48,33,MOT
0,1,1,5,0.287682072,6,1,see,"('MOT', 'OPE')",Providence,wil19.xml,7,1,0,OPE,48,33,MOT
0,1,1,5,0.287682072,6,1,is,"('MOT', 'OPE')",Providence,wil19.xml,7,1,0,OPE,48,33,MOT
0,1,1,5,0.287682072,6,1,on,"('MOT', 'OPE')",Providence,wil19.xml,7,1,0,OPE,48,33,MOT
4,37,8,94,0.223143551,131,37,a,"('CHI', 'MOT')",Providence,wil19.xml,143,12,4,MOT,574,2469,CHI
0,1,2,7,0.223143551,8,1,it,"('CHI', 'OPE')",Providence,wil19.xml,10,2,0,OPE,43,53,CHI
0,19,4,120,0.161268148,139,19,this,"('CHI', 'MOT')",Providence,wil19.xml,143,4,0,MOT,574,2469,CHI
0,2,2,6,-0.182321557,8,2,what,"('CHI', 'OPE')",Providence,wil19.xml,10,2,0,OPE,43,53,CHI
0,30,4,109,-0.276986783,139,30,the,"('CHI', 'MOT')",Providence,wil19.xml,143,4,0,MOT,574,2469,CHI
0,14,13,116,-0.53329848,130,14,yeah,"('CHI', 'MOT')",Providence,wil19.xml,143,13,0,MOT,574,2469,CHI
0,1,1,0,-0.693147181,1,1,that,"('MOT', 'FAT')",Providence,wil19.xml,2,1,0,FAT,82,7,MOT
2,1,0,244,4.528559084,245,1,up,"('CHI', 'MOT')",Providence,wil20.xml,247,2,2,MOT,830,2504,CHI
1,3,0,243,3.721669277,246,3,all,"('CHI', 'MOT')",Providence,wil20.xml,247,1,1,MOT,830,2504,CHI
1,5,0,241,3.316204169,246,5,some,"('CHI', 'MOT')",Providence,wil20.xml,247,1,1,MOT,830,2504,CHI
1,7,0,239,3.028522096,246,7,make,"('CHI', 'MOT')",Providence,wil20.xml,247,1,1,MOT,830,2504,CHI
1,8,0,238,2.910739061,246,8,little,"('CHI', 'MOT')",Providence,wil20.xml,247,1,1,MOT,830,2504,CHI
2,10,0,235,2.823810991,245,10,put,"('CHI', 'MOT')",Providence,wil20.xml,247,2,2,MOT,830,2504,CHI
2,14,0,231,2.513656063,245,14,want,"('CHI', 'MOT')",Providence,wil20.xml,247,2,2,MOT,830,2504,CHI
1,0,9,63,2.382627801,63,0,it,"('MOT', 'CHI')",Providence,wil20.xml,73,10,1,CHI,710,202,MOT
0,8,1,238,2.21759188,246,8,did,"('CHI', 'MOT')",Providence,wil20.xml,247,1,0,MOT,830,2504,CHI
0,4,4,239,2.100060829,243,4,my,"('CHI', 'MOT')",Providence,wil20.xml,247,4,0,MOT,830,2504,CHI
1,1,6,65,2.022283128,66,1,the,"('MOT', 'CHI')",Providence,wil20.xml,73,7,1,CHI,710,202,MOT
5,6,21,215,1.920816581,221,6,no,"('CHI', 'MOT')",Providence,wil20.xml,247,26,5,MOT,830,2504,CHI
0,9,2,236,1.820508883,245,9,where,"('CHI', 'MOT')",Providence,wil20.xml,247,2,0,MOT,830,2504,CHI
1,1,0,12,1.609437912,13,1,yeah,"('CHI', 'OPE')",Providence,wil20.xml,14,1,1,OPE,35,63,CHI
0,12,2,233,1.558144618,245,12,oh,"('CHI', 'MOT')",Providence,wil20.xml,247,2,0,MOT,830,2504,CHI
1,0,0,5,1.540445041,5,0,with,"('OPE', 'MOT')",Providence,wil20.xml,6,1,1,MOT,22,109,OPE
3,39,1,204,1.406913648,243,39,a,"('CHI', 'MOT')",Providence,wil20.xml,247,4,3,MOT,830,2504,CHI
1,30,1,215,1.382253952,245,30,is,"('CHI', 'MOT')",Providence,wil20.xml,247,2,1,MOT,830,2504,CHI
0,20,1,226,1.37029402,246,20,do,"('CHI', 'MOT')",Providence,wil20.xml,247,1,0,MOT,830,2504,CHI
1,20,3,223,1.358123484,243,20,what,"('CHI', 'MOT')",Providence,wil20.xml,247,4,1,MOT,830,2504,CHI
0,16,2,229,1.289880631,245,16,like,"('CHI', 'MOT')",Providence,wil20.xml,247,2,0,MOT,830,2504,CHI
0,18,2,227,1.178654996,245,18,wanna,"('CHI', 'MOT')",Providence,wil20.xml,247,2,0,MOT,830,2504,CHI
1,32,2,212,1.092533243,244,32,it,"('CHI', 'MOT')",Providence,wil20.xml,247,3,1,MOT,830,2504,CHI
1,9,2,61,1.057790294,70,9,no,"('MOT', 'CHI')",Providence,wil20.xml,73,3,1,CHI,710,202,MOT
2,16,11,218,1.021180549,234,16,yeah,"('CHI', 'MOT')",Providence,wil20.xml,247,13,2,MOT,830,2504,CHI
1,31,3,212,0.936910019,243,31,the,"('CHI', 'MOT')",Providence,wil20.xml,247,4,1,MOT,830,2504,CHI
0,2,7,64,0.923670839,66,2,oh,"('MOT', 'CHI')",Providence,wil20.xml,73,7,0,CHI,710,202,MOT
0,1,1,12,0.916290732,13,1,no,"('CHI', 'OPE')",Providence,wil20.xml,14,1,0,OPE,35,63,CHI
1,1,0,4,0.84729786,5,1,to,"('OPE', 'MOT')",Providence,wil20.xml,6,1,1,MOT,22,109,OPE
0,27,2,218,0.790889465,245,27,on,"('CHI', 'MOT')",Providence,wil20.xml,247,2,0,MOT,830,2504,CHI
0,21,4,222,0.618456288,243,21,this,"('CHI', 'MOT')",Providence,wil20.xml,247,4,0,MOT,830,2504,CHI
0,3,1,10,0.223143551,13,3,go,"('CHI', 'OPE')",Providence,wil20.xml,14,1,0,OPE,35,63,CHI
0,1,1,2,-0.182321557,3,1,oh,"('MOT', 'OPE')",Providence,wil20.xml,4,1,0,OPE,22,14,MOT
0,2,1,3,-0.251314428,5,2,you,"('OPE', 'MOT')",Providence,wil20.xml,6,1,0,MOT,22,109,OPE
3,0,2,241,4.933445655,241,0,all,"('CHI', 'MOT')",Providence,wil21.xml,246,5,3,MOT,1001,2267,CHI
2,0,4,150,4.043051268,150,0,not,"('MOT', 'CHI')",Providence,wil21.xml,156,6,2,CHI,1454,553,MOT
2,1,4,239,3.814961293,240,1,see,"('CHI', 'MOT')",Providence,wil21.xml,246,6,2,MOT,1001,2267,CHI
1,3,0,242,3.717628867,245,3,there,"('CHI', 'MOT')",Providence,wil21.xml,246,1,1,MOT,1001,2267,CHI
1,3,0,242,3.717628867,245,3,my,"('CHI', 'MOT')",Providence,wil21.xml,246,1,1,MOT,1001,2267,CHI
1,7,0,238,3.024481687,245,7,with,"('CHI', 'MOT')",Providence,wil21.xml,246,1,1,MOT,1001,2267,CHI
0,1,2,153,2.970414466,154,1,one,"('MOT', 'CHI')",Providence,wil21.xml,156,2,0,CHI,1454,553,MOT
1,2,4,149,2.679062664,151,2,get,"('MOT', 'CHI')",Providence,wil21.xml,156,5,1,CHI,1454,553,MOT
2,12,0,232,2.652700106,244,12,did,"('CHI', 'MOT')",Providence,wil21.xml,246,2,2,MOT,1001,2267,CHI
1,5,3,237,2.606796467,242,5,up,"('CHI', 'MOT')",Providence,wil21.xml,246,4,1,MOT,1001,2267,CHI
0,1,4,151,2.552045953,152,1,want,"('MOT', 'CHI')",Providence,wil21.xml,156,4,0,CHI,1454,553,MOT
3,15,0,228,2.505525937,243,15,this,"('CHI', 'MOT')",Providence,wil21.xml,246,3,3,MOT,1001,2267,CHI
0,2,3,151,2.335374916,153,2,up,"('MOT', 'CHI')",Providence,wil21.xml,156,3,0,CHI,1454,553,MOT
2,11,2,231,2.319114395,242,11,one,"('CHI', 'MOT')",Providence,wil21.xml,246,4,2,MOT,1001,2267,CHI
1,9,2,234,2.282382386,243,9,in,"('CHI', 'MOT')",Providence,wil21.xml,246,3,1,MOT,1001,2267,CHI
0,1,6,149,2.251291799,150,1,a,"('MOT', 'CHI')",Providence,wil21.xml,156,6,0,CHI,1454,553,MOT
0,5,1,150,2.165874047,155,5,my,"('MOT', 'CHI')",Providence,wil21.xml,156,1,0,CHI,1454,553,MOT
1,11,2,232,2.100060829,243,11,and,"('CHI', 'MOT')",Providence,wil21.xml,246,3,1,MOT,1001,2267,CHI
1,12,2,231,2.020018121,243,12,gonna,"('CHI', 'MOT')",Providence,wil21.xml,246,3,1,MOT,1001,2267,CHI
1,0,0,9,1.992430165,9,0,it,"('CHI', 'OPE')",Providence,wil21.xml,10,1,1,OPE,67,60,CHI
0,2,5,149,1.985915484,151,2,like,"('MOT', 'CHI')",Providence,wil21.xml,156,5,0,CHI,1454,553,MOT
0,11,1,234,1.925869398,245,11,want,"('CHI', 'MOT')",Providence,wil21.xml,246,1,0,MOT,1001,2267,CHI
0,2,6,148,1.84582669,150,2,did,"('MOT', 'CHI')",Providence,wil21.xml,156,6,0,CHI,1454,553,MOT
3,5,20,218,1.791759469,223,5,no,"('CHI', 'MOT')",Providence,wil21.xml,246,23,3,MOT,1001,2267,CHI
13,27,5,201,1.749199855,228,27,it,"('CHI', 'MOT')",Providence,wil21.xml,246,18,13,MOT,1001,2267,CHI
0,14,1,231,1.702725847,245,14,a,"('CHI', 'MOT')",Providence,wil21.xml,246,1,0,MOT,1001,2267,CHI
2,16,4,224,1.674895129,240,16,do,"('CHI', 'MOT')",Providence,wil21.xml,246,6,2,MOT,1001,2267,CHI
5,20,7,214,1.572011507,234,20,go,"('CHI', 'MOT')",Providence,wil21.xml,246,12,5,MOT,1001,2267,CHI
0,2,9,145,1.507438744,147,2,gonna,"('MOT', 'CHI')",Providence,wil21.xml,156,9,0,CHI,1454,553,MOT
0,2,9,145,1.507438744,147,2,this,"('MOT', 'CHI')",Providence,wil21.xml,156,9,0,CHI,1454,553,MOT
1,21,2,222,1.493925025,243,21,that,"('CHI', 'MOT')",Providence,wil21.xml,246,3,1,MOT,1001,2267,CHI
4,26,4,212,1.491654877,238,26,on,"('CHI', 'MOT')",Providence,wil21.xml,246,8,4,MOT,1001,2267,CHI
1,3,14,138,1.436484106,141,3,oh,"('MOT', 'CHI')",Providence,wil21.xml,156,15,1,CHI,1454,553,MOT
1,2,20,133,1.379021602,135,2,what,"('MOT', 'CHI')",Providence,wil21.xml,156,21,1,CHI,1454,553,MOT
4,27,5,210,1.355801681,237,27,what,"('CHI', 'MOT')",Providence,wil21.xml,246,9,4,MOT,1001,2267,CHI
3,14,6,133,1.284295193,147,14,no,"('MOT', 'CHI')",Providence,wil21.xml,156,9,3,CHI,1454,553,MOT
1,18,5,222,1.158204386,240,18,oh,"('CHI', 'MOT')",Providence,wil21.xml,246,6,1,MOT,1001,2267,CHI
0,5,6,145,1.15267951,150,5,there,"('MOT', 'CHI')",Providence,wil21.xml,156,6,0,CHI,1454,553,MOT
1,4,16,135,1.088030179,139,4,yeah,"('MOT', 'CHI')",Providence,wil21.xml,156,17,1,CHI,1454,553,MOT
6,36,8,196,1.01772463,232,36,the,"('CHI', 'MOT')",Providence,wil21.xml,246,14,6,MOT,1001,2267,CHI
0,3,13,140,0.88238918,143,3,it,"('MOT', 'CHI')",Providence,wil21.xml,156,13,0,CHI,1454,553,MOT
4,21,16,205,0.856698635,226,21,wanna,"('CHI', 'MOT')",Providence,wil21.xml,246,20,4,MOT,1001,2267,CHI
5,99,0,142,0.733740578,241,99,you,"('CHI', 'MOT')",Providence,wil21.xml,246,5,5,MOT,1001,2267,CHI
0,1,1,8,0.606135804,9,1,on,"('CHI', 'OPE')",Providence,wil21.xml,10,1,0,OPE,67,60,CHI
1,2,1,6,0.510825624,8,2,go,"('CHI', 'OPE')",Providence,wil21.xml,10,2,1,OPE,67,60,CHI
1,6,21,128,0.481838087,134,6,on,"('MOT', 'CHI')",Providence,wil21.xml,156,22,1,CHI,1454,553,MOT
1,8,17,130,0.441832752,138,8,go,"('MOT', 'CHI')",Providence,wil21.xml,156,18,1,CHI,1454,553,MOT
0,23,5,218,0.369097464,241,23,yeah,"('CHI', 'MOT')",Providence,wil21.xml,246,5,0,MOT,1001,2267,CHI
1,1,64,90,0.327906874,91,1,you,"('MOT', 'CHI')",Providence,wil21.xml,156,65,1,CHI,1454,553,MOT
1,6,26,123,0.255138525,129,6,the,"('MOT', 'CHI')",Providence,wil21.xml,156,27,1,CHI,1454,553,MOT
0,2,1,7,0.200670695,9,2,see,"('CHI', 'OPE')",Providence,wil21.xml,10,1,0,OPE,67,60,CHI
0,10,15,131,-0.268263987,141,10,wanna,"('MOT', 'CHI')",Providence,wil21.xml,156,15,0,CHI,1454,553,MOT
0,4,2,4,-0.693147181,8,4,you,"('CHI', 'OPE')",Providence,wil21.xml,10,2,0,OPE,67,60,CHI
0,1,1,0,-0.693147181,1,1,all,"('OPE', 'CHI')",Providence,wil21.xml,2,1,0,CHI,9,6,OPE
0,1,1,0,-0.693147181,1,1,with,"('OPE', 'MOT')",Providence,wil21.xml,2,1,0,MOT,13,23,OPE
1,1,0,271,4.514515818,272,1,big,"('CHI', 'MOT')",Providence,wil22.xml,273,1,1,MOT,1101,3814,CHI
2,5,1,265,3.303216973,270,5,all,"('CHI', 'MOT')",Providence,wil22.xml,273,3,2,MOT,1101,3814,CHI
1,6,0,266,3.261752849,272,6,up,"('CHI', 'MOT')",Providence,wil22.xml,273,1,1,MOT,1101,3814,CHI
0,5,1,267,2.722756348,272,5,of,"('CHI', 'MOT')",Providence,wil22.xml,273,1,0,MOT,1101,3814,CHI
1,0,0,18,2.590267165,18,0,up,"('MOT', 'CHI')",Providence,wil22.xml,19,1,1,CHI,236,93,MOT
0,6,1,266,2.568605669,272,6,did,"('CHI', 'MOT')",Providence,wil22.xml,273,1,0,MOT,1101,3814,CHI
0,6,1,266,2.568605669,272,6,where,"('CHI', 'MOT')",Providence,wil22.xml,273,1,0,MOT,1101,3814,CHI
3,10,3,257,2.503668926,267,10,go,"('CHI', 'MOT')",Providence,wil22.xml,273,6,3,MOT,1101,3814,CHI
1,18,0,254,2.263224019,272,18,gonna,"('CHI', 'MOT')",Providence,wil22.xml,273,1,1,MOT,1101,3814,CHI
1,0,1,17,2.251291799,17,0,get,"('MOT', 'CHI')",Providence,wil22.xml,19,2,1,CHI,236,93,MOT
1,0,1,17,2.251291799,17,0,there,"('MOT', 'CHI')",Providence,wil22.xml,19,2,1,CHI,236,93,MOT
1,0,1,17,2.251291799,17,0,he,"('MOT', 'CHI')",Providence,wil22.xml,19,2,1,CHI,236,93,MOT
1,0,1,17,2.251291799,17,0,on,"('MOT', 'CHI')",Providence,wil22.xml,19,2,1,CHI,236,93,MOT
0,9,1,263,2.211930725,272,9,for,"('CHI', 'MOT')",Providence,wil22.xml,273,1,0,MOT,1101,3814,CHI
1,8,4,260,2.148434413,268,8,not,"('CHI', 'MOT')",Providence,wil22.xml,273,5,1,MOT,1101,3814,CHI
0,7,2,264,2.143735892,271,7,want,"('CHI', 'MOT')",Providence,wil22.xml,273,2,0,MOT,1101,3814,CHI
1,16,1,255,2.083111271,271,16,in,"('CHI', 'MOT')",Providence,wil22.xml,273,2,1,MOT,1101,3814,CHI
1,13,2,257,2.050454005,270,13,see,"('CHI', 'MOT')",Providence,wil22.xml,273,3,1,MOT,1101,3814,CHI
0,3,7,263,2.007468042,266,3,my,"('CHI', 'MOT')",Providence,wil22.xml,273,7,0,MOT,1101,3814,CHI
1,19,1,252,1.920592341,271,19,with,"('CHI', 'MOT')",Providence,wil22.xml,273,2,1,MOT,1101,3814,CHI
3,15,5,250,1.898369204,265,15,there,"('CHI', 'MOT')",Providence,wil22.xml,273,8,3,MOT,1101,3814,CHI
2,0,1,9,1.887069649,9,0,do,"('MOT', 'FAT')",Providence,wil22.xml,12,3,2,FAT,150,87,MOT
1,10,5,257,1.810521746,267,10,one,"('CHI', 'MOT')",Providence,wil22.xml,273,6,1,MOT,1101,3814,CHI
1,22,1,249,1.780830399,271,22,to,"('CHI', 'MOT')",Providence,wil22.xml,273,2,1,MOT,1101,3814,CHI
2,0,2,8,1.609437912,8,0,what,"('MOT', 'FAT')",Providence,wil22.xml,12,4,2,FAT,150,87,MOT
1,27,1,244,1.584120104,271,27,can,"('CHI', 'MOT')",Providence,wil22.xml,273,2,1,MOT,1101,3814,CHI
1,0,0,5,1.540445041,5,0,it,"('CHI', 'OPE')",Providence,wil22.xml,6,1,1,OPE,34,21,CHI
0,11,3,259,1.511457504,270,11,he,"('CHI', 'MOT')",Providence,wil22.xml,273,3,0,MOT,1101,3814,CHI
1,19,3,250,1.507774259,269,19,and,"('CHI', 'MOT')",Providence,wil22.xml,273,4,1,MOT,1101,3814,CHI
2,36,1,234,1.48405853,270,36,do,"('CHI', 'MOT')",Providence,wil22.xml,273,3,2,MOT,1101,3814,CHI
2,30,2,239,1.474984436,269,30,wanna,"('CHI', 'MOT')",Providence,wil22.xml,273,4,2,MOT,1101,3814,CHI
8,9,40,216,1.407566496,225,9,no,"('CHI', 'MOT')",Providence,wil22.xml,273,48,8,MOT,1101,3814,CHI
4,39,3,227,1.314320861,266,39,on,"('CHI', 'MOT')",Providence,wil22.xml,273,7,4,MOT,1101,3814,CHI
17,43,9,204,1.29143051,247,43,a,"('CHI', 'MOT')",Providence,wil22.xml,273,26,17,MOT,1101,3814,CHI
0,1,1,17,1.203972804,18,1,make,"('MOT', 'CHI')",Providence,wil22.xml,19,1,0,CHI,236,93,MOT
2,40,2,229,1.195399574,269,40,yeah,"('CHI', 'MOT')",Providence,wil22.xml,273,4,2,MOT,1101,3814,CHI
2,0,4,6,1.098612289,6,0,you,"('MOT', 'FAT')",Providence,wil22.xml,12,6,2,FAT,150,87,MOT
1,30,3,239,1.069519328,269,30,this,"('CHI', 'MOT')",Providence,wil22.xml,273,4,1,MOT,1101,3814,CHI
1,2,0,9,1.060871961,11,2,it,"('MOT', 'FAT')",Providence,wil22.xml,12,1,1,FAT,150,87,MOT
1,4,0,14,0.980829253,18,4,she,"('MOT', 'CHI')",Providence,wil22.xml,19,1,1,CHI,236,93,MOT
8,58,6,201,0.911618819,259,58,it,"('CHI', 'MOT')",Providence,wil22.xml,273,14,8,MOT,1101,3814,CHI
8,44,11,210,0.891217094,254,44,the,"('CHI', 'MOT')",Providence,wil22.xml,273,19,8,MOT,1101,3814,CHI
1,37,3,232,0.865920372,269,37,is,"('CHI', 'MOT')",Providence,wil22.xml,273,4,1,MOT,1101,3814,CHI
0,1,2,16,0.864997437,17,1,a,"('MOT', 'CHI')",Providence,wil22.xml,19,2,0,CHI,236,93,MOT
2,40,5,226,0.778802625,266,40,that,"('CHI', 'MOT')",Providence,wil22.xml,273,7,2,MOT,1101,3814,CHI
0,1,1,10,0.773189888,11,1,at,"('MOT', 'FAT')",Providence,wil22.xml,12,1,0,FAT,150,87,MOT
0,1,1,10,0.773189888,11,1,and,"('MOT', 'FAT')",Providence,wil22.xml,12,1,0,FAT,150,87,MOT
2,48,4,219,0.722061828,267,48,oh,"('CHI', 'MOT')",Providence,wil22.xml,273,6,2,MOT,1101,3814,CHI
1,37,4,231,0.708072831,268,37,what,"('CHI', 'MOT')",Providence,wil22.xml,273,5,1,MOT,1101,3814,CHI
1,0,1,2,0.693147181,2,0,you,"('OPE', 'MOT')",Providence,wil22.xml,4,2,1,MOT,25,78,OPE
1,0,1,2,0.693147181,2,0,yeah,"('OPE', 'MOT')",Providence,wil22.xml,4,2,1,MOT,25,78,OPE
1,0,1,2,0.693147181,2,0,a,"('OPE', 'MOT')",Providence,wil22.xml,4,2,1,MOT,25,78,OPE
0,1,3,15,0.587786665,16,1,yeah,"('MOT', 'CHI')",Providence,wil22.xml,19,3,0,CHI,236,93,MOT
1,83,1,188,0.485507816,271,83,you,"('CHI', 'MOT')",Providence,wil22.xml,273,2,1,MOT,1101,3814,CHI
0,2,2,15,0.459532329,17,2,it,"('MOT', 'CHI')",Providence,wil22.xml,19,2,0,CHI,236,93,MOT
1,1,1,3,0.405465108,4,1,you,"('FAT', 'MOT')",Providence,wil22.xml,6,2,1,MOT,35,105,FAT
0,1,2,9,0.405465108,10,1,in,"('MOT', 'FAT')",Providence,wil22.xml,12,2,0,FAT,150,87,MOT
0,1,2,9,0.405465108,10,1,up,"('MOT', 'FAT')",Providence,wil22.xml,12,2,0,FAT,150,87,MOT
0,1,1,4,0.15415068,5,1,that,"('FAT', 'MOT')",Providence,wil22.xml,6,1,0,MOT,35,105,FAT
0,1,1,2,-0.182321557,3,1,oh,"('OPE', 'MOT')",Providence,wil22.xml,4,1,0,MOT,25,78,OPE
0,1,1,2,-0.182321557,3,1,gonna,"('OPE', 'MOT')",Providence,wil22.xml,4,1,0,MOT,25,78,OPE
0,6,2,11,-0.387765531,17,6,is,"('MOT', 'CHI')",Providence,wil22.xml,19,2,0,CHI,236,93,MOT
0,1,5,6,-0.441832752,7,1,the,"('MOT', 'FAT')",Providence,wil22.xml,12,5,0,FAT,150,87,MOT
0,1,1,231,3.663561646,232,1,he,"('CHI', 'MOT')",Providence,wil23.xml,233,1,0,MOT,1351,2334,CHI
1,2,1,229,3.659278984,231,2,up,"('CHI', 'MOT')",Providence,wil23.xml,233,2,1,MOT,1351,2334,CHI
5,2,8,218,3.387774361,220,2,big,"('CHI', 'MOT')",Providence,wil23.xml,233,13,5,MOT,1351,2334,CHI
2,2,5,224,3.232121052,226,2,some,"('CHI', 'MOT')",Providence,wil23.xml,233,7,2,MOT,1351,2334,CHI
0,1,3,229,3.144152279,230,1,all,"('CHI', 'MOT')",Providence,wil23.xml,233,3,0,MOT,1351,2334,CHI
3,1,3,82,3.056356895,83,1,in,"('MOT', 'CHI')",Providence,wil23.xml,89,6,3,CHI,746,453,MOT
0,3,1,229,2.970414466,232,3,my,"('CHI', 'MOT')",Providence,wil23.xml,233,1,0,MOT,1351,2334,CHI
4,6,3,220,2.895648815,226,6,with,"('CHI', 'MOT')",Providence,wil23.xml,233,7,4,MOT,1351,2334,CHI
1,6,1,225,2.811981124,231,6,are,"('CHI', 'MOT')",Providence,wil23.xml,233,2,1,MOT,1351,2334,CHI
1,9,0,223,2.747270914,232,9,put,"('CHI', 'MOT')",Providence,wil23.xml,233,1,1,MOT,1351,2334,CHI
0,1,1,87,2.708050201,88,1,all,"('MOT', 'CHI')",Providence,wil23.xml,89,1,0,CHI,746,453,MOT
0,1,1,87,2.708050201,88,1,one,"('MOT', 'CHI')",Providence,wil23.xml,89,1,0,CHI,746,453,MOT
1,7,2,223,2.451005098,230,7,like,"('CHI', 'MOT')",Providence,wil23.xml,233,3,1,MOT,1351,2334,CHI
0,1,2,86,2.409194828,87,1,where,"('MOT', 'CHI')",Providence,wil23.xml,89,2,0,CHI,746,453,MOT
1,10,1,221,2.359996,231,10,in,"('CHI', 'MOT')",Providence,wil23.xml,233,2,1,MOT,1351,2334,CHI
1,8,2,222,2.333222062,230,8,see,"('CHI', 'MOT')",Providence,wil23.xml,233,3,1,MOT,1351,2334,CHI
0,2,1,86,2.302585093,88,2,get,"('MOT', 'CHI')",Providence,wil23.xml,89,1,0,CHI,746,453,MOT
0,7,1,225,2.277267285,232,7,did,"('CHI', 'MOT')",Providence,wil23.xml,233,1,0,MOT,1351,2334,CHI
0,4,3,226,2.227861547,230,4,get,"('CHI', 'MOT')",Providence,wil23.xml,233,3,0,MOT,1351,2334,CHI
3,2,8,76,2.10475935,78,2,do,"('MOT', 'CHI')",Providence,wil23.xml,89,11,3,CHI,746,453,MOT
0,1,4,84,1.981001469,85,1,want,"('MOT', 'CHI')",Providence,wil23.xml,89,4,0,CHI,746,453,MOT
0,1,4,84,1.981001469,85,1,big,"('MOT', 'CHI')",Providence,wil23.xml,89,4,0,CHI,746,453,MOT
0,5,4,224,1.858898772,229,5,look,"('CHI', 'MOT')",Providence,wil23.xml,233,4,0,MOT,1351,2334,CHI
0,1,5,83,1.815289967,84,1,that,"('MOT', 'CHI')",Providence,wil23.xml,89,5,0,CHI,746,453,MOT
1,0,0,7,1.791759469,7,0,that,"('MOT', 'OPE')",Providence,wil23.xml,8,1,1,OPE,86,81,MOT
1,6,8,218,1.769876758,224,6,want,"('CHI', 'MOT')",Providence,wil23.xml,233,9,1,MOT,1351,2334,CHI
3,3,9,74,1.730390523,77,3,the,"('MOT', 'CHI')",Providence,wil23.xml,89,12,3,CHI,746,453,MOT
0,3,2,84,1.716047647,87,3,are,"('MOT', 'CHI')",Providence,wil23.xml,89,2,0,CHI,746,453,MOT
0,14,1,218,1.648658626,232,14,gonna,"('CHI', 'MOT')",Providence,wil23.xml,233,1,0,MOT,1351,2334,CHI
1,22,1,209,1.622397057,231,22,oh,"('CHI', 'MOT')",Providence,wil23.xml,233,2,1,MOT,1351,2334,CHI
1,30,0,202,1.615868803,232,30,to,"('CHI', 'MOT')",Providence,wil23.xml,233,1,1,MOT,1351,2334,CHI
0,15,1,217,1.584120104,232,15,not,"('CHI', 'MOT')",Providence,wil23.xml,233,1,0,MOT,1351,2334,CHI
0,2,4,83,1.575536361,85,2,like,"('MOT', 'CHI')",Providence,wil23.xml,89,4,0,CHI,746,453,MOT
0,3,3,83,1.481604541,86,3,with,"('MOT', 'CHI')",Providence,wil23.xml,89,3,0,CHI,746,453,MOT
2,26,2,203,1.453433664,229,26,do,"('CHI', 'MOT')",Providence,wil23.xml,233,4,2,MOT,1351,2334,CHI
0,15,2,216,1.29215537,231,15,one,"('CHI', 'MOT')",Providence,wil23.xml,233,2,0,MOT,1351,2334,CHI
0,2,6,81,1.264597426,83,2,what,"('MOT', 'CHI')",Providence,wil23.xml,89,6,0,CHI,746,453,MOT
1,2,12,74,1.243193517,76,2,oh,"('MOT', 'CHI')",Providence,wil23.xml,89,13,1,CHI,746,453,MOT
0,13,3,217,1.19824213,230,13,and,"('CHI', 'MOT')",Providence,wil23.xml,233,3,0,MOT,1351,2334,CHI
0,11,4,218,1.165751592,229,11,go,"('CHI', 'MOT')",Providence,wil23.xml,233,4,0,MOT,1351,2334,CHI
0,1,1,16,1.15267951,17,1,oh,"('CHI', 'OPE')",Providence,wil23.xml,18,1,0,OPE,152,129,CHI
0,1,1,16,1.15267951,17,1,yeah,"('CHI', 'OPE')",Providence,wil23.xml,18,1,0,OPE,152,129,CHI
0,1,1,16,1.15267951,17,1,with,"('CHI', 'OPE')",Providence,wil23.xml,18,1,0,OPE,152,129,CHI
0,1,1,16,1.15267951,17,1,see,"('CHI', 'OPE')",Providence,wil23.xml,18,1,0,OPE,152,129,CHI
0,1,1,16,1.15267951,17,1,do,"('CHI', 'OPE')",Providence,wil23.xml,18,1,0,OPE,152,129,CHI
0,1,1,16,1.15267951,17,1,to,"('CHI', 'OPE')",Providence,wil23.xml,18,1,0,OPE,152,129,CHI
0,1,1,16,1.15267951,17,1,and,"('CHI', 'OPE')",Providence,wil23.xml,18,1,0,OPE,152,129,CHI
0,2,7,80,1.134979933,82,2,this,"('MOT', 'CHI')",Providence,wil23.xml,89,7,0,CHI,746,453,MOT
0,2,7,80,1.134979933,82,2,to,"('MOT', 'CHI')",Providence,wil23.xml,89,7,0,CHI,746,453,MOT
1,24,3,205,1.124929597,229,24,this,"('CHI', 'MOT')",Providence,wil23.xml,233,4,1,MOT,1351,2334,CHI
2,18,8,205,1.085367062,223,18,it,"('CHI', 'MOT')",Providence,wil23.xml,233,10,2,MOT,1351,2334,CHI
21,25,30,157,1.077589759,182,25,a,"('CHI', 'MOT')",Providence,wil23.xml,233,51,21,MOT,1351,2334,CHI
4,18,2,65,1.028208648,83,18,no,"('MOT', 'CHI')",Providence,wil23.xml,89,6,4,CHI,746,453,MOT
0,27,1,205,1.024504317,232,27,is,"('CHI', 'MOT')",Providence,wil23.xml,233,1,0,MOT,1351,2334,CHI
1,31,3,198,0.878069519,229,31,what,"('CHI', 'MOT')",Providence,wil23.xml,233,4,1,MOT,1351,2334,CHI
6,30,13,184,0.842678915,214,30,the,"('CHI', 'MOT')",Providence,wil23.xml,233,19,6,MOT,1351,2334,CHI
0,12,1,76,0.836248024,88,12,yeah,"('MOT', 'CHI')",Providence,wil23.xml,89,1,0,CHI,746,453,MOT
1,4,11,73,0.814099791,77,4,go,"('MOT', 'CHI')",Providence,wil23.xml,89,12,1,CHI,746,453,MOT
2,8,8,71,0.810930216,79,8,it,"('MOT', 'CHI')",Providence,wil23.xml,89,10,2,CHI,746,453,MOT
1,3,1,13,0.810930216,16,3,you,"('CHI', 'OPE')",Providence,wil23.xml,18,2,1,OPE,152,129,CHI
3,8,37,185,0.724399724,193,8,no,"('CHI', 'MOT')",Providence,wil23.xml,233,40,3,MOT,1351,2334,CHI
1,1,1,5,0.693147181,6,1,the,"('MOT', 'OPE')",Providence,wil23.xml,8,2,1,OPE,86,81,MOT
2,25,9,197,0.687212445,222,25,that,"('CHI', 'MOT')",Providence,wil23.xml,233,11,2,MOT,1351,2334,CHI
3,12,9,65,0.551735527,77,12,wanna,"('MOT', 'CHI')",Providence,wil23.xml,89,12,3,CHI,746,453,MOT
0,1,3,14,0.530628251,15,1,wanna,"('CHI', 'OPE')",Providence,wil23.xml,18,3,0,OPE,152,129,CHI
5,80,3,145,0.519675239,225,80,you,"('CHI', 'MOT')",Providence,wil23.xml,233,8,5,MOT,1351,2334,CHI
0,17,6,210,0.463908704,227,17,on,"('CHI', 'MOT')",Providence,wil23.xml,233,6,0,MOT,1351,2334,CHI
0,3,1,14,0.459532329,17,3,that,"('CHI', 'OPE')",Providence,wil23.xml,18,1,0,OPE,152,129,CHI
2,19,17,195,0.433635985,214,19,wanna,"('CHI', 'MOT')",Providence,wil23.xml,233,19,2,MOT,1351,2334,CHI
1,2,1,4,0.287682072,6,2,it,"('MOT', 'OPE')",Providence,wil23.xml,8,2,1,OPE,86,81,MOT
0,5,9,75,0.217064505,80,5,on,"('MOT', 'CHI')",Providence,wil23.xml,89,9,0,CHI,746,453,MOT
0,3,2,13,0.117783036,16,3,go,"('CHI', 'OPE')",Providence,wil23.xml,18,2,0,OPE,152,129,CHI
0,1,2,5,0,6,1,you,"('MOT', 'OPE')",Providence,wil23.xml,8,2,0,OPE,86,81,MOT
0,1,2,5,0,6,1,but,"('MOT', 'OPE')",Providence,wil23.xml,8,2,0,OPE,86,81,MOT
3,6,31,49,-0.100083459,55,6,you,"('MOT', 'CHI')",Providence,wil23.xml,89,34,3,CHI,746,453,MOT
0,23,11,199,-0.331357136,222,23,yeah,"('CHI', 'MOT')",Providence,wil23.xml,233,11,0,MOT,1351,2334,CHI
0,1,3,2,-0.693147181,3,1,yeah,"('OPE', 'MOT')",Providence,wil23.xml,6,3,0,MOT,27,35,OPE
1,0,1,142,4.276666119,142,0,one,"('CHI', 'MOT')",Providence,wil24.xml,144,2,1,MOT,838,1501,CHI
1,0,3,115,3.663561646,115,0,big,"('MOT', 'CHI')",Providence,wil24.xml,119,4,1,CHI,1515,724,MOT
0,1,1,142,3.184974273,143,1,at,"('CHI', 'MOT')",Providence,wil24.xml,144,1,0,MOT,838,1501,CHI
0,1,1,142,3.184974273,143,1,where,"('CHI', 'MOT')",Providence,wil24.xml,144,1,0,MOT,838,1501,CHI
0,1,1,117,2.995732274,118,1,make,"('MOT', 'CHI')",Providence,wil24.xml,119,1,0,CHI,1515,724,MOT
0,1,2,141,2.890371758,142,1,look,"('CHI', 'MOT')",Providence,wil24.xml,144,2,0,MOT,838,1501,CHI
1,3,1,139,2.890371758,142,3,see,"('CHI', 'MOT')",Providence,wil24.xml,144,2,1,MOT,838,1501,CHI
1,1,4,113,2.807680042,114,1,put,"('MOT', 'CHI')",Providence,wil24.xml,119,5,1,CHI,1515,724,MOT
0,1,2,116,2.699681951,117,1,did,"('MOT', 'CHI')",Providence,wil24.xml,119,2,0,CHI,1515,724,MOT
0,2,1,116,2.590267165,118,2,my,"('MOT', 'CHI')",Providence,wil24.xml,119,1,0,CHI,1515,724,MOT
1,1,0,22,2.120263536,23,1,there,"('VI1', 'MOT')",Providence,wil24.xml,24,1,1,MOT,274,158,VI1
0,1,5,113,2.114532861,114,1,at,"('MOT', 'CHI')",Providence,wil24.xml,119,5,0,CHI,1515,724,MOT
1,8,1,134,2.079441542,142,8,a,"('CHI', 'MOT')",Providence,wil24.xml,144,2,1,MOT,838,1501,CHI
0,2,3,114,2.062634423,116,2,what,"('MOT', 'CHI')",Providence,wil24.xml,119,3,0,CHI,1515,724,MOT
0,4,2,138,1.974081026,142,4,like,"('CHI', 'MOT')",Providence,wil24.xml,144,2,0,MOT,838,1501,CHI
0,1,6,112,1.972343406,113,1,get,"('MOT', 'CHI')",Providence,wil24.xml,119,6,0,CHI,1515,724,MOT
0,2,4,113,1.871802177,115,2,look,"('MOT', 'CHI')",Providence,wil24.xml,119,4,0,CHI,1515,724,MOT
0,2,4,113,1.871802177,115,2,see,"('MOT', 'CHI')",Providence,wil24.xml,119,4,0,CHI,1515,724,MOT
0,4,2,113,1.78339122,117,4,where,"('MOT', 'CHI')",Providence,wil24.xml,119,2,0,CHI,1515,724,MOT
6,11,6,121,1.71978597,132,11,it,"('CHI', 'MOT')",Providence,wil24.xml,144,12,6,MOT,838,1501,CHI
0,2,5,112,1.709067753,114,2,want,"('MOT', 'CHI')",Providence,wil24.xml,119,5,0,CHI,1515,724,MOT
1,1,16,101,1.69995192,102,1,it,"('MOT', 'CHI')",Providence,wil24.xml,119,17,1,CHI,1515,724,MOT
1,13,1,129,1.637608789,142,13,with,"('CHI', 'MOT')",Providence,wil24.xml,144,2,1,MOT,838,1501,CHI
2,13,2,127,1.623622547,140,13,that,"('CHI', 'MOT')",Providence,wil24.xml,144,4,2,MOT,838,1501,CHI
0,3,4,112,1.584120104,115,3,up,"('MOT', 'CHI')",Providence,wil24.xml,119,4,0,CHI,1515,724,MOT
1,1,1,16,1.558144618,17,1,for,"('MOT', 'VI1')",Providence,wil24.xml,19,2,1,VI1,200,288,MOT
0,7,2,135,1.504077397,142,7,get,"('CHI', 'MOT')",Providence,wil24.xml,144,2,0,MOT,838,1501,CHI
0,2,7,110,1.440361582,112,2,and,"('MOT', 'CHI')",Providence,wil24.xml,119,7,0,CHI,1515,724,MOT
2,10,5,127,1.437966372,137,10,go,"('CHI', 'MOT')",Providence,wil24.xml,144,7,2,MOT,838,1501,CHI
0,1,1,22,1.427116356,23,1,for,"('VI1', 'MOT')",Providence,wil24.xml,24,1,0,MOT,274,158,VI1
0,1,1,22,1.427116356,23,1,of,"('VI1', 'MOT')",Providence,wil24.xml,24,1,0,MOT,274,158,VI1
1,17,1,125,1.386294361,142,17,to,"('CHI', 'MOT')",Providence,wil24.xml,144,2,1,MOT,838,1501,CHI
6,18,5,115,1.341796591,133,18,do,"('CHI', 'MOT')",Providence,wil24.xml,144,11,6,MOT,838,1501,CHI
0,2,8,109,1.326190437,111,2,there,"('MOT', 'CHI')",Providence,wil24.xml,119,8,0,CHI,1515,724,MOT
0,13,1,130,1.239064124,143,13,can,"('CHI', 'MOT')",Providence,wil24.xml,144,1,0,MOT,838,1501,CHI
0,2,9,108,1.22199131,110,2,in,"('MOT', 'CHI')",Providence,wil24.xml,119,9,0,CHI,1515,724,MOT
0,1,1,17,1.203972804,18,1,with,"('MOT', 'VI1')",Providence,wil24.xml,19,1,0,VI1,200,288,MOT
0,1,1,17,1.203972804,18,1,look,"('MOT', 'VI1')",Providence,wil24.xml,19,1,0,VI1,200,288,MOT
0,1,1,17,1.203972804,18,1,but,"('MOT', 'VI1')",Providence,wil24.xml,19,1,0,VI1,200,288,MOT
0,10,2,132,1.185623666,142,10,in,"('CHI', 'MOT')",Providence,wil24.xml,144,2,0,MOT,838,1501,CHI
7,14,12,111,1.171055989,125,14,the,"('CHI', 'MOT')",Providence,wil24.xml,144,19,7,MOT,838,1501,CHI
1,2,1,15,1.15267951,17,2,this,"('MOT', 'VI1')",Providence,wil24.xml,19,2,1,VI1,200,288,MOT
1,5,9,104,1.126011263,109,5,yeah,"('MOT', 'CHI')",Providence,wil24.xml,119,10,1,CHI,1515,724,MOT
0,1,2,21,1.098612289,22,1,what,"('VI1', 'MOT')",Providence,wil24.xml,24,2,0,MOT,274,158,VI1
0,1,2,21,1.098612289,22,1,no,"('VI1', 'MOT')",Providence,wil24.xml,24,2,0,MOT,274,158,VI1
0,1,2,21,1.098612289,22,1,that,"('VI1', 'MOT')",Providence,wil24.xml,24,2,0,MOT,274,158,VI1
1,6,10,127,1.087562452,133,6,want,"('CHI', 'MOT')",Providence,wil24.xml,144,11,1,MOT,838,1501,CHI
0,2,1,21,1.021651248,23,2,was,"('VI1', 'MOT')",Providence,wil24.xml,24,1,0,MOT,274,158,VI1
0,2,1,21,1.021651248,23,2,a,"('VI1', 'MOT')",Providence,wil24.xml,24,1,0,MOT,274,158,VI1
0,1,17,101,1.006804739,102,1,on,"('MOT', 'CHI')",Providence,wil24.xml,119,17,0,CHI,1515,724,MOT
1,12,5,126,0.990398704,138,12,on,"('CHI', 'MOT')",Providence,wil24.xml,144,6,1,MOT,838,1501,CHI
0,8,4,132,0.966843011,140,8,this,"('CHI', 'MOT')",Providence,wil24.xml,144,4,0,MOT,838,1501,CHI
0,2,12,105,0.953678264,107,2,gonna,"('MOT', 'CHI')",Providence,wil24.xml,119,12,0,CHI,1515,724,MOT
0,2,12,105,0.953678264,107,2,not,"('MOT', 'CHI')",Providence,wil24.xml,119,12,0,CHI,1515,724,MOT
1,2,3,18,0.893817876,20,2,to,"('VI1', 'MOT')",Providence,wil24.xml,24,4,1,MOT,274,158,VI1
0,6,5,108,0.861769893,114,6,do,"('MOT', 'CHI')",Providence,wil24.xml,119,5,0,CHI,1515,724,MOT
0,1,3,20,0.832909123,21,1,is,"('VI1', 'MOT')",Providence,wil24.xml,24,3,0,MOT,274,158,VI1
1,1,4,13,0.826678573,14,1,yeah,"('MOT', 'VI1')",Providence,wil24.xml,19,5,1,VI1,200,288,MOT
0,2,1,16,0.798507696,18,2,in,"('MOT', 'VI1')",Providence,wil24.xml,19,1,0,VI1,200,288,MOT
0,2,1,16,0.798507696,18,2,we,"('MOT', 'VI1')",Providence,wil24.xml,19,1,0,VI1,200,288,MOT
0,2,1,16,0.798507696,18,2,see,"('MOT', 'VI1')",Providence,wil24.xml,19,1,0,VI1,200,288,MOT
0,2,1,16,0.798507696,18,2,up,"('MOT', 'VI1')",Providence,wil24.xml,19,1,0,VI1,200,288,MOT
5,41,2,96,0.791339207,137,41,you,"('CHI', 'MOT')",Providence,wil24.xml,144,7,5,MOT,838,1501,CHI
0,12,3,129,0.78845736,141,12,oh,"('CHI', 'MOT')",Providence,wil24.xml,144,3,0,MOT,838,1501,CHI
8,10,24,77,0.76160515,87,10,the,"('MOT', 'CHI')",Providence,wil24.xml,119,32,8,CHI,1515,724,MOT
0,4,11,129,0.730887509,133,4,no,"('CHI', 'MOT')",Providence,wil24.xml,144,11,0,MOT,838,1501,CHI
0,2,2,20,0.693147181,22,2,gonna,"('VI1', 'MOT')",Providence,wil24.xml,24,2,0,MOT,274,158,VI1
3,7,25,109,0.676340062,116,7,wanna,"('CHI', 'MOT')",Providence,wil24.xml,144,28,3,MOT,838,1501,CHI
0,1,3,15,0.587786665,16,1,what,"('MOT', 'VI1')",Providence,wil24.xml,19,3,0,VI1,200,288,MOT
0,1,3,15,0.587786665,16,1,do,"('MOT', 'VI1')",Providence,wil24.xml,19,3,0,VI1,200,288,MOT
1,4,20,94,0.553385238,98,4,this,"('MOT', 'CHI')",Providence,wil24.xml,119,21,1,CHI,1515,724,MOT
1,2,5,16,0.510825624,18,2,the,"('VI1', 'MOT')",Providence,wil24.xml,24,6,1,MOT,274,158,VI1
0,3,1,15,0.510825624,18,3,gonna,"('MOT', 'VI1')",Providence,wil24.xml,19,1,0,VI1,200,288,MOT
1,1,0,2,0.510825624,3,1,you,"('OPE', 'MOT')",Providence,wil24.xml,4,1,1,MOT,14,42,OPE
0,2,2,15,0.459532329,17,2,is,"('MOT', 'VI1')",Providence,wil24.xml,19,2,0,VI1,200,288,MOT
0,2,2,15,0.459532329,17,2,not,"('MOT', 'VI1')",Providence,wil24.xml,19,2,0,VI1,200,288,MOT
1,5,1,12,0.459532329,17,5,the,"('MOT', 'VI1')",Providence,wil24.xml,19,2,1,VI1,200,288,MOT
1,20,4,94,0.456304785,114,20,wanna,"('MOT', 'CHI')",Providence,wil24.xml,119,5,1,CHI,1515,724,MOT
1,4,2,12,0.364643114,16,4,and,"('MOT', 'VI1')",Providence,wil24.xml,19,3,1,VI1,200,288,MOT
0,9,6,104,0.362905494,113,9,no,"('MOT', 'CHI')",Providence,wil24.xml,119,6,0,CHI,1515,724,MOT
1,6,18,94,0.327687407,100,6,oh,"('MOT', 'CHI')",Providence,wil24.xml,119,19,1,CHI,1515,724,MOT
5,22,13,79,0.295261968,101,22,go,"('MOT', 'CHI')",Providence,wil24.xml,119,18,5,CHI,1515,724,MOT
0,2,4,18,0.200670695,20,2,and,"('VI1', 'MOT')",Providence,wil24.xml,24,4,0,MOT,274,158,VI1
0,5,13,101,0.182321557,106,5,a,"('MOT', 'CHI')",Providence,wil24.xml,119,13,0,CHI,1515,724,MOT
0,2,3,14,0.182321557,16,2,that,"('MOT', 'VI1')",Providence,wil24.xml,19,3,0,VI1,200,288,MOT
0,4,2,18,0.182321557,22,4,yeah,"('VI1', 'MOT')",Providence,wil24.xml,24,2,0,MOT,274,158,VI1
1,2,7,14,0.182321557,16,2,it,"('VI1', 'MOT')",Providence,wil24.xml,24,8,1,MOT,274,158,VI1
0,4,2,13,-0.051293294,17,4,a,"('MOT', 'VI1')",Providence,wil24.xml,19,2,0,VI1,200,288,MOT
0,4,2,13,-0.051293294,17,4,to,"('MOT', 'VI1')",Providence,wil24.xml,19,2,0,VI1,200,288,MOT
0,3,4,12,-0.344840486,15,3,it,"('MOT', 'VI1')",Providence,wil24.xml,19,4,0,VI1,200,288,MOT
0,2,38,79,-0.368651135,81,2,you,"('MOT', 'CHI')",Providence,wil24.xml,119,38,0,CHI,1515,724,MOT
1,8,3,7,-0.462623522,15,8,you,"('MOT', 'VI1')",Providence,wil24.xml,19,4,1,VI1,200,288,MOT
0,3,7,14,-0.639079959,17,3,you,"('VI1', 'MOT')",Providence,wil24.xml,24,7,0,MOT,274,158,VI1
0,14,16,114,-0.730887509,128,14,yeah,"('CHI', 'MOT')",Providence,wil24.xml,144,16,0,MOT,838,1501,CHI
1,0,4,431,4.81797476,431,0,for,"('SI1', 'CHI')",Providence,wil25.xml,436,5,1,CHI,3204,1871,SI1
1,1,4,430,4.124827579,431,1,my,"('SI1', 'CHI')",Providence,wil25.xml,436,5,1,CHI,3204,1871,SI1
0,1,5,430,3.431680398,431,1,where,"('SI1', 'CHI')",Providence,wil25.xml,436,5,0,CHI,3204,1871,SI1
1,3,0,141,3.191847152,144,3,all,"('CHI', 'SI1')",Providence,wil25.xml,145,1,1,SI1,643,1060,CHI
1,3,0,141,3.191847152,144,3,do,"('CHI', 'SI1')",Providence,wil25.xml,145,1,1,SI1,643,1060,CHI
1,3,0,141,3.191847152,144,3,not,"('CHI', 'SI1')",Providence,wil25.xml,145,1,1,SI1,643,1060,CHI
0,1,1,143,3.191847152,144,1,there,"('CHI', 'SI1')",Providence,wil25.xml,145,1,0,SI1,643,1060,CHI
0,1,7,428,3.175736332,429,1,look,"('SI1', 'CHI')",Providence,wil25.xml,436,7,0,CHI,3204,1871,SI1
1,3,6,426,3.175736332,429,3,put,"('SI1', 'CHI')",Providence,wil25.xml,436,7,1,CHI,3204,1871,SI1
1,2,11,422,3.009916909,424,2,all,"('SI1', 'CHI')",Providence,wil25.xml,436,12,1,CHI,3204,1871,SI1
2,0,0,25,3.008154794,25,0,no,"('MOT', 'SI1')",Providence,wil25.xml,27,2,2,SI1,278,174,MOT
2,0,0,25,3.008154794,25,0,can,"('MOT', 'SI1')",Providence,wil25.xml,27,2,2,SI1,278,174,MOT
1,4,0,140,2.968703601,144,4,and,"('CHI', 'SI1')",Providence,wil25.xml,145,1,1,SI1,643,1060,CHI
4,3,3,135,2.967561397,138,3,that,"('CHI', 'SI1')",Providence,wil25.xml,145,7,4,SI1,643,1060,CHI
1,1,20,414,2.897592006,415,1,we,"('SI1', 'CHI')",Providence,wil25.xml,436,21,1,CHI,3204,1871,SI1
1,0,0,25,2.890371758,25,0,on,"('MOT', 'CHI')",Providence,wil25.xml,26,1,1,CHI,256,120,MOT
2,4,11,419,2.833213344,423,4,one,"('SI1', 'CHI')",Providence,wil25.xml,436,13,2,CHI,3204,1871,SI1
0,1,11,424,2.798687475,425,1,want,"('SI1', 'CHI')",Providence,wil25.xml,436,11,0,CHI,3204,1871,SI1
1,5,0,139,2.786382044,144,5,can,"('CHI', 'SI1')",Providence,wil25.xml,145,1,1,SI1,643,1060,CHI
1,1,6,137,2.744417845,138,1,what,"('CHI', 'SI1')",Providence,wil25.xml,145,7,1,SI1,643,1060,CHI
2,1,35,398,2.735864889,399,1,a,"('SI1', 'CHI')",Providence,wil25.xml,436,37,2,CHI,3204,1871,SI1
2,3,3,137,2.722234836,140,3,on,"('CHI', 'SI1')",Providence,wil25.xml,145,5,2,SI1,643,1060,CHI
1,4,10,421,2.575543924,425,4,not,"('SI1', 'CHI')",Providence,wil25.xml,436,11,1,CHI,3204,1871,SI1
4,5,3,133,2.562096288,138,5,one,"('CHI', 'SI1')",Providence,wil25.xml,145,7,4,SI1,643,1060,CHI
0,3,1,141,2.498699972,144,3,where,"('CHI', 'SI1')",Providence,wil25.xml,145,1,0,SI1,643,1060,CHI
0,2,2,141,2.491827093,143,2,want,"('CHI', 'SI1')",Providence,wil25.xml,145,2,0,SI1,643,1060,CHI
1,0,2,24,2.341805806,24,0,oh,"('MOT', 'SI1')",Providence,wil25.xml,27,3,1,SI1,278,174,MOT
1,0,2,24,2.341805806,24,0,one,"('MOT', 'SI1')",Providence,wil25.xml,27,3,1,SI1,278,174,MOT
2,0,3,22,2.33075597,22,0,in,"('MOT', 'SI1')",Providence,wil25.xml,27,5,2,SI1,278,174,MOT
6,8,23,399,2.328413523,407,8,in,"('SI1', 'CHI')",Providence,wil25.xml,436,29,6,CHI,3204,1871,SI1
0,2,3,140,2.261763098,142,2,big,"('CHI', 'SI1')",Providence,wil25.xml,145,3,0,SI1,643,1060,CHI
2,4,22,408,2.256943812,412,4,see,"('SI1', 'CHI')",Providence,wil25.xml,436,24,2,CHI,3204,1871,SI1
0,3,2,140,2.20414502,143,3,in,"('CHI', 'SI1')",Providence,wil25.xml,145,2,0,SI1,643,1060,CHI
0,5,6,425,2.197224577,430,5,did,"('SI1', 'CHI')",Providence,wil25.xml,436,6,0,CHI,3204,1871,SI1
1,1,0,24,2.197224577,25,1,go,"('MOT', 'CHI')",Providence,wil25.xml,26,1,1,CHI,256,120,MOT
1,6,2,136,2.107612419,142,6,see,"('CHI', 'SI1')",Providence,wil25.xml,145,3,1,SI1,643,1060,CHI
0,5,1,139,2.093234864,144,5,with,"('CHI', 'SI1')",Providence,wil25.xml,145,1,0,SI1,643,1060,CHI
0,5,7,424,2.077124044,429,5,there,"('SI1', 'CHI')",Providence,wil25.xml,436,7,0,CHI,3204,1871,SI1
5,11,19,401,2.074622255,412,11,is,"('SI1', 'CHI')",Providence,wil25.xml,436,24,5,CHI,3204,1871,SI1
1,5,15,415,2.056021267,420,5,do,"('SI1', 'CHI')",Providence,wil25.xml,436,16,1,CHI,3204,1871,SI1
4,11,17,404,2.022123269,415,11,this,"('SI1', 'CHI')",Providence,wil25.xml,436,21,4,CHI,3204,1871,SI1
2,0,2,13,2.014903021,13,0,to,"('SI1', 'MOT')",Providence,wil25.xml,17,4,2,MOT,100,108,SI1
2,0,5,20,1.992430165,20,0,the,"('MOT', 'SI1')",Providence,wil25.xml,27,7,2,SI1,278,174,MOT
0,4,2,139,1.981001469,143,4,did,"('CHI', 'SI1')",Providence,wil25.xml,145,2,0,SI1,643,1060,CHI
4,6,8,127,1.929745212,133,6,this,"('CHI', 'SI1')",Providence,wil25.xml,145,12,4,SI1,643,1060,CHI
1,0,4,22,1.925290862,22,0,and,"('MOT', 'SI1')",Providence,wil25.xml,27,5,1,SI1,278,174,MOT
1,1,1,24,1.909542505,25,1,it,"('MOT', 'SI1')",Providence,wil25.xml,27,2,1,SI1,278,174,MOT
1,0,4,21,1.882731247,21,0,and,"('MOT', 'CHI')",Providence,wil25.xml,26,5,1,CHI,256,120,MOT
1,4,23,408,1.851478704,412,4,to,"('SI1', 'CHI')",Providence,wil25.xml,436,24,1,CHI,3204,1871,SI1
0,3,15,418,1.827864474,421,3,and,"('SI1', 'CHI')",Providence,wil25.xml,436,15,0,CHI,3204,1871,SI1
0,7,1,137,1.805552791,144,7,gonna,"('CHI', 'SI1')",Providence,wil25.xml,145,1,0,SI1,643,1060,CHI
1,1,0,15,1.791759469,16,1,it,"('SI1', 'MOT')",Providence,wil25.xml,17,1,1,MOT,100,108,SI1
0,4,13,419,1.734601055,423,4,up,"('SI1', 'CHI')",Providence,wil25.xml,436,13,0,CHI,3204,1871,SI1
9,13,6,117,1.713116342,130,13,it,"('CHI', 'SI1')",Providence,wil25.xml,145,15,9,SI1,643,1060,CHI
5,8,9,123,1.712295298,131,8,is,"('CHI', 'SI1')",Providence,wil25.xml,145,14,5,SI1,643,1060,CHI
2,8,21,405,1.710790407,413,8,on,"('SI1', 'CHI')",Providence,wil25.xml,436,23,2,CHI,3204,1871,SI1
4,5,14,122,1.681758574,127,5,no,"('CHI', 'SI1')",Providence,wil25.xml,145,18,4,SI1,643,1060,CHI
1,10,2,132,1.655627295,142,10,oh,"('CHI', 'SI1')",Providence,wil25.xml,145,3,1,SI1,643,1060,CHI
1,1,2,22,1.609437912,23,1,the,"('MOT', 'CHI')",Providence,wil25.xml,26,3,1,CHI,256,120,MOT
1,0,0,5,1.540445041,5,0,oh,"('BRO', 'CHI')",Providence,wil25.xml,6,1,1,CHI,26,23,BRO
4,14,4,123,1.533276551,137,14,wanna,"('CHI', 'SI1')",Providence,wil25.xml,145,8,4,SI1,643,1060,CHI
2,8,26,400,1.516347489,408,8,oh,"('SI1', 'CHI')",Providence,wil25.xml,436,28,2,CHI,3204,1871,SI1
1,8,19,408,1.440361582,416,8,get,"('SI1', 'CHI')",Providence,wil25.xml,436,20,1,CHI,3204,1871,SI1
1,0,0,4,1.386294361,4,0,to,"('BRO', 'SI1')",Providence,wil25.xml,5,1,1,SI1,19,35,BRO
0,1,1,20,1.343734747,21,1,in,"('CHI', 'MOT')",Providence,wil25.xml,22,1,0,MOT,109,159,CHI
0,1,1,20,1.343734747,21,1,this,"('CHI', 'MOT')",Providence,wil25.xml,22,1,0,MOT,109,159,CHI
0,1,1,20,1.343734747,21,1,is,"('CHI', 'MOT')",Providence,wil25.xml,22,1,0,MOT,109,159,CHI
0,1,1,20,1.343734747,21,1,one,"('CHI', 'MOT')",Providence,wil25.xml,22,1,0,MOT,109,159,CHI
14,27,38,357,1.342699014,384,27,it,"('SI1', 'CHI')",Providence,wil25.xml,436,52,14,CHI,3204,1871,SI1
1,25,0,119,1.320044976,144,25,you,"('CHI', 'SI1')",Providence,wil25.xml,145,1,1,SI1,643,1060,CHI
0,12,1,132,1.320044976,144,12,we,"('CHI', 'SI1')",Providence,wil25.xml,145,1,0,SI1,643,1060,CHI
1,2,1,18,1.299282984,20,2,that,"('CHI', 'MOT')",Providence,wil25.xml,22,2,1,MOT,109,159,CHI
0,9,2,134,1.287854288,143,9,a,"('CHI', 'SI1')",Providence,wil25.xml,145,2,0,SI1,643,1060,CHI
0,1,2,24,1.216395324,25,1,want,"('MOT', 'SI1')",Providence,wil25.xml,27,2,0,SI1,278,174,MOT
0,1,2,24,1.216395324,25,1,wanna,"('MOT', 'SI1')",Providence,wil25.xml,27,2,0,SI1,278,174,MOT
1,1,3,17,1.203972804,18,1,yeah,"('CHI', 'MOT')",Providence,wil25.xml,22,4,1,MOT,109,159,CHI
0,1,2,23,1.178654996,24,1,not,"('MOT', 'CHI')",Providence,wil25.xml,26,2,0,CHI,256,120,MOT
0,2,1,24,1.134979933,26,2,we,"('MOT', 'SI1')",Providence,wil25.xml,27,1,0,SI1,278,174,MOT
0,2,1,23,1.098612289,25,2,is,"('MOT', 'CHI')",Providence,wil25.xml,26,1,0,CHI,256,120,MOT
0,1,1,15,1.098612289,16,1,he,"('SI1', 'MOT')",Providence,wil25.xml,17,1,0,MOT,100,108,SI1
0,1,1,15,1.098612289,16,1,one,"('SI1', 'MOT')",Providence,wil25.xml,17,1,0,MOT,100,108,SI1
13,24,55,344,1.085189268,368,24,go,"('SI1', 'CHI')",Providence,wil25.xml,436,68,13,CHI,3204,1871,SI1
4,24,4,113,1.022450928,137,24,the,"('CHI', 'SI1')",Providence,wil25.xml,145,8,4,SI1,643,1060,CHI
0,7,17,412,1.018752313,419,7,what,"('SI1', 'CHI')",Providence,wil25.xml,436,17,0,CHI,3204,1871,SI1
0,1,2,19,1.011600912,20,1,what,"('CHI', 'MOT')",Providence,wil25.xml,22,2,0,MOT,109,159,CHI
0,1,3,23,0.955511445,24,1,this,"('MOT', 'SI1')",Providence,wil25.xml,27,3,0,SI1,278,174,MOT
0,1,3,22,0.916290732,23,1,it,"('MOT', 'CHI')",Providence,wil25.xml,26,3,0,CHI,256,120,MOT
3,17,8,117,0.843628131,134,17,go,"('CHI', 'SI1')",Providence,wil25.xml,145,11,3,SI1,643,1060,CHI
0,11,14,411,0.792238083,422,11,that,"('SI1', 'CHI')",Providence,wil25.xml,436,14,0,CHI,3204,1871,SI1
0,2,2,22,0.773189888,24,2,this,"('MOT', 'CHI')",Providence,wil25.xml,26,2,0,CHI,256,120,MOT
0,1,2,14,0.753771802,15,1,go,"('SI1', 'MOT')",Providence,wil25.xml,17,2,0,MOT,100,108,SI1
0,1,2,14,0.753771802,15,1,this,"('SI1', 'MOT')",Providence,wil25.xml,17,2,0,MOT,100,108,SI1
0,1,2,14,0.753771802,15,1,but,"('SI1', 'MOT')",Providence,wil25.xml,17,2,0,MOT,100,108,SI1
0,1,2,14,0.753771802,15,1,no,"('SI1', 'MOT')",Providence,wil25.xml,17,2,0,MOT,100,108,SI1
0,1,4,22,0.733969175,23,1,that,"('MOT', 'SI1')",Providence,wil25.xml,27,4,0,SI1,278,174,MOT
0,1,4,21,0.693147181,22,1,want,"('MOT', 'CHI')",Providence,wil25.xml,26,4,0,CHI,256,120,MOT
1,8,0,17,0.693147181,25,8,wanna,"('MOT', 'CHI')",Providence,wil25.xml,26,1,1,CHI,256,120,MOT
0,2,1,14,0.693147181,16,2,yeah,"('SI1', 'MOT')",Providence,wil25.xml,17,1,0,MOT,100,108,SI1
0,3,1,18,0.650587566,21,3,a,"('CHI', 'MOT')",Providence,wil25.xml,22,1,0,MOT,109,159,CHI
0,2,2,18,0.606135804,20,2,wanna,"('CHI', 'MOT')",Providence,wil25.xml,22,2,0,MOT,109,159,CHI
0,2,2,18,0.606135804,20,2,the,"('CHI', 'MOT')",Providence,wil25.xml,22,2,0,MOT,109,159,CHI
0,2,3,22,0.550046337,24,2,go,"('MOT', 'SI1')",Providence,wil25.xml,27,3,0,SI1,278,174,MOT
0,5,1,21,0.441832752,26,5,a,"('MOT', 'SI1')",Providence,wil25.xml,27,1,0,SI1,278,174,MOT
0,1,1,6,0.405465108,7,1,go,"('CHI', 'FAT')",Providence,wil25.xml,8,1,0,FAT,27,55,CHI
0,1,1,6,0.405465108,7,1,to,"('CHI', 'FAT')",Providence,wil25.xml,8,1,0,FAT,27,55,CHI
0,2,2,13,0.348306694,15,2,you,"('SI1', 'MOT')",Providence,wil25.xml,17,2,0,MOT,100,108,SI1
0,2,3,17,0.336472237,19,2,go,"('CHI', 'MOT')",Providence,wil25.xml,22,3,0,MOT,109,159,CHI
0,1,1,5,0.287682072,6,1,you,"('SI1', 'FAT')",Providence,wil25.xml,7,1,0,FAT,27,29,SI1
0,1,1,5,0.287682072,6,1,do,"('SI1', 'FAT')",Providence,wil25.xml,7,1,0,FAT,27,29,SI1
0,3,3,21,0.262364264,24,3,yeah,"('MOT', 'SI1')",Providence,wil25.xml,27,3,0,SI1,278,174,MOT
2,36,24,374,0.176513215,410,36,no,"('SI1', 'CHI')",Providence,wil25.xml,436,26,2,CHI,3204,1871,SI1
10,33,89,304,0.082414339,337,33,the,"('SI1', 'CHI')",Providence,wil25.xml,436,99,10,CHI,3204,1871,SI1
0,3,85,348,0.014265577,351,3,you,"('SI1', 'CHI')",Providence,wil25.xml,436,85,0,CHI,3204,1871,SI1
0,7,1,14,-0.042559614,21,7,you,"('CHI', 'MOT')",Providence,wil25.xml,22,1,0,MOT,109,159,CHI
0,7,16,122,-0.094615976,129,7,yeah,"('CHI', 'SI1')",Providence,wil25.xml,145,16,0,SI1,643,1060,CHI
1,4,7,15,-0.174353387,19,4,you,"('MOT', 'SI1')",Providence,wil25.xml,27,8,1,SI1,278,174,MOT
0,1,1,2,-0.182321557,3,1,the,"('FAT', 'SI1')",Providence,wil25.xml,4,1,0,SI1,36,22,FAT
3,40,45,348,-0.273153972,388,40,wanna,"('SI1', 'CHI')",Providence,wil25.xml,436,48,3,CHI,3204,1871,SI1
2,62,23,349,-0.316911711,411,62,yeah,"('SI1', 'CHI')",Providence,wil25.xml,436,25,2,CHI,3204,1871,SI1
1,0,5,165,3.731699451,165,0,in,"('MOT', 'CHI')",Providence,wil26.xml,171,6,1,CHI,2598,690,MOT
1,0,5,165,3.731699451,165,0,at,"('MOT', 'CHI')",Providence,wil26.xml,171,6,1,CHI,2598,690,MOT
1,1,2,194,3.673765816,195,1,he,"('CHI', 'MOT')",Providence,wil26.xml,198,3,1,MOT,782,3015,CHI
0,1,1,169,3.355735008,170,1,up,"('MOT', 'CHI')",Providence,wil26.xml,171,1,0,CHI,2598,690,MOT
3,3,2,190,3.32708941,193,3,where,"('CHI', 'MOT')",Providence,wil26.xml,198,5,3,MOT,782,3015,CHI
3,4,1,190,3.263211639,194,4,up,"('CHI', 'MOT')",Providence,wil26.xml,198,4,3,MOT,782,3015,CHI
0,1,2,195,3.208825489,196,1,my,"('CHI', 'MOT')",Providence,wil26.xml,198,2,0,MOT,782,3015,CHI
0,2,1,195,3.096080247,197,2,did,"('CHI', 'MOT')",Providence,wil26.xml,198,1,0,MOT,782,3015,CHI
0,1,3,167,2.833213344,168,1,make,"('MOT', 'CHI')",Providence,wil26.xml,171,3,0,CHI,2598,690,MOT
0,2,2,194,2.803360381,196,2,at,"('CHI', 'MOT')",Providence,wil26.xml,198,2,0,MOT,782,3015,CHI
1,8,0,189,2.690615139,197,8,big,"('CHI', 'MOT')",Providence,wil26.xml,198,1,1,MOT,782,3015,CHI
1,5,2,190,2.575153528,195,5,all,"('CHI', 'MOT')",Providence,wil26.xml,198,3,1,MOT,782,3015,CHI
2,7,2,187,2.505525937,194,7,not,"('CHI', 'MOT')",Providence,wil26.xml,198,4,2,MOT,782,3015,CHI
0,5,1,192,2.402933067,197,5,they,"('CHI', 'MOT')",Providence,wil26.xml,198,1,0,MOT,782,3015,CHI
1,11,0,186,2.402933067,197,11,get,"('CHI', 'MOT')",Providence,wil26.xml,198,1,1,MOT,782,3015,CHI
1,0,25,145,2.351375257,145,0,one,"('MOT', 'CHI')",Providence,wil26.xml,171,26,1,CHI,2598,690,MOT
0,1,6,164,2.34540509,165,1,not,"('MOT', 'CHI')",Providence,wil26.xml,171,6,0,CHI,2598,690,MOT
2,1,18,150,2.344860576,151,1,it,"('MOT', 'CHI')",Providence,wil26.xml,171,20,2,CHI,2598,690,MOT
0,2,4,165,2.239526957,167,2,big,"('MOT', 'CHI')",Providence,wil26.xml,171,4,0,CHI,2598,690,MOT
3,11,2,182,2.228477121,193,11,gonna,"('CHI', 'MOT')",Providence,wil26.xml,198,5,3,MOT,782,3015,CHI
3,11,2,182,2.228477121,193,11,want,"('CHI', 'MOT')",Providence,wil26.xml,198,5,3,MOT,782,3015,CHI
1,3,6,161,2.22161603,164,3,go,"('MOT', 'CHI')",Providence,wil26.xml,171,7,1,CHI,2598,690,MOT
0,7,1,190,2.115250994,197,7,in,"('CHI', 'MOT')",Providence,wil26.xml,198,1,0,MOT,782,3015,CHI
1,12,1,184,2.030170493,196,12,put,"('CHI', 'MOT')",Providence,wil26.xml,198,2,1,MOT,782,3015,CHI
0,1,9,161,2.008823974,162,1,have,"('MOT', 'CHI')",Providence,wil26.xml,171,9,0,CHI,2598,690,MOT
1,5,6,186,1.966853323,191,5,wanna,"('CHI', 'MOT')",Providence,wil26.xml,198,7,1,MOT,782,3015,CHI
1,19,0,178,1.892107443,197,19,on,"('CHI', 'MOT')",Providence,wil26.xml,198,1,1,MOT,782,3015,CHI
1,1,20,149,1.888386305,150,1,this,"('MOT', 'CHI')",Providence,wil26.xml,171,21,1,CHI,2598,690,MOT
1,1,20,149,1.888386305,150,1,and,"('MOT', 'CHI')",Providence,wil26.xml,171,21,1,CHI,2598,690,MOT
0,1,11,159,1.829499797,160,1,some,"('MOT', 'CHI')",Providence,wil26.xml,171,11,0,CHI,2598,690,MOT
1,7,5,185,1.802122256,192,7,go,"('CHI', 'MOT')",Providence,wil26.xml,198,6,1,MOT,782,3015,CHI
0,1,12,158,1.749199855,159,1,they,"('MOT', 'CHI')",Providence,wil26.xml,171,12,0,CHI,2598,690,MOT
0,1,12,158,1.749199855,159,1,see,"('MOT', 'CHI')",Providence,wil26.xml,171,12,0,CHI,2598,690,MOT
0,11,1,186,1.709785886,197,11,have,"('CHI', 'MOT')",Providence,wil26.xml,198,1,0,MOT,782,3015,CHI
0,7,2,162,1.675927654,169,7,want,"('MOT', 'CHI')",Providence,wil26.xml,171,2,0,CHI,2598,690,MOT
7,6,24,134,1.592850889,140,6,the,"('MOT', 'CHI')",Providence,wil26.xml,171,31,7,CHI,2598,690,MOT
0,13,1,184,1.555635206,197,13,for,"('CHI', 'MOT')",Providence,wil26.xml,198,1,0,MOT,782,3015,CHI
1,16,2,179,1.533699653,195,16,one,"('CHI', 'MOT')",Providence,wil26.xml,198,3,1,MOT,782,3015,CHI
1,21,1,175,1.504077397,196,21,do,"('CHI', 'MOT')",Providence,wil26.xml,198,2,1,MOT,782,3015,CHI
1,1,30,139,1.459319496,140,1,is,"('MOT', 'CHI')",Providence,wil26.xml,171,31,1,CHI,2598,690,MOT
1,23,1,173,1.41706602,196,23,and,"('CHI', 'MOT')",Providence,wil26.xml,198,2,1,MOT,782,3015,CHI
8,5,40,118,1.32175584,123,5,a,"('MOT', 'CHI')",Providence,wil26.xml,171,48,8,CHI,2598,690,MOT
0,17,1,180,1.304320778,197,17,see,"('CHI', 'MOT')",Providence,wil26.xml,198,1,0,MOT,782,3015,CHI
0,6,5,160,1.232143681,166,6,look,"('MOT', 'CHI')",Providence,wil26.xml,171,5,0,CHI,2598,690,MOT
2,31,2,163,1.119231576,194,31,it,"('CHI', 'MOT')",Providence,wil26.xml,198,4,2,MOT,782,3015,CHI
3,28,4,163,1.084464143,191,28,this,"('CHI', 'MOT')",Providence,wil26.xml,198,7,3,MOT,782,3015,CHI
0,16,2,180,1.068759326,196,16,oh,"('CHI', 'MOT')",Providence,wil26.xml,198,2,0,MOT,782,3015,CHI
0,22,1,175,1.05919832,197,22,to,"('CHI', 'MOT')",Providence,wil26.xml,198,1,0,MOT,782,3015,CHI
0,11,3,157,1.041453875,168,11,no,"('MOT', 'CHI')",Providence,wil26.xml,171,3,0,CHI,2598,690,MOT
7,30,8,153,1.032596818,183,30,the,"('CHI', 'MOT')",Providence,wil26.xml,198,15,7,MOT,782,3015,CHI
0,25,1,172,0.936595998,197,25,we,"('CHI', 'MOT')",Providence,wil26.xml,198,1,0,MOT,782,3015,CHI
2,15,11,170,0.849081982,185,15,no,"('CHI', 'MOT')",Providence,wil26.xml,198,13,2,MOT,782,3015,CHI
0,5,11,155,0.730887509,160,5,wanna,"('MOT', 'CHI')",Providence,wil26.xml,171,11,0,CHI,2598,690,MOT
0,4,14,153,0.686877568,157,4,oh,"('MOT', 'CHI')",Providence,wil26.xml,171,14,0,CHI,2598,690,MOT
0,16,4,178,0.653141846,194,16,there,"('CHI', 'MOT')",Providence,wil26.xml,198,4,0,MOT,782,3015,CHI
2,37,5,154,0.526491741,191,37,yeah,"('CHI', 'MOT')",Providence,wil26.xml,198,7,2,MOT,782,3015,CHI
0,1,41,129,0.428454626,130,1,what,"('MOT', 'CHI')",Providence,wil26.xml,171,41,0,CHI,2598,690,MOT
10,51,13,124,0.403925462,175,51,a,"('CHI', 'MOT')",Providence,wil26.xml,198,23,10,MOT,782,3015,CHI
5,50,8,135,0.382992252,185,50,is,"('CHI', 'MOT')",Providence,wil26.xml,198,13,5,MOT,782,3015,CHI
1,3,42,125,0.36772478,128,3,you,"('MOT', 'CHI')",Providence,wil26.xml,171,43,1,CHI,2598,690,MOT
2,58,3,135,0.348164254,193,58,you,"('CHI', 'MOT')",Providence,wil26.xml,198,5,2,MOT,782,3015,CHI
1,55,3,139,0.15415068,194,55,that,"('CHI', 'MOT')",Providence,wil26.xml,198,4,1,MOT,782,3015,CHI
2,10,33,126,0.017052788,136,10,that,"('MOT', 'CHI')",Providence,wil26.xml,171,35,2,CHI,2598,690,MOT
0,40,3,155,-0.03980625,195,40,what,"('CHI', 'MOT')",Providence,wil26.xml,198,3,0,MOT,782,3015,CHI
0,9,35,127,-0.98624932,136,9,yeah,"('MOT', 'CHI')",Providence,wil26.xml,171,35,0,CHI,2598,690,MOT
1,0,8,146,3.292464182,146,0,look,"('MOT', 'CHI')",Providence,wil27.xml,155,9,1,CHI,2689,639,MOT
1,0,10,144,3.111804445,144,0,in,"('MOT', 'CHI')",Providence,wil27.xml,155,11,1,CHI,2689,639,MOT
2,0,18,135,2.927550761,135,0,go,"('MOT', 'CHI')",Providence,wil27.xml,155,20,2,CHI,2689,639,MOT
3,1,13,138,2.751535313,139,1,get,"('MOT', 'CHI')",Providence,wil27.xml,155,16,3,CHI,2689,639,MOT
1,0,6,43,2.302585093,43,0,no,"('CHI', 'MOT')",Providence,wil27.xml,50,7,1,MOT,214,1480,CHI
0,1,6,148,2.244691115,149,1,at,"('MOT', 'CHI')",Providence,wil27.xml,155,6,0,CHI,2689,639,MOT
1,3,0,46,2.140066163,49,3,some,"('CHI', 'MOT')",Providence,wil27.xml,50,1,1,MOT,214,1480,CHI
0,1,7,147,2.120263536,148,1,all,"('MOT', 'CHI')",Providence,wil27.xml,155,7,0,CHI,2689,639,MOT
0,2,5,148,1.979358083,150,2,there,"('MOT', 'CHI')",Providence,wil27.xml,155,5,0,CHI,2689,639,MOT
0,1,10,144,1.812378756,145,1,one,"('MOT', 'CHI')",Providence,wil27.xml,155,10,0,CHI,2689,639,MOT
0,2,1,47,1.734601055,49,2,my,"('CHI', 'MOT')",Providence,wil27.xml,50,1,0,MOT,214,1480,CHI
0,2,1,47,1.734601055,49,2,where,"('CHI', 'MOT')",Providence,wil27.xml,50,1,0,MOT,214,1480,CHI
1,3,11,140,1.644529232,143,3,make,"('MOT', 'CHI')",Providence,wil27.xml,155,12,1,CHI,2689,639,MOT
0,1,12,142,1.644529232,143,1,is,"('MOT', 'CHI')",Providence,wil27.xml,155,12,0,CHI,2689,639,MOT
1,4,1,44,1.609437912,48,4,like,"('CHI', 'MOT')",Providence,wil27.xml,50,2,1,MOT,214,1480,CHI
1,3,2,44,1.589235205,47,3,yeah,"('CHI', 'MOT')",Providence,wil27.xml,50,3,1,MOT,214,1480,CHI
0,1,14,140,1.497108727,141,1,oh,"('MOT', 'CHI')",Providence,wil27.xml,155,14,0,CHI,2689,639,MOT
0,1,16,138,1.365240952,139,1,on,"('MOT', 'CHI')",Providence,wil27.xml,155,16,0,CHI,2689,639,MOT
1,9,0,40,1.223775432,49,9,big,"('CHI', 'MOT')",Providence,wil27.xml,50,1,1,MOT,214,1480,CHI
0,4,1,45,1.223775432,49,4,oh,"('CHI', 'MOT')",Providence,wil27.xml,50,1,0,MOT,214,1480,CHI
0,4,1,45,1.223775432,49,4,in,"('CHI', 'MOT')",Providence,wil27.xml,50,1,0,MOT,214,1480,CHI
0,2,13,140,1.16315081,142,2,up,"('MOT', 'CHI')",Providence,wil27.xml,155,13,0,CHI,2689,639,MOT
0,3,2,45,1.139434283,48,3,look,"('CHI', 'MOT')",Providence,wil27.xml,50,2,0,MOT,214,1480,CHI
1,7,1,41,1.139434283,48,7,this,"('CHI', 'MOT')",Providence,wil27.xml,50,2,1,MOT,214,1480,CHI
2,12,0,36,1.059391576,48,12,a,"('CHI', 'MOT')",Providence,wil27.xml,50,2,2,MOT,214,1480,CHI
2,2,37,114,1.057112558,116,2,the,"('MOT', 'CHI')",Providence,wil27.xml,155,39,2,CHI,2689,639,MOT
0,1,23,131,0.985816795,132,1,to,"('MOT', 'CHI')",Providence,wil27.xml,155,23,0,CHI,2689,639,MOT
1,0,0,2,0.980829253,2,0,do,"('FAT', 'MOT')",Providence,wil27.xml,3,1,1,MOT,23,19,FAT
4,13,14,124,0.909122242,137,13,want,"('MOT', 'CHI')",Providence,wil27.xml,155,18,4,CHI,2689,639,MOT
0,2,17,136,0.898591155,138,2,wanna,"('MOT', 'CHI')",Providence,wil27.xml,155,17,0,CHI,2689,639,MOT
1,7,2,40,0.896088025,47,7,do,"('CHI', 'MOT')",Providence,wil27.xml,50,3,1,MOT,214,1480,CHI
5,6,35,109,0.870353637,115,6,it,"('MOT', 'CHI')",Providence,wil27.xml,155,40,5,CHI,2689,639,MOT
0,1,27,127,0.80709144,128,1,that,"('MOT', 'CHI')",Providence,wil27.xml,155,27,0,CHI,2689,639,MOT
3,1,70,81,0.806475866,82,1,you,"('MOT', 'CHI')",Providence,wil27.xml,155,73,3,CHI,2689,639,MOT
0,8,6,141,0.740613718,149,8,yeah,"('MOT', 'CHI')",Providence,wil27.xml,155,6,0,CHI,2689,639,MOT
1,11,1,37,0.733969175,48,11,that,"('CHI', 'MOT')",Providence,wil27.xml,50,2,1,MOT,214,1480,CHI
3,7,26,119,0.724895879,126,7,a,"('MOT', 'CHI')",Providence,wil27.xml,155,29,3,CHI,2689,639,MOT
0,1,29,125,0.724895879,126,1,do,"('MOT', 'CHI')",Providence,wil27.xml,155,29,0,CHI,2689,639,MOT
2,18,0,30,0.679901954,48,18,the,"('CHI', 'MOT')",Providence,wil27.xml,50,2,2,MOT,214,1480,CHI
0,8,1,41,0.635988767,49,8,he,"('CHI', 'MOT')",Providence,wil27.xml,50,1,0,MOT,214,1480,CHI
1,8,3,38,0.575364145,46,8,want,"('CHI', 'MOT')",Providence,wil27.xml,50,4,1,MOT,214,1480,CHI
1,13,2,34,0.336472237,47,13,it,"('CHI', 'MOT')",Providence,wil27.xml,50,3,1,MOT,214,1480,CHI
0,2,30,123,0.279838895,125,2,this,"('MOT', 'CHI')",Providence,wil27.xml,155,30,0,CHI,2689,639,MOT
0,13,1,36,0.194156014,49,13,is,"('CHI', 'MOT')",Providence,wil27.xml,50,1,0,MOT,214,1480,CHI
0,16,1,33,0,49,16,to,"('CHI', 'MOT')",Providence,wil27.xml,50,1,0,MOT,214,1480,CHI
0,13,9,133,-0.039740329,146,13,no,"('MOT', 'CHI')",Providence,wil27.xml,155,9,0,CHI,2689,639,MOT
0,21,3,26,-0.808660068,47,21,you,"('CHI', 'MOT')",Providence,wil27.xml,50,3,0,MOT,214,1480,CHI
1,4,0,244,3.506557897,248,4,was,"('CHI', 'MOT')",Providence,wil28.xml,249,1,1,MOT,1121,2791,CHI
1,3,1,244,3.438011355,247,3,for,"('CHI', 'MOT')",Providence,wil28.xml,249,2,1,MOT,1121,2791,CHI
0,1,2,246,3.438011355,247,1,put,"('CHI', 'MOT')",Providence,wil28.xml,249,2,0,MOT,1121,2791,CHI
2,4,3,240,3.048595763,244,4,there,"('CHI', 'MOT')",Providence,wil28.xml,249,5,2,MOT,1121,2791,CHI
0,4,1,244,2.813410717,248,4,of,"('CHI', 'MOT')",Providence,wil28.xml,249,1,0,MOT,1121,2791,CHI
1,0,5,64,2.803360381,64,0,wanna,"('MOT', 'CHI')",Providence,wil28.xml,70,6,1,CHI,1643,448,MOT
1,7,1,240,2.744864174,247,7,little,"('CHI', 'MOT')",Providence,wil28.xml,249,2,1,MOT,1121,2791,CHI
0,5,1,243,2.63108916,248,5,at,"('CHI', 'MOT')",Providence,wil28.xml,249,1,0,MOT,1121,2791,CHI
1,13,0,235,2.47693848,248,13,did,"('CHI', 'MOT')",Providence,wil28.xml,249,1,1,MOT,1121,2791,CHI
0,1,1,68,2.470920408,69,1,make,"('MOT', 'CHI')",Providence,wil28.xml,70,1,0,CHI,1643,448,MOT
3,13,1,232,2.464865899,245,13,up,"('CHI', 'MOT')",Providence,wil28.xml,249,4,3,MOT,1121,2791,CHI
1,6,3,239,2.464865899,245,6,big,"('CHI', 'MOT')",Providence,wil28.xml,249,4,1,MOT,1121,2791,CHI
3,4,13,229,2.346070205,233,4,make,"('CHI', 'MOT')",Providence,wil28.xml,249,16,3,MOT,1121,2791,CHI
1,0,9,60,2.335374916,60,0,what,"('MOT', 'CHI')",Providence,wil28.xml,70,10,1,CHI,1643,448,MOT
0,4,3,242,2.294552921,246,4,some,"('CHI', 'MOT')",Providence,wil28.xml,249,3,0,MOT,1121,2791,CHI
0,4,3,242,2.294552921,246,4,not,"('CHI', 'MOT')",Providence,wil28.xml,249,3,0,MOT,1121,2791,CHI
2,8,5,234,2.201331359,242,8,like,"('CHI', 'MOT')",Providence,wil28.xml,249,7,2,MOT,1121,2791,CHI
0,1,2,67,2.1690537,68,1,get,"('MOT', 'CHI')",Providence,wil28.xml,70,2,0,CHI,1643,448,MOT
3,4,17,225,2.128231706,229,4,no,"('CHI', 'MOT')",Providence,wil28.xml,249,20,3,MOT,1121,2791,CHI
0,9,1,239,2.120263536,248,9,wanna,"('CHI', 'MOT')",Providence,wil28.xml,249,1,0,MOT,1121,2791,CHI
0,2,1,67,2.0654553,69,2,want,"('MOT', 'CHI')",Providence,wil28.xml,70,1,0,CHI,1643,448,MOT
3,18,2,226,2.001276769,244,18,do,"('CHI', 'MOT')",Providence,wil28.xml,249,5,3,MOT,1121,2791,CHI
0,1,3,66,1.931521412,67,1,at,"('MOT', 'CHI')",Providence,wil28.xml,70,3,0,CHI,1643,448,MOT
1,1,7,61,1.85629799,62,1,one,"('MOT', 'CHI')",Providence,wil28.xml,70,8,1,CHI,1643,448,MOT
1,16,2,230,1.76392467,246,16,in,"('CHI', 'MOT')",Providence,wil28.xml,249,3,1,MOT,1121,2791,CHI
0,1,4,65,1.734601055,66,1,for,"('MOT', 'CHI')",Providence,wil28.xml,70,4,0,CHI,1643,448,MOT
0,1,4,65,1.734601055,66,1,look,"('MOT', 'CHI')",Providence,wil28.xml,70,4,0,CHI,1643,448,MOT
0,1,4,65,1.734601055,66,1,some,"('MOT', 'CHI')",Providence,wil28.xml,70,4,0,CHI,1643,448,MOT
1,4,2,63,1.70837786,67,4,no,"('MOT', 'CHI')",Providence,wil28.xml,70,3,1,CHI,1643,448,MOT
0,15,1,233,1.650259907,248,15,on,"('CHI', 'MOT')",Providence,wil28.xml,249,1,0,MOT,1121,2791,CHI
0,11,2,236,1.646251886,247,11,see,"('CHI', 'MOT')",Providence,wil28.xml,249,2,0,MOT,1121,2791,CHI
0,16,1,232,1.589635285,248,16,go,"('CHI', 'MOT')",Providence,wil28.xml,249,1,0,MOT,1121,2791,CHI
0,1,5,64,1.56563529,65,1,go,"('MOT', 'CHI')",Providence,wil28.xml,70,5,0,CHI,1643,448,MOT
0,17,1,231,1.532476871,248,17,want,"('CHI', 'MOT')",Providence,wil28.xml,249,1,0,MOT,1121,2791,CHI
0,10,3,236,1.506095561,246,10,get,"('CHI', 'MOT')",Providence,wil28.xml,249,3,0,MOT,1121,2791,CHI
5,21,9,214,1.396188435,235,21,the,"('CHI', 'MOT')",Providence,wil28.xml,249,14,5,MOT,1121,2791,CHI
10,30,9,200,1.366123002,230,30,it,"('CHI', 'MOT')",Providence,wil28.xml,249,19,10,MOT,1121,2791,CHI
2,32,2,213,1.319733595,245,32,is,"('CHI', 'MOT')",Providence,wil28.xml,249,4,2,MOT,1121,2791,CHI
0,1,7,62,1.284015512,63,1,oh,"('MOT', 'CHI')",Providence,wil28.xml,70,7,0,CHI,1643,448,MOT
0,1,8,61,1.16315081,62,1,and,"('MOT', 'CHI')",Providence,wil28.xml,70,8,0,CHI,1643,448,MOT
2,0,1,3,1.098612289,3,0,you,"('MOT', 'OPE')",Providence,wil28.xml,6,3,2,OPE,70,29,MOT
4,68,0,177,1.092960275,245,68,you,"('CHI', 'MOT')",Providence,wil28.xml,249,4,4,MOT,1121,2791,CHI
1,1,16,52,1.062894206,53,1,is,"('MOT', 'CHI')",Providence,wil28.xml,70,17,1,CHI,1643,448,MOT
1,3,8,58,1.052092273,61,3,yeah,"('MOT', 'CHI')",Providence,wil28.xml,70,9,1,CHI,1643,448,MOT
17,37,17,178,1.049164013,215,37,a,"('CHI', 'MOT')",Providence,wil28.xml,249,34,17,MOT,1121,2791,CHI
0,2,6,62,1.011600912,64,2,on,"('MOT', 'CHI')",Providence,wil28.xml,70,6,0,CHI,1643,448,MOT
1,4,7,58,0.940007258,62,4,this,"('MOT', 'CHI')",Providence,wil28.xml,70,8,1,CHI,1643,448,MOT
0,13,5,231,0.920364057,244,13,one,"('CHI', 'MOT')",Providence,wil28.xml,249,5,0,MOT,1121,2791,CHI
0,26,2,221,0.835321669,247,26,what,"('CHI', 'MOT')",Providence,wil28.xml,249,2,0,MOT,1121,2791,CHI
0,1,12,57,0.762140052,58,1,to,"('MOT', 'CHI')",Providence,wil28.xml,70,12,0,CHI,1643,448,MOT
0,30,2,217,0.697171331,247,30,to,"('CHI', 'MOT')",Providence,wil28.xml,249,2,0,MOT,1121,2791,CHI
0,1,13,56,0.676340062,57,1,that,"('MOT', 'CHI')",Providence,wil28.xml,70,13,0,CHI,1643,448,MOT
1,3,13,53,0.594707108,56,3,a,"('MOT', 'CHI')",Providence,wil28.xml,70,14,1,CHI,1643,448,MOT
1,2,0,4,0.575364145,6,2,it,"('FAT', 'MOT')",Providence,wil28.xml,7,1,1,MOT,32,111,FAT
0,29,3,217,0.502793452,246,29,oh,"('CHI', 'MOT')",Providence,wil28.xml,249,3,0,MOT,1121,2791,CHI
2,39,7,201,0.500775288,240,39,this,"('CHI', 'MOT')",Providence,wil28.xml,249,9,2,MOT,1121,2791,CHI
0,3,8,59,0.470003629,62,3,in,"('MOT', 'CHI')",Providence,wil28.xml,70,8,0,CHI,1643,448,MOT
0,38,2,209,0.467596889,247,38,that,"('CHI', 'MOT')",Providence,wil28.xml,249,2,0,MOT,1121,2791,CHI
0,1,18,51,0.300104592,52,1,it,"('MOT', 'CHI')",Providence,wil28.xml,70,18,0,CHI,1643,448,MOT
0,1,1,5,0.287682072,6,1,was,"('FAT', 'MOT')",Providence,wil28.xml,7,1,0,MOT,32,111,FAT
0,1,1,5,0.287682072,6,1,not,"('FAT', 'MOT')",Providence,wil28.xml,7,1,0,MOT,32,111,FAT
0,1,1,4,0.15415068,5,1,this,"('MOT', 'OPE')",Providence,wil28.xml,6,1,0,OPE,70,29,MOT
0,1,1,4,0.15415068,5,1,is,"('MOT', 'OPE')",Providence,wil28.xml,6,1,0,OPE,70,29,MOT
0,1,1,3,0,4,1,wanna,"('FAT', 'CHI')",Providence,wil28.xml,5,1,0,CHI,34,23,FAT
1,23,18,207,-0.082691716,230,23,yeah,"('CHI', 'MOT')",Providence,wil28.xml,249,19,1,MOT,1121,2791,CHI
0,2,1,4,-0.117783036,6,2,to,"('FAT', 'MOT')",Providence,wil28.xml,7,1,0,MOT,32,111,FAT
0,1,2,2,-0.470003629,3,1,you,"('MOT', 'FAT')",Providence,wil28.xml,5,2,0,FAT,33,20,MOT
0,6,12,52,-0.490622916,58,6,the,"('MOT', 'CHI')",Providence,wil28.xml,70,12,0,CHI,1643,448,MOT
0,4,1,1,-0.762140052,5,4,yeah,"('MOT', 'OPE')",Providence,wil28.xml,6,1,0,OPE,70,29,MOT
0,1,3,1,-0.916290732,2,1,a,"('FAT', 'CHI')",Providence,wil28.xml,5,3,0,CHI,34,23,FAT
0,2,1,255,3.359603484,257,2,my,"('CHI', 'MOT')",Providence,wil29.xml,258,1,0,MOT,1309,3067,CHI
1,4,1,252,3.250374492,256,4,where,"('CHI', 'MOT')",Providence,wil29.xml,258,2,1,MOT,1309,3067,CHI
1,6,0,251,3.205452805,257,6,some,"('CHI', 'MOT')",Providence,wil29.xml,258,1,1,MOT,1309,3067,CHI
0,4,1,253,2.848777861,257,4,look,"('CHI', 'MOT')",Providence,wil29.xml,258,1,0,MOT,1309,3067,CHI
2,6,3,247,2.748055536,253,6,one,"('CHI', 'MOT')",Providence,wil29.xml,258,5,2,MOT,1309,3067,CHI
1,6,2,249,2.686875204,255,6,all,"('CHI', 'MOT')",Providence,wil29.xml,258,3,1,MOT,1309,3067,CHI
2,10,1,245,2.640355188,255,10,no,"('CHI', 'MOT')",Providence,wil29.xml,258,3,2,MOT,1309,3067,CHI
1,7,2,248,2.553343811,255,7,get,"('CHI', 'MOT')",Providence,wil29.xml,258,3,1,MOT,1309,3067,CHI
0,6,1,251,2.512305624,257,6,make,"('CHI', 'MOT')",Providence,wil29.xml,258,1,0,MOT,1309,3067,CHI
1,10,2,245,2.23489008,255,10,want,"('CHI', 'MOT')",Providence,wil29.xml,258,3,1,MOT,1309,3067,CHI
1,10,2,245,2.23489008,255,10,not,"('CHI', 'MOT')",Providence,wil29.xml,258,3,1,MOT,1309,3067,CHI
3,8,7,240,2.225624052,248,8,big,"('CHI', 'MOT')",Providence,wil29.xml,258,10,3,MOT,1309,3067,CHI
2,16,1,239,2.205037117,255,16,gonna,"('CHI', 'MOT')",Providence,wil29.xml,258,3,2,MOT,1309,3067,CHI
0,9,1,248,2.15563068,257,9,for,"('CHI', 'MOT')",Providence,wil29.xml,258,1,0,MOT,1309,3067,CHI
1,20,0,237,2.106840516,257,20,did,"('CHI', 'MOT')",Providence,wil29.xml,258,1,1,MOT,1309,3067,CHI
1,9,5,243,1.848454813,252,9,up,"('CHI', 'MOT')",Providence,wil29.xml,258,6,1,MOT,1309,3067,CHI
0,14,1,243,1.750165572,257,14,with,"('CHI', 'MOT')",Providence,wil29.xml,258,1,0,MOT,1309,3067,CHI
1,20,2,235,1.588262915,255,20,see,"('CHI', 'MOT')",Providence,wil29.xml,258,3,1,MOT,1309,3067,CHI
2,19,4,233,1.56077274,252,19,in,"('CHI', 'MOT')",Providence,wil29.xml,258,6,2,MOT,1309,3067,CHI
2,22,3,231,1.558471469,253,22,and,"('CHI', 'MOT')",Providence,wil29.xml,258,5,2,MOT,1309,3067,CHI
3,24,4,227,1.503583448,251,24,is,"('CHI', 'MOT')",Providence,wil29.xml,258,7,3,MOT,1309,3067,CHI
0,9,4,245,1.450832882,254,9,like,"('CHI', 'MOT')",Providence,wil29.xml,258,4,0,MOT,1309,3067,CHI
5,19,12,222,1.34464966,241,19,go,"('CHI', 'MOT')",Providence,wil29.xml,258,17,5,MOT,1309,3067,CHI
1,26,2,229,1.336948487,255,26,on,"('CHI', 'MOT')",Providence,wil29.xml,258,3,1,MOT,1309,3067,CHI
0,22,1,235,1.322721557,257,22,can,"('CHI', 'MOT')",Providence,wil29.xml,258,1,0,MOT,1309,3067,CHI
3,33,3,219,1.317826562,252,33,to,"('CHI', 'MOT')",Providence,wil29.xml,258,6,3,MOT,1309,3067,CHI
1,22,3,232,1.31107094,254,22,there,"('CHI', 'MOT')",Providence,wil29.xml,258,4,1,MOT,1309,3067,CHI
3,30,4,221,1.288472068,251,30,that,"('CHI', 'MOT')",Providence,wil29.xml,258,7,3,MOT,1309,3067,CHI
2,40,2,214,1.138458197,254,40,it,"('CHI', 'MOT')",Providence,wil29.xml,258,4,2,MOT,1309,3067,CHI
1,1,0,6,1.098612289,7,1,to,"('MOT', 'CHI')",Providence,wil29.xml,8,1,1,CHI,84,57,MOT
1,0,2,5,1.029619417,5,0,it,"('MOT', 'CHI')",Providence,wil29.xml,8,3,1,CHI,84,57,MOT
0,33,1,224,0.931855248,257,33,we,"('CHI', 'MOT')",Providence,wil29.xml,258,1,0,MOT,1309,3067,CHI
3,22,14,219,0.799422609,241,22,this,"('CHI', 'MOT')",Providence,wil29.xml,258,17,3,MOT,1309,3067,CHI
0,24,3,231,0.720762348,255,24,what,"('CHI', 'MOT')",Providence,wil29.xml,258,3,0,MOT,1309,3067,CHI
0,31,2,225,0.700929321,256,31,oh,"('CHI', 'MOT')",Providence,wil29.xml,258,2,0,MOT,1309,3067,CHI
17,53,23,165,0.557345639,218,53,the,"('CHI', 'MOT')",Providence,wil29.xml,258,40,17,MOT,1309,3067,CHI
2,30,10,216,0.538996501,246,30,a,"('CHI', 'MOT')",Providence,wil29.xml,258,12,2,MOT,1309,3067,CHI
1,12,19,226,0.517794293,238,12,yeah,"('CHI', 'MOT')",Providence,wil29.xml,258,20,1,MOT,1309,3067,CHI
0,1,1,6,0.405465108,7,1,go,"('MOT', 'CHI')",Providence,wil29.xml,8,1,0,CHI,84,57,MOT
1,1,2,4,0.336472237,5,1,the,"('MOT', 'CHI')",Providence,wil29.xml,8,3,1,CHI,84,57,MOT
1,84,2,171,0.190134097,255,84,you,"('CHI', 'MOT')",Providence,wil29.xml,258,3,1,MOT,1309,3067,CHI
0,1,1,2,-0.182321557,3,1,there,"('CHI', 'OPE')",Providence,wil29.xml,4,1,0,OPE,45,19,CHI
0,1,1,1,-0.405465108,2,1,you,"('MOT', 'FAT')",Providence,wil29.xml,3,1,0,FAT,16,11,MOT
0,1,1,1,-0.405465108,2,1,see,"('MOT', 'FAT')",Providence,wil29.xml,3,1,0,FAT,16,11,MOT
0,1,2,176,3.107944264,177,1,make,"('MOT', 'CHI')",Providence,wil30.xml,179,2,0,CHI,2800,1159,MOT
1,2,3,173,2.978925155,175,2,wanna,"('MOT', 'CHI')",Providence,wil30.xml,179,4,1,CHI,2800,1159,MOT
0,1,4,174,2.691243083,175,1,she,"('MOT', 'CHI')",Providence,wil30.xml,179,4,0,CHI,2800,1159,MOT
2,3,5,169,2.674148649,172,3,put,"('MOT', 'CHI')",Providence,wil30.xml,179,7,2,CHI,2800,1159,MOT
1,1,10,167,2.57084908,168,1,of,"('MOT', 'CHI')",Providence,wil30.xml,179,11,1,CHI,2800,1159,MOT
1,3,4,171,2.531426665,174,3,he,"('MOT', 'CHI')",Providence,wil30.xml,179,5,1,CHI,2800,1159,MOT
0,1,6,172,2.392197252,173,1,was,"('MOT', 'CHI')",Providence,wil30.xml,179,6,0,CHI,2800,1159,MOT
0,2,4,173,2.285777975,175,2,at,"('MOT', 'CHI')",Providence,wil30.xml,179,4,0,CHI,2800,1159,MOT
3,4,9,163,2.267697834,167,4,one,"('MOT', 'CHI')",Providence,wil30.xml,179,12,3,CHI,2800,1159,MOT
0,1,8,170,2.157559321,171,1,they,"('MOT', 'CHI')",Providence,wil30.xml,179,8,0,CHI,2800,1159,MOT
0,1,8,170,2.157559321,171,1,little,"('MOT', 'CHI')",Providence,wil30.xml,179,8,0,CHI,2800,1159,MOT
1,2,11,165,2.085376277,167,2,all,"('MOT', 'CHI')",Providence,wil30.xml,179,12,1,CHI,2800,1159,MOT
0,1,9,169,2.056452023,170,1,not,"('MOT', 'CHI')",Providence,wil30.xml,179,9,0,CHI,2800,1159,MOT
0,2,6,171,1.986732144,173,2,up,"('MOT', 'CHI')",Providence,wil30.xml,179,6,0,CHI,2800,1159,MOT
2,4,10,163,1.980015762,167,4,there,"('MOT', 'CHI')",Providence,wil30.xml,179,12,2,CHI,2800,1159,MOT
1,0,0,8,1.897119985,8,0,all,"('CHI', 'OPE')",Providence,wil30.xml,9,1,1,OPE,104,43,CHI
0,6,2,171,1.855181296,177,6,my,"('MOT', 'CHI')",Providence,wil30.xml,179,2,0,CHI,2800,1159,MOT
0,4,4,171,1.774952351,175,4,get,"('MOT', 'CHI')",Providence,wil30.xml,179,4,0,CHI,2800,1159,MOT
0,1,13,165,1.722766598,166,1,we,"('MOT', 'CHI')",Providence,wil30.xml,179,13,0,CHI,2800,1159,MOT
0,3,6,170,1.699050071,173,3,have,"('MOT', 'CHI')",Providence,wil30.xml,179,6,0,CHI,2800,1159,MOT
2,0,61,116,1.694909643,116,0,you,"('MOT', 'CHI')",Providence,wil30.xml,179,63,2,CHI,2800,1159,MOT
0,1,2,37,1.609437912,38,1,no,"('CHI', 'MOT')",Providence,wil30.xml,40,2,0,MOT,257,1208,CHI
0,2,1,37,1.516347489,39,2,gonna,"('CHI', 'MOT')",Providence,wil30.xml,40,1,0,MOT,257,1208,CHI
1,0,1,7,1.504077397,7,0,you,"('CHI', 'OPE')",Providence,wil30.xml,9,2,1,OPE,104,43,CHI
1,0,1,7,1.504077397,7,0,yeah,"('CHI', 'OPE')",Providence,wil30.xml,9,2,1,OPE,104,43,CHI
1,0,1,7,1.504077397,7,0,the,"('CHI', 'OPE')",Providence,wil30.xml,9,2,1,OPE,104,43,CHI
2,5,15,157,1.462280268,162,5,like,"('MOT', 'CHI')",Providence,wil30.xml,179,17,2,CHI,2800,1159,MOT
2,6,0,32,1.455287233,38,6,do,"('CHI', 'MOT')",Providence,wil30.xml,40,2,2,MOT,257,1208,CHI
0,2,12,165,1.392229097,167,2,oh,"('MOT', 'CHI')",Providence,wil30.xml,179,12,0,CHI,2800,1159,MOT
0,3,10,166,1.270462546,169,3,on,"('MOT', 'CHI')",Providence,wil30.xml,179,10,0,CHI,2800,1159,MOT
2,0,2,5,1.252762968,5,0,it,"('CHI', 'OPE')",Providence,wil30.xml,9,4,2,OPE,104,43,CHI
0,3,1,36,1.228665417,39,3,go,"('CHI', 'MOT')",Providence,wil30.xml,40,1,0,MOT,257,1208,CHI
1,3,23,152,1.105002087,155,3,do,"('MOT', 'CHI')",Providence,wil30.xml,179,24,1,CHI,2800,1159,MOT
1,13,6,159,1.015920573,172,13,want,"('MOT', 'CHI')",Providence,wil30.xml,179,7,1,CHI,2800,1159,MOT
0,4,1,35,1.005521866,39,4,like,"('CHI', 'MOT')",Providence,wil30.xml,40,1,0,MOT,257,1208,CHI
0,4,1,35,1.005521866,39,4,they,"('CHI', 'MOT')",Providence,wil30.xml,40,1,0,MOT,257,1208,CHI
0,2,18,159,0.999405639,161,2,can,"('MOT', 'CHI')",Providence,wil30.xml,179,18,0,CHI,2800,1159,MOT
0,2,3,35,0.955511445,37,2,there,"('CHI', 'MOT')",Providence,wil30.xml,40,3,0,MOT,257,1208,CHI
0,9,5,165,0.921988753,174,9,gonna,"('MOT', 'CHI')",Providence,wil30.xml,179,5,0,CHI,2800,1159,MOT
2,10,14,153,0.916290732,163,10,and,"('MOT', 'CHI')",Providence,wil30.xml,179,16,2,CHI,2800,1159,MOT
0,3,2,35,0.916290732,38,3,did,"('CHI', 'MOT')",Providence,wil30.xml,40,2,0,MOT,257,1208,CHI
0,1,1,12,0.916290732,13,1,a,"('OPE', 'CHI')",Providence,wil30.xml,14,1,0,CHI,86,54,OPE
3,8,23,145,0.900290391,153,8,a,"('MOT', 'CHI')",Providence,wil30.xml,179,26,3,CHI,2800,1159,MOT
0,7,7,165,0.88238918,172,7,go,"('MOT', 'CHI')",Providence,wil30.xml,179,7,0,CHI,2800,1159,MOT
0,6,9,164,0.803689055,170,6,look,"('MOT', 'CHI')",Providence,wil30.xml,179,9,0,CHI,2800,1159,MOT
4,10,28,137,0.689128421,147,10,the,"('MOT', 'CHI')",Providence,wil30.xml,179,32,4,CHI,2800,1159,MOT
5,16,21,137,0.669766732,153,16,it,"('MOT', 'CHI')",Providence,wil30.xml,179,26,5,CHI,2800,1159,MOT
0,6,1,33,0.669049629,39,6,up,"('CHI', 'MOT')",Providence,wil30.xml,40,1,0,MOT,257,1208,CHI
3,7,4,26,0.664976304,33,7,it,"('CHI', 'MOT')",Providence,wil30.xml,40,7,3,MOT,257,1208,CHI
1,16,8,154,0.609533041,170,16,no,"('MOT', 'CHI')",Providence,wil30.xml,179,9,1,CHI,2800,1159,MOT
1,6,3,30,0.593063722,36,6,this,"('CHI', 'MOT')",Providence,wil30.xml,40,4,1,MOT,257,1208,CHI
1,8,2,29,0.550046337,37,8,is,"('CHI', 'MOT')",Providence,wil30.xml,40,3,1,MOT,257,1208,CHI
0,1,1,7,0.510825624,8,1,like,"('CHI', 'OPE')",Providence,wil30.xml,9,1,0,OPE,104,43,CHI
0,1,1,7,0.510825624,8,1,see,"('CHI', 'OPE')",Providence,wil30.xml,9,1,0,OPE,104,43,CHI
0,1,1,7,0.510825624,8,1,that,"('CHI', 'OPE')",Providence,wil30.xml,9,1,0,OPE,104,43,CHI
0,2,1,11,0.510825624,13,2,go,"('OPE', 'CHI')",Providence,wil30.xml,14,1,0,CHI,86,54,OPE
0,2,1,11,0.510825624,13,2,the,"('OPE', 'CHI')",Providence,wil30.xml,14,1,0,CHI,86,54,OPE
1,8,19,151,0.486284515,159,8,in,"('MOT', 'CHI')",Providence,wil30.xml,179,20,1,CHI,2800,1159,MOT
0,6,13,160,0.470003629,166,6,see,"('MOT', 'CHI')",Providence,wil30.xml,179,13,0,CHI,2800,1159,MOT
1,6,4,29,0.412244795,35,6,that,"('CHI', 'MOT')",Providence,wil30.xml,40,5,1,MOT,257,1208,CHI
1,7,23,148,0.411854906,155,7,is,"('MOT', 'CHI')",Providence,wil30.xml,179,24,1,CHI,2800,1159,MOT
3,13,27,136,0.298780966,149,13,to,"('MOT', 'CHI')",Providence,wil30.xml,179,30,3,CHI,2800,1159,MOT
3,18,1,18,0.287682072,36,18,the,"('CHI', 'MOT')",Providence,wil30.xml,40,4,3,MOT,257,1208,CHI
0,5,21,153,0.14792013,158,5,what,"('MOT', 'CHI')",Providence,wil30.xml,179,21,0,CHI,2800,1159,MOT
0,11,1,28,0.130053128,39,11,and,"('CHI', 'MOT')",Providence,wil30.xml,40,1,0,MOT,257,1208,CHI
2,11,4,23,0.117783036,34,11,a,"('CHI', 'MOT')",Providence,wil30.xml,40,6,2,MOT,257,1208,CHI
1,4,2,7,0.039220713,11,4,yeah,"('OPE', 'CHI')",Providence,wil30.xml,14,3,1,CHI,86,54,OPE
0,6,23,150,-0.102190941,156,6,that,"('MOT', 'CHI')",Providence,wil30.xml,179,23,0,CHI,2800,1159,MOT
1,15,20,143,-0.139761942,158,15,this,"('MOT', 'CHI')",Providence,wil30.xml,179,21,1,CHI,2800,1159,MOT
0,15,12,152,-0.281747337,167,15,yeah,"('MOT', 'CHI')",Providence,wil30.xml,179,12,0,CHI,2800,1159,MOT
0,10,3,27,-0.343771539,37,10,in,"('CHI', 'MOT')",Providence,wil30.xml,40,3,0,MOT,257,1208,CHI
1,1,4,364,3.959451699,365,1,was,"('MOT', 'CHI')",Providence,wil31.xml,370,5,1,CHI,5785,1947,MOT
0,1,5,364,3.266304518,365,1,make,"('MOT', 'CHI')",Providence,wil31.xml,370,5,0,CHI,5785,1947,MOT
1,1,17,351,2.87356464,352,1,of,"('MOT', 'CHI')",Providence,wil31.xml,370,18,1,CHI,5785,1947,MOT
1,1,18,350,2.821945619,351,1,up,"('MOT', 'CHI')",Providence,wil31.xml,370,19,1,CHI,5785,1947,MOT
1,4,7,358,2.678278043,362,4,my,"('MOT', 'CHI')",Providence,wil31.xml,370,8,1,CHI,5785,1947,MOT
0,2,7,361,2.604060488,363,2,did,"('MOT', 'CHI')",Providence,wil31.xml,370,7,0,CHI,5785,1947,MOT
1,2,18,349,2.416480511,351,2,with,"('MOT', 'CHI')",Providence,wil31.xml,370,19,1,CHI,5785,1947,MOT
0,1,17,352,2.23453163,353,1,but,"('MOT', 'CHI')",Providence,wil31.xml,370,17,0,CHI,5785,1947,MOT
0,2,13,355,2.076659899,357,2,look,"('MOT', 'CHI')",Providence,wil31.xml,370,13,0,CHI,5785,1947,MOT
2,4,23,341,2.04266229,345,4,not,"('MOT', 'CHI')",Providence,wil31.xml,370,25,2,CHI,5785,1947,MOT
1,2,28,339,1.998278135,341,2,like,"('MOT', 'CHI')",Providence,wil31.xml,370,29,1,CHI,5785,1947,MOT
0,4,8,358,1.985130862,362,4,big,"('MOT', 'CHI')",Providence,wil31.xml,370,8,0,CHI,5785,1947,MOT
0,1,23,346,1.943048917,347,1,go,"('MOT', 'CHI')",Providence,wil31.xml,370,23,0,CHI,5785,1947,MOT
1,8,9,352,1.902660165,360,8,there,"('MOT', 'CHI')",Providence,wil31.xml,370,10,1,CHI,5785,1947,MOT
4,4,45,317,1.84582669,321,4,is,"('MOT', 'CHI')",Providence,wil31.xml,370,49,4,CHI,5785,1947,MOT
0,3,13,354,1.788977826,357,3,where,"('MOT', 'CHI')",Providence,wil31.xml,370,13,0,CHI,5785,1947,MOT
0,1,27,342,1.783101406,343,1,gonna,"('MOT', 'CHI')",Providence,wil31.xml,370,27,0,CHI,5785,1947,MOT
0,2,21,347,1.626679719,349,2,are,"('MOT', 'CHI')",Providence,wil31.xml,370,21,0,CHI,5785,1947,MOT
1,4,27,338,1.523153544,342,4,wanna,"('MOT', 'CHI')",Providence,wil31.xml,370,28,1,CHI,5785,1947,MOT
21,20,51,278,1.446237397,298,20,it,"('MOT', 'CHI')",Providence,wil31.xml,370,72,21,CHI,5785,1947,MOT
0,1,41,328,1.347771079,329,1,we,"('MOT', 'CHI')",Providence,wil31.xml,370,41,0,CHI,5785,1947,MOT
0,3,22,345,1.293584963,348,3,for,"('MOT', 'CHI')",Providence,wil31.xml,370,22,0,CHI,5785,1947,MOT
0,4,19,347,1.212507707,351,4,get,"('MOT', 'CHI')",Providence,wil31.xml,370,19,0,CHI,5785,1947,MOT
0,3,24,343,1.207811581,346,3,put,"('MOT', 'CHI')",Providence,wil31.xml,370,24,0,CHI,5785,1947,MOT
1,3,48,318,1.15267951,321,3,and,"('MOT', 'CHI')",Providence,wil31.xml,370,49,1,CHI,5785,1947,MOT
1,6,29,334,1.116311866,340,6,in,"('MOT', 'CHI')",Providence,wil31.xml,370,30,1,CHI,5785,1947,MOT
0,6,18,346,0.927654491,352,6,one,"('MOT', 'CHI')",Providence,wil31.xml,370,18,0,CHI,5785,1947,MOT
3,32,14,321,0.81746561,353,32,no,"('MOT', 'CHI')",Providence,wil31.xml,370,17,3,CHI,5785,1947,MOT
1,9,28,332,0.79430533,341,9,all,"('MOT', 'CHI')",Providence,wil31.xml,370,29,1,CHI,5785,1947,MOT
0,6,21,343,0.779381858,349,6,see,"('MOT', 'CHI')",Providence,wil31.xml,370,21,0,CHI,5785,1947,MOT
2,9,42,317,0.760399408,326,9,this,"('MOT', 'CHI')",Providence,wil31.xml,370,44,2,CHI,5785,1947,MOT
0,3,38,329,0.735967178,332,3,what,"('MOT', 'CHI')",Providence,wil31.xml,370,38,0,CHI,5785,1947,MOT
1,15,19,335,0.693147181,350,15,want,"('MOT', 'CHI')",Providence,wil31.xml,370,20,1,CHI,5785,1947,MOT
2,10,48,310,0.524024843,320,10,do,"('MOT', 'CHI')",Providence,wil31.xml,370,50,2,CHI,5785,1947,MOT
0,3,48,319,0.482426149,322,3,can,"('MOT', 'CHI')",Providence,wil31.xml,370,48,0,CHI,5785,1947,MOT
3,11,59,297,0.479076925,308,11,that,"('MOT', 'CHI')",Providence,wil31.xml,370,62,3,CHI,5785,1947,MOT
1,9,39,321,0.458027438,330,9,on,"('MOT', 'CHI')",Providence,wil31.xml,370,40,1,CHI,5785,1947,MOT
3,12,56,299,0.45667433,311,12,a,"('MOT', 'CHI')",Providence,wil31.xml,370,59,3,CHI,5785,1947,MOT
8,17,98,247,0.208217901,264,17,the,"('MOT', 'CHI')",Providence,wil31.xml,370,106,8,CHI,5785,1947,MOT
0,7,33,330,0.191210504,337,7,oh,"('MOT', 'CHI')",Providence,wil31.xml,370,33,0,CHI,5785,1947,MOT
5,34,40,291,0.176223977,325,34,yeah,"('MOT', 'CHI')",Providence,wil31.xml,370,45,5,CHI,5785,1947,MOT
0,4,54,312,0.12726178,316,4,to,"('MOT', 'CHI')",Providence,wil31.xml,370,54,0,CHI,5785,1947,MOT
5,9,124,232,0.107038496,241,9,you,"('MOT', 'CHI')",Providence,wil31.xml,370,129,5,CHI,5785,1947,MOT
3,0,9,208,4.094344562,208,0,like,"('MOT', 'CHI')",Providence,wil32.xml,220,12,3,CHI,2766,1151,MOT
1,0,0,59,3.705408756,59,0,not,"('CHI', 'MOT')",Providence,wil32.xml,60,1,1,MOT,669,535,CHI
1,0,8,211,3.656544073,211,0,put,"('MOT', 'CHI')",Providence,wil32.xml,220,9,1,CHI,2766,1151,MOT
1,0,12,207,3.327431231,207,0,have,"('MOT', 'CHI')",Providence,wil32.xml,220,13,1,CHI,2766,1151,MOT
0,1,2,217,3.314186005,218,1,get,"('MOT', 'CHI')",Providence,wil32.xml,220,2,0,CHI,2766,1151,MOT
1,1,8,210,2.963396893,211,1,one,"('MOT', 'CHI')",Providence,wil32.xml,220,9,1,CHI,2766,1151,MOT
0,1,4,215,2.899588413,216,1,of,"('MOT', 'CHI')",Providence,wil32.xml,220,4,0,CHI,2766,1151,MOT
1,0,22,197,2.76757618,197,0,do,"('MOT', 'CHI')",Providence,wil32.xml,220,23,1,CHI,2766,1151,MOT
1,1,1,57,2.708050201,58,1,gonna,"('CHI', 'MOT')",Providence,wil32.xml,60,2,1,MOT,669,535,CHI
0,2,3,215,2.681021529,217,2,go,"('MOT', 'CHI')",Providence,wil32.xml,220,3,0,CHI,2766,1151,MOT
0,1,6,213,2.602689685,214,1,gonna,"('MOT', 'CHI')",Providence,wil32.xml,220,6,0,CHI,2766,1151,MOT
1,1,13,205,2.564949357,206,1,see,"('MOT', 'CHI')",Providence,wil32.xml,220,14,1,CHI,2766,1151,MOT
3,9,2,206,2.517696473,215,9,my,"('MOT', 'CHI')",Providence,wil32.xml,220,5,3,CHI,2766,1151,MOT
0,1,7,212,2.48026627,213,1,all,"('MOT', 'CHI')",Providence,wil32.xml,220,7,0,CHI,2766,1151,MOT
1,1,2,56,2.468099531,57,1,go,"('CHI', 'MOT')",Providence,wil32.xml,60,3,1,MOT,669,535,CHI
2,2,1,55,2.468099531,57,2,one,"('CHI', 'MOT')",Providence,wil32.xml,60,3,2,MOT,669,535,CHI
0,2,5,213,2.335374916,215,2,there,"('MOT', 'CHI')",Providence,wil32.xml,220,5,0,CHI,2766,1151,MOT
1,3,0,56,2.319114395,59,3,all,"('CHI', 'MOT')",Providence,wil32.xml,60,1,1,MOT,669,535,CHI
0,1,1,58,2.319114395,59,1,wanna,"('CHI', 'MOT')",Providence,wil32.xml,60,1,0,MOT,669,535,CHI
0,1,1,58,2.319114395,59,1,big,"('CHI', 'MOT')",Providence,wil32.xml,60,1,0,MOT,669,535,CHI
4,3,21,192,2.210510414,195,3,and,"('MOT', 'CHI')",Providence,wil32.xml,220,25,4,CHI,2766,1151,MOT
0,2,7,211,2.074801162,213,2,not,"('MOT', 'CHI')",Providence,wil32.xml,220,7,0,CHI,2766,1151,MOT
4,8,9,199,2.046497386,207,8,no,"('MOT', 'CHI')",Providence,wil32.xml,220,13,4,CHI,2766,1151,MOT
1,0,0,9,1.992430165,9,0,we,"('MOT', 'TOY')",Providence,wil32.xml,10,1,1,TOY,103,88,MOT
0,2,8,210,1.964778633,212,2,was,"('MOT', 'CHI')",Providence,wil32.xml,220,8,0,CHI,2766,1151,MOT
1,5,0,54,1.913649287,59,5,can,"('CHI', 'MOT')",Providence,wil32.xml,60,1,1,MOT,669,535,CHI
4,9,10,197,1.871802177,206,9,where,"('MOT', 'CHI')",Providence,wil32.xml,220,14,4,CHI,2766,1151,MOT
1,2,3,54,1.863218433,56,2,it,"('CHI', 'MOT')",Providence,wil32.xml,60,4,1,MOT,669,535,CHI
1,3,2,54,1.774952351,57,3,get,"('CHI', 'MOT')",Providence,wil32.xml,60,3,1,MOT,669,535,CHI
3,4,23,190,1.722766598,194,4,on,"('MOT', 'CHI')",Providence,wil32.xml,220,26,3,CHI,2766,1151,MOT
1,2,4,53,1.691676011,55,2,yeah,"('CHI', 'MOT')",Providence,wil32.xml,60,5,1,MOT,669,535,CHI
4,8,16,192,1.629438579,200,8,oh,"('MOT', 'CHI')",Providence,wil32.xml,220,20,4,CHI,2766,1151,MOT
0,3,1,56,1.625967214,59,3,little,"('CHI', 'MOT')",Providence,wil32.xml,60,1,0,MOT,669,535,CHI
0,2,12,206,1.609437912,208,2,at,"('MOT', 'CHI')",Providence,wil32.xml,220,12,0,CHI,2766,1151,MOT
0,2,2,56,1.609437912,58,2,this,"('CHI', 'MOT')",Providence,wil32.xml,60,2,0,MOT,669,535,CHI
1,5,1,53,1.609437912,58,5,do,"('CHI', 'MOT')",Providence,wil32.xml,60,2,1,MOT,669,535,CHI
2,5,17,196,1.575536361,201,5,to,"('MOT', 'CHI')",Providence,wil32.xml,220,19,2,CHI,2766,1151,MOT
1,4,2,53,1.5518088,57,4,want,"('CHI', 'MOT')",Providence,wil32.xml,60,3,1,MOT,669,535,CHI
0,5,6,209,1.504077397,214,5,want,"('MOT', 'CHI')",Providence,wil32.xml,220,6,0,CHI,2766,1151,MOT
4,8,19,189,1.486642335,197,8,a,"('MOT', 'CHI')",Providence,wil32.xml,220,23,4,CHI,2766,1151,MOT
0,1,22,197,1.427116356,198,1,we,"('MOT', 'CHI')",Providence,wil32.xml,220,22,0,CHI,2766,1151,MOT
0,1,5,54,1.403993938,55,1,on,"('CHI', 'MOT')",Providence,wil32.xml,60,5,0,MOT,669,535,CHI
0,4,1,55,1.402823663,59,4,that,"('CHI', 'MOT')",Providence,wil32.xml,60,1,0,MOT,669,535,CHI
0,5,7,208,1.381653982,213,5,he,"('MOT', 'CHI')",Providence,wil32.xml,220,7,0,CHI,2766,1151,MOT
0,2,3,55,1.369487243,57,2,what,"('CHI', 'MOT')",Providence,wil32.xml,60,3,0,MOT,669,535,CHI
0,3,12,205,1.32175584,208,3,what,"('MOT', 'CHI')",Providence,wil32.xml,220,12,0,CHI,2766,1151,MOT
0,3,12,205,1.32175584,208,3,wanna,"('MOT', 'CHI')",Providence,wil32.xml,220,12,0,CHI,2766,1151,MOT
0,1,7,52,1.116961427,53,1,no,"('CHI', 'MOT')",Providence,wil32.xml,60,7,0,MOT,669,535,CHI
0,3,3,54,1.08180517,57,3,and,"('CHI', 'MOT')",Providence,wil32.xml,60,3,0,MOT,669,535,CHI
1,5,20,194,1.069198403,199,5,this,"('MOT', 'CHI')",Providence,wil32.xml,220,21,1,CHI,2766,1151,MOT
1,5,4,50,0.99852883,55,5,the,"('CHI', 'MOT')",Providence,wil32.xml,60,5,1,MOT,669,535,CHI
5,14,22,179,0.989412997,193,14,yeah,"('MOT', 'CHI')",Providence,wil32.xml,220,27,5,CHI,2766,1151,MOT
1,2,0,7,0.893817876,9,2,and,"('MOT', 'TOY')",Providence,wil32.xml,10,1,1,TOY,103,88,MOT
0,4,3,53,0.858661619,57,4,he,"('CHI', 'MOT')",Providence,wil32.xml,60,3,0,MOT,669,535,CHI
3,10,4,43,0.798507696,53,10,a,"('CHI', 'MOT')",Providence,wil32.xml,60,7,3,MOT,669,535,CHI
1,9,17,193,0.712949808,202,9,in,"('MOT', 'CHI')",Providence,wil32.xml,220,18,1,CHI,2766,1151,MOT
1,14,1,44,0.693147181,58,14,you,"('CHI', 'MOT')",Providence,wil32.xml,60,2,1,MOT,669,535,CHI
1,0,1,2,0.693147181,2,0,a,"('TOY', 'MOT')",Providence,wil32.xml,4,2,1,MOT,46,73,TOY
0,1,11,48,0.673729095,49,1,where,"('CHI', 'MOT')",Providence,wil32.xml,60,11,0,MOT,669,535,CHI
0,1,1,8,0.606135804,9,1,with,"('MOT', 'TOY')",Providence,wil32.xml,10,1,0,TOY,103,88,MOT
0,1,1,8,0.606135804,9,1,a,"('MOT', 'TOY')",Providence,wil32.xml,10,1,0,TOY,103,88,MOT
1,1,0,2,0.510825624,3,1,my,"('TOY', 'CHI')",Providence,wil32.xml,4,1,1,CHI,43,17,TOY
1,12,21,186,0.248461359,198,12,it,"('MOT', 'CHI')",Providence,wil32.xml,220,22,1,CHI,2766,1151,MOT
1,12,21,186,0.248461359,198,12,the,"('MOT', 'CHI')",Providence,wil32.xml,220,22,1,CHI,2766,1151,MOT
1,4,51,164,0.230523659,168,4,you,"('MOT', 'CHI')",Providence,wil32.xml,220,52,1,CHI,2766,1151,MOT
1,3,1,5,0.223143551,8,3,go,"('MOT', 'TOY')",Providence,wil32.xml,10,2,1,TOY,103,88,MOT
0,2,13,45,0.085157808,47,2,is,"('CHI', 'MOT')",Providence,wil32.xml,60,13,0,MOT,669,535,CHI
1,3,2,4,-0.105360516,7,3,the,"('MOT', 'TOY')",Providence,wil32.xml,10,3,1,TOY,103,88,MOT
0,4,10,46,-0.143100844,50,4,oh,"('CHI', 'MOT')",Providence,wil32.xml,60,10,0,MOT,669,535,CHI
0,1,1,2,-0.182321557,3,1,and,"('TOY', 'MOT')",Providence,wil32.xml,4,1,0,MOT,46,73,TOY
1,14,35,170,-0.426742507,184,14,is,"('MOT', 'CHI')",Providence,wil32.xml,220,36,1,CHI,2766,1151,MOT
1,17,35,167,-0.609064063,184,17,that,"('MOT', 'CHI')",Providence,wil32.xml,220,36,1,CHI,2766,1151,MOT
0,1,2,1,-0.693147181,2,1,oh,"('CHI', 'FAT')",Providence,wil32.xml,4,2,0,FAT,23,9,CHI
0,1,2,1,-0.693147181,2,1,the,"('TOY', 'MOT')",Providence,wil32.xml,4,2,0,MOT,46,73,TOY
1,3,0,150,3.251665648,153,3,look,"('CHI', 'FAT')",Providence,wil33.xml,154,1,1,FAT,883,1219,CHI
0,1,1,152,3.251665648,153,1,up,"('CHI', 'FAT')",Providence,wil33.xml,154,1,0,FAT,883,1219,CHI
0,1,1,152,3.251665648,153,1,he,"('CHI', 'FAT')",Providence,wil33.xml,154,1,0,FAT,883,1219,CHI
1,0,1,48,3.218875825,48,0,was,"('FAT', 'CHI')",Providence,wil33.xml,50,2,1,CHI,402,392,FAT
2,2,3,147,3.071369688,149,2,gonna,"('CHI', 'FAT')",Providence,wil33.xml,154,5,2,FAT,883,1219,CHI
0,2,1,151,2.84620054,153,2,did,"('CHI', 'FAT')",Providence,wil33.xml,154,1,0,FAT,883,1219,CHI
2,4,3,145,2.560544064,149,4,one,"('CHI', 'FAT')",Providence,wil33.xml,154,5,2,FAT,883,1219,CHI
1,5,1,147,2.552045953,152,5,but,"('CHI', 'FAT')",Providence,wil33.xml,154,2,1,FAT,883,1219,CHI
1,1,1,47,2.525728644,48,1,little,"('FAT', 'CHI')",Providence,wil33.xml,50,2,1,CHI,402,392,FAT
1,2,0,47,2.427748236,49,2,is,"('FAT', 'CHI')",Providence,wil33.xml,50,1,1,CHI,402,392,FAT
0,3,2,149,2.26436388,152,3,we,"('CHI', 'FAT')",Providence,wil33.xml,154,2,0,FAT,883,1219,CHI
1,3,5,145,2.238046572,148,3,not,"('CHI', 'FAT')",Providence,wil33.xml,154,6,1,FAT,883,1219,CHI
0,5,1,148,2.153053359,153,5,there,"('CHI', 'FAT')",Providence,wil33.xml,154,1,0,FAT,883,1219,CHI
0,5,1,148,2.153053359,153,5,can,"('CHI', 'FAT')",Providence,wil33.xml,154,1,0,FAT,883,1219,CHI
0,1,1,48,2.140066163,49,1,in,"('FAT', 'CHI')",Providence,wil33.xml,50,1,0,CHI,402,392,FAT
0,1,1,48,2.140066163,49,1,we,"('FAT', 'CHI')",Providence,wil33.xml,50,1,0,CHI,402,392,FAT
0,1,1,48,2.140066163,49,1,my,"('FAT', 'CHI')",Providence,wil33.xml,50,1,0,CHI,402,392,FAT
1,0,1,13,2.014903021,13,0,are,"('CHI', 'MOT')",Providence,wil33.xml,15,2,1,MOT,55,194,CHI
2,3,1,44,1.994700313,47,3,there,"('FAT', 'CHI')",Providence,wil33.xml,50,3,2,CHI,402,392,FAT
0,1,2,47,1.832581464,48,1,are,"('FAT', 'CHI')",Providence,wil33.xml,50,2,0,CHI,402,392,FAT
4,11,4,135,1.819158443,146,11,it,"('CHI', 'FAT')",Providence,wil33.xml,154,8,4,FAT,883,1219,CHI
0,4,3,147,1.811562097,151,4,are,"('CHI', 'FAT')",Providence,wil33.xml,154,3,0,FAT,883,1219,CHI
2,4,11,137,1.743968805,141,4,want,"('CHI', 'FAT')",Providence,wil33.xml,154,13,2,FAT,883,1219,CHI
0,6,2,146,1.704748092,152,6,for,"('CHI', 'FAT')",Providence,wil33.xml,154,2,0,FAT,883,1219,CHI
1,7,4,142,1.685075327,149,7,see,"('CHI', 'FAT')",Providence,wil33.xml,154,5,1,FAT,883,1219,CHI
1,0,0,6,1.673976434,6,0,yeah,"('MOT', 'CHI')",Providence,wil33.xml,7,1,1,CHI,40,29,MOT
1,11,2,140,1.62924054,151,11,oh,"('CHI', 'FAT')",Providence,wil33.xml,154,3,1,FAT,883,1219,CHI
0,5,3,146,1.62924054,151,5,like,"('CHI', 'FAT')",Providence,wil33.xml,154,3,0,FAT,883,1219,CHI
0,4,4,146,1.622683139,150,4,my,"('CHI', 'FAT')",Providence,wil33.xml,154,4,0,FAT,883,1219,CHI
0,2,8,144,1.596014892,146,2,where,"('CHI', 'FAT')",Providence,wil33.xml,154,8,0,FAT,883,1219,CHI
0,1,3,46,1.589235205,47,1,want,"('FAT', 'CHI')",Providence,wil33.xml,50,3,0,CHI,402,392,FAT
3,4,3,40,1.526056303,44,4,and,"('FAT', 'CHI')",Providence,wil33.xml,50,6,3,CHI,402,392,FAT
0,4,5,145,1.461931775,149,4,get,"('CHI', 'FAT')",Providence,wil33.xml,154,5,0,FAT,883,1219,CHI
0,1,4,45,1.386294361,46,1,with,"('FAT', 'CHI')",Providence,wil33.xml,50,4,0,CHI,402,392,FAT
6,6,3,35,1.363304843,41,6,a,"('FAT', 'CHI')",Providence,wil33.xml,50,9,6,CHI,402,392,FAT
0,9,2,143,1.348073148,152,9,in,"('CHI', 'FAT')",Providence,wil33.xml,154,2,0,FAT,883,1219,CHI
3,6,2,39,1.344621665,45,6,it,"('FAT', 'CHI')",Providence,wil33.xml,50,5,3,CHI,402,392,FAT
1,6,8,139,1.339774345,145,6,to,"('CHI', 'FAT')",Providence,wil33.xml,154,9,1,FAT,883,1219,CHI
0,4,1,45,1.223775432,49,4,yeah,"('FAT', 'CHI')",Providence,wil33.xml,50,1,0,CHI,402,392,FAT
0,7,4,143,1.15267951,150,7,is,"('CHI', 'FAT')",Providence,wil33.xml,154,4,0,FAT,883,1219,CHI
1,13,4,136,1.125459539,149,13,that,"('CHI', 'FAT')",Providence,wil33.xml,154,5,1,FAT,883,1219,CHI
1,8,8,137,1.088459917,145,8,go,"('CHI', 'FAT')",Providence,wil33.xml,154,9,1,FAT,883,1219,CHI
5,22,6,121,1.068049638,143,22,a,"('CHI', 'FAT')",Providence,wil33.xml,154,11,5,FAT,883,1219,CHI
4,7,22,121,1.065326311,128,7,no,"('CHI', 'FAT')",Providence,wil33.xml,154,26,4,FAT,883,1219,CHI
0,1,6,43,1.056052674,44,1,go,"('FAT', 'CHI')",Providence,wil33.xml,50,6,0,CHI,402,392,FAT
1,3,5,41,1.056052674,44,3,that,"('FAT', 'CHI')",Providence,wil33.xml,50,6,1,CHI,402,392,FAT
0,5,1,44,1.041453875,49,5,he,"('FAT', 'CHI')",Providence,wil33.xml,50,1,0,CHI,402,392,FAT
0,10,3,141,1.023104736,151,10,and,"('CHI', 'FAT')",Providence,wil33.xml,154,3,0,FAT,883,1219,CHI
1,8,9,136,0.994622575,144,8,wanna,"('CHI', 'FAT')",Providence,wil33.xml,154,10,1,FAT,883,1219,CHI
0,1,1,13,0.980829253,14,1,is,"('CHI', 'MOT')",Providence,wil33.xml,15,1,0,MOT,55,194,CHI
0,14,2,138,0.94260804,152,14,on,"('CHI', 'FAT')",Providence,wil33.xml,154,2,0,FAT,883,1219,CHI
0,4,2,44,0.916290732,48,4,gonna,"('FAT', 'CHI')",Providence,wil33.xml,50,2,0,CHI,402,392,FAT
2,4,0,9,0.810930216,13,4,you,"('CHI', 'MOT')",Providence,wil33.xml,15,2,2,MOT,55,194,CHI
0,2,5,43,0.805625164,45,2,what,"('FAT', 'CHI')",Providence,wil33.xml,50,5,0,CHI,402,392,FAT
2,16,9,127,0.67718333,143,16,the,"('CHI', 'FAT')",Providence,wil33.xml,154,11,2,FAT,883,1219,CHI
0,4,3,43,0.672944473,47,4,wanna,"('FAT', 'CHI')",Providence,wil33.xml,50,3,0,CHI,402,392,FAT
0,2,6,42,0.650587566,44,2,to,"('FAT', 'CHI')",Providence,wil33.xml,50,6,0,CHI,402,392,FAT
0,1,2,12,0.628608659,13,1,go,"('CHI', 'MOT')",Providence,wil33.xml,15,2,0,MOT,55,194,CHI
0,2,1,12,0.575364145,14,2,wanna,"('CHI', 'MOT')",Providence,wil33.xml,15,1,0,MOT,55,194,CHI
0,4,4,42,0.470003629,46,4,no,"('FAT', 'CHI')",Providence,wil33.xml,50,4,0,CHI,402,392,FAT
1,13,10,130,0.465874236,143,13,yeah,"('CHI', 'FAT')",Providence,wil33.xml,154,11,1,FAT,883,1219,CHI
0,10,7,137,0.408826456,147,10,do,"('CHI', 'FAT')",Providence,wil33.xml,154,7,0,FAT,883,1219,CHI
0,13,6,135,0.292136423,148,13,what,"('CHI', 'FAT')",Providence,wil33.xml,154,6,0,FAT,883,1219,CHI
0,3,1,11,0.287682072,14,3,it,"('CHI', 'MOT')",Providence,wil33.xml,15,1,0,MOT,55,194,CHI
0,1,1,5,0.287682072,6,1,oh,"('MOT', 'CHI')",Providence,wil33.xml,7,1,0,CHI,40,29,MOT
0,1,1,5,0.287682072,6,1,do,"('MOT', 'CHI')",Providence,wil33.xml,7,1,0,CHI,40,29,MOT
1,0,9,5,0.15415068,5,0,no,"('CHI', 'MOT')",Providence,wil33.xml,15,10,1,MOT,55,194,CHI
0,1,1,4,0.15415068,5,1,in,"('FAT', 'MOT')",Providence,wil33.xml,6,1,0,MOT,43,69,FAT
4,38,10,102,0.129114602,140,38,you,"('CHI', 'FAT')",Providence,wil33.xml,154,14,4,FAT,883,1219,CHI
0,16,6,132,0.097980408,148,16,this,"('CHI', 'FAT')",Providence,wil33.xml,154,6,0,FAT,883,1219,CHI
0,5,7,38,-0.182321557,43,5,on,"('FAT', 'CHI')",Providence,wil33.xml,50,7,0,CHI,402,392,FAT
0,2,15,33,-0.32090772,35,2,you,"('FAT', 'CHI')",Providence,wil33.xml,50,15,0,CHI,402,392,FAT
0,1,3,2,-0.693147181,3,1,you,"('FAT', 'MOT')",Providence,wil33.xml,6,3,0,MOT,43,69,FAT
1,0,1,281,4.952299717,281,0,was,"('CHI', 'FAT')",Providence,wil34.xml,283,2,1,FAT,1566,1868,CHI
0,1,1,281,3.857214769,282,1,want,"('CHI', 'FAT')",Providence,wil34.xml,283,1,0,FAT,1566,1868,CHI
0,1,1,281,3.857214769,282,1,make,"('CHI', 'FAT')",Providence,wil34.xml,283,1,0,FAT,1566,1868,CHI
1,0,7,167,3.520460802,167,0,of,"('FAT', 'CHI')",Providence,wil34.xml,175,8,1,CHI,1205,738,FAT
0,1,1,173,3.378724526,174,1,gonna,"('FAT', 'CHI')",Providence,wil34.xml,175,1,0,CHI,1205,738,FAT
0,1,1,173,3.378724526,174,1,for,"('FAT', 'CHI')",Providence,wil34.xml,175,1,0,CHI,1205,738,FAT
0,1,1,173,3.378724526,174,1,one,"('FAT', 'CHI')",Providence,wil34.xml,175,1,0,CHI,1205,738,FAT
2,2,3,168,3.201584328,170,2,he,"('FAT', 'CHI')",Providence,wil34.xml,175,5,2,CHI,1205,738,FAT
0,3,1,279,3.164067588,282,3,some,"('CHI', 'FAT')",Providence,wil34.xml,283,1,0,FAT,1566,1868,CHI
1,4,2,276,3.116178427,280,4,have,"('CHI', 'FAT')",Providence,wil34.xml,283,3,1,FAT,1566,1868,CHI
0,2,1,172,2.973259418,174,2,at,"('FAT', 'CHI')",Providence,wil34.xml,175,1,0,CHI,1205,738,FAT
0,4,1,278,2.940924037,282,4,they,"('CHI', 'FAT')",Providence,wil34.xml,283,1,0,FAT,1566,1868,CHI
0,2,3,278,2.93385687,280,2,little,"('CHI', 'FAT')",Providence,wil34.xml,283,3,0,FAT,1566,1868,CHI
0,3,2,278,2.872858175,281,3,my,"('CHI', 'FAT')",Providence,wil34.xml,283,2,0,FAT,1566,1868,CHI
0,1,3,171,2.856470206,172,1,did,"('FAT', 'CHI')",Providence,wil34.xml,175,3,0,CHI,1205,738,FAT
1,2,4,168,2.79611922,170,2,was,"('FAT', 'CHI')",Providence,wil34.xml,175,5,1,CHI,1205,738,FAT
0,5,1,277,2.75860248,282,5,for,"('CHI', 'FAT')",Providence,wil34.xml,283,1,0,FAT,1566,1868,CHI
0,3,3,277,2.646174797,280,3,with,"('CHI', 'FAT')",Providence,wil34.xml,283,3,0,FAT,1566,1868,CHI
1,5,4,273,2.590267165,278,5,gonna,"('CHI', 'FAT')",Providence,wil34.xml,283,5,1,FAT,1566,1868,CHI
1,2,6,166,2.533108752,168,2,like,"('FAT', 'CHI')",Providence,wil34.xml,175,7,1,CHI,1205,738,FAT
1,2,6,166,2.533108752,168,2,can,"('FAT', 'CHI')",Providence,wil34.xml,175,7,1,CHI,1205,738,FAT
0,7,1,275,2.470920408,282,7,did,"('CHI', 'FAT')",Providence,wil34.xml,283,1,0,FAT,1566,1868,CHI
0,4,3,276,2.423031246,280,4,look,"('CHI', 'FAT')",Providence,wil34.xml,283,3,0,FAT,1566,1868,CHI
0,4,3,276,2.423031246,280,4,wanna,"('CHI', 'FAT')",Providence,wil34.xml,283,3,0,FAT,1566,1868,CHI
1,7,4,271,2.302585093,278,7,can,"('CHI', 'FAT')",Providence,wil34.xml,283,5,1,FAT,1566,1868,CHI
0,2,4,169,2.262919837,171,2,are,"('FAT', 'CHI')",Providence,wil34.xml,175,4,0,CHI,1205,738,FAT
5,9,10,259,2.254382991,268,9,there,"('CHI', 'FAT')",Providence,wil34.xml,283,15,5,FAT,1566,1868,CHI
1,1,14,159,2.254382991,160,1,want,"('FAT', 'CHI')",Providence,wil34.xml,175,15,1,CHI,1205,738,FAT
0,9,1,273,2.247776856,282,9,think,"('CHI', 'FAT')",Providence,wil34.xml,283,1,0,FAT,1566,1868,CHI
0,1,7,167,2.245426679,168,1,go,"('FAT', 'CHI')",Providence,wil34.xml,175,7,0,CHI,1205,738,FAT
0,4,4,275,2.237157288,279,4,where,"('CHI', 'FAT')",Providence,wil34.xml,283,4,0,FAT,1566,1868,CHI
2,9,5,267,2.226423732,276,9,to,"('CHI', 'FAT')",Providence,wil34.xml,283,7,2,FAT,1566,1868,CHI
1,1,15,158,2.191032607,159,1,do,"('FAT', 'CHI')",Providence,wil34.xml,175,16,1,CHI,1205,738,FAT
1,6,6,270,2.177633568,276,6,on,"('CHI', 'FAT')",Providence,wil34.xml,283,7,1,FAT,1566,1868,CHI
0,3,6,274,2.165475879,277,3,get,"('CHI', 'FAT')",Providence,wil34.xml,283,6,0,FAT,1566,1868,CHI
0,3,3,169,2.163323026,172,3,there,"('FAT', 'CHI')",Providence,wil34.xml,175,3,0,CHI,1205,738,FAT
1,10,3,269,2.141847108,279,10,not,"('CHI', 'FAT')",Providence,wil34.xml,283,4,1,FAT,1566,1868,CHI
2,7,12,262,1.848700846,269,7,he,"('CHI', 'FAT')",Providence,wil34.xml,283,14,2,FAT,1566,1868,CHI
0,5,3,167,1.757857918,172,5,no,"('FAT', 'CHI')",Providence,wil34.xml,175,3,0,CHI,1205,738,FAT
4,15,9,255,1.734601055,270,15,one,"('CHI', 'FAT')",Providence,wil34.xml,283,13,4,FAT,1566,1868,CHI
3,12,10,258,1.719096869,270,12,in,"('CHI', 'FAT')",Providence,wil34.xml,283,13,3,FAT,1566,1868,CHI
0,2,9,164,1.627456418,166,2,on,"('FAT', 'CHI')",Providence,wil34.xml,175,9,0,CHI,1205,738,FAT
0,4,9,270,1.61306768,274,4,we,"('CHI', 'FAT')",Providence,wil34.xml,283,9,0,FAT,1566,1868,CHI
2,13,8,260,1.591419407,273,13,like,"('CHI', 'FAT')",Providence,wil34.xml,283,10,2,FAT,1566,1868,CHI
0,9,4,270,1.544010107,279,9,are,"('CHI', 'FAT')",Providence,wil34.xml,283,4,0,FAT,1566,1868,CHI
2,36,2,243,1.334289576,279,36,oh,"('CHI', 'FAT')",Providence,wil34.xml,283,4,2,FAT,1566,1868,CHI
0,7,4,164,1.282090584,171,7,oh,"('FAT', 'CHI')",Providence,wil34.xml,175,4,0,CHI,1205,738,FAT
2,1,49,123,1.271455102,124,1,you,"('FAT', 'CHI')",Providence,wil34.xml,175,51,2,CHI,1205,738,FAT
1,10,11,261,1.265666373,271,10,no,"('CHI', 'FAT')",Providence,wil34.xml,283,12,1,FAT,1566,1868,CHI
0,22,2,259,1.123658321,281,22,see,"('CHI', 'FAT')",Providence,wil34.xml,283,2,0,FAT,1566,1868,CHI
18,32,29,204,1.028381793,236,32,it,"('CHI', 'FAT')",Providence,wil34.xml,283,47,18,FAT,1566,1868,CHI
0,10,8,265,0.92353714,275,10,and,"('CHI', 'FAT')",Providence,wil34.xml,283,8,0,FAT,1566,1868,CHI
4,9,26,136,0.831549503,145,9,it,"('FAT', 'CHI')",Providence,wil34.xml,175,30,4,CHI,1205,738,FAT
0,2,1,16,0.798507696,18,2,are,"('FAT', 'SIS')",Providence,wil34.xml,19,1,0,SIS,105,58,FAT
3,22,16,242,0.789774016,264,22,go,"('CHI', 'FAT')",Providence,wil34.xml,283,19,3,FAT,1566,1868,CHI
0,6,9,160,0.780158558,166,6,and,"('FAT', 'CHI')",Providence,wil34.xml,175,9,0,CHI,1205,738,FAT
6,28,22,227,0.726493022,255,28,yeah,"('CHI', 'FAT')",Providence,wil34.xml,283,28,6,FAT,1566,1868,CHI
2,10,18,145,0.665920368,155,10,is,"('FAT', 'CHI')",Providence,wil34.xml,175,20,2,CHI,1205,738,FAT
0,1,3,15,0.587786665,16,1,go,"('FAT', 'SIS')",Providence,wil34.xml,19,3,0,SIS,105,58,FAT
0,1,3,15,0.587786665,16,1,yeah,"('FAT', 'SIS')",Providence,wil34.xml,19,3,0,SIS,105,58,FAT
4,26,22,231,0.538224598,257,26,is,"('CHI', 'FAT')",Providence,wil34.xml,283,26,4,FAT,1566,1868,CHI
3,32,14,234,0.536334801,266,32,what,"('CHI', 'FAT')",Providence,wil34.xml,283,17,3,FAT,1566,1868,CHI
1,17,15,250,0.507115044,267,17,a,"('CHI', 'FAT')",Providence,wil34.xml,283,16,1,FAT,1566,1868,CHI
5,28,25,225,0.499991282,253,28,the,"('CHI', 'FAT')",Providence,wil34.xml,283,30,5,FAT,1566,1868,CHI
3,12,24,136,0.464684468,148,12,a,"('FAT', 'CHI')",Providence,wil34.xml,175,27,3,CHI,1205,738,FAT
1,23,12,247,0.412845215,270,23,that,"('CHI', 'FAT')",Providence,wil34.xml,283,13,1,FAT,1566,1868,CHI
2,13,32,236,0.40148896,249,13,this,"('CHI', 'FAT')",Providence,wil34.xml,283,34,2,FAT,1566,1868,CHI
4,18,23,130,0.308338397,148,18,yeah,"('FAT', 'CHI')",Providence,wil34.xml,175,27,4,CHI,1205,738,FAT
0,20,9,254,0.177983155,274,20,do,"('CHI', 'FAT')",Providence,wil34.xml,283,9,0,FAT,1566,1868,CHI
0,16,7,152,0.105360516,168,16,this,"('FAT', 'CHI')",Providence,wil34.xml,175,7,0,CHI,1205,738,FAT
2,56,9,216,0.10373977,272,56,you,"('CHI', 'FAT')",Providence,wil34.xml,283,11,2,FAT,1566,1868,CHI
0,5,23,147,0.026317308,152,5,the,"('FAT', 'CHI')",Providence,wil34.xml,175,23,0,CHI,1205,738,FAT
1,15,18,141,-0.061368946,156,15,what,"('FAT', 'CHI')",Providence,wil34.xml,175,19,1,CHI,1205,738,FAT
0,9,20,146,-0.337381741,155,9,that,"('FAT', 'CHI')",Providence,wil34.xml,175,20,0,CHI,1205,738,FAT
0,2,6,11,-0.470003629,13,2,you,"('FAT', 'SIS')",Providence,wil34.xml,19,6,0,SIS,105,58,FAT
1,2,1,218,3.610917913,220,2,my,"('MOT', 'CHI')",Providence,wil35.xml,222,2,1,CHI,3108,845,MOT
1,0,10,211,3.489489989,211,0,not,"('MOT', 'CHI')",Providence,wil35.xml,222,11,1,CHI,3108,845,MOT
1,0,14,207,3.202268088,207,0,of,"('MOT', 'CHI')",Providence,wil35.xml,222,15,1,CHI,3108,845,MOT
0,1,4,217,2.908720897,218,1,was,"('MOT', 'CHI')",Providence,wil35.xml,222,4,0,CHI,3108,845,MOT
0,1,4,217,2.908720897,218,1,little,"('MOT', 'CHI')",Providence,wil35.xml,222,4,0,CHI,3108,845,MOT
1,1,1,67,2.862200881,68,1,make,"('CHI', 'MOT')",Providence,wil35.xml,70,2,1,MOT,249,789,CHI
5,2,21,194,2.649209701,196,2,one,"('MOT', 'CHI')",Providence,wil35.xml,222,26,5,CHI,3108,845,MOT
0,1,7,214,2.489525596,215,1,where,"('MOT', 'CHI')",Providence,wil35.xml,222,7,0,CHI,3108,845,MOT
0,2,5,215,2.344549292,217,2,some,"('MOT', 'CHI')",Providence,wil35.xml,222,5,0,CHI,3108,845,MOT
1,1,4,64,2.25878247,65,1,no,"('CHI', 'MOT')",Providence,wil35.xml,70,5,1,MOT,249,789,CHI
1,3,1,65,2.1690537,68,3,all,"('CHI', 'MOT')",Providence,wil35.xml,70,2,1,MOT,249,789,CHI
0,2,1,67,2.0654553,69,2,is,"('CHI', 'MOT')",Providence,wil35.xml,70,1,0,MOT,249,789,CHI
1,5,0,64,2.0654553,69,5,wanna,"('CHI', 'MOT')",Providence,wil35.xml,70,1,1,MOT,249,789,CHI
0,1,14,207,1.881371628,208,1,get,"('MOT', 'CHI')",Providence,wil35.xml,222,14,0,CHI,3108,845,MOT
1,1,28,192,1.839012354,193,1,there,"('MOT', 'CHI')",Providence,wil35.xml,222,29,1,CHI,3108,845,MOT
2,5,13,202,1.815973727,207,5,oh,"('MOT', 'CHI')",Providence,wil35.xml,222,15,2,CHI,3108,845,MOT
0,1,15,206,1.815973727,207,1,are,"('MOT', 'CHI')",Providence,wil35.xml,222,15,0,CHI,3108,845,MOT
1,7,0,62,1.777773227,69,7,do,"('CHI', 'MOT')",Providence,wil35.xml,70,1,1,MOT,249,789,CHI
0,3,9,210,1.586448394,213,3,did,"('MOT', 'CHI')",Providence,wil35.xml,222,9,0,CHI,3108,845,MOT
0,2,13,207,1.545195644,209,2,have,"('MOT', 'CHI')",Providence,wil35.xml,222,13,0,CHI,3108,845,MOT
0,3,10,209,1.494775004,212,3,up,"('MOT', 'CHI')",Providence,wil35.xml,222,10,0,CHI,3108,845,MOT
1,3,21,197,1.437066686,200,3,on,"('MOT', 'CHI')",Providence,wil35.xml,222,22,1,CHI,3108,845,MOT
2,5,21,194,1.391281903,199,5,this,"('MOT', 'CHI')",Providence,wil35.xml,222,23,2,CHI,3108,845,MOT
1,6,2,61,1.371905624,67,6,a,"('CHI', 'MOT')",Providence,wil35.xml,70,3,1,MOT,249,789,CHI
1,4,18,199,1.36219681,203,4,like,"('MOT', 'CHI')",Providence,wil35.xml,222,19,1,CHI,3108,845,MOT
0,1,26,195,1.26291534,196,1,see,"('MOT', 'CHI')",Providence,wil35.xml,222,26,0,CHI,3108,845,MOT
3,7,24,188,1.222760718,195,7,it,"('MOT', 'CHI')",Providence,wil35.xml,222,27,3,CHI,3108,845,MOT
0,6,1,63,1.218157439,69,6,go,"('CHI', 'MOT')",Providence,wil35.xml,70,1,0,MOT,249,789,CHI
0,6,1,63,1.218157439,69,6,of,"('CHI', 'MOT')",Providence,wil35.xml,70,1,0,MOT,249,789,CHI
0,6,1,63,1.218157439,69,6,to,"('CHI', 'MOT')",Providence,wil35.xml,70,1,0,MOT,249,789,CHI
2,10,13,197,1.209837924,207,10,no,"('MOT', 'CHI')",Providence,wil35.xml,222,15,2,CHI,3108,845,MOT
1,0,0,3,1.203972804,3,0,can,"('MOT', 'FAT')",Providence,wil35.xml,4,1,1,FAT,53,19,MOT
4,7,30,181,1.193501504,188,7,is,"('MOT', 'CHI')",Providence,wil35.xml,222,34,4,CHI,3108,845,MOT
7,7,44,164,1.182999681,171,7,the,"('MOT', 'CHI')",Providence,wil35.xml,222,51,7,CHI,3108,845,MOT
0,2,5,63,1.160170182,65,2,want,"('CHI', 'MOT')",Providence,wil35.xml,70,5,0,MOT,249,789,CHI
1,10,1,58,1.157452789,68,10,the,"('CHI', 'MOT')",Providence,wil35.xml,70,2,1,MOT,249,789,CHI
1,3,28,190,1.145865174,193,3,and,"('MOT', 'CHI')",Providence,wil35.xml,222,29,1,CHI,3108,845,MOT
1,7,3,59,1.041453875,66,7,it,"('CHI', 'MOT')",Providence,wil35.xml,70,4,1,MOT,249,789,CHI
0,4,3,63,1.01523068,67,4,oh,"('CHI', 'MOT')",Providence,wil35.xml,70,3,0,MOT,249,789,CHI
0,3,17,202,1.001985453,205,3,can,"('MOT', 'CHI')",Providence,wil35.xml,222,17,0,CHI,3108,845,MOT
2,11,3,54,0.872488109,65,11,yeah,"('CHI', 'MOT')",Providence,wil35.xml,70,5,2,MOT,249,789,CHI
0,9,1,60,0.861482495,69,9,and,"('CHI', 'MOT')",Providence,wil35.xml,70,1,0,MOT,249,789,CHI
3,15,17,187,0.840783179,202,15,yeah,"('MOT', 'CHI')",Providence,wil35.xml,222,20,3,CHI,3108,845,MOT
1,7,20,194,0.791417402,201,7,what,"('MOT', 'CHI')",Providence,wil35.xml,222,21,1,CHI,3108,845,MOT
0,3,22,197,0.743919506,200,3,do,"('MOT', 'CHI')",Providence,wil35.xml,222,22,0,CHI,3108,845,MOT
1,0,0,1,0.693147181,1,0,you,"('CHI', 'OPE')",Providence,wil35.xml,2,1,1,OPE,9,13,CHI
1,0,0,1,0.693147181,1,0,yeah,"('CHI', 'OPE')",Providence,wil35.xml,2,1,1,OPE,9,13,CHI
1,0,0,1,0.693147181,1,0,with,"('CHI', 'OPE')",Providence,wil35.xml,2,1,1,OPE,9,13,CHI
1,6,28,187,0.586249386,193,6,go,"('MOT', 'CHI')",Providence,wil35.xml,222,29,1,CHI,3108,845,MOT
3,10,36,173,0.495182847,183,10,that,"('MOT', 'CHI')",Providence,wil35.xml,222,39,3,CHI,3108,845,MOT
3,14,28,177,0.444426787,191,14,a,"('MOT', 'CHI')",Providence,wil35.xml,222,31,3,CHI,3108,845,MOT
0,11,2,57,0.377294231,68,11,that,"('CHI', 'MOT')",Providence,wil35.xml,70,2,0,MOT,249,789,CHI
0,2,51,169,0.084387392,171,2,to,"('MOT', 'CHI')",Providence,wil35.xml,222,51,0,CHI,3108,845,MOT
0,8,19,195,0.081262964,203,8,want,"('MOT', 'CHI')",Providence,wil35.xml,222,19,0,CHI,3108,845,MOT
0,1,1,2,-0.182321557,3,1,you,"('MOT', 'FAT')",Providence,wil35.xml,4,1,0,FAT,53,19,MOT
0,1,1,2,-0.182321557,3,1,that,"('MOT', 'FAT')",Providence,wil35.xml,4,1,0,FAT,53,19,MOT
1,6,100,115,-1.075307601,121,6,you,"('MOT', 'CHI')",Providence,wil35.xml,222,101,1,CHI,3108,845,MOT
1,2,0,156,3.571096418,158,2,put,"('CHI', 'MOT')",Providence,wil36.xml,159,1,1,MOT,746,2356,CHI
3,1,2,121,3.567518597,122,1,one,"('MOT', 'CHI')",Providence,wil36.xml,127,5,3,CHI,1683,758,MOT
1,0,5,121,3.425889994,121,0,with,"('MOT', 'CHI')",Providence,wil36.xml,127,6,1,CHI,1683,758,MOT
1,0,5,121,3.425889994,121,0,not,"('MOT', 'CHI')",Providence,wil36.xml,127,6,1,CHI,1683,758,MOT
0,1,1,157,3.283414346,158,1,where,"('CHI', 'MOT')",Providence,wil36.xml,159,1,0,MOT,746,2356,CHI
0,2,1,156,2.877949238,158,2,was,"('CHI', 'MOT')",Providence,wil36.xml,159,1,0,MOT,746,2356,CHI
0,1,2,124,2.764745545,125,1,look,"('MOT', 'CHI')",Providence,wil36.xml,127,2,0,CHI,1683,758,MOT
1,1,5,120,2.732742814,121,1,on,"('MOT', 'CHI')",Providence,wil36.xml,127,6,1,CHI,1683,758,MOT
3,9,0,147,2.536866389,156,9,not,"('CHI', 'MOT')",Providence,wil36.xml,159,3,3,MOT,746,2356,CHI
1,5,2,151,2.354544832,156,5,one,"('CHI', 'MOT')",Providence,wil36.xml,159,3,1,MOT,746,2356,CHI
0,1,4,122,2.343407088,123,1,put,"('MOT', 'CHI')",Providence,wil36.xml,127,4,0,CHI,1683,758,MOT
1,2,5,119,2.327277706,121,2,in,"('MOT', 'CHI')",Providence,wil36.xml,127,6,1,CHI,1683,758,MOT
1,0,1,16,2.197224577,16,0,with,"('MOT', 'FAT')",Providence,wil36.xml,18,2,1,FAT,219,134,MOT
0,5,1,153,2.184802057,158,5,of,"('CHI', 'MOT')",Providence,wil36.xml,159,1,0,MOT,746,2356,CHI
0,1,5,121,2.181224236,122,1,but,"('MOT', 'CHI')",Providence,wil36.xml,127,5,0,CHI,1683,758,MOT
0,2,3,122,2.128231706,124,2,see,"('MOT', 'CHI')",Providence,wil36.xml,127,3,0,CHI,1683,758,MOT
1,12,0,146,2.10475935,158,12,on,"('CHI', 'MOT')",Providence,wil36.xml,159,1,1,MOT,746,2356,CHI
3,9,3,144,2.047692843,153,9,like,"('CHI', 'MOT')",Providence,wil36.xml,159,6,3,MOT,746,2356,CHI
0,1,6,120,2.039595633,121,1,little,"('MOT', 'CHI')",Providence,wil36.xml,127,6,0,CHI,1683,758,MOT
0,6,1,152,2.030651378,158,6,with,"('CHI', 'MOT')",Providence,wil36.xml,159,1,0,MOT,746,2356,CHI
0,6,1,152,2.030651378,158,6,but,"('CHI', 'MOT')",Providence,wil36.xml,159,1,0,MOT,746,2356,CHI
1,6,3,149,2.011723368,155,6,make,"('CHI', 'MOT')",Providence,wil36.xml,159,4,1,MOT,746,2356,CHI
1,0,2,15,1.916922612,15,0,and,"('MOT', 'FAT')",Providence,wil36.xml,18,3,1,FAT,219,134,MOT
2,1,0,15,1.909542505,16,1,of,"('MOT', 'FAT')",Providence,wil36.xml,18,2,2,FAT,219,134,MOT
3,2,17,105,1.887987501,107,2,like,"('MOT', 'CHI')",Providence,wil36.xml,127,20,3,CHI,1683,758,MOT
0,4,2,121,1.848454813,125,4,my,"('MOT', 'CHI')",Providence,wil36.xml,127,2,0,CHI,1683,758,MOT
0,1,8,118,1.800058272,119,1,gonna,"('MOT', 'CHI')",Providence,wil36.xml,127,8,0,CHI,1683,758,MOT
0,1,8,118,1.800058272,119,1,of,"('MOT', 'CHI')",Providence,wil36.xml,127,8,0,CHI,1683,758,MOT
0,8,1,150,1.779336949,158,8,there,"('CHI', 'MOT')",Providence,wil36.xml,159,1,0,MOT,746,2356,CHI
1,1,2,26,1.757857918,27,1,no,"('CHI', 'OPE')",Providence,wil36.xml,30,3,1,OPE,219,174,CHI
1,13,1,144,1.736699692,157,13,oh,"('CHI', 'MOT')",Providence,wil36.xml,159,2,1,MOT,746,2356,CHI
1,1,0,14,1.734601055,15,1,it,"('FAT', 'MOT')",Providence,wil36.xml,16,1,1,MOT,81,104,FAT
0,3,5,151,1.717651497,154,3,my,"('CHI', 'MOT')",Providence,wil36.xml,159,5,0,MOT,746,2356,CHI
2,1,24,100,1.707989586,101,1,that,"('MOT', 'CHI')",Providence,wil36.xml,127,26,2,CHI,1683,758,MOT
1,0,0,6,1.673976434,6,0,no,"('CHI', 'FAT')",Providence,wil36.xml,7,1,1,FAT,38,45,CHI
1,0,0,6,1.673976434,6,0,the,"('CHI', 'FAT')",Providence,wil36.xml,7,1,1,FAT,38,45,CHI
0,9,1,149,1.673976434,158,9,go,"('CHI', 'MOT')",Providence,wil36.xml,159,1,0,MOT,746,2356,CHI
1,0,0,6,1.673976434,6,0,a,"('CHI', 'SIS')",Providence,wil36.xml,7,1,1,SIS,36,28,CHI
1,0,0,6,1.673976434,6,0,see,"('CHI', 'SIS')",Providence,wil36.xml,7,1,1,SIS,36,28,CHI
2,14,2,141,1.655048424,155,14,can,"('CHI', 'MOT')",Providence,wil36.xml,159,4,2,MOT,746,2356,CHI
0,1,1,28,1.642227735,29,1,there,"('CHI', 'OPE')",Providence,wil36.xml,30,1,0,OPE,219,174,CHI
0,1,1,28,1.642227735,29,1,some,"('CHI', 'OPE')",Providence,wil36.xml,30,1,0,OPE,219,174,CHI
0,1,1,28,1.642227735,29,1,and,"('CHI', 'OPE')",Providence,wil36.xml,30,1,0,OPE,219,174,CHI
0,10,1,148,1.578666254,158,10,have,"('CHI', 'MOT')",Providence,wil36.xml,159,1,0,MOT,746,2356,CHI
0,10,1,148,1.578666254,158,10,are,"('CHI', 'MOT')",Providence,wil36.xml,159,1,0,MOT,746,2356,CHI
1,22,0,136,1.534214491,158,22,and,"('CHI', 'MOT')",Providence,wil36.xml,159,1,1,MOT,746,2356,CHI
0,2,7,118,1.508184179,120,2,get,"('MOT', 'CHI')",Providence,wil36.xml,127,7,0,CHI,1683,758,MOT
0,2,7,118,1.508184179,120,2,for,"('MOT', 'CHI')",Providence,wil36.xml,127,7,0,CHI,1683,758,MOT
7,7,15,98,1.494775004,105,7,to,"('MOT', 'CHI')",Providence,wil36.xml,127,22,7,CHI,1683,758,MOT
0,11,1,147,1.491654877,158,11,gonna,"('CHI', 'MOT')",Providence,wil36.xml,159,1,0,MOT,746,2356,CHI
0,3,5,119,1.488077055,122,3,all,"('MOT', 'CHI')",Providence,wil36.xml,127,5,0,CHI,1683,758,MOT
0,3,5,119,1.488077055,122,3,are,"('MOT', 'CHI')",Providence,wil36.xml,127,5,0,CHI,1683,758,MOT
5,9,9,104,1.461517782,113,9,go,"('MOT', 'CHI')",Providence,wil36.xml,127,14,5,CHI,1683,758,MOT
5,9,13,132,1.456286733,141,9,want,"('CHI', 'MOT')",Providence,wil36.xml,159,18,5,MOT,746,2356,CHI
1,11,2,113,1.435084525,124,11,want,"('MOT', 'CHI')",Providence,wil36.xml,127,3,1,CHI,1683,758,MOT
7,21,4,127,1.434085025,148,21,a,"('CHI', 'MOT')",Providence,wil36.xml,159,11,7,MOT,746,2356,CHI
0,2,10,147,1.433760898,149,2,no,"('CHI', 'MOT')",Providence,wil36.xml,159,10,0,MOT,746,2356,CHI
0,1,12,114,1.429969425,115,1,have,"('MOT', 'CHI')",Providence,wil36.xml,127,12,0,CHI,1683,758,MOT
0,12,1,146,1.411612169,158,12,we,"('CHI', 'MOT')",Providence,wil36.xml,159,1,0,MOT,746,2356,CHI
0,2,8,117,1.394593164,119,2,we,"('MOT', 'CHI')",Providence,wil36.xml,127,8,0,CHI,1683,758,MOT
0,2,8,117,1.394593164,119,2,what,"('MOT', 'CHI')",Providence,wil36.xml,127,8,0,CHI,1683,758,MOT
1,1,1,13,1.386294361,14,1,a,"('FAT', 'MOT')",Providence,wil36.xml,16,2,1,MOT,81,104,FAT
0,1,2,27,1.32175584,28,1,is,"('CHI', 'OPE')",Providence,wil36.xml,30,2,0,OPE,219,174,CHI
4,18,5,132,1.290984181,150,18,do,"('CHI', 'MOT')",Providence,wil36.xml,159,9,4,MOT,746,2356,CHI
3,11,6,107,1.290984181,118,11,no,"('MOT', 'CHI')",Providence,wil36.xml,127,9,3,CHI,1683,758,MOT
0,10,2,147,1.284714568,157,10,yeah,"('CHI', 'MOT')",Providence,wil36.xml,159,2,0,MOT,746,2356,CHI
2,0,1,4,1.280933845,4,0,like,"('CHI', 'FAT')",Providence,wil36.xml,7,3,2,FAT,38,45,CHI
0,8,3,148,1.255932543,156,8,get,"('CHI', 'MOT')",Providence,wil36.xml,159,3,0,MOT,746,2356,CHI
0,2,1,27,1.236762627,29,2,for,"('CHI', 'OPE')",Providence,wil36.xml,30,1,0,OPE,219,174,CHI
0,2,1,27,1.236762627,29,2,see,"('CHI', 'OPE')",Providence,wil36.xml,30,1,0,OPE,219,174,CHI
1,1,2,14,1.223775432,15,1,this,"('MOT', 'FAT')",Providence,wil36.xml,18,3,1,FAT,219,134,MOT
1,1,2,14,1.223775432,15,1,the,"('MOT', 'FAT')",Providence,wil36.xml,18,3,1,FAT,219,134,MOT
0,15,1,143,1.203972804,158,15,in,"('CHI', 'MOT')",Providence,wil36.xml,159,1,0,MOT,746,2356,CHI
0,1,1,16,1.15267951,17,1,oh,"('MOT', 'FAT')",Providence,wil36.xml,18,1,0,FAT,219,134,MOT
0,1,1,16,1.15267951,17,1,gonna,"('MOT', 'FAT')",Providence,wil36.xml,18,1,0,FAT,219,134,MOT
0,1,1,16,1.15267951,17,1,what,"('MOT', 'FAT')",Providence,wil36.xml,18,1,0,FAT,219,134,MOT
0,1,1,16,1.15267951,17,1,see,"('MOT', 'FAT')",Providence,wil36.xml,18,1,0,FAT,219,134,MOT
0,1,1,16,1.15267951,17,1,she,"('MOT', 'FAT')",Providence,wil36.xml,18,1,0,FAT,219,134,MOT
0,1,1,16,1.15267951,17,1,some,"('MOT', 'FAT')",Providence,wil36.xml,18,1,0,FAT,219,134,MOT
0,1,1,16,1.15267951,17,1,that,"('MOT', 'FAT')",Providence,wil36.xml,18,1,0,FAT,219,134,MOT
0,1,1,16,1.15267951,17,1,think,"('MOT', 'FAT')",Providence,wil36.xml,18,1,0,FAT,219,134,MOT
3,10,12,134,1.138792366,144,10,wanna,"('CHI', 'MOT')",Providence,wil36.xml,159,15,3,MOT,746,2356,CHI
10,25,8,116,1.106911091,141,25,it,"('CHI', 'MOT')",Providence,wil36.xml,159,18,10,MOT,746,2356,CHI
1,2,1,14,1.098612289,16,2,a,"('MOT', 'FAT')",Providence,wil36.xml,18,2,1,FAT,219,134,MOT
1,3,16,107,1.080912712,110,3,oh,"('MOT', 'CHI')",Providence,wil36.xml,127,17,1,CHI,1683,758,MOT
0,1,3,26,1.064710737,27,1,do,"('CHI', 'OPE')",Providence,wil36.xml,30,3,0,OPE,219,174,CHI
0,1,1,14,1.041453875,15,1,oh,"('FAT', 'MOT')",Providence,wil36.xml,16,1,0,MOT,81,104,FAT
0,1,1,14,1.041453875,15,1,gonna,"('FAT', 'MOT')",Providence,wil36.xml,16,1,0,MOT,81,104,FAT
1,8,7,111,0.989128056,119,8,this,"('MOT', 'CHI')",Providence,wil36.xml,127,8,1,CHI,1683,758,MOT
1,0,0,2,0.980829253,2,0,yeah,"('OPE', 'MOT')",Providence,wil36.xml,3,1,1,MOT,7,46,OPE
0,3,1,26,0.949080555,29,3,yeah,"('CHI', 'OPE')",Providence,wil36.xml,30,1,0,OPE,219,174,CHI
0,3,1,26,0.949080555,29,3,with,"('CHI', 'OPE')",Providence,wil36.xml,30,1,0,OPE,219,174,CHI
2,22,4,131,0.927101648,153,22,to,"('CHI', 'MOT')",Providence,wil36.xml,159,6,2,MOT,746,2356,CHI
0,3,10,114,0.907922482,117,3,some,"('MOT', 'CHI')",Providence,wil36.xml,127,10,0,CHI,1683,758,MOT
2,28,3,126,0.835262317,154,28,the,"('CHI', 'MOT')",Providence,wil36.xml,159,5,2,MOT,746,2356,CHI
0,1,2,15,0.810930216,16,1,like,"('MOT', 'FAT')",Providence,wil36.xml,18,2,0,FAT,219,134,MOT
0,1,2,15,0.810930216,16,1,have,"('MOT', 'FAT')",Providence,wil36.xml,18,2,0,FAT,219,134,MOT
0,1,2,15,0.810930216,16,1,we,"('MOT', 'FAT')",Providence,wil36.xml,18,2,0,FAT,219,134,MOT
2,7,15,103,0.793230639,110,7,and,"('MOT', 'CHI')",Providence,wil36.xml,127,17,2,CHI,1683,758,MOT
0,2,1,15,0.747214402,17,2,yeah,"('MOT', 'FAT')",Providence,wil36.xml,18,1,0,FAT,219,134,MOT
0,18,2,139,0.738170862,157,18,what,"('CHI', 'MOT')",Providence,wil36.xml,159,2,0,MOT,746,2356,CHI
1,0,0,1,0.693147181,1,0,you,"('OPE', 'FAT')",Providence,wil36.xml,2,1,1,FAT,6,14,OPE
1,3,1,11,0.693147181,14,3,you,"('FAT', 'MOT')",Providence,wil36.xml,16,2,1,MOT,81,104,FAT
5,20,14,120,0.658541651,140,20,that,"('CHI', 'MOT')",Providence,wil36.xml,159,19,5,MOT,746,2356,CHI
0,2,1,13,0.635988767,15,2,go,"('FAT', 'MOT')",Providence,wil36.xml,16,1,0,MOT,81,104,FAT
0,3,2,25,0.628608659,28,3,go,"('CHI', 'OPE')",Providence,wil36.xml,30,2,0,OPE,219,174,CHI
1,4,3,22,0.624154309,26,4,a,"('CHI', 'OPE')",Providence,wil36.xml,30,4,1,OPE,219,174,CHI
0,1,1,8,0.606135804,9,1,oh,"('FAT', 'CHI')",Providence,wil36.xml,10,1,0,CHI,59,46,FAT
1,10,9,107,0.589468751,117,10,wanna,"('MOT', 'CHI')",Providence,wil36.xml,127,10,1,CHI,1683,758,MOT
1,2,0,4,0.575364145,6,2,it,"('CHI', 'FAT')",Providence,wil36.xml,7,1,1,FAT,38,45,CHI
3,58,1,97,0.573243253,155,58,you,"('CHI', 'MOT')",Providence,wil36.xml,159,4,3,MOT,746,2356,CHI
1,1,0,2,0.510825624,3,1,you,"('FAT', 'OPE')",Providence,wil36.xml,4,1,1,OPE,20,30,FAT
1,4,4,21,0.433635985,25,4,the,"('CHI', 'OPE')",Providence,wil36.xml,30,5,1,OPE,219,174,CHI
0,1,3,12,0.405465108,13,1,yeah,"('FAT', 'MOT')",Providence,wil36.xml,16,3,0,MOT,81,104,FAT
0,2,2,14,0.405465108,16,2,to,"('MOT', 'FAT')",Providence,wil36.xml,18,2,0,FAT,219,134,MOT
0,3,3,24,0.371563556,27,3,it,"('CHI', 'OPE')",Providence,wil36.xml,30,3,0,OPE,219,174,CHI
0,1,1,5,0.287682072,6,1,oh,"('CHI', 'FAT')",Providence,wil36.xml,7,1,0,FAT,38,45,CHI
0,6,11,110,0.259825118,116,6,yeah,"('MOT', 'CHI')",Providence,wil36.xml,127,11,0,CHI,1683,758,MOT
0,3,21,103,0.16034265,106,3,can,"('MOT', 'CHI')",Providence,wil36.xml,127,21,0,CHI,1683,758,MOT
1,29,6,123,0.131677824,152,29,is,"('CHI', 'MOT')",Providence,wil36.xml,159,7,1,MOT,746,2356,CHI
0,5,15,107,0.111225635,112,5,it,"('MOT', 'CHI')",Providence,wil36.xml,127,15,0,CHI,1683,758,MOT
0,5,15,107,0.111225635,112,5,do,"('MOT', 'CHI')",Providence,wil36.xml,127,15,0,CHI,1683,758,MOT
1,3,4,10,0.068992871,13,3,you,"('MOT', 'FAT')",Providence,wil36.xml,18,5,1,FAT,219,134,MOT
1,9,18,99,0.046520016,108,9,a,"('MOT', 'CHI')",Providence,wil36.xml,127,19,1,CHI,1683,758,MOT
2,11,22,92,0.009569451,103,11,the,"('MOT', 'CHI')",Providence,wil36.xml,127,24,2,CHI,1683,758,MOT
1,21,11,126,-0.033006296,147,21,this,"('CHI', 'MOT')",Providence,wil36.xml,159,12,1,MOT,746,2356,CHI
0,1,2,4,-0.133531393,5,1,go,"('CHI', 'SIS')",Providence,wil36.xml,7,2,0,SIS,36,28,CHI
2,9,5,14,-0.182321557,23,9,you,"('CHI', 'OPE')",Providence,wil36.xml,30,7,2,OPE,219,174,CHI
0,1,1,2,-0.182321557,3,1,with,"('FAT', 'OPE')",Providence,wil36.xml,4,1,0,OPE,20,30,FAT
3,6,58,60,-0.483242809,66,6,you,"('MOT', 'CHI')",Providence,wil36.xml,127,61,3,CHI,1683,758,MOT
1,0,0,265,5.18178355,265,0,was,"('CHI', 'MOT')",Providence,wil37.xml,266,1,1,MOT,1582,2513,CHI
0,1,1,264,3.795489189,265,1,big,"('CHI', 'MOT')",Providence,wil37.xml,266,1,0,MOT,1582,2513,CHI
1,5,0,260,3.390024081,265,5,some,"('CHI', 'MOT')",Providence,wil37.xml,266,1,1,MOT,1582,2513,CHI
2,3,3,258,3.338561811,261,3,all,"('CHI', 'MOT')",Providence,wil37.xml,266,5,2,MOT,1582,2513,CHI
1,4,1,260,3.280911216,264,4,make,"('CHI', 'MOT')",Providence,wil37.xml,266,2,1,MOT,1582,2513,CHI
0,3,1,262,3.102342009,265,3,look,"('CHI', 'MOT')",Providence,wil37.xml,266,1,0,MOT,1582,2513,CHI
0,3,2,261,2.810907587,264,3,did,"('CHI', 'MOT')",Providence,wil37.xml,266,2,0,MOT,1582,2513,CHI
0,4,2,260,2.587764035,264,4,but,"('CHI', 'MOT')",Providence,wil37.xml,266,2,0,MOT,1582,2513,CHI
1,4,5,256,2.57261223,260,4,my,"('CHI', 'MOT')",Providence,wil37.xml,266,6,1,MOT,1582,2513,CHI
0,6,1,259,2.542726221,265,6,at,"('CHI', 'MOT')",Providence,wil37.xml,266,1,0,MOT,1582,2513,CHI
2,12,1,251,2.503954845,263,12,on,"('CHI', 'MOT')",Providence,wil37.xml,266,3,2,MOT,1582,2513,CHI
0,1,1,69,2.48490665,70,1,did,"('MOT', 'CHI')",Providence,wil37.xml,71,1,0,CHI,1006,492,MOT
0,1,1,69,2.48490665,70,1,wanna,"('MOT', 'CHI')",Providence,wil37.xml,71,1,0,CHI,1006,492,MOT
1,8,2,255,2.466214517,263,8,put,"('CHI', 'MOT')",Providence,wil37.xml,266,3,1,MOT,1582,2513,CHI
1,11,1,253,2.405442478,264,11,are,"('CHI', 'MOT')",Providence,wil37.xml,266,2,1,MOT,1582,2513,CHI
1,9,2,254,2.360854001,263,9,go,"('CHI', 'MOT')",Providence,wil37.xml,266,3,1,MOT,1582,2513,CHI
2,14,1,249,2.360854001,263,14,gonna,"('CHI', 'MOT')",Providence,wil37.xml,266,3,2,MOT,1582,2513,CHI
2,10,3,251,2.326960899,261,10,there,"('CHI', 'MOT')",Providence,wil37.xml,266,5,2,MOT,1582,2513,CHI
0,9,1,256,2.186051277,265,9,not,"('CHI', 'MOT')",Providence,wil37.xml,266,1,0,MOT,1582,2513,CHI
1,9,3,253,2.174751721,262,9,of,"('CHI', 'MOT')",Providence,wil37.xml,266,4,1,MOT,1582,2513,CHI
2,8,6,250,2.159484249,258,8,get,"('CHI', 'MOT')",Providence,wil37.xml,266,8,2,MOT,1582,2513,CHI
6,13,7,240,2.140066163,253,13,one,"('CHI', 'MOT')",Providence,wil37.xml,266,13,6,MOT,1582,2513,CHI
2,14,3,247,2.016805971,261,14,can,"('CHI', 'MOT')",Providence,wil37.xml,266,5,2,MOT,1582,2513,CHI
0,1,3,67,1.945910149,68,1,go,"('MOT', 'CHI')",Providence,wil37.xml,71,3,0,CHI,1006,492,MOT
0,1,3,67,1.945910149,68,1,was,"('MOT', 'CHI')",Providence,wil37.xml,71,3,0,CHI,1006,492,MOT
0,1,3,67,1.945910149,68,1,but,"('MOT', 'CHI')",Providence,wil37.xml,71,3,0,CHI,1006,492,MOT
4,11,10,241,1.889276807,252,11,want,"('CHI', 'MOT')",Providence,wil37.xml,266,14,4,MOT,1582,2513,CHI
1,1,0,15,1.791759469,16,1,the,"('FAT', 'CHI')",Providence,wil37.xml,17,1,1,CHI,89,93,FAT
0,3,1,67,1.791759469,70,3,no,"('MOT', 'CHI')",Providence,wil37.xml,71,1,0,CHI,1006,492,MOT
0,2,2,67,1.777773227,69,2,yeah,"('MOT', 'CHI')",Providence,wil37.xml,71,2,0,CHI,1006,492,MOT
0,2,2,67,1.777773227,69,2,where,"('MOT', 'CHI')",Providence,wil37.xml,71,2,0,CHI,1006,492,MOT
0,1,4,66,1.749199855,67,1,have,"('MOT', 'CHI')",Providence,wil37.xml,71,4,0,CHI,1006,492,MOT
0,1,4,66,1.749199855,67,1,my,"('MOT', 'CHI')",Providence,wil37.xml,71,4,0,CHI,1006,492,MOT
3,18,5,240,1.69995192,258,18,like,"('CHI', 'MOT')",Providence,wil37.xml,266,8,3,MOT,1582,2513,CHI
0,6,5,255,1.680333734,261,6,where,"('CHI', 'MOT')",Providence,wil37.xml,266,5,0,MOT,1582,2513,CHI
1,11,6,248,1.575536361,259,11,we,"('CHI', 'MOT')",Providence,wil37.xml,266,7,1,MOT,1582,2513,CHI
0,10,3,253,1.572396641,263,10,in,"('CHI', 'MOT')",Providence,wil37.xml,266,3,0,MOT,1582,2513,CHI
0,2,3,66,1.540445041,68,2,on,"('MOT', 'CHI')",Providence,wil37.xml,71,3,0,CHI,1006,492,MOT
3,29,3,231,1.473999942,260,29,what,"('CHI', 'MOT')",Providence,wil37.xml,266,6,3,MOT,1582,2513,CHI
1,2,7,61,1.466337069,63,2,can,"('MOT', 'CHI')",Providence,wil37.xml,71,8,1,CHI,1006,492,MOT
0,1,6,64,1.432103897,65,1,put,"('MOT', 'CHI')",Providence,wil37.xml,71,6,0,CHI,1006,492,MOT
0,6,7,253,1.421385681,259,6,see,"('CHI', 'MOT')",Providence,wil37.xml,266,7,0,MOT,1582,2513,CHI
0,3,3,65,1.252762968,68,3,get,"('MOT', 'CHI')",Providence,wil37.xml,71,3,0,CHI,1006,492,MOT
2,37,2,225,1.245215763,262,37,that,"('CHI', 'MOT')",Providence,wil37.xml,266,4,2,MOT,1582,2513,CHI
3,3,12,53,1.227229666,56,3,it,"('MOT', 'CHI')",Providence,wil37.xml,71,15,3,CHI,1006,492,MOT
0,2,5,64,1.174985267,66,2,for,"('MOT', 'CHI')",Providence,wil37.xml,71,5,0,CHI,1006,492,MOT
0,2,5,64,1.174985267,66,2,there,"('MOT', 'CHI')",Providence,wil37.xml,71,5,0,CHI,1006,492,MOT
0,2,5,64,1.174985267,66,2,think,"('MOT', 'CHI')",Providence,wil37.xml,71,5,0,CHI,1006,492,MOT
0,2,5,64,1.174985267,66,2,are,"('MOT', 'CHI')",Providence,wil37.xml,71,5,0,CHI,1006,492,MOT
7,26,15,218,1.110882381,244,26,the,"('CHI', 'MOT')",Providence,wil37.xml,266,22,7,MOT,1582,2513,CHI
0,1,1,15,1.098612289,16,1,yeah,"('FAT', 'CHI')",Providence,wil37.xml,17,1,0,CHI,89,93,FAT
0,1,1,15,1.098612289,16,1,are,"('FAT', 'CHI')",Providence,wil37.xml,17,1,0,CHI,89,93,FAT
0,17,3,246,1.079920156,263,17,have,"('CHI', 'MOT')",Providence,wil37.xml,266,3,0,MOT,1582,2513,CHI
1,8,16,241,1.076936563,249,8,no,"('CHI', 'MOT')",Providence,wil37.xml,266,17,1,MOT,1582,2513,CHI
0,8,8,250,1.060871961,258,8,up,"('CHI', 'MOT')",Providence,wil37.xml,266,8,0,MOT,1582,2513,CHI
0,2,6,63,1.026638789,65,2,see,"('MOT', 'CHI')",Providence,wil37.xml,71,6,0,CHI,1006,492,MOT
1,20,6,239,1.015920573,259,20,wanna,"('CHI', 'MOT')",Providence,wil37.xml,266,7,1,MOT,1582,2513,CHI
8,24,22,212,0.984883523,236,24,it,"('CHI', 'MOT')",Providence,wil37.xml,266,30,8,MOT,1582,2513,CHI
1,5,6,59,0.893817876,64,5,this,"('MOT', 'CHI')",Providence,wil37.xml,71,7,1,CHI,1006,492,MOT
1,5,6,59,0.893817876,64,5,up,"('MOT', 'CHI')",Providence,wil37.xml,71,7,1,CHI,1006,492,MOT
0,2,7,62,0.893817876,64,2,in,"('MOT', 'CHI')",Providence,wil37.xml,71,7,0,CHI,1006,492,MOT
2,7,6,56,0.890972924,63,7,and,"('MOT', 'CHI')",Providence,wil37.xml,71,8,2,CHI,1006,492,MOT
7,30,17,212,0.884526024,242,30,a,"('CHI', 'MOT')",Providence,wil37.xml,266,24,7,MOT,1582,2513,CHI
2,26,8,230,0.870828358,256,26,to,"('CHI', 'MOT')",Providence,wil37.xml,266,10,2,MOT,1582,2513,CHI
0,22,3,241,0.834797698,263,22,oh,"('CHI', 'MOT')",Providence,wil37.xml,266,3,0,MOT,1582,2513,CHI
1,20,8,237,0.807557532,257,20,and,"('CHI', 'MOT')",Providence,wil37.xml,266,9,1,MOT,1582,2513,CHI
3,35,8,220,0.78690215,255,35,do,"('CHI', 'MOT')",Providence,wil37.xml,266,11,3,MOT,1582,2513,CHI
1,0,0,1,0.693147181,1,0,you,"('CHI', 'OPE')",Providence,wil37.xml,2,1,1,OPE,57,6,CHI
0,2,1,14,0.693147181,16,2,is,"('FAT', 'CHI')",Providence,wil37.xml,17,1,0,CHI,89,93,FAT
0,2,1,14,0.693147181,16,2,on,"('FAT', 'CHI')",Providence,wil37.xml,17,1,0,CHI,89,93,FAT
0,16,6,244,0.655689618,260,16,for,"('CHI', 'MOT')",Providence,wil37.xml,266,6,0,MOT,1582,2513,CHI
2,23,13,228,0.620734603,251,23,this,"('CHI', 'MOT')",Providence,wil37.xml,266,15,2,MOT,1582,2513,CHI
1,27,7,231,0.619039208,258,27,is,"('CHI', 'MOT')",Providence,wil37.xml,266,8,1,MOT,1582,2513,CHI
2,6,11,52,0.538996501,58,6,the,"('MOT', 'CHI')",Providence,wil37.xml,71,13,2,CHI,1006,492,MOT
0,13,9,244,0.519875459,257,13,yeah,"('CHI', 'MOT')",Providence,wil37.xml,266,9,0,MOT,1582,2513,CHI
10,91,10,155,0.298492989,246,91,you,"('CHI', 'MOT')",Providence,wil37.xml,266,20,10,MOT,1582,2513,CHI
4,5,24,38,0.223143551,43,5,you,"('MOT', 'CHI')",Providence,wil37.xml,71,28,4,CHI,1006,492,MOT
0,2,19,50,-0.15415068,52,2,that,"('MOT', 'CHI')",Providence,wil37.xml,71,19,0,CHI,1006,492,MOT
0,6,9,56,-0.184922338,62,6,a,"('MOT', 'CHI')",Providence,wil37.xml,71,9,0,CHI,1006,492,MOT
0,3,16,52,-0.233614851,55,3,to,"('MOT', 'CHI')",Providence,wil37.xml,71,16,0,CHI,1006,492,MOT
0,9,7,55,-0.310154928,64,9,is,"('MOT', 'CHI')",Providence,wil37.xml,71,7,0,CHI,1006,492,MOT
0,4,3,10,-0.446287103,14,4,you,"('FAT', 'CHI')",Providence,wil37.xml,17,3,0,CHI,89,93,FAT
0,1,1,0,-0.693147181,1,1,have,"('CHI', 'FAT')",Providence,wil37.xml,2,1,0,FAT,22,9,CHI
0,1,1,0,-0.693147181,1,1,a,"('CHI', 'FAT')",Providence,wil37.xml,2,1,0,FAT,22,9,CHI
0,1,1,0,-0.693147181,1,1,have,"('MOT', 'FAT')",Providence,wil37.xml,2,1,0,FAT,12,18,MOT
0,2,1,410,3.828641396,412,2,big,"('CHI', 'MOT')",Providence,wil38.xml,413,1,0,MOT,2334,5263,CHI
0,3,2,408,3.250858871,411,3,he,"('CHI', 'MOT')",Providence,wil38.xml,413,2,0,MOT,2334,5263,CHI
0,4,2,407,3.027715319,411,4,they,"('CHI', 'MOT')",Providence,wil38.xml,413,2,0,MOT,2334,5263,CHI
0,5,3,405,2.619825968,410,5,was,"('CHI', 'MOT')",Providence,wil38.xml,413,3,0,MOT,2334,5263,CHI
1,9,3,400,2.617395833,409,9,did,"('CHI', 'MOT')",Providence,wil38.xml,413,4,1,MOT,2334,5263,CHI
3,16,4,390,2.367123614,406,16,of,"('CHI', 'MOT')",Providence,wil38.xml,413,7,3,MOT,2334,5263,CHI
1,6,8,398,2.355694918,404,6,my,"('CHI', 'MOT')",Providence,wil38.xml,413,9,1,MOT,2334,5263,CHI
2,32,0,379,2.239257959,411,32,can,"('CHI', 'MOT')",Providence,wil38.xml,413,2,2,MOT,2334,5263,CHI
1,18,2,392,2.160293638,410,18,all,"('CHI', 'MOT')",Providence,wil38.xml,413,3,1,MOT,2334,5263,CHI
1,8,9,395,2.014903021,403,8,but,"('CHI', 'MOT')",Providence,wil38.xml,413,10,1,MOT,2334,5263,CHI
2,21,4,386,1.94184345,407,21,gonna,"('CHI', 'MOT')",Providence,wil38.xml,413,6,2,MOT,2334,5263,CHI
2,5,26,380,1.864080131,385,5,want,"('CHI', 'MOT')",Providence,wil38.xml,413,28,2,MOT,2334,5263,CHI
1,15,5,392,1.854832073,407,15,are,"('CHI', 'MOT')",Providence,wil38.xml,413,6,1,MOT,2334,5263,CHI
0,24,1,388,1.70837786,412,24,at,"('CHI', 'MOT')",Providence,wil38.xml,413,1,0,MOT,2334,5263,CHI
4,36,4,369,1.704748092,405,36,think,"('CHI', 'MOT')",Providence,wil38.xml,413,8,4,MOT,2334,5263,CHI
3,17,12,381,1.654173806,398,17,where,"('CHI', 'MOT')",Providence,wil38.xml,413,15,3,MOT,2334,5263,CHI
0,26,1,386,1.631416819,412,26,put,"('CHI', 'MOT')",Providence,wil38.xml,413,1,0,MOT,2334,5263,CHI
4,30,7,372,1.611916228,402,30,like,"('CHI', 'MOT')",Providence,wil38.xml,413,11,4,MOT,2334,5263,CHI
0,16,3,394,1.578372093,410,16,with,"('CHI', 'MOT')",Providence,wil38.xml,413,3,0,MOT,2334,5263,CHI
0,16,3,394,1.578372093,410,16,up,"('CHI', 'MOT')",Providence,wil38.xml,413,3,0,MOT,2334,5263,CHI
5,24,13,371,1.561087651,395,24,wanna,"('CHI', 'MOT')",Providence,wil38.xml,413,18,5,MOT,2334,5263,CHI
1,0,0,5,1.540445041,5,0,have,"('MOT', 'CHI')",Providence,wil38.xml,6,1,1,CHI,92,35,MOT
2,23,7,381,1.529016345,404,23,one,"('CHI', 'MOT')",Providence,wil38.xml,413,9,2,MOT,2334,5263,CHI
0,30,1,382,1.493266481,412,30,have,"('CHI', 'MOT')",Providence,wil38.xml,413,1,0,MOT,2334,5263,CHI
2,15,13,383,1.484274769,398,15,for,"('CHI', 'MOT')",Providence,wil38.xml,413,15,2,MOT,2334,5263,CHI
3,33,6,371,1.468391723,404,33,go,"('CHI', 'MOT')",Providence,wil38.xml,413,9,3,MOT,2334,5263,CHI
8,55,6,344,1.393245592,399,55,do,"('CHI', 'MOT')",Providence,wil38.xml,413,14,8,MOT,2334,5263,CHI
1,16,9,387,1.378914254,403,16,get,"('CHI', 'MOT')",Providence,wil38.xml,413,10,1,MOT,2334,5263,CHI
2,31,6,374,1.339104478,405,31,we,"('CHI', 'MOT')",Providence,wil38.xml,413,8,2,MOT,2334,5263,CHI
4,34,10,365,1.275462556,399,34,see,"('CHI', 'MOT')",Providence,wil38.xml,413,14,4,MOT,2334,5263,CHI
3,47,5,358,1.221321443,405,47,oh,"('CHI', 'MOT')",Providence,wil38.xml,413,8,3,MOT,2334,5263,CHI
2,55,3,353,1.143507609,408,55,what,"('CHI', 'MOT')",Providence,wil38.xml,413,5,2,MOT,2334,5263,CHI
4,42,9,358,1.136639684,400,42,a,"('CHI', 'MOT')",Providence,wil38.xml,413,13,4,MOT,2334,5263,CHI
0,21,4,388,1.135791292,409,21,in,"('CHI', 'MOT')",Providence,wil38.xml,413,4,0,MOT,2334,5263,CHI
5,33,16,359,1.106255638,392,33,is,"('CHI', 'MOT')",Providence,wil38.xml,413,21,5,MOT,2334,5263,CHI
0,17,6,390,1.043901856,407,17,not,"('CHI', 'MOT')",Providence,wil38.xml,413,6,0,MOT,2334,5263,CHI
3,8,52,350,1.032122547,358,8,no,"('CHI', 'MOT')",Providence,wil38.xml,413,55,3,MOT,2334,5263,CHI
18,60,26,309,0.921125781,369,60,it,"('CHI', 'MOT')",Providence,wil38.xml,413,44,18,MOT,2334,5263,CHI
6,42,19,346,0.855019906,388,42,there,"('CHI', 'MOT')",Providence,wil38.xml,413,25,6,MOT,2334,5263,CHI
1,49,4,359,0.851371186,408,49,on,"('CHI', 'MOT')",Providence,wil38.xml,413,5,1,MOT,2334,5263,CHI
6,73,11,323,0.683858082,396,73,that,"('CHI', 'MOT')",Providence,wil38.xml,413,17,6,MOT,2334,5263,CHI
3,59,11,340,0.513322504,399,59,to,"('CHI', 'MOT')",Providence,wil38.xml,413,14,3,MOT,2334,5263,CHI
1,1,1,3,0.405465108,4,1,to,"('MOT', 'CHI')",Providence,wil38.xml,6,2,1,CHI,92,35,MOT
6,31,46,330,0.385593034,361,31,yeah,"('CHI', 'MOT')",Providence,wil38.xml,413,52,6,MOT,2334,5263,CHI
0,39,5,369,0.381367557,408,39,look,"('CHI', 'MOT')",Providence,wil38.xml,413,5,0,MOT,2334,5263,CHI
6,83,16,308,0.310849132,391,83,the,"('CHI', 'MOT')",Providence,wil38.xml,413,22,6,MOT,2334,5263,CHI
1,0,3,2,0.287682072,2,0,a,"('MOT', 'CHI')",Providence,wil38.xml,6,4,1,CHI,92,35,MOT
1,45,13,354,0.085878489,399,45,and,"('CHI', 'MOT')",Providence,wil38.xml,413,14,1,MOT,2334,5263,CHI
12,172,13,216,0.081967636,388,172,you,"('CHI', 'MOT')",Providence,wil38.xml,413,25,12,MOT,2334,5263,CHI
1,38,16,358,0.071598561,396,38,this,"('CHI', 'MOT')",Providence,wil38.xml,413,17,1,MOT,2334,5263,CHI
2,0,5,414,4.932072972,414,0,he,"('CHI', 'MOT')",Providence,wil39.xml,421,7,2,MOT,2855,3591,CHI
2,2,0,417,4.656338473,419,2,big,"('CHI', 'MOT')",Providence,wil39.xml,421,2,2,MOT,2855,3591,CHI
1,0,0,62,3.753417975,62,0,big,"('MOT', 'CHI')",Providence,wil39.xml,63,1,1,CHI,629,402,MOT
3,6,1,411,3.686495663,417,6,make,"('CHI', 'MOT')",Providence,wil39.xml,421,4,3,MOT,2855,3591,CHI
0,3,1,417,3.560098664,420,3,some,"('CHI', 'MOT')",Providence,wil39.xml,421,1,0,MOT,2855,3591,CHI
0,4,2,415,3.04690056,419,4,she,"('CHI', 'MOT')",Providence,wil39.xml,421,2,0,MOT,2855,3591,CHI
0,4,2,415,3.04690056,419,4,all,"('CHI', 'MOT')",Providence,wil39.xml,421,2,0,MOT,2855,3591,CHI
1,7,2,411,3.044522438,418,7,they,"('CHI', 'MOT')",Providence,wil39.xml,421,3,1,MOT,2855,3591,CHI
2,8,3,408,2.990958995,416,8,one,"('CHI', 'MOT')",Providence,wil39.xml,421,5,2,MOT,2855,3591,CHI
0,5,2,414,2.864579003,419,5,little,"('CHI', 'MOT')",Providence,wil39.xml,421,2,0,MOT,2855,3591,CHI
0,9,1,411,2.643807932,420,9,of,"('CHI', 'MOT')",Providence,wil39.xml,421,1,0,MOT,2855,3591,CHI
1,12,2,406,2.559014622,418,12,for,"('CHI', 'MOT')",Providence,wil39.xml,421,3,1,MOT,2855,3591,CHI
1,1,2,59,2.517696473,60,1,wanna,"('MOT', 'CHI')",Providence,wil39.xml,63,3,1,CHI,629,402,MOT
1,1,2,59,2.517696473,60,1,not,"('MOT', 'CHI')",Providence,wil39.xml,63,3,1,CHI,629,402,MOT
2,11,5,403,2.447166322,414,11,not,"('CHI', 'MOT')",Providence,wil39.xml,421,7,2,MOT,2855,3591,CHI
3,8,11,399,2.430196218,407,8,was,"('CHI', 'MOT')",Providence,wil39.xml,421,14,3,MOT,2855,3591,CHI
1,10,4,406,2.384823191,416,10,but,"('CHI', 'MOT')",Providence,wil39.xml,421,5,1,MOT,2855,3591,CHI
1,10,4,406,2.384823191,416,10,think,"('CHI', 'MOT')",Providence,wil39.xml,421,5,1,MOT,2855,3591,CHI
0,1,1,61,2.367123614,62,1,have,"('MOT', 'CHI')",Providence,wil39.xml,63,1,0,CHI,629,402,MOT
0,1,1,61,2.367123614,62,1,one,"('MOT', 'CHI')",Providence,wil39.xml,63,1,0,CHI,629,402,MOT
1,1,3,58,2.319114395,59,1,and,"('MOT', 'CHI')",Providence,wil39.xml,63,4,1,CHI,629,402,MOT
1,10,5,405,2.248896588,415,10,look,"('CHI', 'MOT')",Providence,wil39.xml,421,6,1,MOT,2855,3591,CHI
0,6,5,410,2.143661134,416,6,like,"('CHI', 'MOT')",Providence,wil39.xml,421,5,0,MOT,2855,3591,CHI
0,1,2,60,2.063693185,61,1,are,"('MOT', 'CHI')",Providence,wil39.xml,63,2,0,CHI,629,402,MOT
3,1,9,50,2.024381764,51,1,the,"('MOT', 'CHI')",Providence,wil39.xml,63,12,3,CHI,629,402,MOT
0,2,1,60,1.961658506,62,2,get,"('MOT', 'CHI')",Providence,wil39.xml,63,1,0,CHI,629,402,MOT
0,2,1,60,1.961658506,62,2,my,"('MOT', 'CHI')",Providence,wil39.xml,63,1,0,CHI,629,402,MOT
2,10,12,397,1.94184345,407,10,get,"('CHI', 'MOT')",Providence,wil39.xml,421,14,2,MOT,2855,3591,CHI
1,17,4,399,1.892346706,416,17,can,"('CHI', 'MOT')",Providence,wil39.xml,421,5,1,MOT,2855,3591,CHI
1,1,6,55,1.863218433,56,1,oh,"('MOT', 'CHI')",Providence,wil39.xml,63,7,1,CHI,629,402,MOT
1,1,6,55,1.863218433,56,1,that,"('MOT', 'CHI')",Providence,wil39.xml,63,7,1,CHI,629,402,MOT
0,1,3,59,1.824549292,60,1,can,"('MOT', 'CHI')",Providence,wil39.xml,63,3,0,CHI,629,402,MOT
3,12,16,390,1.778237444,402,12,go,"('CHI', 'MOT')",Providence,wil39.xml,421,19,3,MOT,2855,3591,CHI
7,20,18,376,1.725534243,396,20,in,"('CHI', 'MOT')",Providence,wil39.xml,421,25,7,MOT,2855,3591,CHI
1,0,1,9,1.704748092,9,0,you,"('CHI', 'OPE')",Providence,wil39.xml,11,2,1,OPE,81,35,CHI
0,2,2,59,1.658228077,61,2,we,"('MOT', 'CHI')",Providence,wil39.xml,63,2,0,CHI,629,402,MOT
5,29,9,378,1.631688521,407,29,do,"('CHI', 'MOT')",Providence,wil39.xml,421,14,5,MOT,2855,3591,CHI
13,23,29,356,1.61961324,379,23,it,"('CHI', 'MOT')",Providence,wil39.xml,421,42,13,MOT,2855,3591,CHI
0,13,4,404,1.607054121,417,13,where,"('CHI', 'MOT')",Providence,wil39.xml,421,4,0,MOT,2855,3591,CHI
1,13,9,398,1.592630794,411,13,wanna,"('CHI', 'MOT')",Providence,wil39.xml,421,10,1,MOT,2855,3591,CHI
1,16,7,397,1.585627264,413,16,up,"('CHI', 'MOT')",Providence,wil39.xml,421,8,1,MOT,2855,3591,CHI
2,25,6,388,1.566209178,413,25,what,"('CHI', 'MOT')",Providence,wil39.xml,421,8,2,MOT,2855,3591,CHI
2,10,19,390,1.561674889,400,10,there,"('CHI', 'MOT')",Providence,wil39.xml,421,21,2,MOT,2855,3591,CHI
3,1,15,44,1.547562509,45,1,you,"('MOT', 'CHI')",Providence,wil39.xml,63,18,3,CHI,629,402,MOT
0,14,4,403,1.53806125,417,14,put,"('CHI', 'MOT')",Providence,wil39.xml,421,4,0,MOT,2855,3591,CHI
10,29,20,362,1.5047716,391,29,and,"('CHI', 'MOT')",Providence,wil39.xml,421,30,10,MOT,2855,3591,CHI
2,6,33,380,1.502789567,386,6,no,"('CHI', 'MOT')",Providence,wil39.xml,421,35,2,MOT,2855,3591,CHI
2,18,11,390,1.462280268,408,18,we,"('CHI', 'MOT')",Providence,wil39.xml,421,13,2,MOT,2855,3591,CHI
0,4,1,58,1.450832882,62,4,go,"('MOT', 'CHI')",Providence,wil39.xml,63,1,0,CHI,629,402,MOT
0,2,3,58,1.419084184,60,2,do,"('MOT', 'CHI')",Providence,wil39.xml,63,3,0,CHI,629,402,MOT
6,22,23,370,1.352779638,392,22,is,"('CHI', 'MOT')",Providence,wil39.xml,421,29,6,MOT,2855,3591,CHI
0,5,1,57,1.268511325,62,5,there,"('MOT', 'CHI')",Providence,wil39.xml,63,1,0,CHI,629,402,MOT
0,24,3,394,1.211940974,418,24,did,"('CHI', 'MOT')",Providence,wil39.xml,421,3,0,MOT,2855,3591,CHI
1,0,0,3,1.203972804,3,0,go,"('FAT', 'MOT')",Providence,wil39.xml,4,1,1,MOT,21,16,FAT
0,13,7,401,1.194403353,414,13,gonna,"('CHI', 'MOT')",Providence,wil39.xml,421,7,0,MOT,2855,3591,CHI
5,19,29,368,1.176087601,387,19,to,"('CHI', 'MOT')",Providence,wil39.xml,421,34,5,MOT,2855,3591,CHI
19,47,28,327,1.162300108,374,47,the,"('CHI', 'MOT')",Providence,wil39.xml,421,47,19,MOT,2855,3591,CHI
1,7,2,53,1.131402111,60,7,want,"('MOT', 'CHI')",Providence,wil39.xml,63,3,1,CHI,629,402,MOT
1,2,9,51,1.116961427,53,2,this,"('MOT', 'CHI')",Providence,wil39.xml,63,10,1,CHI,629,402,MOT
17,40,35,329,1.104017707,369,40,a,"('CHI', 'MOT')",Providence,wil39.xml,421,52,17,MOT,2855,3591,CHI
0,12,9,400,1.063021344,412,12,are,"('CHI', 'MOT')",Providence,wil39.xml,421,9,0,MOT,2855,3591,CHI
0,15,8,398,0.953104705,413,15,see,"('CHI', 'MOT')",Providence,wil39.xml,421,8,0,MOT,2855,3591,CHI
0,8,16,397,0.92121685,405,8,want,"('CHI', 'MOT')",Providence,wil39.xml,421,16,0,MOT,2855,3591,CHI
0,1,1,9,0.693147181,10,1,yeah,"('CHI', 'OPE')",Providence,wil39.xml,11,1,0,OPE,81,35,CHI
0,9,19,393,0.654307347,402,9,my,"('CHI', 'MOT')",Providence,wil39.xml,421,19,0,MOT,2855,3591,CHI
2,25,21,373,0.613104473,398,25,on,"('CHI', 'MOT')",Providence,wil39.xml,421,23,2,MOT,2855,3591,CHI
0,4,5,54,0.538996501,58,4,to,"('MOT', 'CHI')",Providence,wil39.xml,63,5,0,CHI,629,402,MOT
1,8,5,49,0.494018505,57,8,yeah,"('MOT', 'CHI')",Providence,wil39.xml,63,6,1,CHI,629,402,MOT
0,1,1,6,0.405465108,7,1,you,"('FAT', 'CHI')",Providence,wil39.xml,8,1,0,CHI,32,58,FAT
4,42,25,350,0.390601502,392,42,that,"('CHI', 'MOT')",Providence,wil39.xml,421,29,4,MOT,2855,3591,CHI
0,5,5,53,0.356674944,58,5,gonna,"('MOT', 'CHI')",Providence,wil39.xml,63,5,0,CHI,629,402,MOT
7,48,37,329,0.296516052,377,48,yeah,"('CHI', 'MOT')",Providence,wil39.xml,421,44,7,MOT,2855,3591,CHI
1,28,18,374,0.282743791,402,28,oh,"('CHI', 'MOT')",Providence,wil39.xml,421,19,1,MOT,2855,3591,CHI
1,27,19,374,0.268836779,401,27,this,"('CHI', 'MOT')",Providence,wil39.xml,421,20,1,MOT,2855,3591,CHI
2,11,7,43,0.241162057,54,11,a,"('MOT', 'CHI')",Providence,wil39.xml,63,9,2,CHI,629,402,MOT
1,4,0,3,0.182321557,7,4,a,"('FAT', 'CHI')",Providence,wil39.xml,8,1,1,CHI,32,58,FAT
11,98,27,285,0.15415068,383,98,you,"('CHI', 'MOT')",Providence,wil39.xml,421,38,11,MOT,2855,3591,CHI
0,11,3,49,0.032789823,60,11,no,"('MOT', 'CHI')",Providence,wil39.xml,63,3,0,CHI,629,402,MOT
0,4,11,48,-0.185403223,52,4,it,"('MOT', 'CHI')",Providence,wil39.xml,63,11,0,CHI,629,402,MOT
0,6,11,46,-0.52187546,52,6,on,"('MOT', 'CHI')",Providence,wil39.xml,63,11,0,CHI,629,402,MOT
0,7,10,46,-0.557015006,53,7,is,"('MOT', 'CHI')",Providence,wil39.xml,63,10,0,CHI,629,402,MOT
3,2,4,258,3.658801999,260,2,he,"('CHI', 'MOT')",Providence,wil40.xml,267,7,3,MOT,1464,2482,CHI
1,3,1,262,3.507807117,265,3,she,"('CHI', 'MOT')",Providence,wil40.xml,267,2,1,MOT,1464,2482,CHI
0,2,1,264,3.393762403,266,2,little,"('CHI', 'MOT')",Providence,wil40.xml,267,1,0,MOT,1464,2482,CHI
0,2,1,264,3.393762403,266,2,where,"('CHI', 'MOT')",Providence,wil40.xml,267,1,0,MOT,1464,2482,CHI
7,6,4,250,3.12154162,256,6,up,"('CHI', 'MOT')",Providence,wil40.xml,267,11,7,MOT,1464,2482,CHI
1,4,2,260,3.057767664,264,4,have,"('CHI', 'MOT')",Providence,wil40.xml,267,3,1,MOT,1464,2482,CHI
0,1,1,104,2.881069365,105,1,go,"('MOT', 'CHI')",Providence,wil40.xml,106,1,0,CHI,981,599,MOT
0,1,1,104,2.881069365,105,1,was,"('MOT', 'CHI')",Providence,wil40.xml,106,1,0,CHI,981,599,MOT
1,4,3,259,2.871679625,263,4,there,"('CHI', 'MOT')",Providence,wil40.xml,267,4,1,MOT,1464,2482,CHI
0,3,2,262,2.814659936,265,3,was,"('CHI', 'MOT')",Providence,wil40.xml,267,2,0,MOT,1464,2482,CHI
0,5,1,261,2.700615223,266,5,some,"('CHI', 'MOT')",Providence,wil40.xml,267,1,0,MOT,1464,2482,CHI
1,8,1,257,2.696876901,265,8,with,"('CHI', 'MOT')",Providence,wil40.xml,267,2,1,MOT,1464,2482,CHI
1,2,2,101,2.63905733,103,2,but,"('MOT', 'CHI')",Providence,wil40.xml,106,3,1,CHI,981,599,MOT
0,1,2,103,2.583997552,104,1,this,"('MOT', 'CHI')",Providence,wil40.xml,106,2,0,CHI,981,599,MOT
0,1,2,103,2.583997552,104,1,see,"('MOT', 'CHI')",Providence,wil40.xml,106,2,0,CHI,981,599,MOT
1,6,3,257,2.535207388,263,6,get,"('CHI', 'MOT')",Providence,wil40.xml,267,4,1,MOT,1464,2482,CHI
0,2,1,103,2.475604257,105,2,big,"('MOT', 'CHI')",Providence,wil40.xml,106,1,0,CHI,981,599,MOT
1,3,8,255,2.469639178,258,3,of,"('CHI', 'MOT')",Providence,wil40.xml,267,9,1,MOT,1464,2482,CHI
0,5,2,260,2.409194828,265,5,think,"('CHI', 'MOT')",Providence,wil40.xml,267,2,0,MOT,1464,2482,CHI
0,1,3,102,2.351375257,103,1,have,"('MOT', 'CHI')",Providence,wil40.xml,106,3,0,CHI,981,599,MOT
1,1,8,96,2.197224577,97,1,there,"('MOT', 'CHI')",Providence,wil40.xml,106,9,1,CHI,981,599,MOT
0,5,3,259,2.182298927,264,5,all,"('CHI', 'MOT')",Providence,wil40.xml,267,3,0,MOT,1464,2482,CHI
1,9,3,254,2.178532444,263,9,for,"('CHI', 'MOT')",Providence,wil40.xml,267,4,1,MOT,1464,2482,CHI
0,8,2,257,2.00372972,265,8,but,"('CHI', 'MOT')",Providence,wil40.xml,267,2,0,MOT,1464,2482,CHI
0,1,5,100,1.995671659,101,1,some,"('MOT', 'CHI')",Providence,wil40.xml,106,5,0,CHI,981,599,MOT
0,1,5,100,1.995671659,101,1,do,"('MOT', 'CHI')",Providence,wil40.xml,106,5,0,CHI,981,599,MOT
1,2,7,96,1.897119985,98,2,can,"('MOT', 'CHI')",Providence,wil40.xml,106,8,1,CHI,981,599,MOT
5,11,14,237,1.7837913,248,11,want,"('CHI', 'MOT')",Providence,wil40.xml,267,19,5,MOT,1464,2482,CHI
2,11,7,247,1.776491997,258,11,in,"('CHI', 'MOT')",Providence,wil40.xml,267,9,2,MOT,1464,2482,CHI
1,9,6,251,1.761682014,260,9,go,"('CHI', 'MOT')",Providence,wil40.xml,267,7,1,MOT,1464,2482,CHI
0,2,4,100,1.754019141,102,2,all,"('MOT', 'CHI')",Providence,wil40.xml,106,4,0,CHI,981,599,MOT
1,15,4,247,1.550597412,262,15,can,"('CHI', 'MOT')",Providence,wil40.xml,267,5,1,MOT,1464,2482,CHI
0,6,6,255,1.546802341,261,6,wanna,"('CHI', 'MOT')",Providence,wil40.xml,267,6,0,MOT,1464,2482,CHI
0,7,1,98,1.494775004,105,7,wanna,"('MOT', 'CHI')",Providence,wil40.xml,106,1,0,CHI,981,599,MOT
0,7,6,254,1.413270949,261,7,see,"('CHI', 'MOT')",Providence,wil40.xml,267,6,0,MOT,1464,2482,CHI
0,1,10,95,1.406913648,96,1,are,"('MOT', 'CHI')",Providence,wil40.xml,106,10,0,CHI,981,599,MOT
0,10,4,253,1.390075084,263,10,make,"('CHI', 'MOT')",Providence,wil40.xml,267,4,0,MOT,1464,2482,CHI
2,17,7,241,1.371026889,258,17,like,"('CHI', 'MOT')",Providence,wil40.xml,267,9,2,MOT,1464,2482,CHI
1,2,13,90,1.365240952,92,2,a,"('MOT', 'CHI')",Providence,wil40.xml,106,14,1,CHI,981,599,MOT
0,23,1,243,1.314320861,266,23,gonna,"('CHI', 'MOT')",Providence,wil40.xml,267,1,0,MOT,1464,2482,CHI
12,25,19,211,1.282615932,236,25,it,"('CHI', 'MOT')",Providence,wil40.xml,267,31,12,MOT,1464,2482,CHI
0,10,5,252,1.232143681,262,10,one,"('CHI', 'MOT')",Providence,wil40.xml,267,5,0,MOT,1464,2482,CHI
2,18,8,239,1.226094721,257,18,oh,"('CHI', 'MOT')",Providence,wil40.xml,267,10,2,MOT,1464,2482,CHI
0,3,6,97,1.15923691,100,3,oh,"('MOT', 'CHI')",Providence,wil40.xml,106,6,0,CHI,981,599,MOT
0,1,13,92,1.15267951,93,1,on,"('MOT', 'CHI')",Providence,wil40.xml,106,13,0,CHI,981,599,MOT
1,10,3,92,1.147883338,102,10,get,"('MOT', 'CHI')",Providence,wil40.xml,106,4,1,CHI,981,599,MOT
0,14,4,249,1.079920156,263,14,we,"('CHI', 'MOT')",Providence,wil40.xml,267,4,0,MOT,1464,2482,CHI
0,4,5,97,1.079380927,101,4,and,"('MOT', 'CHI')",Providence,wil40.xml,106,5,0,CHI,981,599,MOT
2,26,6,233,1.064710737,259,26,this,"('CHI', 'MOT')",Providence,wil40.xml,267,8,2,MOT,1464,2482,CHI
0,5,13,249,1.045367774,254,5,my,"('CHI', 'MOT')",Providence,wil40.xml,267,13,0,MOT,1464,2482,CHI
0,3,7,96,1.031601578,99,3,with,"('MOT', 'CHI')",Providence,wil40.xml,106,7,0,CHI,981,599,MOT
0,25,2,240,0.942857759,265,25,are,"('CHI', 'MOT')",Providence,wil40.xml,267,2,0,MOT,1464,2482,CHI
5,22,18,222,0.942720964,244,22,the,"('CHI', 'MOT')",Providence,wil40.xml,267,23,5,MOT,1464,2482,CHI
0,10,2,94,0.87924946,104,10,yeah,"('MOT', 'CHI')",Providence,wil40.xml,106,2,0,CHI,981,599,MOT
3,18,17,229,0.868265825,247,18,a,"('CHI', 'MOT')",Providence,wil40.xml,267,20,3,MOT,1464,2482,CHI
0,22,3,242,0.83856418,264,22,do,"('CHI', 'MOT')",Providence,wil40.xml,267,3,0,MOT,1464,2482,CHI
1,15,11,240,0.830577214,255,15,and,"('CHI', 'MOT')",Providence,wil40.xml,267,12,1,MOT,1464,2482,CHI
3,24,13,227,0.810436267,251,24,that,"('CHI', 'MOT')",Providence,wil40.xml,267,16,3,MOT,1464,2482,CHI
2,15,17,233,0.802962047,248,15,no,"('CHI', 'MOT')",Providence,wil40.xml,267,19,2,MOT,1464,2482,CHI
0,6,5,95,0.74290869,101,6,want,"('MOT', 'CHI')",Providence,wil40.xml,106,5,0,CHI,981,599,MOT
3,24,17,223,0.593828979,247,24,is,"('CHI', 'MOT')",Providence,wil40.xml,267,20,3,MOT,1464,2482,CHI
1,15,15,236,0.563576189,251,15,yeah,"('CHI', 'MOT')",Providence,wil40.xml,267,16,1,MOT,1464,2482,CHI
0,1,1,7,0.510825624,8,1,all,"('CHI', 'OPE')",Providence,wil40.xml,9,1,0,OPE,108,36,CHI
1,0,3,3,0.510825624,3,0,you,"('MOT', 'FAT')",Providence,wil40.xml,7,4,1,FAT,65,48,MOT
0,7,6,93,0.46608973,100,7,is,"('MOT', 'CHI')",Providence,wil40.xml,106,6,0,CHI,981,599,MOT
1,2,0,3,0.441832752,5,2,you,"('OPE', 'MOT')",Providence,wil40.xml,6,1,1,MOT,20,160,OPE
1,2,0,3,0.441832752,5,2,it,"('OPE', 'MOT')",Providence,wil40.xml,6,1,1,MOT,20,160,OPE
3,31,16,217,0.397496938,248,31,to,"('CHI', 'MOT')",Providence,wil40.xml,267,19,3,MOT,1464,2482,CHI
0,4,12,90,0.315852949,94,4,the,"('MOT', 'CHI')",Providence,wil40.xml,106,12,0,CHI,981,599,MOT
0,5,10,91,0.30830136,96,5,that,"('MOT', 'CHI')",Providence,wil40.xml,106,10,0,CHI,981,599,MOT
0,1,1,5,0.287682072,6,1,did,"('MOT', 'FAT')",Providence,wil40.xml,7,1,0,FAT,65,48,MOT
0,8,7,91,0.220671362,99,8,no,"('MOT', 'CHI')",Providence,wil40.xml,106,7,0,CHI,981,599,MOT
0,1,1,4,0.15415068,5,1,you,"('CHI', 'FAT')",Providence,wil40.xml,6,1,0,FAT,27,26,CHI
0,1,1,4,0.15415068,5,1,all,"('OPE', 'MOT')",Providence,wil40.xml,6,1,0,MOT,20,160,OPE
0,5,12,89,0.133531393,94,5,to,"('MOT', 'CHI')",Providence,wil40.xml,106,12,0,CHI,981,599,MOT
0,28,6,233,0.125416661,261,28,on,"('CHI', 'MOT')",Providence,wil40.xml,267,6,0,MOT,1464,2482,CHI
0,1,1,3,0,4,1,that,"('FAT', 'CHI')",Providence,wil40.xml,5,1,0,CHI,36,26,FAT
0,1,1,3,0,4,1,there,"('FAT', 'MOT')",Providence,wil40.xml,5,1,0,MOT,25,23,FAT
0,4,18,84,-0.105360516,88,4,what,"('MOT', 'CHI')",Providence,wil40.xml,106,18,0,CHI,981,599,MOT
1,0,6,2,-0.117783036,2,0,you,"('CHI', 'OPE')",Providence,wil40.xml,9,7,1,OPE,108,36,CHI
0,2,1,4,-0.117783036,6,2,no,"('MOT', 'FAT')",Providence,wil40.xml,7,1,0,FAT,65,48,MOT
0,19,15,233,-0.291611351,252,19,what,"('CHI', 'MOT')",Providence,wil40.xml,267,15,0,MOT,1464,2482,CHI
3,68,16,180,-0.370873663,248,68,you,"('CHI', 'MOT')",Providence,wil40.xml,267,19,3,MOT,1464,2482,CHI
0,9,13,84,-0.456758402,93,9,it,"('MOT', 'CHI')",Providence,wil40.xml,106,13,0,CHI,981,599,MOT
1,5,45,55,-0.842678915,60,5,you,"('MOT', 'CHI')",Providence,wil40.xml,106,46,1,CHI,981,599,MOT
1,1,0,269,4.507189778,270,1,was,"('CHI', 'MOT')",Providence,wil41.xml,271,1,1,MOT,1625,2264,CHI
1,0,4,266,4.338224012,266,0,look,"('CHI', 'MOT')",Providence,wil41.xml,271,5,1,MOT,1625,2264,CHI
0,1,1,269,3.814042597,270,1,make,"('CHI', 'MOT')",Providence,wil41.xml,271,1,0,MOT,1625,2264,CHI
1,2,1,267,3.810359352,269,2,for,"('CHI', 'MOT')",Providence,wil41.xml,271,2,1,MOT,1625,2264,CHI
2,4,0,265,3.704998836,269,4,all,"('CHI', 'MOT')",Providence,wil41.xml,271,2,2,MOT,1625,2264,CHI
1,5,0,265,3.408577489,270,5,put,"('CHI', 'MOT')",Providence,wil41.xml,271,1,1,MOT,1625,2264,CHI
0,1,1,157,3.283414346,158,1,was,"('MOT', 'CHI')",Providence,wil41.xml,159,1,0,CHI,1388,1033,MOT
0,1,1,157,3.283414346,158,1,they,"('MOT', 'CHI')",Providence,wil41.xml,159,1,0,CHI,1388,1033,MOT
1,1,4,153,3.103945858,154,1,see,"('MOT', 'CHI')",Providence,wil41.xml,159,5,1,CHI,1388,1033,MOT
1,4,2,264,3.072693315,268,4,but,"('CHI', 'MOT')",Providence,wil41.xml,271,3,1,MOT,1625,2264,CHI
3,8,1,259,2.992021694,267,8,up,"('CHI', 'MOT')",Providence,wil41.xml,271,4,3,MOT,1625,2264,CHI
0,1,2,156,2.989462661,157,1,but,"('MOT', 'CHI')",Providence,wil41.xml,159,2,0,CHI,1388,1033,MOT
0,4,1,266,2.897751865,270,4,he,"('CHI', 'MOT')",Providence,wil41.xml,271,1,0,MOT,1625,2264,CHI
0,4,1,266,2.897751865,270,4,one,"('CHI', 'MOT')",Providence,wil41.xml,271,1,0,MOT,1625,2264,CHI
1,5,2,263,2.890371758,268,5,get,"('CHI', 'MOT')",Providence,wil41.xml,271,3,1,MOT,1625,2264,CHI
0,2,1,156,2.877949238,158,2,little,"('MOT', 'CHI')",Providence,wil41.xml,159,1,0,CHI,1388,1033,MOT
0,2,1,156,2.877949238,158,2,where,"('MOT', 'CHI')",Providence,wil41.xml,159,1,0,CHI,1388,1033,MOT
1,0,0,24,2.85263143,24,0,we,"('FAT', 'CHI')",Providence,wil41.xml,25,1,1,CHI,146,198,FAT
0,1,3,155,2.76000994,156,1,have,"('MOT', 'CHI')",Providence,wil41.xml,159,3,0,CHI,1388,1033,MOT
1,1,7,150,2.727852828,151,1,gonna,"('MOT', 'CHI')",Providence,wil41.xml,159,8,1,CHI,1388,1033,MOT
0,5,1,265,2.715430308,270,5,of,"('CHI', 'MOT')",Providence,wil41.xml,271,1,0,MOT,1625,2264,CHI
1,0,0,19,2.63905733,19,0,put,"('CHI', 'FAT')",Providence,wil41.xml,20,1,1,FAT,179,175,CHI
0,6,1,264,2.561279629,270,6,with,"('CHI', 'MOT')",Providence,wil41.xml,271,1,0,MOT,1625,2264,CHI
0,6,1,264,2.561279629,270,6,see,"('CHI', 'MOT')",Providence,wil41.xml,271,1,0,MOT,1625,2264,CHI
1,6,3,261,2.550188942,267,6,we,"('CHI', 'MOT')",Providence,wil41.xml,271,4,1,MOT,1625,2264,CHI
2,4,9,256,2.492569523,260,4,go,"('CHI', 'MOT')",Providence,wil41.xml,271,11,2,MOT,1625,2264,CHI
0,5,2,264,2.424064991,269,5,they,"('CHI', 'MOT')",Providence,wil41.xml,271,2,0,MOT,1625,2264,CHI
0,3,4,264,2.416657549,267,3,where,"('CHI', 'MOT')",Providence,wil41.xml,271,4,0,MOT,1625,2264,CHI
0,1,5,153,2.410798678,154,1,make,"('MOT', 'CHI')",Providence,wil41.xml,159,5,0,CHI,1388,1033,MOT
1,5,5,260,2.409194828,265,5,there,"('CHI', 'MOT')",Providence,wil41.xml,271,6,1,MOT,1625,2264,CHI
1,1,0,30,2.397895273,31,1,at,"('FAT', 'MOT')",Providence,wil41.xml,32,1,1,MOT,220,372,FAT
1,0,1,18,2.302585093,18,0,but,"('CHI', 'FAT')",Providence,wil41.xml,20,2,1,FAT,179,175,CHI
0,3,2,154,2.29631548,157,3,get,"('MOT', 'CHI')",Providence,wil41.xml,159,2,0,CHI,1388,1033,MOT
0,3,2,154,2.29631548,157,3,we,"('MOT', 'CHI')",Providence,wil41.xml,159,2,0,CHI,1388,1033,MOT
0,1,6,152,2.270836395,153,1,put,"('MOT', 'CHI')",Providence,wil41.xml,159,6,0,CHI,1388,1033,MOT
0,6,2,263,2.269914311,269,6,did,"('CHI', 'MOT')",Providence,wil41.xml,271,2,0,MOT,1625,2264,CHI
1,0,2,22,2.261763098,22,0,go,"('FAT', 'CHI')",Providence,wil41.xml,25,3,1,CHI,146,198,FAT
0,4,4,263,2.193513998,267,4,at,"('CHI', 'MOT')",Providence,wil41.xml,271,4,0,MOT,1625,2264,CHI
1,1,0,23,2.159484249,24,1,can,"('FAT', 'CHI')",Providence,wil41.xml,25,1,1,CHI,146,198,FAT
0,1,7,151,2.146580845,152,1,some,"('MOT', 'CHI')",Providence,wil41.xml,159,7,0,CHI,1388,1033,MOT
1,3,6,149,2.146580845,152,3,and,"('MOT', 'CHI')",Providence,wil41.xml,159,7,1,CHI,1388,1033,MOT
0,7,2,262,2.136382918,269,7,think,"('CHI', 'MOT')",Providence,wil41.xml,271,2,0,MOT,1625,2264,CHI
0,2,9,260,2.079441542,262,2,my,"('CHI', 'MOT')",Providence,wil41.xml,271,9,0,MOT,1625,2264,CHI
1,1,1,29,2.079441542,30,1,is,"('FAT', 'MOT')",Providence,wil41.xml,32,2,1,MOT,220,372,FAT
4,5,20,242,2.077034802,247,5,want,"('CHI', 'MOT')",Providence,wil41.xml,271,24,4,MOT,1625,2264,CHI
1,0,2,17,2.028148247,17,0,do,"('CHI', 'FAT')",Providence,wil41.xml,20,3,1,FAT,179,175,CHI
1,8,5,257,2.00372972,265,8,like,"('CHI', 'MOT')",Providence,wil41.xml,271,6,1,MOT,1625,2264,CHI
1,0,1,12,1.945910149,12,0,up,"('MOT', 'FAT')",Providence,wil41.xml,14,2,1,FAT,181,244,MOT
0,5,2,152,1.890850372,157,5,look,"('MOT', 'CHI')",Providence,wil41.xml,159,2,0,CHI,1388,1033,MOT
0,3,4,152,1.878191975,155,3,my,"('MOT', 'CHI')",Providence,wil41.xml,159,4,0,CHI,1388,1033,MOT
0,2,6,151,1.865371287,153,2,are,"('MOT', 'CHI')",Providence,wil41.xml,159,6,0,CHI,1388,1033,MOT
1,11,4,255,1.853317362,266,11,yeah,"('CHI', 'MOT')",Providence,wil41.xml,271,5,1,MOT,1625,2264,CHI
0,8,1,150,1.779336949,158,8,up,"('MOT', 'CHI')",Providence,wil41.xml,159,1,0,CHI,1388,1033,MOT
1,18,2,250,1.737692248,268,18,can,"('CHI', 'MOT')",Providence,wil41.xml,271,3,1,MOT,1625,2264,CHI
0,1,1,30,1.704748092,31,1,like,"('FAT', 'MOT')",Providence,wil41.xml,32,1,0,MOT,220,372,FAT
0,1,1,30,1.704748092,31,1,see,"('FAT', 'MOT')",Providence,wil41.xml,32,1,0,MOT,220,372,FAT
0,1,1,30,1.704748092,31,1,no,"('FAT', 'MOT')",Providence,wil41.xml,32,1,0,MOT,220,372,FAT
0,1,1,30,1.704748092,31,1,where,"('FAT', 'MOT')",Providence,wil41.xml,32,1,0,MOT,220,372,FAT
5,10,8,136,1.683026269,146,10,a,"('MOT', 'CHI')",Providence,wil41.xml,159,13,5,CHI,1388,1033,MOT
1,2,1,28,1.673976434,30,2,wanna,"('FAT', 'MOT')",Providence,wil41.xml,32,2,1,MOT,220,372,FAT
0,12,2,257,1.650875102,269,12,gonna,"('CHI', 'MOT')",Providence,wil41.xml,271,2,0,MOT,1625,2264,CHI
2,2,2,26,1.609437912,28,2,go,"('FAT', 'MOT')",Providence,wil41.xml,32,4,2,MOT,220,372,FAT
0,3,6,150,1.577689214,153,3,can,"('MOT', 'CHI')",Providence,wil41.xml,159,6,0,CHI,1388,1033,MOT
1,1,2,21,1.568615918,22,1,to,"('FAT', 'CHI')",Providence,wil41.xml,25,3,1,CHI,146,198,FAT
1,1,0,11,1.540445041,12,1,have,"('OPE', 'CHI')",Providence,wil41.xml,13,1,1,CHI,52,170,OPE
3,7,11,138,1.524696684,145,7,to,"('MOT', 'CHI')",Providence,wil41.xml,159,14,3,CHI,1388,1033,MOT
8,26,9,228,1.502126177,254,26,it,"('CHI', 'MOT')",Providence,wil41.xml,271,17,8,MOT,1625,2264,CHI
1,7,12,251,1.466337069,258,7,wanna,"('CHI', 'MOT')",Providence,wil41.xml,271,13,1,MOT,1625,2264,CHI
0,1,1,23,1.466337069,24,1,it,"('FAT', 'CHI')",Providence,wil41.xml,25,1,0,CHI,146,198,FAT
0,1,1,23,1.466337069,24,1,with,"('FAT', 'CHI')",Providence,wil41.xml,25,1,0,CHI,146,198,FAT
0,1,1,23,1.466337069,24,1,at,"('FAT', 'CHI')",Providence,wil41.xml,25,1,0,CHI,146,198,FAT
0,1,1,23,1.466337069,24,1,on,"('FAT', 'CHI')",Providence,wil41.xml,25,1,0,CHI,146,198,FAT
1,13,6,251,1.440361582,264,13,on,"('CHI', 'MOT')",Providence,wil41.xml,271,7,1,MOT,1625,2264,CHI
2,20,5,244,1.440361582,264,20,not,"('CHI', 'MOT')",Providence,wil41.xml,271,7,2,MOT,1625,2264,CHI
1,2,1,21,1.427116356,23,2,is,"('FAT', 'CHI')",Providence,wil41.xml,25,2,1,CHI,146,198,FAT
1,1,4,26,1.421385681,27,1,yeah,"('FAT', 'MOT')",Providence,wil41.xml,32,5,1,MOT,220,372,FAT
2,4,1,25,1.313723668,29,4,to,"('FAT', 'MOT')",Providence,wil41.xml,32,3,2,MOT,220,372,FAT
1,6,9,143,1.279610219,149,6,is,"('MOT', 'CHI')",Providence,wil41.xml,159,10,1,CHI,1388,1033,MOT
0,1,1,18,1.252762968,19,1,oh,"('CHI', 'FAT')",Providence,wil41.xml,20,1,0,FAT,179,175,CHI
0,1,1,18,1.252762968,19,1,we,"('CHI', 'FAT')",Providence,wil41.xml,20,1,0,FAT,179,175,CHI
0,1,1,18,1.252762968,19,1,my,"('CHI', 'FAT')",Providence,wil41.xml,20,1,0,FAT,179,175,CHI
0,1,1,18,1.252762968,19,1,that,"('CHI', 'FAT')",Providence,wil41.xml,20,1,0,FAT,179,175,CHI
0,1,1,18,1.252762968,19,1,and,"('CHI', 'FAT')",Providence,wil41.xml,20,1,0,FAT,179,175,CHI
5,17,17,232,1.24878682,249,17,to,"('CHI', 'MOT')",Providence,wil41.xml,271,22,5,MOT,1625,2264,CHI
2,11,7,139,1.239690887,150,11,want,"('MOT', 'CHI')",Providence,wil41.xml,159,9,2,CHI,1388,1033,MOT
0,3,9,147,1.239690887,150,3,not,"('MOT', 'CHI')",Providence,wil41.xml,159,9,0,CHI,1388,1033,MOT
0,12,4,255,1.238002553,267,12,in,"('CHI', 'MOT')",Providence,wil41.xml,271,4,0,MOT,1625,2264,CHI
2,8,11,138,1.190549784,146,8,like,"('MOT', 'CHI')",Providence,wil41.xml,159,13,2,CHI,1388,1033,MOT
1,15,3,140,1.185044794,155,15,this,"('MOT', 'CHI')",Providence,wil41.xml,159,4,1,CHI,1388,1033,MOT
1,4,1,26,1.16315081,30,4,we,"('FAT', 'MOT')",Providence,wil41.xml,32,2,1,MOT,220,372,FAT
0,9,3,147,1.150572028,156,9,there,"('MOT', 'CHI')",Providence,wil41.xml,159,3,0,CHI,1388,1033,MOT
0,3,10,146,1.146078826,149,3,what,"('MOT', 'CHI')",Providence,wil41.xml,159,10,0,CHI,1388,1033,MOT
0,1,2,22,1.139434283,23,1,want,"('FAT', 'CHI')",Providence,wil41.xml,25,2,0,CHI,146,198,FAT
0,1,2,22,1.139434283,23,1,and,"('FAT', 'CHI')",Providence,wil41.xml,25,2,0,CHI,146,198,FAT
0,2,1,22,1.060871961,24,2,see,"('FAT', 'CHI')",Providence,wil41.xml,25,1,0,CHI,146,198,FAT
1,7,10,141,1.059391576,148,7,yeah,"('MOT', 'CHI')",Providence,wil41.xml,159,11,1,CHI,1388,1033,MOT
0,2,15,142,1.051780989,144,2,oh,"('MOT', 'CHI')",Providence,wil41.xml,159,15,0,CHI,1388,1033,MOT
0,5,7,147,1.047968556,152,5,in,"('MOT', 'CHI')",Providence,wil41.xml,159,7,0,CHI,1388,1033,MOT
1,2,4,25,1.015920573,27,2,not,"('FAT', 'MOT')",Providence,wil41.xml,32,5,1,MOT,220,372,FAT
0,3,1,28,1.011600912,31,3,with,"('FAT', 'MOT')",Providence,wil41.xml,32,1,0,MOT,220,372,FAT
0,2,2,28,0.980829253,30,2,gonna,"('FAT', 'MOT')",Providence,wil41.xml,32,2,0,MOT,220,372,FAT
0,2,2,28,0.980829253,30,2,in,"('FAT', 'MOT')",Providence,wil41.xml,32,2,0,MOT,220,372,FAT
0,2,2,28,0.980829253,30,2,of,"('FAT', 'MOT')",Providence,wil41.xml,32,2,0,MOT,220,372,FAT
0,2,2,28,0.980829253,30,2,did,"('FAT', 'MOT')",Providence,wil41.xml,32,2,0,MOT,220,372,FAT
0,2,2,28,0.980829253,30,2,put,"('FAT', 'MOT')",Providence,wil41.xml,32,2,0,MOT,220,372,FAT
0,2,2,28,0.980829253,30,2,can,"('FAT', 'MOT')",Providence,wil41.xml,32,2,0,MOT,220,372,FAT
1,16,9,245,0.947181219,261,16,do,"('CHI', 'MOT')",Providence,wil41.xml,271,10,1,MOT,1625,2264,CHI
2,10,12,135,0.91856088,145,10,it,"('MOT', 'CHI')",Providence,wil41.xml,159,14,2,CHI,1388,1033,MOT
1,3,1,15,0.916290732,18,3,the,"('CHI', 'FAT')",Providence,wil41.xml,20,2,1,FAT,179,175,CHI
0,1,2,17,0.916290732,18,1,no,"('CHI', 'FAT')",Providence,wil41.xml,20,2,0,FAT,179,175,CHI
1,3,3,25,0.916290732,28,3,and,"('FAT', 'MOT')",Providence,wil41.xml,32,4,1,MOT,220,372,FAT
0,1,1,12,0.916290732,13,1,are,"('MOT', 'FAT')",Providence,wil41.xml,14,1,0,FAT,181,244,MOT
0,11,7,253,0.901365082,264,11,oh,"('CHI', 'MOT')",Providence,wil41.xml,271,7,0,MOT,1625,2264,CHI
0,11,7,253,0.901365082,264,11,are,"('CHI', 'MOT')",Providence,wil41.xml,271,7,0,MOT,1625,2264,CHI
2,5,1,17,0.875468737,22,5,no,"('FAT', 'CHI')",Providence,wil41.xml,25,3,2,CHI,146,198,FAT
0,2,1,17,0.84729786,19,2,on,"('CHI', 'FAT')",Providence,wil41.xml,20,1,0,FAT,179,175,CHI
9,23,31,208,0.837900098,231,23,a,"('CHI', 'MOT')",Providence,wil41.xml,271,40,9,MOT,1625,2264,CHI
1,10,9,139,0.827625095,149,10,do,"('MOT', 'CHI')",Providence,wil41.xml,159,10,1,CHI,1388,1033,MOT
2,3,2,13,0.810930216,16,3,you,"('CHI', 'FAT')",Providence,wil41.xml,20,4,2,FAT,179,175,CHI
6,29,19,217,0.762304648,246,29,the,"('CHI', 'MOT')",Providence,wil41.xml,271,25,6,MOT,1625,2264,CHI
3,10,19,127,0.744819191,137,10,the,"('MOT', 'CHI')",Providence,wil41.xml,159,22,3,CHI,1388,1033,MOT
0,10,5,144,0.706050585,154,10,that,"('MOT', 'CHI')",Providence,wil41.xml,159,5,0,CHI,1388,1033,MOT
3,5,4,20,0.693147181,25,5,the,"('FAT', 'MOT')",Providence,wil41.xml,32,7,3,MOT,220,372,FAT
0,3,2,27,0.693147181,30,3,do,"('FAT', 'MOT')",Providence,wil41.xml,32,2,0,MOT,220,372,FAT
2,27,11,231,0.619039208,258,27,that,"('CHI', 'MOT')",Providence,wil41.xml,271,13,2,MOT,1625,2264,CHI
0,1,2,11,0.559615788,12,1,go,"('MOT', 'FAT')",Providence,wil41.xml,14,2,0,FAT,181,244,MOT
0,1,2,11,0.559615788,12,1,can,"('MOT', 'FAT')",Providence,wil41.xml,14,2,0,FAT,181,244,MOT
0,3,1,16,0.559615788,19,3,like,"('CHI', 'FAT')",Providence,wil41.xml,20,1,0,FAT,179,175,CHI
1,2,2,9,0.550046337,11,2,to,"('MOT', 'FAT')",Providence,wil41.xml,14,3,1,FAT,181,244,MOT
1,38,5,227,0.537392651,265,38,what,"('CHI', 'MOT')",Providence,wil41.xml,271,6,1,MOT,1625,2264,CHI
0,2,2,16,0.510825624,18,2,with,"('CHI', 'FAT')",Providence,wil41.xml,20,2,0,FAT,179,175,CHI
0,2,1,11,0.510825624,13,2,gonna,"('MOT', 'FAT')",Providence,wil41.xml,14,1,0,FAT,181,244,MOT
0,2,1,11,0.510825624,13,2,like,"('MOT', 'FAT')",Providence,wil41.xml,14,1,0,FAT,181,244,MOT
0,2,1,11,0.510825624,13,2,he,"('MOT', 'FAT')",Providence,wil41.xml,14,1,0,FAT,181,244,MOT
0,2,1,11,0.510825624,13,2,and,"('MOT', 'FAT')",Providence,wil41.xml,14,1,0,FAT,181,244,MOT
6,26,30,209,0.480547264,235,26,this,"('CHI', 'MOT')",Providence,wil41.xml,271,36,6,MOT,1625,2264,CHI
0,4,2,26,0.470003629,30,4,it,"('FAT', 'MOT')",Providence,wil41.xml,32,2,0,MOT,220,372,FAT
0,2,3,20,0.470003629,22,2,wanna,"('FAT', 'CHI')",Providence,wil41.xml,25,3,0,CHI,146,198,FAT
0,2,1,10,0.441832752,12,2,it,"('OPE', 'CHI')",Providence,wil41.xml,13,1,0,CHI,52,170,OPE
1,5,0,7,0.441832752,12,5,you,"('OPE', 'CHI')",Providence,wil41.xml,13,1,1,CHI,52,170,OPE
0,3,3,26,0.438254931,29,3,what,"('FAT', 'MOT')",Providence,wil41.xml,32,3,0,MOT,220,372,FAT
1,0,1,1,0.405465108,1,0,where,"('CHI', 'OPE')",Providence,wil41.xml,3,2,1,OPE,18,7,CHI
2,14,29,226,0.382992252,240,14,no,"('CHI', 'MOT')",Providence,wil41.xml,271,31,2,MOT,1625,2264,CHI
6,60,12,193,0.380567556,253,60,you,"('CHI', 'MOT')",Providence,wil41.xml,271,18,6,MOT,1625,2264,CHI
2,4,3,11,0.376477571,15,4,it,"('CHI', 'FAT')",Providence,wil41.xml,20,5,2,FAT,179,175,CHI
9,12,47,91,0.331153075,103,12,you,"('MOT', 'CHI')",Providence,wil41.xml,159,56,9,CHI,1388,1033,MOT
0,14,6,139,0.255933374,153,14,go,"('MOT', 'CHI')",Providence,wil41.xml,159,6,0,CHI,1388,1033,MOT
0,3,1,10,0.223143551,13,3,not,"('MOT', 'FAT')",Providence,wil41.xml,14,1,0,FAT,181,244,MOT
0,8,1,23,0.200670695,31,8,that,"('FAT', 'MOT')",Providence,wil41.xml,32,1,0,MOT,220,372,FAT
2,29,17,223,0.190226736,252,29,and,"('CHI', 'MOT')",Providence,wil41.xml,271,19,2,MOT,1625,2264,CHI
0,3,3,19,0.182321557,22,3,a,"('FAT', 'CHI')",Providence,wil41.xml,25,3,0,CHI,146,198,FAT
7,37,33,194,0.155224217,231,37,is,"('CHI', 'MOT')",Providence,wil41.xml,271,40,7,MOT,1625,2264,CHI
0,2,6,24,0.15415068,26,2,a,"('FAT', 'MOT')",Providence,wil41.xml,32,6,0,MOT,220,372,FAT
0,2,2,10,0.15415068,12,2,we,"('MOT', 'FAT')",Providence,wil41.xml,14,2,0,FAT,181,244,MOT
0,2,2,10,0.15415068,12,2,think,"('MOT', 'FAT')",Providence,wil41.xml,14,2,0,FAT,181,244,MOT
0,2,2,10,0.15415068,12,2,do,"('MOT', 'FAT')",Providence,wil41.xml,14,2,0,FAT,181,244,MOT
0,10,10,139,0.134477914,149,10,wanna,"('MOT', 'CHI')",Providence,wil41.xml,159,10,0,CHI,1388,1033,MOT
0,3,5,24,0.03509132,27,3,you,"('FAT', 'MOT')",Providence,wil41.xml,32,5,0,MOT,220,372,FAT
0,5,3,24,0.032789823,29,5,have,"('FAT', 'MOT')",Providence,wil41.xml,32,3,0,MOT,220,372,FAT
0,5,3,24,0.032789823,29,5,on,"('FAT', 'MOT')",Providence,wil41.xml,32,3,0,MOT,220,372,FAT
0,4,3,18,-0.040821995,22,4,that,"('FAT', 'CHI')",Providence,wil41.xml,25,3,0,CHI,146,198,FAT
0,3,4,18,-0.042559614,21,3,do,"('FAT', 'CHI')",Providence,wil41.xml,25,4,0,CHI,146,198,FAT
0,3,4,18,-0.042559614,21,3,the,"('FAT', 'CHI')",Providence,wil41.xml,25,4,0,CHI,146,198,FAT
0,3,3,14,-0.051293294,17,3,a,"('CHI', 'FAT')",Providence,wil41.xml,20,3,0,FAT,179,175,CHI
1,3,7,14,-0.051293294,17,3,you,"('FAT', 'CHI')",Providence,wil41.xml,25,8,1,CHI,146,198,FAT
1,20,13,125,-0.133531393,145,20,no,"('MOT', 'CHI')",Providence,wil41.xml,159,14,1,CHI,1388,1033,MOT
0,3,2,9,-0.133531393,12,3,you,"('MOT', 'FAT')",Providence,wil41.xml,14,2,0,FAT,181,244,MOT
0,8,19,132,-0.285919957,140,8,on,"('MOT', 'CHI')",Providence,wil41.xml,159,19,0,CHI,1388,1033,MOT
0,3,3,8,-0.430782916,11,3,that,"('MOT', 'FAT')",Providence,wil41.xml,14,3,0,FAT,181,244,MOT
0,3,3,8,-0.430782916,11,3,the,"('MOT', 'FAT')",Providence,wil41.xml,14,3,0,FAT,181,244,MOT
0,2,1,227,3.245193133,229,2,make,"('CHI', 'MOT')",Providence,wil42.xml,230,1,0,MOT,1833,2264,CHI
2,1,3,74,2.803360381,75,1,for,"('MOT', 'CHI')",Providence,wil42.xml,80,5,2,CHI,984,620,MOT
0,1,5,224,2.785892688,225,1,he,"('CHI', 'MOT')",Providence,wil42.xml,230,5,0,MOT,1833,2264,CHI
2,2,1,75,2.76000994,77,2,where,"('MOT', 'CHI')",Providence,wil42.xml,80,3,2,CHI,984,620,MOT
1,5,2,222,2.725671802,227,5,see,"('CHI', 'MOT')",Providence,wil42.xml,230,3,1,MOT,1833,2264,CHI
0,3,2,225,2.665490587,228,3,little,"('CHI', 'MOT')",Providence,wil42.xml,230,2,0,MOT,1833,2264,CHI
4,1,7,68,2.614021251,69,1,what,"('MOT', 'CHI')",Providence,wil42.xml,80,11,4,CHI,984,620,MOT
0,1,1,78,2.602689685,79,1,up,"('MOT', 'CHI')",Providence,wil42.xml,80,1,0,CHI,984,620,MOT
1,6,2,221,2.571521123,227,6,there,"('CHI', 'MOT')",Providence,wil42.xml,230,3,1,MOT,1833,2264,CHI
1,6,2,221,2.571521123,227,6,not,"('CHI', 'MOT')",Providence,wil42.xml,230,3,1,MOT,1833,2264,CHI
0,5,1,224,2.552045953,229,5,did,"('CHI', 'MOT')",Providence,wil42.xml,230,1,0,MOT,1833,2264,CHI
0,2,4,224,2.538973871,226,2,at,"('CHI', 'MOT')",Providence,wil42.xml,230,4,0,MOT,1833,2264,CHI
1,9,1,219,2.442347035,228,9,think,"('CHI', 'MOT')",Providence,wil42.xml,230,2,1,MOT,1833,2264,CHI
1,4,5,220,2.424802726,224,4,one,"('CHI', 'MOT')",Providence,wil42.xml,230,6,1,MOT,1833,2264,CHI
0,6,1,223,2.397895273,229,6,all,"('CHI', 'MOT')",Providence,wil42.xml,230,1,0,MOT,1833,2264,CHI
1,8,2,219,2.320206694,227,8,like,"('CHI', 'MOT')",Providence,wil42.xml,230,3,1,MOT,1833,2264,CHI
0,1,2,77,2.302585093,78,1,make,"('MOT', 'CHI')",Providence,wil42.xml,80,2,0,CHI,984,620,MOT
0,1,2,77,2.302585093,78,1,see,"('MOT', 'CHI')",Providence,wil42.xml,80,2,0,CHI,984,620,MOT
1,5,5,219,2.242481169,224,5,up,"('CHI', 'MOT')",Providence,wil42.xml,230,6,1,MOT,1833,2264,CHI
0,6,2,222,2.105874799,228,6,have,"('CHI', 'MOT')",Providence,wil42.xml,230,2,0,MOT,1833,2264,CHI
0,3,5,222,2.092745507,225,3,look,"('CHI', 'MOT')",Providence,wil42.xml,230,5,0,MOT,1833,2264,CHI
2,0,1,10,1.974081026,10,0,it,"('CHI', 'OPE')",Providence,wil42.xml,13,3,2,OPE,95,67,CHI
0,2,2,76,1.897119985,78,2,all,"('MOT', 'CHI')",Providence,wil42.xml,80,2,0,CHI,984,620,MOT
2,14,3,211,1.869601956,225,14,put,"('CHI', 'MOT')",Providence,wil42.xml,230,5,2,MOT,1833,2264,CHI
0,5,4,221,1.84582669,226,5,but,"('CHI', 'MOT')",Providence,wil42.xml,230,4,0,MOT,1833,2264,CHI
2,13,4,211,1.800648417,224,13,with,"('CHI', 'MOT')",Providence,wil42.xml,230,6,2,MOT,1833,2264,CHI
0,3,8,219,1.722766598,222,3,my,"('CHI', 'MOT')",Providence,wil42.xml,230,8,0,MOT,1833,2264,CHI
1,7,7,215,1.722766598,222,7,wanna,"('CHI', 'MOT')",Providence,wil42.xml,230,8,1,MOT,1833,2264,CHI
2,9,8,211,1.713797928,220,9,get,"('CHI', 'MOT')",Providence,wil42.xml,230,10,2,MOT,1833,2264,CHI
1,3,4,72,1.704748092,75,3,no,"('MOT', 'CHI')",Providence,wil42.xml,80,5,1,CHI,984,620,MOT
0,1,5,74,1.704748092,75,1,get,"('MOT', 'CHI')",Providence,wil42.xml,80,5,0,CHI,984,620,MOT
0,2,3,75,1.661397651,77,2,like,"('MOT', 'CHI')",Providence,wil42.xml,80,3,0,CHI,984,620,MOT
0,2,3,75,1.661397651,77,2,are,"('MOT', 'CHI')",Providence,wil42.xml,80,3,0,CHI,984,620,MOT
3,15,6,206,1.622982138,221,15,do,"('CHI', 'MOT')",Providence,wil42.xml,230,9,3,MOT,1833,2264,CHI
0,3,2,75,1.609437912,78,3,my,"('MOT', 'CHI')",Providence,wil42.xml,80,2,0,CHI,984,620,MOT
0,3,2,75,1.609437912,78,3,some,"('MOT', 'CHI')",Providence,wil42.xml,80,2,0,CHI,984,620,MOT
0,7,4,219,1.558144618,226,7,some,"('CHI', 'MOT')",Providence,wil42.xml,230,4,0,MOT,1833,2264,CHI
1,1,0,11,1.540445041,12,1,want,"('CHI', 'OPE')",Providence,wil42.xml,13,1,1,OPE,95,67,CHI
0,6,5,219,1.533129719,225,6,in,"('CHI', 'MOT')",Providence,wil42.xml,230,5,0,MOT,1833,2264,CHI
1,2,8,69,1.48709906,71,2,go,"('MOT', 'CHI')",Providence,wil42.xml,80,9,1,CHI,984,620,MOT
1,12,5,212,1.469291281,224,12,can,"('CHI', 'MOT')",Providence,wil42.xml,230,6,1,MOT,1833,2264,CHI
1,11,6,212,1.427116356,223,11,for,"('CHI', 'MOT')",Providence,wil42.xml,230,7,1,MOT,1833,2264,CHI
0,1,7,72,1.427116356,73,1,can,"('MOT', 'CHI')",Providence,wil42.xml,80,7,0,CHI,984,620,MOT
1,3,6,70,1.427116356,73,3,that,"('MOT', 'CHI')",Providence,wil42.xml,80,7,1,CHI,984,620,MOT
0,3,3,74,1.373715579,77,3,there,"('MOT', 'CHI')",Providence,wil42.xml,80,3,0,CHI,984,620,MOT
3,17,8,202,1.329135947,219,17,go,"('CHI', 'MOT')",Providence,wil42.xml,230,11,3,MOT,1833,2264,CHI
3,29,3,195,1.326190437,224,29,that,"('CHI', 'MOT')",Providence,wil42.xml,230,6,3,MOT,1833,2264,CHI
1,3,7,69,1.30833282,72,3,we,"('MOT', 'CHI')",Providence,wil42.xml,80,8,1,CHI,984,620,MOT
5,14,17,194,1.252762968,208,14,a,"('CHI', 'MOT')",Providence,wil42.xml,230,22,5,MOT,1833,2264,CHI
1,6,4,69,1.145132304,75,6,do,"('MOT', 'CHI')",Providence,wil42.xml,80,5,1,CHI,984,620,MOT
5,26,9,190,1.107828944,216,26,is,"('CHI', 'MOT')",Providence,wil42.xml,230,14,5,MOT,1833,2264,CHI
0,2,7,71,1.021651248,73,2,gonna,"('MOT', 'CHI')",Providence,wil42.xml,80,7,0,CHI,984,620,MOT
0,2,7,71,1.021651248,73,2,put,"('MOT', 'CHI')",Providence,wil42.xml,80,7,0,CHI,984,620,MOT
0,13,4,213,0.99852883,226,13,are,"('CHI', 'MOT')",Providence,wil42.xml,230,4,0,MOT,1833,2264,CHI
9,24,20,177,0.962928043,201,24,it,"('CHI', 'MOT')",Providence,wil42.xml,230,29,9,MOT,1833,2264,CHI
0,7,2,71,0.916290732,78,7,want,"('MOT', 'CHI')",Providence,wil42.xml,80,2,0,CHI,984,620,MOT
0,2,8,70,0.902867712,72,2,with,"('MOT', 'CHI')",Providence,wil42.xml,80,8,0,CHI,984,620,MOT
3,19,13,195,0.875468737,214,19,this,"('CHI', 'MOT')",Providence,wil42.xml,230,16,3,MOT,1833,2264,CHI
2,31,5,192,0.851752211,223,31,what,"('CHI', 'MOT')",Providence,wil42.xml,230,7,2,MOT,1833,2264,CHI
0,1,1,11,0.84729786,12,1,we,"('CHI', 'OPE')",Providence,wil42.xml,13,1,0,OPE,95,67,CHI
0,1,1,11,0.84729786,12,1,do,"('CHI', 'OPE')",Providence,wil42.xml,13,1,0,OPE,95,67,CHI
1,2,0,6,0.798507696,8,2,yeah,"('OPE', 'CHI')",Providence,wil42.xml,9,1,1,CHI,45,82,OPE
1,5,8,66,0.79395188,71,5,on,"('MOT', 'CHI')",Providence,wil42.xml,80,9,1,CHI,984,620,MOT
2,8,27,193,0.780606486,201,8,want,"('CHI', 'MOT')",Providence,wil42.xml,230,29,2,MOT,1833,2264,CHI
0,10,8,212,0.711165686,222,10,we,"('CHI', 'MOT')",Providence,wil42.xml,230,8,0,MOT,1833,2264,CHI
0,9,2,69,0.693147181,78,9,wanna,"('MOT', 'CHI')",Providence,wil42.xml,80,2,0,CHI,984,620,MOT
2,16,15,197,0.691597994,213,16,yeah,"('CHI', 'MOT')",Providence,wil42.xml,230,17,2,MOT,1833,2264,CHI
1,7,7,65,0.615185639,72,7,a,"('MOT', 'CHI')",Providence,wil42.xml,80,8,1,CHI,984,620,MOT
1,19,10,200,0.530628251,219,19,on,"('CHI', 'MOT')",Providence,wil42.xml,230,11,1,MOT,1833,2264,CHI
0,4,7,69,0.510825624,73,4,yeah,"('MOT', 'CHI')",Providence,wil42.xml,80,7,0,CHI,984,620,MOT
0,3,9,68,0.506269807,71,3,is,"('MOT', 'CHI')",Providence,wil42.xml,80,9,0,CHI,984,620,MOT
3,28,13,186,0.503905181,214,28,the,"('CHI', 'MOT')",Providence,wil42.xml,230,16,3,MOT,1833,2264,CHI
5,25,22,178,0.48937708,203,25,to,"('CHI', 'MOT')",Providence,wil42.xml,230,27,5,MOT,1833,2264,CHI
0,1,2,10,0.485507816,11,1,to,"('CHI', 'OPE')",Providence,wil42.xml,13,2,0,OPE,95,67,CHI
0,8,13,209,0.483796951,217,8,no,"('CHI', 'MOT')",Providence,wil42.xml,230,13,0,MOT,1833,2264,CHI
0,12,2,66,0.430782916,78,12,it,"('MOT', 'CHI')",Providence,wil42.xml,80,2,0,CHI,984,620,MOT
1,0,1,1,0.405465108,1,0,you,"('MOT', 'OPE')",Providence,wil42.xml,3,2,1,OPE,18,12,MOT
1,6,11,62,0.356674944,68,6,oh,"('MOT', 'CHI')",Providence,wil42.xml,80,12,1,CHI,984,620,MOT
1,6,11,62,0.356674944,68,6,the,"('MOT', 'CHI')",Providence,wil42.xml,80,12,1,CHI,984,620,MOT
3,5,24,48,0.234572247,53,5,you,"('MOT', 'CHI')",Providence,wil42.xml,80,27,3,CHI,984,620,MOT
8,71,12,139,0.18610228,210,71,you,"('CHI', 'MOT')",Providence,wil42.xml,230,20,8,MOT,1833,2264,CHI
0,23,6,201,0.163039627,224,23,oh,"('CHI', 'MOT')",Providence,wil42.xml,230,6,0,MOT,1833,2264,CHI
1,19,16,194,0.123613956,213,19,and,"('CHI', 'MOT')",Providence,wil42.xml,230,17,1,MOT,1833,2264,CHI
0,2,19,59,0,61,2,this,"('MOT', 'CHI')",Providence,wil42.xml,80,19,0,CHI,984,620,MOT
0,5,10,65,0,70,5,and,"('MOT', 'CHI')",Providence,wil42.xml,80,10,0,CHI,984,620,MOT
0,4,1,8,-0.068992871,12,4,you,"('CHI', 'OPE')",Providence,wil42.xml,13,1,0,OPE,95,67,CHI
0,1,1,2,-0.182321557,3,1,is,"('MOT', 'FAT')",Providence,wil42.xml,4,1,0,FAT,24,19,MOT
0,3,1,5,-0.182321557,8,3,you,"('OPE', 'CHI')",Providence,wil42.xml,9,1,0,CHI,45,82,OPE
1,11,13,55,-0.344840486,66,11,to,"('MOT', 'CHI')",Providence,wil42.xml,80,14,1,CHI,984,620,MOT
0,1,1,1,-0.405465108,2,1,the,"('CHI', 'FAT')",Providence,wil42.xml,3,1,0,FAT,22,14,CHI
0,1,2,0,-0.980829253,1,1,you,"('CHI', 'FAT')",Providence,wil42.xml,3,2,0,FAT,22,14,CHI
1,0,1,83,3.749504076,83,0,all,"('FAT', 'CHI')",Providence,wil43.xml,85,2,1,CHI,589,600,FAT
1,0,3,81,3.320228319,81,0,for,"('FAT', 'CHI')",Providence,wil43.xml,85,4,1,CHI,589,600,FAT
1,0,5,79,3.008154794,79,0,like,"('FAT', 'CHI')",Providence,wil43.xml,85,6,1,CHI,589,600,FAT
1,1,3,116,2.987364024,117,1,did,"('CHI', 'FAT')",Providence,wil43.xml,121,4,1,FAT,1140,964,CHI
0,1,2,118,2.716349004,119,1,are,"('CHI', 'FAT')",Providence,wil43.xml,121,2,0,FAT,1140,964,CHI
0,2,1,118,2.606796467,120,2,wanna,"('CHI', 'FAT')",Providence,wil43.xml,121,1,0,FAT,1140,964,CHI
0,2,1,118,2.606796467,120,2,at,"('CHI', 'FAT')",Providence,wil43.xml,121,1,0,FAT,1140,964,CHI
1,1,4,79,2.460809098,80,1,one,"('FAT', 'CHI')",Providence,wil43.xml,85,5,1,CHI,589,600,FAT
0,1,2,82,2.363209715,83,1,in,"('FAT', 'CHI')",Providence,wil43.xml,85,2,0,CHI,589,600,FAT
0,1,2,82,2.363209715,83,1,there,"('FAT', 'CHI')",Providence,wil43.xml,85,2,0,CHI,589,600,FAT
0,3,1,117,2.319114395,120,3,for,"('CHI', 'FAT')",Providence,wil43.xml,121,1,0,FAT,1140,964,CHI
0,3,1,117,2.319114395,120,3,little,"('CHI', 'FAT')",Providence,wil43.xml,121,1,0,FAT,1140,964,CHI
0,2,2,117,2.310883896,119,2,of,"('CHI', 'FAT')",Providence,wil43.xml,121,2,0,FAT,1140,964,CHI
1,5,1,114,2.310883896,119,5,was,"('CHI', 'FAT')",Providence,wil43.xml,121,2,1,FAT,1140,964,CHI
0,2,2,117,2.310883896,119,2,up,"('CHI', 'FAT')",Providence,wil43.xml,121,2,0,FAT,1140,964,CHI
0,2,1,82,2.257122719,84,2,oh,"('FAT', 'CHI')",Providence,wil43.xml,85,1,0,CHI,589,600,FAT
0,2,1,82,2.257122719,84,2,look,"('FAT', 'CHI')",Providence,wil43.xml,85,1,0,CHI,589,600,FAT
1,4,1,79,2.140066163,83,4,see,"('FAT', 'CHI')",Providence,wil43.xml,85,2,1,CHI,589,600,FAT
0,1,3,81,2.128231706,82,1,can,"('FAT', 'CHI')",Providence,wil43.xml,85,3,0,CHI,589,600,FAT
1,6,0,78,2.102972039,84,6,of,"('FAT', 'CHI')",Providence,wil43.xml,85,1,1,CHI,589,600,FAT
0,2,3,116,2.079441542,118,2,look,"('CHI', 'FAT')",Providence,wil43.xml,121,3,0,FAT,1140,964,CHI
0,2,3,116,2.079441542,118,2,one,"('CHI', 'FAT')",Providence,wil43.xml,121,3,0,FAT,1140,964,CHI
0,3,2,116,2.023201823,119,3,what,"('CHI', 'FAT')",Providence,wil43.xml,121,2,0,FAT,1140,964,CHI
0,3,1,81,1.969440646,84,3,but,"('FAT', 'CHI')",Providence,wil43.xml,85,1,0,CHI,589,600,FAT
0,2,2,81,1.957744607,83,2,and,"('FAT', 'CHI')",Providence,wil43.xml,85,2,0,CHI,589,600,FAT
1,3,3,78,1.933933958,81,3,on,"('FAT', 'CHI')",Providence,wil43.xml,85,4,1,CHI,589,600,FAT
0,3,3,115,1.791759469,118,3,oh,"('CHI', 'FAT')",Providence,wil43.xml,121,3,0,FAT,1140,964,CHI
1,1,0,15,1.791759469,16,1,that,"('CHI', 'MOT')",Providence,wil43.xml,17,1,1,MOT,163,118,CHI
1,6,3,111,1.734601055,117,6,can,"('CHI', 'FAT')",Providence,wil43.xml,121,4,1,FAT,1140,964,CHI
1,6,3,111,1.734601055,117,6,on,"('CHI', 'FAT')",Providence,wil43.xml,121,4,1,FAT,1140,964,CHI
0,2,5,114,1.726162187,116,2,want,"('CHI', 'FAT')",Providence,wil43.xml,121,5,0,FAT,1140,964,CHI
0,2,5,114,1.726162187,116,2,all,"('CHI', 'FAT')",Providence,wil43.xml,121,5,0,FAT,1140,964,CHI
1,1,16,103,1.719000115,104,1,my,"('CHI', 'FAT')",Providence,wil43.xml,121,17,1,FAT,1140,964,CHI
2,4,5,74,1.673976434,78,4,this,"('FAT', 'CHI')",Providence,wil43.xml,85,7,2,CHI,589,600,FAT
4,3,18,96,1.660210238,99,3,is,"('CHI', 'FAT')",Providence,wil43.xml,121,22,4,FAT,1140,964,CHI
3,9,4,105,1.640074882,114,9,in,"('CHI', 'FAT')",Providence,wil43.xml,121,7,3,FAT,1140,964,CHI
0,1,6,78,1.621860432,79,1,gonna,"('FAT', 'CHI')",Providence,wil43.xml,85,6,0,CHI,589,600,FAT
0,1,6,78,1.621860432,79,1,not,"('FAT', 'CHI')",Providence,wil43.xml,85,6,0,CHI,589,600,FAT
2,9,1,73,1.617406082,82,9,no,"('FAT', 'CHI')",Providence,wil43.xml,85,3,2,CHI,589,600,FAT
2,6,6,107,1.595049175,113,6,see,"('CHI', 'FAT')",Providence,wil43.xml,121,8,2,FAT,1140,964,CHI
0,4,3,114,1.568615918,118,4,but,"('CHI', 'FAT')",Providence,wil43.xml,121,3,0,FAT,1140,964,CHI
0,4,2,79,1.446918983,83,4,where,"('FAT', 'CHI')",Providence,wil43.xml,85,2,0,CHI,589,600,FAT
0,3,3,79,1.435084525,82,3,put,"('FAT', 'CHI')",Providence,wil43.xml,85,3,0,CHI,589,600,FAT
1,6,5,109,1.429969425,115,6,go,"('CHI', 'FAT')",Providence,wil43.xml,121,6,1,FAT,1140,964,CHI
1,3,11,106,1.377325691,109,3,to,"('CHI', 'FAT')",Providence,wil43.xml,121,12,1,FAT,1140,964,CHI
0,2,5,78,1.36219681,80,2,wanna,"('FAT', 'CHI')",Providence,wil43.xml,85,5,0,CHI,589,600,FAT
2,1,2,12,1.32175584,13,1,to,"('CHI', 'MOT')",Providence,wil43.xml,17,4,2,MOT,163,118,CHI
0,1,9,75,1.265666373,76,1,go,"('FAT', 'CHI')",Providence,wil43.xml,85,9,0,CHI,589,600,FAT
1,4,10,106,1.237258782,110,4,we,"('CHI', 'FAT')",Providence,wil43.xml,121,11,1,FAT,1140,964,CHI
0,4,5,112,1.215336563,116,4,have,"('CHI', 'FAT')",Providence,wil43.xml,121,5,0,FAT,1140,964,CHI
0,5,4,112,1.195604555,117,5,not,"('CHI', 'FAT')",Providence,wil43.xml,121,4,0,FAT,1140,964,CHI
2,4,10,69,1.16760516,73,4,that,"('FAT', 'CHI')",Providence,wil43.xml,85,12,2,CHI,589,600,FAT
0,1,1,15,1.098612289,16,1,wanna,"('CHI', 'MOT')",Providence,wil43.xml,17,1,0,MOT,163,118,CHI
0,1,1,15,1.098612289,16,1,on,"('CHI', 'MOT')",Providence,wil43.xml,17,1,0,MOT,163,118,CHI
1,4,8,72,1.042522822,76,4,it,"('FAT', 'CHI')",Providence,wil43.xml,85,9,1,CHI,589,600,FAT
0,5,3,77,1.029619417,82,5,want,"('FAT', 'CHI')",Providence,wil43.xml,85,3,0,CHI,589,600,FAT
1,9,6,105,0.946927701,114,9,no,"('CHI', 'FAT')",Providence,wil43.xml,121,7,1,FAT,1140,964,CHI
6,10,17,88,0.934309237,98,10,it,"('CHI', 'FAT')",Providence,wil43.xml,121,23,6,FAT,1140,964,CHI
2,11,4,68,0.928713252,79,11,yeah,"('FAT', 'CHI')",Providence,wil43.xml,85,6,2,CHI,589,600,FAT
1,7,5,72,0.928713252,79,7,is,"('FAT', 'CHI')",Providence,wil43.xml,85,6,1,CHI,589,600,FAT
1,11,5,104,0.890972924,115,11,do,"('CHI', 'FAT')",Providence,wil43.xml,121,6,1,FAT,1140,964,CHI
0,6,3,76,0.875468737,82,6,a,"('FAT', 'CHI')",Providence,wil43.xml,85,3,0,CHI,589,600,FAT
3,5,0,9,0.757685702,14,5,you,"('CHI', 'MOT')",Providence,wil43.xml,17,3,3,MOT,163,118,CHI
0,1,2,14,0.753771802,15,1,is,"('CHI', 'MOT')",Providence,wil43.xml,17,2,0,MOT,163,118,CHI
1,9,5,70,0.705569701,79,9,to,"('FAT', 'CHI')",Providence,wil43.xml,85,6,1,CHI,589,600,FAT
0,2,1,14,0.693147181,16,2,yeah,"('CHI', 'MOT')",Providence,wil43.xml,17,1,0,MOT,163,118,CHI
4,19,10,88,0.532464799,107,19,yeah,"('CHI', 'FAT')",Providence,wil43.xml,121,14,4,FAT,1140,964,CHI
1,5,18,97,0.501256173,102,5,and,"('CHI', 'FAT')",Providence,wil43.xml,121,19,1,FAT,1140,964,CHI
0,3,10,72,0.472604411,75,3,do,"('FAT', 'CHI')",Providence,wil43.xml,85,10,0,CHI,589,600,FAT
0,1,3,13,0.470003629,14,1,do,"('CHI', 'MOT')",Providence,wil43.xml,17,3,0,MOT,163,118,CHI
0,4,13,104,0.382992252,108,4,this,"('CHI', 'FAT')",Providence,wil43.xml,121,13,0,FAT,1140,964,CHI
1,11,10,99,0.361790045,110,11,a,"('CHI', 'FAT')",Providence,wil43.xml,121,11,1,FAT,1140,964,CHI
0,2,2,13,0.348306694,15,2,a,"('CHI', 'MOT')",Providence,wil43.xml,17,2,0,MOT,163,118,CHI
0,2,2,13,0.348306694,15,2,the,"('CHI', 'MOT')",Providence,wil43.xml,17,2,0,MOT,163,118,CHI
5,22,15,79,0.199951788,101,22,you,"('CHI', 'FAT')",Providence,wil43.xml,121,20,5,FAT,1140,964,CHI
3,21,12,85,0.144169791,106,21,the,"('CHI', 'FAT')",Providence,wil43.xml,121,15,3,FAT,1140,964,CHI
1,2,5,9,0.080042708,11,2,see,"('CHI', 'MOT')",Providence,wil43.xml,17,6,1,MOT,163,118,CHI
0,7,12,102,-0.00896867,109,7,get,"('CHI', 'FAT')",Providence,wil43.xml,121,12,0,FAT,1140,964,CHI
0,7,12,102,-0.00896867,109,7,there,"('CHI', 'FAT')",Providence,wil43.xml,121,12,0,FAT,1140,964,CHI
0,10,9,102,-0.059592097,112,10,that,"('CHI', 'FAT')",Providence,wil43.xml,121,9,0,FAT,1140,964,CHI
0,6,10,69,-0.087011377,75,6,the,"('FAT', 'CHI')",Providence,wil43.xml,85,10,0,CHI,589,600,FAT
0,3,23,59,-0.446287103,62,3,you,"('FAT', 'CHI')",Providence,wil43.xml,85,23,0,CHI,589,600,FAT
1,0,1,179,4.505349851,179,0,little,"('FAT', 'CHI')",Providence,wil44.xml,181,2,1,CHI,1259,1309,FAT
1,0,4,176,3.929020582,176,0,think,"('FAT', 'CHI')",Providence,wil44.xml,181,5,1,CHI,1259,1309,FAT
1,1,1,178,3.81220267,179,1,he,"('FAT', 'CHI')",Providence,wil44.xml,181,2,1,CHI,1259,1309,FAT
1,0,6,174,3.666406598,174,0,for,"('FAT', 'CHI')",Providence,wil44.xml,181,7,1,CHI,1259,1309,FAT
0,1,1,179,3.412247218,180,1,big,"('FAT', 'CHI')",Providence,wil44.xml,181,1,0,CHI,1259,1309,FAT
0,1,1,167,3.344038968,168,1,some,"('CHI', 'FAT')",Providence,wil44.xml,169,1,0,FAT,1077,1414,CHI
0,1,2,178,3.11905549,179,1,of,"('FAT', 'CHI')",Providence,wil44.xml,181,2,0,CHI,1259,1309,FAT
0,1,2,178,3.11905549,179,1,did,"('FAT', 'CHI')",Providence,wil44.xml,181,2,0,CHI,1259,1309,FAT
0,1,2,178,3.11905549,179,1,up,"('FAT', 'CHI')",Providence,wil44.xml,181,2,0,CHI,1259,1309,FAT
1,0,1,43,3.113515309,43,0,put,"('OPE', 'CHI')",Providence,wil44.xml,45,2,1,CHI,232,307,OPE
1,1,5,174,3.096708191,175,1,put,"('FAT', 'CHI')",Providence,wil44.xml,181,6,1,CHI,1259,1309,FAT
0,1,2,166,3.050457173,167,1,he,"('CHI', 'FAT')",Providence,wil44.xml,169,2,0,FAT,1077,1414,CHI
0,2,1,178,3.00678211,180,2,gonna,"('FAT', 'CHI')",Providence,wil44.xml,181,1,0,CHI,1259,1309,FAT
0,2,1,178,3.00678211,180,2,at,"('FAT', 'CHI')",Providence,wil44.xml,181,1,0,CHI,1259,1309,FAT
0,2,1,166,2.93857386,168,2,they,"('CHI', 'FAT')",Providence,wil44.xml,169,1,0,FAT,1077,1414,CHI
1,2,3,163,2.920769235,165,2,want,"('CHI', 'FAT')",Providence,wil44.xml,169,4,1,FAT,1077,1414,CHI
0,1,3,177,2.890371758,178,1,but,"('FAT', 'CHI')",Providence,wil44.xml,181,3,0,CHI,1259,1309,FAT
1,2,4,174,2.830408293,176,2,we,"('FAT', 'CHI')",Providence,wil44.xml,181,5,1,CHI,1259,1309,FAT
1,1,0,43,2.730029108,44,1,he,"('OPE', 'CHI')",Providence,wil44.xml,45,1,1,CHI,232,307,OPE
0,2,2,177,2.713590381,179,2,look,"('FAT', 'CHI')",Providence,wil44.xml,181,2,0,CHI,1259,1309,FAT
3,3,6,157,2.689701062,160,3,where,"('CHI', 'FAT')",Providence,wil44.xml,169,9,3,FAT,1077,1414,CHI
0,3,1,165,2.650891787,168,3,gonna,"('CHI', 'FAT')",Providence,wil44.xml,169,1,0,FAT,1077,1414,CHI
0,3,1,165,2.650891787,168,3,little,"('CHI', 'FAT')",Providence,wil44.xml,169,1,0,FAT,1077,1414,CHI
0,3,1,165,2.650891787,168,3,up,"('CHI', 'FAT')",Providence,wil44.xml,169,1,0,FAT,1077,1414,CHI
1,0,0,17,2.538973871,17,0,to,"('CHI', 'OPE')",Providence,wil44.xml,18,1,1,OPE,115,75,CHI
0,2,3,176,2.48490665,178,2,wanna,"('FAT', 'CHI')",Providence,wil44.xml,181,3,0,CHI,1259,1309,FAT
3,4,7,167,2.445241393,171,4,like,"('FAT', 'CHI')",Providence,wil44.xml,181,10,3,CHI,1259,1309,FAT
0,4,1,164,2.427748236,168,4,with,"('CHI', 'FAT')",Providence,wil44.xml,169,1,0,FAT,1077,1414,CHI
0,4,1,164,2.427748236,168,4,at,"('CHI', 'FAT')",Providence,wil44.xml,169,1,0,FAT,1077,1414,CHI
0,2,3,164,2.415913778,166,2,have,"('CHI', 'FAT')",Providence,wil44.xml,169,3,0,FAT,1077,1414,CHI
0,2,3,164,2.415913778,166,2,was,"('CHI', 'FAT')",Providence,wil44.xml,169,3,0,FAT,1077,1414,CHI
0,3,2,164,2.357309993,167,3,look,"('CHI', 'FAT')",Providence,wil44.xml,169,2,0,FAT,1077,1414,CHI
0,3,2,164,2.357309993,167,3,but,"('CHI', 'FAT')",Providence,wil44.xml,169,2,0,FAT,1077,1414,CHI
0,3,2,164,2.357309993,167,3,wanna,"('CHI', 'FAT')",Providence,wil44.xml,169,2,0,FAT,1077,1414,CHI
0,2,4,175,2.297014048,177,2,have,"('FAT', 'CHI')",Providence,wil44.xml,181,4,0,CHI,1259,1309,FAT
0,2,4,175,2.297014048,177,2,are,"('FAT', 'CHI')",Providence,wil44.xml,181,4,0,CHI,1259,1309,FAT
0,2,4,175,2.297014048,177,2,not,"('FAT', 'CHI')",Providence,wil44.xml,181,4,0,CHI,1259,1309,FAT
1,5,3,160,2.227622055,165,5,we,"('CHI', 'FAT')",Providence,wil44.xml,169,4,1,FAT,1077,1414,CHI
2,5,6,156,2.098017927,161,5,and,"('CHI', 'FAT')",Providence,wil44.xml,169,8,2,FAT,1077,1414,CHI
0,6,1,162,2.091275999,168,6,of,"('CHI', 'FAT')",Providence,wil44.xml,169,1,0,FAT,1077,1414,CHI
1,0,4,26,2.079441542,26,0,and,"('MOT', 'CHI')",Providence,wil44.xml,31,5,1,CHI,276,222,MOT
0,1,1,43,2.036881927,44,1,one,"('OPE', 'CHI')",Providence,wil44.xml,45,1,0,CHI,232,307,OPE
0,3,4,174,2.009331975,177,3,some,"('FAT', 'CHI')",Providence,wil44.xml,181,4,0,CHI,1259,1309,FAT
0,4,3,174,1.974081026,178,4,can,"('FAT', 'CHI')",Providence,wil44.xml,181,3,0,CHI,1259,1309,FAT
0,7,1,161,1.957744607,168,7,did,"('CHI', 'FAT')",Providence,wil44.xml,169,1,0,FAT,1077,1414,CHI
1,0,2,15,1.916922612,15,0,the,"('CHI', 'OPE')",Providence,wil44.xml,18,3,1,OPE,115,75,CHI
0,4,3,162,1.905088155,166,4,not,"('CHI', 'FAT')",Providence,wil44.xml,169,3,0,FAT,1077,1414,CHI
0,2,7,172,1.874647129,174,2,on,"('FAT', 'CHI')",Providence,wil44.xml,181,7,0,CHI,1259,1309,FAT
0,3,5,173,1.84957904,176,3,one,"('FAT', 'CHI')",Providence,wil44.xml,181,5,0,CHI,1259,1309,FAT
1,8,3,157,1.822156946,165,8,no,"('CHI', 'FAT')",Providence,wil44.xml,169,4,1,FAT,1077,1414,CHI
2,6,8,165,1.821087084,171,6,see,"('FAT', 'CHI')",Providence,wil44.xml,181,10,2,CHI,1259,1309,FAT
0,1,1,34,1.819158443,35,1,wanna,"('CHI', 'MOT')",Providence,wil44.xml,36,1,0,MOT,258,212,CHI
0,1,1,34,1.819158443,35,1,where,"('CHI', 'MOT')",Providence,wil44.xml,36,1,0,MOT,258,212,CHI
5,8,11,145,1.747588251,153,8,do,"('CHI', 'FAT')",Providence,wil44.xml,169,16,5,FAT,1077,1414,CHI
0,1,2,42,1.727220948,43,1,have,"('OPE', 'CHI')",Providence,wil44.xml,45,2,0,CHI,232,307,OPE
0,1,2,42,1.727220948,43,1,at,"('OPE', 'CHI')",Providence,wil44.xml,45,2,0,CHI,232,307,OPE
0,5,3,161,1.722766598,166,5,go,"('CHI', 'FAT')",Providence,wil44.xml,169,3,0,FAT,1077,1414,CHI
1,4,9,155,1.680206983,159,4,one,"('CHI', 'FAT')",Providence,wil44.xml,169,10,1,FAT,1077,1414,CHI
0,1,1,29,1.673976434,30,1,get,"('MOT', 'CHI')",Providence,wil44.xml,31,1,0,CHI,276,222,MOT
0,1,1,29,1.673976434,30,1,see,"('MOT', 'CHI')",Providence,wil44.xml,31,1,0,CHI,276,222,MOT
0,1,1,29,1.673976434,30,1,he,"('MOT', 'CHI')",Providence,wil44.xml,31,1,0,CHI,276,222,MOT
1,5,0,39,1.631416819,44,5,go,"('OPE', 'CHI')",Providence,wil44.xml,45,1,1,CHI,232,307,OPE
1,10,3,155,1.621486251,165,10,like,"('CHI', 'FAT')",Providence,wil44.xml,169,4,1,FAT,1077,1414,CHI
1,2,3,39,1.563975538,41,2,is,"('OPE', 'CHI')",Providence,wil44.xml,45,4,1,CHI,232,307,OPE
0,1,2,33,1.504077397,34,1,yeah,"('CHI', 'MOT')",Providence,wil44.xml,36,2,0,MOT,258,212,CHI
1,9,5,154,1.41706602,163,9,this,"('CHI', 'FAT')",Providence,wil44.xml,169,6,1,FAT,1077,1414,CHI
0,2,1,33,1.413693335,35,2,oh,"('CHI', 'MOT')",Providence,wil44.xml,36,1,0,MOT,258,212,CHI
0,2,1,33,1.413693335,35,2,he,"('CHI', 'MOT')",Providence,wil44.xml,36,1,0,MOT,258,212,CHI
0,2,1,33,1.413693335,35,2,are,"('CHI', 'MOT')",Providence,wil44.xml,36,1,0,MOT,258,212,CHI
3,3,2,23,1.386294361,26,3,what,"('MOT', 'CHI')",Providence,wil44.xml,31,5,3,CHI,276,222,MOT
0,8,3,170,1.386294361,178,8,want,"('FAT', 'CHI')",Providence,wil44.xml,181,3,0,CHI,1259,1309,FAT
1,17,2,161,1.386294361,178,17,this,"('FAT', 'CHI')",Providence,wil44.xml,181,3,1,CHI,1259,1309,FAT
1,13,3,152,1.380324194,165,13,on,"('CHI', 'FAT')",Providence,wil44.xml,169,4,1,FAT,1077,1414,CHI
4,16,6,143,1.372722284,159,16,that,"('CHI', 'FAT')",Providence,wil44.xml,169,10,4,FAT,1077,1414,CHI
0,1,2,28,1.354545663,29,1,oh,"('MOT', 'CHI')",Providence,wil44.xml,31,2,0,CHI,276,222,MOT
0,2,2,41,1.32175584,43,2,like,"('OPE', 'CHI')",Providence,wil44.xml,45,2,0,CHI,232,307,OPE
1,7,8,153,1.303406701,160,7,can,"('CHI', 'FAT')",Providence,wil44.xml,169,9,1,FAT,1077,1414,CHI
0,2,1,28,1.268511325,30,2,yeah,"('MOT', 'CHI')",Providence,wil44.xml,31,1,0,CHI,276,222,MOT
0,2,1,28,1.268511325,30,2,with,"('MOT', 'CHI')",Providence,wil44.xml,31,1,0,CHI,276,222,MOT
0,2,1,28,1.268511325,30,2,is,"('MOT', 'CHI')",Providence,wil44.xml,31,1,0,CHI,276,222,MOT
0,2,1,28,1.268511325,30,2,that,"('MOT', 'CHI')",Providence,wil44.xml,31,1,0,CHI,276,222,MOT
0,2,1,28,1.268511325,30,2,on,"('MOT', 'CHI')",Providence,wil44.xml,31,1,0,CHI,276,222,MOT
1,10,6,164,1.268511325,174,10,in,"('FAT', 'CHI')",Providence,wil44.xml,181,7,1,CHI,1259,1309,FAT
1,6,0,29,1.259542655,35,6,what,"('CHI', 'MOT')",Providence,wil44.xml,36,1,1,MOT,258,212,CHI
0,1,3,32,1.252762968,33,1,no,"('CHI', 'MOT')",Providence,wil44.xml,36,3,0,MOT,258,212,CHI
0,1,3,32,1.252762968,33,1,that,"('CHI', 'MOT')",Providence,wil44.xml,36,3,0,MOT,258,212,CHI
0,7,4,158,1.246792802,165,7,there,"('CHI', 'FAT')",Providence,wil44.xml,169,4,0,FAT,1077,1414,CHI
1,20,2,158,1.232143681,178,20,to,"('FAT', 'CHI')",Providence,wil44.xml,181,3,1,CHI,1259,1309,FAT
0,3,10,156,1.210203354,159,3,my,"('CHI', 'FAT')",Providence,wil44.xml,169,10,0,FAT,1077,1414,CHI
1,0,0,3,1.203972804,3,0,what,"('MOT', 'OPE')",Providence,wil44.xml,4,1,1,OPE,17,21,MOT
1,0,0,3,1.203972804,3,0,you,"('OPE', 'MOT')",Providence,wil44.xml,4,1,1,MOT,16,37,OPE
1,0,0,3,1.203972804,3,0,what,"('OPE', 'MOT')",Providence,wil44.xml,4,1,1,MOT,16,37,OPE
1,7,10,163,1.196250758,170,7,and,"('FAT', 'CHI')",Providence,wil44.xml,181,11,1,CHI,1259,1309,FAT
1,6,1,37,1.16760516,43,6,on,"('OPE', 'CHI')",Providence,wil44.xml,45,2,1,CHI,232,307,OPE
0,1,1,16,1.15267951,17,1,you,"('CHI', 'OPE')",Providence,wil44.xml,18,1,0,OPE,115,75,CHI
0,1,1,16,1.15267951,17,1,see,"('CHI', 'OPE')",Providence,wil44.xml,18,1,0,OPE,115,75,CHI
2,14,7,158,1.151722114,172,14,go,"('FAT', 'CHI')",Providence,wil44.xml,181,9,2,CHI,1259,1309,FAT
1,2,4,29,1.145132304,31,2,it,"('CHI', 'MOT')",Providence,wil44.xml,36,5,1,MOT,258,212,CHI
0,3,1,32,1.126011263,35,3,this,"('CHI', 'MOT')",Providence,wil44.xml,36,1,0,MOT,258,212,CHI
0,2,2,32,1.098612289,34,2,is,"('CHI', 'MOT')",Providence,wil44.xml,36,2,0,MOT,258,212,CHI
0,1,3,27,1.098612289,28,1,up,"('MOT', 'CHI')",Providence,wil44.xml,31,3,0,CHI,276,222,MOT
0,1,3,27,1.098612289,28,1,no,"('MOT', 'CHI')",Providence,wil44.xml,31,3,0,CHI,276,222,MOT
0,1,3,27,1.098612289,28,1,wanna,"('MOT', 'CHI')",Providence,wil44.xml,31,3,0,CHI,276,222,MOT
0,1,5,39,1.098612289,40,1,oh,"('OPE', 'CHI')",Providence,wil44.xml,45,5,0,CHI,232,307,OPE
0,2,3,40,1.076139433,42,2,gonna,"('OPE', 'CHI')",Providence,wil44.xml,45,3,0,CHI,232,307,OPE
0,3,2,40,1.034073768,43,3,no,"('OPE', 'CHI')",Providence,wil44.xml,45,2,0,CHI,232,307,OPE
0,3,2,40,1.034073768,43,3,that,"('OPE', 'CHI')",Providence,wil44.xml,45,2,0,CHI,232,307,OPE
2,7,2,34,0.988611393,41,7,to,"('OPE', 'CHI')",Providence,wil44.xml,45,4,2,CHI,232,307,OPE
0,8,5,156,0.968853062,164,8,in,"('CHI', 'FAT')",Providence,wil44.xml,169,5,0,FAT,1077,1414,CHI
2,5,4,34,0.940983344,39,5,it,"('OPE', 'CHI')",Providence,wil44.xml,45,6,2,CHI,232,307,OPE
1,0,1,3,0.916290732,3,0,it,"('MOT', 'FAT')",Providence,wil44.xml,5,2,1,FAT,65,29,MOT
1,17,5,158,0.899483614,175,17,no,"('FAT', 'CHI')",Providence,wil44.xml,181,6,1,CHI,1259,1309,FAT
1,16,5,147,0.886437769,163,16,see,"('CHI', 'FAT')",Providence,wil44.xml,169,6,1,FAT,1077,1414,CHI
0,1,4,26,0.88238918,27,1,go,"('MOT', 'CHI')",Providence,wil44.xml,31,4,0,CHI,276,222,MOT
1,10,10,160,0.877797027,170,10,there,"('FAT', 'CHI')",Providence,wil44.xml,181,11,1,CHI,1259,1309,FAT
0,2,4,39,0.870828358,41,2,and,"('OPE', 'CHI')",Providence,wil44.xml,45,4,0,CHI,232,307,OPE
0,2,3,31,0.84729786,33,2,was,"('CHI', 'MOT')",Providence,wil44.xml,36,3,0,MOT,258,212,CHI
1,2,6,27,0.831297519,29,2,the,"('CHI', 'MOT')",Providence,wil44.xml,36,7,1,MOT,258,212,CHI
0,1,2,15,0.810930216,16,1,is,"('CHI', 'OPE')",Providence,wil44.xml,18,2,0,OPE,115,75,CHI
0,4,2,39,0.810930216,43,4,a,"('OPE', 'CHI')",Providence,wil44.xml,45,2,0,CHI,232,307,OPE
1,3,1,13,0.810930216,16,3,oh,"('CHI', 'OPE')",Providence,wil44.xml,18,2,1,OPE,115,75,CHI
7,17,20,125,0.791587253,142,17,yeah,"('CHI', 'FAT')",Providence,wil44.xml,169,27,7,FAT,1077,1414,CHI
0,2,1,15,0.747214402,17,2,it,"('CHI', 'OPE')",Providence,wil44.xml,18,1,0,OPE,115,75,CHI
2,2,12,29,0.723918839,31,2,you,"('OPE', 'CHI')",Providence,wil44.xml,45,14,2,CHI,232,307,OPE
5,15,20,129,0.706940503,144,15,it,"('CHI', 'FAT')",Providence,wil44.xml,169,25,5,FAT,1077,1414,CHI
3,16,13,137,0.706134376,153,16,to,"('CHI', 'FAT')",Providence,wil44.xml,169,16,3,FAT,1077,1414,CHI
2,8,3,32,0.693147181,40,8,yeah,"('OPE', 'CHI')",Providence,wil44.xml,45,5,2,CHI,232,307,OPE
1,0,1,2,0.693147181,2,0,do,"('OPE', 'MOT')",Providence,wil44.xml,4,2,1,MOT,16,37,OPE
0,2,3,26,0.693147181,28,2,a,"('MOT', 'CHI')",Providence,wil44.xml,31,3,0,CHI,276,222,MOT
0,2,3,26,0.693147181,28,2,do,"('MOT', 'CHI')",Providence,wil44.xml,31,3,0,CHI,276,222,MOT
4,18,16,143,0.667706681,161,18,it,"('FAT', 'CHI')",Providence,wil44.xml,181,20,4,CHI,1259,1309,FAT
1,13,9,146,0.650587566,159,13,oh,"('CHI', 'FAT')",Providence,wil44.xml,169,10,1,FAT,1077,1414,CHI
5,24,14,138,0.628227634,162,24,the,"('FAT', 'CHI')",Providence,wil44.xml,181,19,5,CHI,1259,1309,FAT
2,16,11,140,0.619943777,156,16,a,"('CHI', 'FAT')",Providence,wil44.xml,169,13,2,FAT,1077,1414,CHI
0,14,4,151,0.618184142,165,14,what,"('CHI', 'FAT')",Providence,wil44.xml,169,4,0,FAT,1077,1414,CHI
1,7,2,26,0.559615788,33,7,you,"('CHI', 'MOT')",Providence,wil44.xml,36,3,1,MOT,258,212,CHI
1,12,12,156,0.555946059,168,12,oh,"('FAT', 'CHI')",Providence,wil44.xml,181,13,1,CHI,1259,1309,FAT
0,2,6,37,0.535518236,39,2,what,"('OPE', 'CHI')",Providence,wil44.xml,45,6,0,CHI,232,307,OPE
0,9,8,152,0.488580015,161,9,are,"('CHI', 'FAT')",Providence,wil44.xml,169,8,0,FAT,1077,1414,CHI
1,5,3,22,0.476924072,27,5,the,"('MOT', 'CHI')",Providence,wil44.xml,31,4,1,CHI,276,222,MOT
0,2,5,29,0.451985124,31,2,a,"('CHI', 'MOT')",Providence,wil44.xml,36,5,0,MOT,258,212,CHI
1,11,14,143,0.424883194,154,11,is,"('CHI', 'FAT')",Providence,wil44.xml,169,15,1,FAT,1077,1414,CHI
0,6,1,24,0.421213465,30,6,to,"('MOT', 'CHI')",Providence,wil44.xml,31,1,0,CHI,276,222,MOT
1,3,7,25,0.405465108,28,3,and,"('CHI', 'MOT')",Providence,wil44.xml,36,8,1,MOT,258,212,CHI
0,3,5,37,0.405465108,40,3,do,"('OPE', 'CHI')",Providence,wil44.xml,45,5,0,CHI,232,307,OPE
0,2,1,8,0.287682072,10,2,at,"('OPE', 'FAT')",Providence,wil44.xml,11,1,0,FAT,60,143,OPE
4,14,33,130,0.221432687,144,14,you,"('FAT', 'CHI')",Providence,wil44.xml,181,37,4,CHI,1259,1309,FAT
5,21,28,127,0.156004248,148,21,that,"('FAT', 'CHI')",Providence,wil44.xml,181,33,5,CHI,1259,1309,FAT
0,2,3,13,0.125163143,15,2,yeah,"('CHI', 'OPE')",Providence,wil44.xml,18,3,0,OPE,115,75,CHI
1,4,1,5,0.09531018,9,4,you,"('OPE', 'FAT')",Providence,wil44.xml,11,2,1,FAT,60,143,OPE
0,8,15,158,0.093526058,166,8,do,"('FAT', 'CHI')",Providence,wil44.xml,181,15,0,CHI,1259,1309,FAT
7,37,20,105,0.044372852,142,37,you,"('CHI', 'FAT')",Providence,wil44.xml,169,27,7,FAT,1077,1414,CHI
0,1,1,3,0,4,1,oh,"('MOT', 'FAT')",Providence,wil44.xml,5,1,0,FAT,65,29,MOT
0,1,1,3,0,4,1,is,"('MOT', 'FAT')",Providence,wil44.xml,5,1,0,FAT,65,29,MOT
0,1,1,3,0,4,1,the,"('MOT', 'FAT')",Providence,wil44.xml,5,1,0,FAT,65,29,MOT
0,7,2,22,-0.031748698,29,7,it,"('MOT', 'CHI')",Providence,wil44.xml,31,2,0,CHI,276,222,MOT
1,10,27,143,-0.062520357,153,10,what,"('FAT', 'CHI')",Providence,wil44.xml,181,28,1,CHI,1259,1309,FAT
3,31,18,129,-0.127339422,160,31,is,"('FAT', 'CHI')",Providence,wil44.xml,181,21,3,CHI,1259,1309,FAT
0,9,3,33,-0.127833372,42,9,the,"('OPE', 'CHI')",Providence,wil44.xml,45,3,0,CHI,232,307,OPE
0,1,1,2,-0.182321557,3,1,can,"('MOT', 'OPE')",Providence,wil44.xml,4,1,0,OPE,17,21,MOT
0,1,1,2,-0.182321557,3,1,there,"('OPE', 'MOT')",Providence,wil44.xml,4,1,0,MOT,16,37,OPE
1,17,22,141,-0.340926587,158,17,a,"('FAT', 'CHI')",Providence,wil44.xml,181,23,1,CHI,1259,1309,FAT
0,3,2,6,-0.374693449,9,3,it,"('OPE', 'FAT')",Providence,wil44.xml,11,2,0,FAT,60,143,OPE
0,3,2,6,-0.374693449,9,3,that,"('OPE', 'FAT')",Providence,wil44.xml,11,2,0,FAT,60,143,OPE
1,17,26,137,-0.5146644,154,17,yeah,"('FAT', 'CHI')",Providence,wil44.xml,181,27,1,CHI,1259,1309,FAT
0,13,21,135,-0.763916251,148,13,the,"('CHI', 'FAT')",Providence,wil44.xml,169,21,0,FAT,1077,1414,CHI
0,4,10,17,-0.958850346,21,4,you,"('MOT', 'CHI')",Providence,wil44.xml,31,10,0,CHI,276,222,MOT
